Total Runs,Current Run,Streak Target,Flips Required,Theoretical Flips,Absolute Difference,Percentage Difference
1,1,1,0,2,-2,-100.0
1,1,2,4,4,0,0.0
1,1,3,14,8,6,75.0
1,1,4,25,16,9,56.25
1,1,5,44,32,12,37.5
1,1,6,33,64,-31,-48.4375
1,1,7,220,128,92,71.875
1,1,8,51,256,-205,-80.078125
1,1,9,784,512,272,53.125
1,1,10,845,1024,-179,-17.48046875
1,1,11,184,2048,-1864,-91.015625
1,1,12,1234,4096,-2862,-69.873046875
1,1,13,4368,8192,-3824,-46.6796875
1,1,14,38677,16384,22293,136.065673828125
1,1,15,1118,32768,-31650,-96.588134765625
2,1,1,0,2,-2,-100.0
2,1,2,1,4,-3,-75.0
2,1,3,5,8,-3,-37.5
2,1,4,5,16,-11,-68.75
2,1,5,22,32,-10,-31.25
2,1,6,35,64,-29,-45.3125
2,1,7,54,128,-74,-57.8125
2,1,8,84,256,-172,-67.1875
2,1,9,1744,512,1232,240.625
2,1,10,1555,1024,531,51.85546875
2,1,11,1400,2048,-648,-31.640625
2,1,12,545,4096,-3551,-86.6943359375
2,1,13,7734,8192,-458,-5.5908203125
2,1,14,6480,16384,-9904,-60.44921875
2,1,15,18871,32768,-13897,-42.4102783203125
2,2,1,0,2,-2,-100.0
2,2,2,4,4,0,0.0
2,2,3,16,8,8,100.0
2,2,4,15,16,-1,-6.25
2,2,5,37,32,5,15.625
2,2,6,43,64,-21,-32.8125
2,2,7,82,128,-46,-35.9375
2,2,8,92,256,-164,-64.0625
2,2,9,53,512,-459,-89.6484375
2,2,10,447,1024,-577,-56.34765625
2,2,11,2088,2048,40,1.953125
2,2,12,1972,4096,-2124,-51.85546875
2,2,13,36312,8192,28120,343.26171875
2,2,14,31334,16384,14950,91.24755859375
2,2,15,73025,32768,40257,122.8546142578125
3,1,1,0,2,-2,-100.0
3,1,2,1,4,-3,-75.0
3,1,3,8,8,0,0.0
3,1,4,17,16,1,6.25
3,1,5,13,32,-19,-59.375
3,1,6,7,64,-57,-89.0625
3,1,7,151,128,23,17.96875
3,1,8,37,256,-219,-85.546875
3,1,9,139,512,-373,-72.8515625
3,1,10,242,1024,-782,-76.3671875
3,1,11,180,2048,-1868,-91.2109375
3,1,12,2531,4096,-1565,-38.2080078125
3,1,13,11072,8192,2880,35.15625
3,1,14,2235,16384,-14149,-86.358642578125
3,1,15,19915,32768,-12853,-39.2242431640625
3,2,1,0,2,-2,-100.0
3,2,2,2,4,-2,-50.0
3,2,3,3,8,-5,-62.5
3,2,4,21,16,5,31.25
3,2,5,26,32,-6,-18.75
3,2,6,21,64,-43,-67.1875
3,2,7,58,128,-70,-54.6875
3,2,8,34,256,-222,-86.71875
3,2,9,234,512,-278,-54.296875
3,2,10,216,1024,-808,-78.90625
3,2,11,874,2048,-1174,-57.32421875
3,2,12,1407,4096,-2689,-65.6494140625
3,2,13,10691,8192,2499,30.50537109375
3,2,14,11668,16384,-4716,-28.7841796875
3,2,15,53034,32768,20266,61.846923828125
3,3,1,0,2,-2,-100.0
3,3,2,11,4,7,175.0
3,3,3,4,8,-4,-50.0
3,3,4,6,16,-10,-62.5
3,3,5,5,32,-27,-84.375
3,3,6,40,64,-24,-37.5
3,3,7,103,128,-25,-19.53125
3,3,8,410,256,154,60.15625
3,3,9,248,512,-264,-51.5625
3,3,10,259,1024,-765,-74.70703125
3,3,11,1896,2048,-152,-7.421875
3,3,12,4457,4096,361,8.8134765625
3,3,13,2868,8192,-5324,-64.990234375
3,3,14,19229,16384,2845,17.364501953125
3,3,15,42585,32768,9817,29.9591064453125
4,1,1,0,2,-2,-100.0
4,1,2,2,4,-2,-50.0
4,1,3,2,8,-6,-75.0
4,1,4,22,16,6,37.5
4,1,5,5,32,-27,-84.375
4,1,6,55,64,-9,-14.0625
4,1,7,339,128,211,164.84375
4,1,8,209,256,-47,-18.359375
4,1,9,459,512,-53,-10.3515625
4,1,10,707,1024,-317,-30.95703125
4,1,11,2558,2048,510,24.90234375
4,1,12,3926,4096,-170,-4.150390625
4,1,13,3120,8192,-5072,-61.9140625
4,1,14,7866,16384,-8518,-51.98974609375
4,1,15,55009,32768,22241,67.8741455078125
4,2,1,0,2,-2,-100.0
4,2,2,1,4,-3,-75.0
4,2,3,6,8,-2,-25.0
4,2,4,5,16,-11,-68.75
4,2,5,13,32,-19,-59.375
4,2,6,100,64,36,56.25
4,2,7,134,128,6,4.6875
4,2,8,238,256,-18,-7.03125
4,2,9,294,512,-218,-42.578125
4,2,10,773,1024,-251,-24.51171875
4,2,11,242,2048,-1806,-88.18359375
4,2,12,455,4096,-3641,-88.8916015625
4,2,13,7133,8192,-1059,-12.92724609375
4,2,14,974,16384,-15410,-94.05517578125
4,2,15,66656,32768,33888,103.41796875
4,3,1,0,2,-2,-100.0
4,3,2,1,4,-3,-75.0
4,3,3,2,8,-6,-75.0
4,3,4,3,16,-13,-81.25
4,3,5,129,32,97,303.125
4,3,6,38,64,-26,-40.625
4,3,7,92,128,-36,-28.125
4,3,8,90,256,-166,-64.84375
4,3,9,508,512,-4,-0.78125
4,3,10,1229,1024,205,20.01953125
4,3,11,4336,2048,2288,111.71875
4,3,12,2360,4096,-1736,-42.3828125
4,3,13,1813,8192,-6379,-77.86865234375
4,3,14,11109,16384,-5275,-32.196044921875
4,3,15,15678,32768,-17090,-52.154541015625
4,4,1,0,2,-2,-100.0
4,4,2,3,4,-1,-25.0
4,4,3,6,8,-2,-25.0
4,4,4,3,16,-13,-81.25
4,4,5,23,32,-9,-28.125
4,4,6,32,64,-32,-50.0
4,4,7,250,128,122,95.3125
4,4,8,17,256,-239,-93.359375
4,4,9,273,512,-239,-46.6796875
4,4,10,55,1024,-969,-94.62890625
4,4,11,5365,2048,3317,161.962890625
4,4,12,4527,4096,431,10.5224609375
4,4,13,13742,8192,5550,67.7490234375
4,4,14,3337,16384,-13047,-79.632568359375
4,4,15,43153,32768,10385,31.6925048828125
5,1,1,0,2,-2,-100.0
5,1,2,5,4,1,25.0
5,1,3,2,8,-6,-75.0
5,1,4,13,16,-3,-18.75
5,1,5,71,32,39,121.875
5,1,6,92,64,28,43.75
5,1,7,10,128,-118,-92.1875
5,1,8,340,256,84,32.8125
5,1,9,307,512,-205,-40.0390625
5,1,10,2341,1024,1317,128.61328125
5,1,11,1281,2048,-767,-37.451171875
5,1,12,2331,4096,-1765,-43.0908203125
5,1,13,4092,8192,-4100,-50.048828125
5,1,14,4960,16384,-11424,-69.7265625
5,1,15,29736,32768,-3032,-9.2529296875
5,2,1,0,2,-2,-100.0
5,2,2,5,4,1,25.0
5,2,3,2,8,-6,-75.0
5,2,4,8,16,-8,-50.0
5,2,5,33,32,1,3.125
5,2,6,122,64,58,90.625
5,2,7,36,128,-92,-71.875
5,2,8,339,256,83,32.421875
5,2,9,229,512,-283,-55.2734375
5,2,10,255,1024,-769,-75.09765625
5,2,11,1445,2048,-603,-29.443359375
5,2,12,1345,4096,-2751,-67.1630859375
5,2,13,4008,8192,-4184,-51.07421875
5,2,14,12670,16384,-3714,-22.66845703125
5,2,15,7533,32768,-25235,-77.0111083984375
5,3,1,0,2,-2,-100.0
5,3,2,3,4,-1,-25.0
5,3,3,21,8,13,162.5
5,3,4,11,16,-5,-31.25
5,3,5,39,32,7,21.875
5,3,6,109,64,45,70.3125
5,3,7,348,128,220,171.875
5,3,8,7,256,-249,-97.265625
5,3,9,312,512,-200,-39.0625
5,3,10,2933,1024,1909,186.42578125
5,3,11,4156,2048,2108,102.9296875
5,3,12,66,4096,-4030,-98.388671875
5,3,13,12507,8192,4315,52.67333984375
5,3,14,3635,16384,-12749,-77.813720703125
5,3,15,8127,32768,-24641,-75.1983642578125
5,4,1,0,2,-2,-100.0
5,4,2,1,4,-3,-75.0
5,4,3,9,8,1,12.5
5,4,4,6,16,-10,-62.5
5,4,5,5,32,-27,-84.375
5,4,6,19,64,-45,-70.3125
5,4,7,109,128,-19,-14.84375
5,4,8,99,256,-157,-61.328125
5,4,9,56,512,-456,-89.0625
5,4,10,1833,1024,809,79.00390625
5,4,11,4884,2048,2836,138.4765625
5,4,12,2012,4096,-2084,-50.87890625
5,4,13,6483,8192,-1709,-20.86181640625
5,4,14,717,16384,-15667,-95.623779296875
5,4,15,26883,32768,-5885,-17.9595947265625
5,5,1,0,2,-2,-100.0
5,5,2,1,4,-3,-75.0
5,5,3,3,8,-5,-62.5
5,5,4,8,16,-8,-50.0
5,5,5,4,32,-28,-87.5
5,5,6,16,64,-48,-75.0
5,5,7,52,128,-76,-59.375
5,5,8,97,256,-159,-62.109375
5,5,9,77,512,-435,-84.9609375
5,5,10,106,1024,-918,-89.6484375
5,5,11,2156,2048,108,5.2734375
5,5,12,2269,4096,-1827,-44.6044921875
5,5,13,5360,8192,-2832,-34.5703125
5,5,14,1568,16384,-14816,-90.4296875
5,5,15,33805,32768,1037,3.1646728515625
6,1,1,0,2,-2,-100.0
6,1,2,2,4,-2,-50.0
6,1,3,4,8,-4,-50.0
6,1,4,84,16,68,425.0
6,1,5,16,32,-16,-50.0
6,1,6,18,64,-46,-71.875
6,1,7,304,128,176,137.5
6,1,8,64,256,-192,-75.0
6,1,9,175,512,-337,-65.8203125
6,1,10,951,1024,-73,-7.12890625
6,1,11,2758,2048,710,34.66796875
6,1,12,5813,4096,1717,41.9189453125
6,1,13,24542,8192,16350,199.5849609375
6,1,14,23401,16384,7017,42.828369140625
6,1,15,81953,32768,49185,150.1007080078125
6,2,1,0,2,-2,-100.0
6,2,2,1,4,-3,-75.0
6,2,3,8,8,0,0.0
6,2,4,4,16,-12,-75.0
6,2,5,43,32,11,34.375
6,2,6,41,64,-23,-35.9375
6,2,7,127,128,-1,-0.78125
6,2,8,523,256,267,104.296875
6,2,9,714,512,202,39.453125
6,2,10,269,1024,-755,-73.73046875
6,2,11,214,2048,-1834,-89.55078125
6,2,12,4250,4096,154,3.759765625
6,2,13,7880,8192,-312,-3.80859375
6,2,14,9673,16384,-6711,-40.960693359375
6,2,15,585,32768,-32183,-98.2147216796875
6,3,1,0,2,-2,-100.0
6,3,2,1,4,-3,-75.0
6,3,3,3,8,-5,-62.5
6,3,4,28,16,12,75.0
6,3,5,23,32,-9,-28.125
6,3,6,254,64,190,296.875
6,3,7,168,128,40,31.25
6,3,8,146,256,-110,-42.96875
6,3,9,402,512,-110,-21.484375
6,3,10,2266,1024,1242,121.2890625
6,3,11,4506,2048,2458,120.01953125
6,3,12,6877,4096,2781,67.8955078125
6,3,13,3022,8192,-5170,-63.1103515625
6,3,14,16277,16384,-107,-0.653076171875
6,3,15,33326,32768,558,1.702880859375
6,4,1,0,2,-2,-100.0
6,4,2,1,4,-3,-75.0
6,4,3,8,8,0,0.0
6,4,4,11,16,-5,-31.25
6,4,5,38,32,6,18.75
6,4,6,18,64,-46,-71.875
6,4,7,45,128,-83,-64.84375
6,4,8,47,256,-209,-81.640625
6,4,9,107,512,-405,-79.1015625
6,4,10,621,1024,-403,-39.35546875
6,4,11,584,2048,-1464,-71.484375
6,4,12,3164,4096,-932,-22.75390625
6,4,13,5011,8192,-3181,-38.83056640625
6,4,14,2188,16384,-14196,-86.6455078125
6,4,15,2495,32768,-30273,-92.3858642578125
6,5,1,0,2,-2,-100.0
6,5,2,1,4,-3,-75.0
6,5,3,4,8,-4,-50.0
6,5,4,6,16,-10,-62.5
6,5,5,14,32,-18,-56.25
6,5,6,146,64,82,128.125
6,5,7,57,128,-71,-55.46875
6,5,8,326,256,70,27.34375
6,5,9,153,512,-359,-70.1171875
6,5,10,116,1024,-908,-88.671875
6,5,11,605,2048,-1443,-70.458984375
6,5,12,14029,4096,9933,242.5048828125
6,5,13,7584,8192,-608,-7.421875
6,5,14,9173,16384,-7211,-44.012451171875
6,5,15,46196,32768,13428,40.97900390625
6,6,1,0,2,-2,-100.0
6,6,2,1,4,-3,-75.0
6,6,3,2,8,-6,-75.0
6,6,4,3,16,-13,-81.25
6,6,5,20,32,-12,-37.5
6,6,6,11,64,-53,-82.8125
6,6,7,71,128,-57,-44.53125
6,6,8,23,256,-233,-91.015625
6,6,9,301,512,-211,-41.2109375
6,6,10,310,1024,-714,-69.7265625
6,6,11,81,2048,-1967,-96.044921875
6,6,12,5959,4096,1863,45.4833984375
6,6,13,9876,8192,1684,20.556640625
6,6,14,3304,16384,-13080,-79.833984375
6,6,15,2507,32768,-30261,-92.3492431640625
7,1,1,0,2,-2,-100.0
7,1,2,1,4,-3,-75.0
7,1,3,4,8,-4,-50.0
7,1,4,11,16,-5,-31.25
7,1,5,10,32,-22,-68.75
7,1,6,142,64,78,121.875
7,1,7,153,128,25,19.53125
7,1,8,36,256,-220,-85.9375
7,1,9,104,512,-408,-79.6875
7,1,10,1337,1024,313,30.56640625
7,1,11,2801,2048,753,36.767578125
7,1,12,8337,4096,4241,103.5400390625
7,1,13,8995,8192,803,9.80224609375
7,1,14,13788,16384,-2596,-15.8447265625
7,1,15,24769,32768,-7999,-24.4110107421875
7,2,1,0,2,-2,-100.0
7,2,2,1,4,-3,-75.0
7,2,3,8,8,0,0.0
7,2,4,4,16,-12,-75.0
7,2,5,9,32,-23,-71.875
7,2,6,108,64,44,68.75
7,2,7,27,128,-101,-78.90625
7,2,8,53,256,-203,-79.296875
7,2,9,53,512,-459,-89.6484375
7,2,10,60,1024,-964,-94.140625
7,2,11,2535,2048,487,23.779296875
7,2,12,2692,4096,-1404,-34.27734375
7,2,13,4770,8192,-3422,-41.7724609375
7,2,14,5567,16384,-10817,-66.021728515625
7,2,15,112765,32768,79997,244.1314697265625
7,3,1,0,2,-2,-100.0
7,3,2,2,4,-2,-50.0
7,3,3,2,8,-6,-75.0
7,3,4,25,16,9,56.25
7,3,5,7,32,-25,-78.125
7,3,6,33,64,-31,-48.4375
7,3,7,91,128,-37,-28.90625
7,3,8,663,256,407,158.984375
7,3,9,115,512,-397,-77.5390625
7,3,10,2145,1024,1121,109.47265625
7,3,11,3614,2048,1566,76.46484375
7,3,12,159,4096,-3937,-96.1181640625
7,3,13,774,8192,-7418,-90.5517578125
7,3,14,656,16384,-15728,-95.99609375
7,3,15,79297,32768,46529,141.9952392578125
7,4,1,0,2,-2,-100.0
7,4,2,1,4,-3,-75.0
7,4,3,5,8,-3,-37.5
7,4,4,10,16,-6,-37.5
7,4,5,19,32,-13,-40.625
7,4,6,39,64,-25,-39.0625
7,4,7,103,128,-25,-19.53125
7,4,8,624,256,368,143.75
7,4,9,8,512,-504,-98.4375
7,4,10,22,1024,-1002,-97.8515625
7,4,11,782,2048,-1266,-61.81640625
7,4,12,2630,4096,-1466,-35.791015625
7,4,13,17906,8192,9714,118.5791015625
7,4,14,5119,16384,-11265,-68.756103515625
7,4,15,20273,32768,-12495,-38.1317138671875
7,5,1,0,2,-2,-100.0
7,5,2,7,4,3,75.0
7,5,3,6,8,-2,-25.0
7,5,4,4,16,-12,-75.0
7,5,5,29,32,-3,-9.375
7,5,6,7,64,-57,-89.0625
7,5,7,682,128,554,432.8125
7,5,8,506,256,250,97.65625
7,5,9,284,512,-228,-44.53125
7,5,10,850,1024,-174,-16.9921875
7,5,11,1624,2048,-424,-20.703125
7,5,12,5101,4096,1005,24.5361328125
7,5,13,15172,8192,6980,85.205078125
7,5,14,32657,16384,16273,99.322509765625
7,5,15,11631,32768,-21137,-64.5050048828125
7,6,1,0,2,-2,-100.0
7,6,2,2,4,-2,-50.0
7,6,3,14,8,6,75.0
7,6,4,3,16,-13,-81.25
7,6,5,6,32,-26,-81.25
7,6,6,31,64,-33,-51.5625
7,6,7,71,128,-57,-44.53125
7,6,8,857,256,601,234.765625
7,6,9,993,512,481,93.9453125
7,6,10,622,1024,-402,-39.2578125
7,6,11,3687,2048,1639,80.029296875
7,6,12,3276,4096,-820,-20.01953125
7,6,13,1708,8192,-6484,-79.150390625
7,6,14,30846,16384,14462,88.26904296875
7,6,15,6163,32768,-26605,-81.1920166015625
7,7,1,0,2,-2,-100.0
7,7,2,2,4,-2,-50.0
7,7,3,2,8,-6,-75.0
7,7,4,12,16,-4,-25.0
7,7,5,8,32,-24,-75.0
7,7,6,12,64,-52,-81.25
7,7,7,126,128,-2,-1.5625
7,7,8,160,256,-96,-37.5
7,7,9,167,512,-345,-67.3828125
7,7,10,465,1024,-559,-54.58984375
7,7,11,161,2048,-1887,-92.138671875
7,7,12,505,4096,-3591,-87.6708984375
7,7,13,6024,8192,-2168,-26.46484375
7,7,14,27501,16384,11117,67.852783203125
7,7,15,39015,32768,6247,19.0643310546875
8,1,1,0,2,-2,-100.0
8,1,2,5,4,1,25.0
8,1,3,4,8,-4,-50.0
8,1,4,10,16,-6,-37.5
8,1,5,44,32,12,37.5
8,1,6,35,64,-29,-45.3125
8,1,7,101,128,-27,-21.09375
8,1,8,408,256,152,59.375
8,1,9,1078,512,566,110.546875
8,1,10,519,1024,-505,-49.31640625
8,1,11,2192,2048,144,7.03125
8,1,12,8151,4096,4055,98.9990234375
8,1,13,6181,8192,-2011,-24.54833984375
8,1,14,613,16384,-15771,-96.258544921875
8,1,15,15485,32768,-17283,-52.7435302734375
8,2,1,0,2,-2,-100.0
8,2,2,2,4,-2,-50.0
8,2,3,8,8,0,0.0
8,2,4,16,16,0,0.0
8,2,5,5,32,-27,-84.375
8,2,6,27,64,-37,-57.8125
8,2,7,118,128,-10,-7.8125
8,2,8,952,256,696,271.875
8,2,9,451,512,-61,-11.9140625
8,2,10,381,1024,-643,-62.79296875
8,2,11,1191,2048,-857,-41.845703125
8,2,12,4159,4096,63,1.5380859375
8,2,13,1956,8192,-6236,-76.123046875
8,2,14,46229,16384,29845,182.159423828125
8,2,15,23126,32768,-9642,-29.425048828125
8,3,1,0,2,-2,-100.0
8,3,2,1,4,-3,-75.0
8,3,3,2,8,-6,-75.0
8,3,4,7,16,-9,-56.25
8,3,5,14,32,-18,-56.25
8,3,6,56,64,-8,-12.5
8,3,7,248,128,120,93.75
8,3,8,81,256,-175,-68.359375
8,3,9,269,512,-243,-47.4609375
8,3,10,1088,1024,64,6.25
8,3,11,276,2048,-1772,-86.5234375
8,3,12,8176,4096,4080,99.609375
8,3,13,9118,8192,926,11.3037109375
8,3,14,5306,16384,-11078,-67.61474609375
8,3,15,89917,32768,57149,174.4049072265625
8,4,1,0,2,-2,-100.0
8,4,2,1,4,-3,-75.0
8,4,3,2,8,-6,-75.0
8,4,4,5,16,-11,-68.75
8,4,5,25,32,-7,-21.875
8,4,6,57,64,-7,-10.9375
8,4,7,41,128,-87,-67.96875
8,4,8,28,256,-228,-89.0625
8,4,9,1192,512,680,132.8125
8,4,10,297,1024,-727,-70.99609375
8,4,11,945,2048,-1103,-53.857421875
8,4,12,4546,4096,450,10.986328125
8,4,13,12101,8192,3909,47.71728515625
8,4,14,308,16384,-16076,-98.1201171875
8,4,15,4644,32768,-28124,-85.82763671875
8,5,1,0,2,-2,-100.0
8,5,2,1,4,-3,-75.0
8,5,3,6,8,-2,-25.0
8,5,4,11,16,-5,-31.25
8,5,5,7,32,-25,-78.125
8,5,6,50,64,-14,-21.875
8,5,7,109,128,-19,-14.84375
8,5,8,766,256,510,199.21875
8,5,9,369,512,-143,-27.9296875
8,5,10,1567,1024,543,53.02734375
8,5,11,1659,2048,-389,-18.994140625
8,5,12,1646,4096,-2450,-59.814453125
8,5,13,11619,8192,3427,41.83349609375
8,5,14,9982,16384,-6402,-39.07470703125
8,5,15,28904,32768,-3864,-11.7919921875
8,6,1,0,2,-2,-100.0
8,6,2,3,4,-1,-25.0
8,6,3,2,8,-6,-75.0
8,6,4,3,16,-13,-81.25
8,6,5,12,32,-20,-62.5
8,6,6,42,64,-22,-34.375
8,6,7,137,128,9,7.03125
8,6,8,226,256,-30,-11.71875
8,6,9,1852,512,1340,261.71875
8,6,10,722,1024,-302,-29.4921875
8,6,11,899,2048,-1149,-56.103515625
8,6,12,9106,4096,5010,122.314453125
8,6,13,4982,8192,-3210,-39.1845703125
8,6,14,1110,16384,-15274,-93.22509765625
8,6,15,16389,32768,-16379,-49.9847412109375
8,7,1,0,2,-2,-100.0
8,7,2,1,4,-3,-75.0
8,7,3,2,8,-6,-75.0
8,7,4,47,16,31,193.75
8,7,5,34,32,2,6.25
8,7,6,66,64,2,3.125
8,7,7,330,128,202,157.8125
8,7,8,436,256,180,70.3125
8,7,9,33,512,-479,-93.5546875
8,7,10,306,1024,-718,-70.1171875
8,7,11,263,2048,-1785,-87.158203125
8,7,12,712,4096,-3384,-82.6171875
8,7,13,13599,8192,5407,66.00341796875
8,7,14,1771,16384,-14613,-89.190673828125
8,7,15,66699,32768,33931,103.5491943359375
8,8,1,0,2,-2,-100.0
8,8,2,1,4,-3,-75.0
8,8,3,14,8,6,75.0
8,8,4,25,16,9,56.25
8,8,5,17,32,-15,-46.875
8,8,6,34,64,-30,-46.875
8,8,7,85,128,-43,-33.59375
8,8,8,479,256,223,87.109375
8,8,9,353,512,-159,-31.0546875
8,8,10,461,1024,-563,-54.98046875
8,8,11,677,2048,-1371,-66.943359375
8,8,12,137,4096,-3959,-96.6552734375
8,8,13,2105,8192,-6087,-74.30419921875
8,8,14,1063,16384,-15321,-93.511962890625
8,8,15,2057,32768,-30711,-93.7225341796875
9,1,1,0,2,-2,-100.0
9,1,2,1,4,-3,-75.0
9,1,3,4,8,-4,-50.0
9,1,4,7,16,-9,-56.25
9,1,5,36,32,4,12.5
9,1,6,28,64,-36,-56.25
9,1,7,233,128,105,82.03125
9,1,8,30,256,-226,-88.28125
9,1,9,1187,512,675,131.8359375
9,1,10,492,1024,-532,-51.953125
9,1,11,2563,2048,515,25.146484375
9,1,12,1423,4096,-2673,-65.2587890625
9,1,13,46,8192,-8146,-99.4384765625
9,1,14,32091,16384,15707,95.867919921875
9,1,15,29508,32768,-3260,-9.94873046875
9,2,1,0,2,-2,-100.0
9,2,2,1,4,-3,-75.0
9,2,3,3,8,-5,-62.5
9,2,4,5,16,-11,-68.75
9,2,5,19,32,-13,-40.625
9,2,6,35,64,-29,-45.3125
9,2,7,43,128,-85,-66.40625
9,2,8,93,256,-163,-63.671875
9,2,9,134,512,-378,-73.828125
9,2,10,1602,1024,578,56.4453125
9,2,11,7068,2048,5020,245.1171875
9,2,12,852,4096,-3244,-79.19921875
9,2,13,440,8192,-7752,-94.62890625
9,2,14,32752,16384,16368,99.90234375
9,2,15,132937,32768,100169,305.6915283203125
9,3,1,0,2,-2,-100.0
9,3,2,2,4,-2,-50.0
9,3,3,2,8,-6,-75.0
9,3,4,8,16,-8,-50.0
9,3,5,23,32,-9,-28.125
9,3,6,53,64,-11,-17.1875
9,3,7,45,128,-83,-64.84375
9,3,8,63,256,-193,-75.390625
9,3,9,118,512,-394,-76.953125
9,3,10,341,1024,-683,-66.69921875
9,3,11,2165,2048,117,5.712890625
9,3,12,3655,4096,-441,-10.7666015625
9,3,13,2678,8192,-5514,-67.3095703125
9,3,14,26021,16384,9637,58.819580078125
9,3,15,42171,32768,9403,28.6956787109375
9,4,1,0,2,-2,-100.0
9,4,2,1,4,-3,-75.0
9,4,3,4,8,-4,-50.0
9,4,4,32,16,16,100.0
9,4,5,27,32,-5,-15.625
9,4,6,84,64,20,31.25
9,4,7,39,128,-89,-69.53125
9,4,8,166,256,-90,-35.15625
9,4,9,646,512,134,26.171875
9,4,10,2740,1024,1716,167.578125
9,4,11,189,2048,-1859,-90.771484375
9,4,12,5345,4096,1249,30.4931640625
9,4,13,551,8192,-7641,-93.27392578125
9,4,14,800,16384,-15584,-95.1171875
9,4,15,1066,32768,-31702,-96.746826171875
9,5,1,0,2,-2,-100.0
9,5,2,1,4,-3,-75.0
9,5,3,22,8,14,175.0
9,5,4,13,16,-3,-18.75
9,5,5,6,32,-26,-81.25
9,5,6,107,64,43,67.1875
9,5,7,201,128,73,57.03125
9,5,8,159,256,-97,-37.890625
9,5,9,300,512,-212,-41.40625
9,5,10,306,1024,-718,-70.1171875
9,5,11,47,2048,-2001,-97.705078125
9,5,12,1451,4096,-2645,-64.5751953125
9,5,13,5800,8192,-2392,-29.19921875
9,5,14,21268,16384,4884,29.8095703125
9,5,15,49947,32768,17179,52.4261474609375
9,6,1,0,2,-2,-100.0
9,6,2,1,4,-3,-75.0
9,6,3,2,8,-6,-75.0
9,6,4,3,16,-13,-81.25
9,6,5,12,32,-20,-62.5
9,6,6,33,64,-31,-48.4375
9,6,7,69,128,-59,-46.09375
9,6,8,169,256,-87,-33.984375
9,6,9,624,512,112,21.875
9,6,10,192,1024,-832,-81.25
9,6,11,3930,2048,1882,91.89453125
9,6,12,13133,4096,9037,220.6298828125
9,6,13,2409,8192,-5783,-70.59326171875
9,6,14,29223,16384,12839,78.363037109375
9,6,15,47301,32768,14533,44.3511962890625
9,7,1,0,2,-2,-100.0
9,7,2,1,4,-3,-75.0
9,7,3,2,8,-6,-75.0
9,7,4,32,16,16,100.0
9,7,5,54,32,22,68.75
9,7,6,68,64,4,6.25
9,7,7,54,128,-74,-57.8125
9,7,8,141,256,-115,-44.921875
9,7,9,455,512,-57,-11.1328125
9,7,10,1497,1024,473,46.19140625
9,7,11,6434,2048,4386,214.16015625
9,7,12,12492,4096,8396,204.98046875
9,7,13,11939,8192,3747,45.73974609375
9,7,14,31098,16384,14714,89.80712890625
9,7,15,32233,32768,-535,-1.6326904296875
9,8,1,0,2,-2,-100.0
9,8,2,1,4,-3,-75.0
9,8,3,5,8,-3,-37.5
9,8,4,3,16,-13,-81.25
9,8,5,38,32,6,18.75
9,8,6,48,64,-16,-25.0
9,8,7,19,128,-109,-85.15625
9,8,8,37,256,-219,-85.546875
9,8,9,1739,512,1227,239.6484375
9,8,10,2490,1024,1466,143.1640625
9,8,11,581,2048,-1467,-71.630859375
9,8,12,3507,4096,-589,-14.3798828125
9,8,13,2434,8192,-5758,-70.2880859375
9,8,14,1165,16384,-15219,-92.889404296875
9,8,15,22987,32768,-9781,-29.8492431640625
9,9,1,0,2,-2,-100.0
9,9,2,1,4,-3,-75.0
9,9,3,2,8,-6,-75.0
9,9,4,30,16,14,87.5
9,9,5,18,32,-14,-43.75
9,9,6,15,64,-49,-76.5625
9,9,7,22,128,-106,-82.8125
9,9,8,67,256,-189,-73.828125
9,9,9,426,512,-86,-16.796875
9,9,10,510,1024,-514,-50.1953125
9,9,11,3149,2048,1101,53.759765625
9,9,12,2059,4096,-2037,-49.7314453125
9,9,13,6559,8192,-1633,-19.93408203125
9,9,14,49372,16384,32988,201.3427734375
9,9,15,4769,32768,-27999,-85.4461669921875
10,1,1,0,2,-2,-100.0
10,1,2,5,4,1,25.0
10,1,3,8,8,0,0.0
10,1,4,5,16,-11,-68.75
10,1,5,38,32,6,18.75
10,1,6,27,64,-37,-57.8125
10,1,7,163,128,35,27.34375
10,1,8,175,256,-81,-31.640625
10,1,9,72,512,-440,-85.9375
10,1,10,453,1024,-571,-55.76171875
10,1,11,748,2048,-1300,-63.4765625
10,1,12,2885,4096,-1211,-29.5654296875
10,1,13,2283,8192,-5909,-72.13134765625
10,1,14,6527,16384,-9857,-60.162353515625
10,1,15,27602,32768,-5166,-15.765380859375
10,2,1,0,2,-2,-100.0
10,2,2,2,4,-2,-50.0
10,2,3,2,8,-6,-75.0
10,2,4,39,16,23,143.75
10,2,5,34,32,2,6.25
10,2,6,83,64,19,29.6875
10,2,7,21,128,-107,-83.59375
10,2,8,334,256,78,30.46875
10,2,9,84,512,-428,-83.59375
10,2,10,1376,1024,352,34.375
10,2,11,2327,2048,279,13.623046875
10,2,12,1581,4096,-2515,-61.4013671875
10,2,13,2419,8192,-5773,-70.47119140625
10,2,14,17714,16384,1330,8.11767578125
10,2,15,14321,32768,-18447,-56.2957763671875
10,3,1,0,2,-2,-100.0
10,3,2,2,4,-2,-50.0
10,3,3,2,8,-6,-75.0
10,3,4,9,16,-7,-43.75
10,3,5,17,32,-15,-46.875
10,3,6,31,64,-33,-51.5625
10,3,7,108,128,-20,-15.625
10,3,8,682,256,426,166.40625
10,3,9,312,512,-200,-39.0625
10,3,10,315,1024,-709,-69.23828125
10,3,11,2107,2048,59,2.880859375
10,3,12,12466,4096,8370,204.345703125
10,3,13,2533,8192,-5659,-69.07958984375
10,3,14,30295,16384,13911,84.906005859375
10,3,15,9664,32768,-23104,-70.5078125
10,4,1,0,2,-2,-100.0
10,4,2,2,4,-2,-50.0
10,4,3,3,8,-5,-62.5
10,4,4,7,16,-9,-56.25
10,4,5,7,32,-25,-78.125
10,4,6,66,64,2,3.125
10,4,7,9,128,-119,-92.96875
10,4,8,620,256,364,142.1875
10,4,9,137,512,-375,-73.2421875
10,4,10,2253,1024,1229,120.01953125
10,4,11,929,2048,-1119,-54.638671875
10,4,12,1679,4096,-2417,-59.0087890625
10,4,13,7752,8192,-440,-5.37109375
10,4,14,22797,16384,6413,39.141845703125
10,4,15,50557,32768,17789,54.2877197265625
10,5,1,0,2,-2,-100.0
10,5,2,2,4,-2,-50.0
10,5,3,3,8,-5,-62.5
10,5,4,15,16,-1,-6.25
10,5,5,11,32,-21,-65.625
10,5,6,43,64,-21,-32.8125
10,5,7,233,128,105,82.03125
10,5,8,339,256,83,32.421875
10,5,9,711,512,199,38.8671875
10,5,10,375,1024,-649,-63.37890625
10,5,11,3284,2048,1236,60.3515625
10,5,12,4600,4096,504,12.3046875
10,5,13,9215,8192,1023,12.48779296875
10,5,14,6375,16384,-10009,-61.090087890625
10,5,15,3057,32768,-29711,-90.6707763671875
10,6,1,0,2,-2,-100.0
10,6,2,2,4,-2,-50.0
10,6,3,5,8,-3,-37.5
10,6,4,4,16,-12,-75.0
10,6,5,27,32,-5,-15.625
10,6,6,179,64,115,179.6875
10,6,7,161,128,33,25.78125
10,6,8,98,256,-158,-61.71875
10,6,9,644,512,132,25.78125
10,6,10,143,1024,-881,-86.03515625
10,6,11,231,2048,-1817,-88.720703125
10,6,12,18607,4096,14511,354.2724609375
10,6,13,15861,8192,7669,93.61572265625
10,6,14,43635,16384,27251,166.326904296875
10,6,15,130999,32768,98231,299.7772216796875
10,7,1,0,2,-2,-100.0
10,7,2,2,4,-2,-50.0
10,7,3,2,8,-6,-75.0
10,7,4,7,16,-9,-56.25
10,7,5,42,32,10,31.25
10,7,6,54,64,-10,-15.625
10,7,7,144,128,16,12.5
10,7,8,42,256,-214,-83.59375
10,7,9,651,512,139,27.1484375
10,7,10,268,1024,-756,-73.828125
10,7,11,201,2048,-1847,-90.185546875
10,7,12,2251,4096,-1845,-45.0439453125
10,7,13,5719,8192,-2473,-30.18798828125
10,7,14,39294,16384,22910,139.83154296875
10,7,15,50400,32768,17632,53.80859375
10,8,1,0,2,-2,-100.0
10,8,2,1,4,-3,-75.0
10,8,3,8,8,0,0.0
10,8,4,40,16,24,150.0
10,8,5,33,32,1,3.125
10,8,6,134,64,70,109.375
10,8,7,28,128,-100,-78.125
10,8,8,336,256,80,31.25
10,8,9,148,512,-364,-71.09375
10,8,10,800,1024,-224,-21.875
10,8,11,1555,2048,-493,-24.072265625
10,8,12,12150,4096,8054,196.630859375
10,8,13,571,8192,-7621,-93.02978515625
10,8,14,10024,16384,-6360,-38.818359375
10,8,15,7056,32768,-25712,-78.466796875
10,9,1,0,2,-2,-100.0
10,9,2,1,4,-3,-75.0
10,9,3,4,8,-4,-50.0
10,9,4,19,16,3,18.75
10,9,5,25,32,-7,-21.875
10,9,6,130,64,66,103.125
10,9,7,56,128,-72,-56.25
10,9,8,984,256,728,284.375
10,9,9,54,512,-458,-89.453125
10,9,10,148,1024,-876,-85.546875
10,9,11,433,2048,-1615,-78.857421875
10,9,12,3376,4096,-720,-17.578125
10,9,13,522,8192,-7670,-93.6279296875
10,9,14,9172,16384,-7212,-44.0185546875
10,9,15,5861,32768,-26907,-82.1136474609375
10,10,1,0,2,-2,-100.0
10,10,2,1,4,-3,-75.0
10,10,3,3,8,-5,-62.5
10,10,4,5,16,-11,-68.75
10,10,5,9,32,-23,-71.875
10,10,6,16,64,-48,-75.0
10,10,7,48,128,-80,-62.5
10,10,8,190,256,-66,-25.78125
10,10,9,318,512,-194,-37.890625
10,10,10,1619,1024,595,58.10546875
10,10,11,67,2048,-1981,-96.728515625
10,10,12,9918,4096,5822,142.138671875
10,10,13,5052,8192,-3140,-38.330078125
10,10,14,2602,16384,-13782,-84.11865234375
10,10,15,9216,32768,-23552,-71.875
11,1,1,0,2,-2,-100.0
11,1,2,4,4,0,0.0
11,1,3,2,8,-6,-75.0
11,1,4,4,16,-12,-75.0
11,1,5,36,32,4,12.5
11,1,6,32,64,-32,-50.0
11,1,7,221,128,93,72.65625
11,1,8,149,256,-107,-41.796875
11,1,9,363,512,-149,-29.1015625
11,1,10,677,1024,-347,-33.88671875
11,1,11,2388,2048,340,16.6015625
11,1,12,3275,4096,-821,-20.0439453125
11,1,13,5064,8192,-3128,-38.18359375
11,1,14,4559,16384,-11825,-72.174072265625
11,1,15,28861,32768,-3907,-11.9232177734375
11,2,1,0,2,-2,-100.0
11,2,2,1,4,-3,-75.0
11,2,3,2,8,-6,-75.0
11,2,4,9,16,-7,-43.75
11,2,5,27,32,-5,-15.625
11,2,6,128,64,64,100.0
11,2,7,370,128,242,189.0625
11,2,8,453,256,197,76.953125
11,2,9,740,512,228,44.53125
11,2,10,393,1024,-631,-61.62109375
11,2,11,2027,2048,-21,-1.025390625
11,2,12,7376,4096,3280,80.078125
11,2,13,12709,8192,4517,55.13916015625
11,2,14,27822,16384,11438,69.81201171875
11,2,15,15073,32768,-17695,-54.0008544921875
11,3,1,0,2,-2,-100.0
11,3,2,3,4,-1,-25.0
11,3,3,3,8,-5,-62.5
11,3,4,10,16,-6,-37.5
11,3,5,6,32,-26,-81.25
11,3,6,5,64,-59,-92.1875
11,3,7,99,128,-29,-22.65625
11,3,8,38,256,-218,-85.15625
11,3,9,387,512,-125,-24.4140625
11,3,10,3676,1024,2652,258.984375
11,3,11,1368,2048,-680,-33.203125
11,3,12,7506,4096,3410,83.251953125
11,3,13,3789,8192,-4403,-53.74755859375
11,3,14,22864,16384,6480,39.55078125
11,3,15,16547,32768,-16221,-49.5025634765625
11,4,1,0,2,-2,-100.0
11,4,2,3,4,-1,-25.0
11,4,3,2,8,-6,-75.0
11,4,4,4,16,-12,-75.0
11,4,5,10,32,-22,-68.75
11,4,6,22,64,-42,-65.625
11,4,7,262,128,134,104.6875
11,4,8,116,256,-140,-54.6875
11,4,9,77,512,-435,-84.9609375
11,4,10,52,1024,-972,-94.921875
11,4,11,197,2048,-1851,-90.380859375
11,4,12,1779,4096,-2317,-56.5673828125
11,4,13,14162,8192,5970,72.8759765625
11,4,14,60363,16384,43979,268.426513671875
11,4,15,70307,32768,37539,114.5599365234375
11,5,1,0,2,-2,-100.0
11,5,2,1,4,-3,-75.0
11,5,3,7,8,-1,-12.5
11,5,4,30,16,14,87.5
11,5,5,22,32,-10,-31.25
11,5,6,75,64,11,17.1875
11,5,7,48,128,-80,-62.5
11,5,8,44,256,-212,-82.8125
11,5,9,1549,512,1037,202.5390625
11,5,10,2726,1024,1702,166.2109375
11,5,11,3336,2048,1288,62.890625
11,5,12,7808,4096,3712,90.625
11,5,13,12864,8192,4672,57.03125
11,5,14,44714,16384,28330,172.91259765625
11,5,15,29465,32768,-3303,-10.0799560546875
11,6,1,0,2,-2,-100.0
11,6,2,3,4,-1,-25.0
11,6,3,6,8,-2,-25.0
11,6,4,39,16,23,143.75
11,6,5,15,32,-17,-53.125
11,6,6,6,64,-58,-90.625
11,6,7,6,128,-122,-95.3125
11,6,8,127,256,-129,-50.390625
11,6,9,219,512,-293,-57.2265625
11,6,10,4196,1024,3172,309.765625
11,6,11,597,2048,-1451,-70.849609375
11,6,12,742,4096,-3354,-81.884765625
11,6,13,3242,8192,-4950,-60.4248046875
11,6,14,22880,16384,6496,39.6484375
11,6,15,29698,32768,-3070,-9.368896484375
11,7,1,0,2,-2,-100.0
11,7,2,1,4,-3,-75.0
11,7,3,5,8,-3,-37.5
11,7,4,9,16,-7,-43.75
11,7,5,19,32,-13,-40.625
11,7,6,36,64,-28,-43.75
11,7,7,40,128,-88,-68.75
11,7,8,213,256,-43,-16.796875
11,7,9,1041,512,529,103.3203125
11,7,10,513,1024,-511,-49.90234375
11,7,11,445,2048,-1603,-78.271484375
11,7,12,2111,4096,-1985,-48.4619140625
11,7,13,34679,8192,26487,323.32763671875
11,7,14,15316,16384,-1068,-6.5185546875
11,7,15,63490,32768,30722,93.756103515625
11,8,1,0,2,-2,-100.0
11,8,2,2,4,-2,-50.0
11,8,3,3,8,-5,-62.5
11,8,4,10,16,-6,-37.5
11,8,5,29,32,-3,-9.375
11,8,6,48,64,-16,-25.0
11,8,7,291,128,163,127.34375
11,8,8,194,256,-62,-24.21875
11,8,9,101,512,-411,-80.2734375
11,8,10,979,1024,-45,-4.39453125
11,8,11,5135,2048,3087,150.732421875
11,8,12,13784,4096,9688,236.5234375
11,8,13,1769,8192,-6423,-78.40576171875
11,8,14,6793,16384,-9591,-58.538818359375
11,8,15,52516,32768,19748,60.26611328125
11,9,1,0,2,-2,-100.0
11,9,2,1,4,-3,-75.0
11,9,3,2,8,-6,-75.0
11,9,4,15,16,-1,-6.25
11,9,5,10,32,-22,-68.75
11,9,6,158,64,94,146.875
11,9,7,125,128,-3,-2.34375
11,9,8,183,256,-73,-28.515625
11,9,9,24,512,-488,-95.3125
11,9,10,168,1024,-856,-83.59375
11,9,11,7235,2048,5187,253.271484375
11,9,12,13626,4096,9530,232.666015625
11,9,13,4627,8192,-3565,-43.51806640625
11,9,14,56919,16384,40535,247.406005859375
11,9,15,39783,32768,7015,21.4080810546875
11,10,1,0,2,-2,-100.0
11,10,2,1,4,-3,-75.0
11,10,3,5,8,-3,-37.5
11,10,4,8,16,-8,-50.0
11,10,5,4,32,-28,-87.5
11,10,6,35,64,-29,-45.3125
11,10,7,105,128,-23,-17.96875
11,10,8,76,256,-180,-70.3125
11,10,9,74,512,-438,-85.546875
11,10,10,629,1024,-395,-38.57421875
11,10,11,1472,2048,-576,-28.125
11,10,12,1010,4096,-3086,-75.341796875
11,10,13,3551,8192,-4641,-56.65283203125
11,10,14,32618,16384,16234,99.08447265625
11,10,15,44598,32768,11830,36.102294921875
11,11,1,0,2,-2,-100.0
11,11,2,10,4,6,150.0
11,11,3,3,8,-5,-62.5
11,11,4,30,16,14,87.5
11,11,5,29,32,-3,-9.375
11,11,6,120,64,56,87.5
11,11,7,29,128,-99,-77.34375
11,11,8,346,256,90,35.15625
11,11,9,838,512,326,63.671875
11,11,10,161,1024,-863,-84.27734375
11,11,11,2484,2048,436,21.2890625
11,11,12,7591,4096,3495,85.3271484375
11,11,13,5211,8192,-2981,-36.38916015625
11,11,14,17029,16384,645,3.936767578125
11,11,15,20781,32768,-11987,-36.5814208984375
12,1,1,0,2,-2,-100.0
12,1,2,4,4,0,0.0
12,1,3,5,8,-3,-37.5
12,1,4,6,16,-10,-62.5
12,1,5,36,32,4,12.5
12,1,6,8,64,-56,-87.5
12,1,7,90,128,-38,-29.6875
12,1,8,98,256,-158,-61.71875
12,1,9,246,512,-266,-51.953125
12,1,10,1270,1024,246,24.0234375
12,1,11,1359,2048,-689,-33.642578125
12,1,12,477,4096,-3619,-88.3544921875
12,1,13,14118,8192,5926,72.3388671875
12,1,14,10388,16384,-5996,-36.5966796875
12,1,15,13087,32768,-19681,-60.0616455078125
12,2,1,0,2,-2,-100.0
12,2,2,4,4,0,0.0
12,2,3,2,8,-6,-75.0
12,2,4,10,16,-6,-37.5
12,2,5,55,32,23,71.875
12,2,6,142,64,78,121.875
12,2,7,62,128,-66,-51.5625
12,2,8,104,256,-152,-59.375
12,2,9,12,512,-500,-97.65625
12,2,10,836,1024,-188,-18.359375
12,2,11,16,2048,-2032,-99.21875
12,2,12,2517,4096,-1579,-38.5498046875
12,2,13,7409,8192,-783,-9.55810546875
12,2,14,42229,16384,25845,157.745361328125
12,2,15,79572,32768,46804,142.83447265625
12,3,1,0,2,-2,-100.0
12,3,2,2,4,-2,-50.0
12,3,3,6,8,-2,-25.0
12,3,4,9,16,-7,-43.75
12,3,5,38,32,6,18.75
12,3,6,71,64,7,10.9375
12,3,7,158,128,30,23.4375
12,3,8,173,256,-83,-32.421875
12,3,9,958,512,446,87.109375
12,3,10,828,1024,-196,-19.140625
12,3,11,3994,2048,1946,95.01953125
12,3,12,493,4096,-3603,-87.9638671875
12,3,13,4143,8192,-4049,-49.42626953125
12,3,14,5985,16384,-10399,-63.470458984375
12,3,15,82495,32768,49727,151.7547607421875
12,4,1,0,2,-2,-100.0
12,4,2,2,4,-2,-50.0
12,4,3,9,8,1,12.5
12,4,4,3,16,-13,-81.25
12,4,5,11,32,-21,-65.625
12,4,6,64,64,0,0.0
12,4,7,11,128,-117,-91.40625
12,4,8,317,256,61,23.828125
12,4,9,57,512,-455,-88.8671875
12,4,10,60,1024,-964,-94.140625
12,4,11,1366,2048,-682,-33.30078125
12,4,12,2343,4096,-1753,-42.7978515625
12,4,13,7559,8192,-633,-7.72705078125
12,4,14,25751,16384,9367,57.171630859375
12,4,15,66354,32768,33586,102.496337890625
12,5,1,0,2,-2,-100.0
12,5,2,1,4,-3,-75.0
12,5,3,2,8,-6,-75.0
12,5,4,6,16,-10,-62.5
12,5,5,54,32,22,68.75
12,5,6,27,64,-37,-57.8125
12,5,7,45,128,-83,-64.84375
12,5,8,392,256,136,53.125
12,5,9,25,512,-487,-95.1171875
12,5,10,264,1024,-760,-74.21875
12,5,11,816,2048,-1232,-60.15625
12,5,12,5227,4096,1131,27.6123046875
12,5,13,8882,8192,690,8.4228515625
12,5,14,6198,16384,-10186,-62.17041015625
12,5,15,1957,32768,-30811,-94.0277099609375
12,6,1,0,2,-2,-100.0
12,6,2,1,4,-3,-75.0
12,6,3,2,8,-6,-75.0
12,6,4,12,16,-4,-25.0
12,6,5,11,32,-21,-65.625
12,6,6,38,64,-26,-40.625
12,6,7,21,128,-107,-83.59375
12,6,8,80,256,-176,-68.75
12,6,9,405,512,-107,-20.8984375
12,6,10,603,1024,-421,-41.11328125
12,6,11,686,2048,-1362,-66.50390625
12,6,12,7717,4096,3621,88.4033203125
12,6,13,129,8192,-8063,-98.42529296875
12,6,14,1874,16384,-14510,-88.56201171875
12,6,15,18295,32768,-14473,-44.1680908203125
12,7,1,0,2,-2,-100.0
12,7,2,1,4,-3,-75.0
12,7,3,3,8,-5,-62.5
12,7,4,12,16,-4,-25.0
12,7,5,49,32,17,53.125
12,7,6,135,64,71,110.9375
12,7,7,223,128,95,74.21875
12,7,8,576,256,320,125.0
12,7,9,223,512,-289,-56.4453125
12,7,10,220,1024,-804,-78.515625
12,7,11,1141,2048,-907,-44.287109375
12,7,12,4917,4096,821,20.0439453125
12,7,13,3348,8192,-4844,-59.130859375
12,7,14,3864,16384,-12520,-76.416015625
12,7,15,156170,32768,123402,376.593017578125
12,8,1,0,2,-2,-100.0
12,8,2,2,4,-2,-50.0
12,8,3,13,8,5,62.5
12,8,4,27,16,11,68.75
12,8,5,81,32,49,153.125
12,8,6,82,64,18,28.125
12,8,7,37,128,-91,-71.09375
12,8,8,19,256,-237,-92.578125
12,8,9,414,512,-98,-19.140625
12,8,10,129,1024,-895,-87.40234375
12,8,11,6653,2048,4605,224.853515625
12,8,12,3135,4096,-961,-23.4619140625
12,8,13,236,8192,-7956,-97.119140625
12,8,14,15198,16384,-1186,-7.23876953125
12,8,15,39427,32768,6659,20.3216552734375
12,9,1,0,2,-2,-100.0
12,9,2,1,4,-3,-75.0
12,9,3,2,8,-6,-75.0
12,9,4,4,16,-12,-75.0
12,9,5,86,32,54,168.75
12,9,6,50,64,-14,-21.875
12,9,7,39,128,-89,-69.53125
12,9,8,38,256,-218,-85.15625
12,9,9,357,512,-155,-30.2734375
12,9,10,210,1024,-814,-79.4921875
12,9,11,3273,2048,1225,59.814453125
12,9,12,2343,4096,-1753,-42.7978515625
12,9,13,5761,8192,-2431,-29.67529296875
12,9,14,6698,16384,-9686,-59.11865234375
12,9,15,9262,32768,-23506,-71.734619140625
12,10,1,0,2,-2,-100.0
12,10,2,1,4,-3,-75.0
12,10,3,2,8,-6,-75.0
12,10,4,26,16,10,62.5
12,10,5,16,32,-16,-50.0
12,10,6,48,64,-16,-25.0
12,10,7,158,128,30,23.4375
12,10,8,142,256,-114,-44.53125
12,10,9,398,512,-114,-22.265625
12,10,10,729,1024,-295,-28.80859375
12,10,11,2572,2048,524,25.5859375
12,10,12,3982,4096,-114,-2.783203125
12,10,13,7811,8192,-381,-4.65087890625
12,10,14,3182,16384,-13202,-80.57861328125
12,10,15,6438,32768,-26330,-80.352783203125
12,11,1,0,2,-2,-100.0
12,11,2,1,4,-3,-75.0
12,11,3,10,8,2,25.0
12,11,4,3,16,-13,-81.25
12,11,5,10,32,-22,-68.75
12,11,6,7,64,-57,-89.0625
12,11,7,19,128,-109,-85.15625
12,11,8,17,256,-239,-93.359375
12,11,9,191,512,-321,-62.6953125
12,11,10,325,1024,-699,-68.26171875
12,11,11,613,2048,-1435,-70.068359375
12,11,12,16444,4096,12348,301.46484375
12,11,13,8831,8192,639,7.80029296875
12,11,14,10661,16384,-5723,-34.930419921875
12,11,15,13366,32768,-19402,-59.210205078125
12,12,1,0,2,-2,-100.0
12,12,2,3,4,-1,-25.0
12,12,3,4,8,-4,-50.0
12,12,4,3,16,-13,-81.25
12,12,5,34,32,2,6.25
12,12,6,51,64,-13,-20.3125
12,12,7,21,128,-107,-83.59375
12,12,8,132,256,-124,-48.4375
12,12,9,971,512,459,89.6484375
12,12,10,576,1024,-448,-43.75
12,12,11,429,2048,-1619,-79.052734375
12,12,12,13652,4096,9556,233.30078125
12,12,13,2045,8192,-6147,-75.03662109375
12,12,14,2562,16384,-13822,-84.36279296875
12,12,15,23808,32768,-8960,-27.34375
13,1,1,0,2,-2,-100.0
13,1,2,1,4,-3,-75.0
13,1,3,3,8,-5,-62.5
13,1,4,7,16,-9,-56.25
13,1,5,14,32,-18,-56.25
13,1,6,151,64,87,135.9375
13,1,7,351,128,223,174.21875
13,1,8,121,256,-135,-52.734375
13,1,9,185,512,-327,-63.8671875
13,1,10,193,1024,-831,-81.15234375
13,1,11,3474,2048,1426,69.62890625
13,1,12,663,4096,-3433,-83.8134765625
13,1,13,2572,8192,-5620,-68.603515625
13,1,14,30168,16384,13784,84.130859375
13,1,15,1510,32768,-31258,-95.391845703125
13,2,1,0,2,-2,-100.0
13,2,2,1,4,-3,-75.0
13,2,3,4,8,-4,-50.0
13,2,4,34,16,18,112.5
13,2,5,63,32,31,96.875
13,2,6,19,64,-45,-70.3125
13,2,7,23,128,-105,-82.03125
13,2,8,25,256,-231,-90.234375
13,2,9,403,512,-109,-21.2890625
13,2,10,666,1024,-358,-34.9609375
13,2,11,1836,2048,-212,-10.3515625
13,2,12,5590,4096,1494,36.474609375
13,2,13,257,8192,-7935,-96.86279296875
13,2,14,2858,16384,-13526,-82.55615234375
13,2,15,30270,32768,-2498,-7.623291015625
13,3,1,0,2,-2,-100.0
13,3,2,4,4,0,0.0
13,3,3,10,8,2,25.0
13,3,4,3,16,-13,-81.25
13,3,5,26,32,-6,-18.75
13,3,6,25,64,-39,-60.9375
13,3,7,148,128,20,15.625
13,3,8,10,256,-246,-96.09375
13,3,9,42,512,-470,-91.796875
13,3,10,4368,1024,3344,326.5625
13,3,11,407,2048,-1641,-80.126953125
13,3,12,1932,4096,-2164,-52.83203125
13,3,13,9599,8192,1407,17.17529296875
13,3,14,27727,16384,11343,69.232177734375
13,3,15,13612,32768,-19156,-58.45947265625
13,4,1,0,2,-2,-100.0
13,4,2,1,4,-3,-75.0
13,4,3,2,8,-6,-75.0
13,4,4,19,16,3,18.75
13,4,5,34,32,2,6.25
13,4,6,6,64,-58,-90.625
13,4,7,803,128,675,527.34375
13,4,8,20,256,-236,-92.1875
13,4,9,182,512,-330,-64.453125
13,4,10,121,1024,-903,-88.18359375
13,4,11,2718,2048,670,32.71484375
13,4,12,3913,4096,-183,-4.4677734375
13,4,13,2197,8192,-5995,-73.18115234375
13,4,14,52543,16384,36159,220.697021484375
13,4,15,12936,32768,-19832,-60.5224609375
13,5,1,0,2,-2,-100.0
13,5,2,1,4,-3,-75.0
13,5,3,2,8,-6,-75.0
13,5,4,5,16,-11,-68.75
13,5,5,19,32,-13,-40.625
13,5,6,80,64,16,25.0
13,5,7,30,128,-98,-76.5625
13,5,8,236,256,-20,-7.8125
13,5,9,336,512,-176,-34.375
13,5,10,3463,1024,2439,238.18359375
13,5,11,1338,2048,-710,-34.66796875
13,5,12,1445,4096,-2651,-64.7216796875
13,5,13,8195,8192,3,0.03662109375
13,5,14,8930,16384,-7454,-45.49560546875
13,5,15,24134,32768,-8634,-26.348876953125
13,6,1,0,2,-2,-100.0
13,6,2,6,4,2,50.0
13,6,3,4,8,-4,-50.0
13,6,4,3,16,-13,-81.25
13,6,5,27,32,-5,-15.625
13,6,6,160,64,96,150.0
13,6,7,96,128,-32,-25.0
13,6,8,81,256,-175,-68.359375
13,6,9,225,512,-287,-56.0546875
13,6,10,58,1024,-966,-94.3359375
13,6,11,715,2048,-1333,-65.087890625
13,6,12,1717,4096,-2379,-58.0810546875
13,6,13,18396,8192,10204,124.560546875
13,6,14,20185,16384,3801,23.199462890625
13,6,15,41105,32768,8337,25.4425048828125
13,7,1,0,2,-2,-100.0
13,7,2,1,4,-3,-75.0
13,7,3,2,8,-6,-75.0
13,7,4,45,16,29,181.25
13,7,5,18,32,-14,-43.75
13,7,6,168,64,104,162.5
13,7,7,184,128,56,43.75
13,7,8,101,256,-155,-60.546875
13,7,9,157,512,-355,-69.3359375
13,7,10,655,1024,-369,-36.03515625
13,7,11,1083,2048,-965,-47.119140625
13,7,12,778,4096,-3318,-81.005859375
13,7,13,14284,8192,6092,74.365234375
13,7,14,12014,16384,-4370,-26.67236328125
13,7,15,11188,32768,-21580,-65.85693359375
13,8,1,0,2,-2,-100.0
13,8,2,3,4,-1,-25.0
13,8,3,31,8,23,287.5
13,8,4,10,16,-6,-37.5
13,8,5,35,32,3,9.375
13,8,6,5,64,-59,-92.1875
13,8,7,82,128,-46,-35.9375
13,8,8,190,256,-66,-25.78125
13,8,9,1408,512,896,175.0
13,8,10,649,1024,-375,-36.62109375
13,8,11,6560,2048,4512,220.3125
13,8,12,32,4096,-4064,-99.21875
13,8,13,32166,8192,23974,292.6513671875
13,8,14,44657,16384,28273,172.564697265625
13,8,15,10810,32768,-21958,-67.010498046875
13,9,1,0,2,-2,-100.0
13,9,2,2,4,-2,-50.0
13,9,3,6,8,-2,-25.0
13,9,4,13,16,-3,-18.75
13,9,5,38,32,6,18.75
13,9,6,131,64,67,104.6875
13,9,7,301,128,173,135.15625
13,9,8,82,256,-174,-67.96875
13,9,9,1278,512,766,149.609375
13,9,10,897,1024,-127,-12.40234375
13,9,11,3994,2048,1946,95.01953125
13,9,12,1782,4096,-2314,-56.494140625
13,9,13,13369,8192,5177,63.19580078125
13,9,14,3323,16384,-13061,-79.718017578125
13,9,15,16950,32768,-15818,-48.272705078125
13,10,1,0,2,-2,-100.0
13,10,2,1,4,-3,-75.0
13,10,3,2,8,-6,-75.0
13,10,4,12,16,-4,-25.0
13,10,5,7,32,-25,-78.125
13,10,6,102,64,38,59.375
13,10,7,27,128,-101,-78.90625
13,10,8,135,256,-121,-47.265625
13,10,9,695,512,183,35.7421875
13,10,10,1020,1024,-4,-0.390625
13,10,11,1109,2048,-939,-45.849609375
13,10,12,8246,4096,4150,101.318359375
13,10,13,266,8192,-7926,-96.7529296875
13,10,14,12706,16384,-3678,-22.44873046875
13,10,15,255821,32768,223053,680.7037353515625
13,11,1,0,2,-2,-100.0
13,11,2,1,4,-3,-75.0
13,11,3,2,8,-6,-75.0
13,11,4,24,16,8,50.0
13,11,5,8,32,-24,-75.0
13,11,6,65,64,1,1.5625
13,11,7,26,128,-102,-79.6875
13,11,8,306,256,50,19.53125
13,11,9,356,512,-156,-30.46875
13,11,10,419,1024,-605,-59.08203125
13,11,11,889,2048,-1159,-56.591796875
13,11,12,13613,4096,9517,232.3486328125
13,11,13,2945,8192,-5247,-64.05029296875
13,11,14,17948,16384,1564,9.5458984375
13,11,15,10664,32768,-22104,-67.4560546875
13,12,1,0,2,-2,-100.0
13,12,2,2,4,-2,-50.0
13,12,3,8,8,0,0.0
13,12,4,3,16,-13,-81.25
13,12,5,33,32,1,3.125
13,12,6,31,64,-33,-51.5625
13,12,7,78,128,-50,-39.0625
13,12,8,550,256,294,114.84375
13,12,9,2023,512,1511,295.1171875
13,12,10,1724,1024,700,68.359375
13,12,11,730,2048,-1318,-64.35546875
13,12,12,2997,4096,-1099,-26.8310546875
13,12,13,6831,8192,-1361,-16.61376953125
13,12,14,8616,16384,-7768,-47.412109375
13,12,15,25712,32768,-7056,-21.533203125
13,13,1,0,2,-2,-100.0
13,13,2,1,4,-3,-75.0
13,13,3,3,8,-5,-62.5
13,13,4,4,16,-12,-75.0
13,13,5,58,32,26,81.25
13,13,6,25,64,-39,-60.9375
13,13,7,285,128,157,122.65625
13,13,8,75,256,-181,-70.703125
13,13,9,180,512,-332,-64.84375
13,13,10,1496,1024,472,46.09375
13,13,11,2158,2048,110,5.37109375
13,13,12,2293,4096,-1803,-44.0185546875
13,13,13,10499,8192,2307,28.16162109375
13,13,14,11411,16384,-4973,-30.352783203125
13,13,15,26868,32768,-5900,-18.00537109375
14,1,1,0,2,-2,-100.0
14,1,2,5,4,1,25.0
14,1,3,3,8,-5,-62.5
14,1,4,8,16,-8,-50.0
14,1,5,4,32,-28,-87.5
14,1,6,57,64,-7,-10.9375
14,1,7,115,128,-13,-10.15625
14,1,8,185,256,-71,-27.734375
14,1,9,150,512,-362,-70.703125
14,1,10,865,1024,-159,-15.52734375
14,1,11,649,2048,-1399,-68.310546875
14,1,12,3868,4096,-228,-5.56640625
14,1,13,11440,8192,3248,39.6484375
14,1,14,13399,16384,-2985,-18.218994140625
14,1,15,1039,32768,-31729,-96.8292236328125
14,2,1,0,2,-2,-100.0
14,2,2,2,4,-2,-50.0
14,2,3,4,8,-4,-50.0
14,2,4,44,16,28,175.0
14,2,5,27,32,-5,-15.625
14,2,6,5,64,-59,-92.1875
14,2,7,163,128,35,27.34375
14,2,8,151,256,-105,-41.015625
14,2,9,263,512,-249,-48.6328125
14,2,10,335,1024,-689,-67.28515625
14,2,11,2282,2048,234,11.42578125
14,2,12,1188,4096,-2908,-70.99609375
14,2,13,548,8192,-7644,-93.310546875
14,2,14,10156,16384,-6228,-38.0126953125
14,2,15,13411,32768,-19357,-59.0728759765625
14,3,1,0,2,-2,-100.0
14,3,2,7,4,3,75.0
14,3,3,2,8,-6,-75.0
14,3,4,9,16,-7,-43.75
14,3,5,27,32,-5,-15.625
14,3,6,21,64,-43,-67.1875
14,3,7,11,128,-117,-91.40625
14,3,8,332,256,76,29.6875
14,3,9,1900,512,1388,271.09375
14,3,10,1029,1024,5,0.48828125
14,3,11,1237,2048,-811,-39.599609375
14,3,12,129,4096,-3967,-96.8505859375
14,3,13,4661,8192,-3531,-43.10302734375
14,3,14,361,16384,-16023,-97.796630859375
14,3,15,17781,32768,-14987,-45.7366943359375
14,4,1,0,2,-2,-100.0
14,4,2,1,4,-3,-75.0
14,4,3,4,8,-4,-50.0
14,4,4,3,16,-13,-81.25
14,4,5,6,32,-26,-81.25
14,4,6,8,64,-56,-87.5
14,4,7,256,128,128,100.0
14,4,8,176,256,-80,-31.25
14,4,9,115,512,-397,-77.5390625
14,4,10,419,1024,-605,-59.08203125
14,4,11,1029,2048,-1019,-49.755859375
14,4,12,1329,4096,-2767,-67.5537109375
14,4,13,21375,8192,13183,160.92529296875
14,4,14,24717,16384,8333,50.860595703125
14,4,15,25765,32768,-7003,-21.3714599609375
14,5,1,0,2,-2,-100.0
14,5,2,3,4,-1,-25.0
14,5,3,6,8,-2,-25.0
14,5,4,6,16,-10,-62.5
14,5,5,12,32,-20,-62.5
14,5,6,120,64,56,87.5
14,5,7,286,128,158,123.4375
14,5,8,289,256,33,12.890625
14,5,9,149,512,-363,-70.8984375
14,5,10,827,1024,-197,-19.23828125
14,5,11,2418,2048,370,18.06640625
14,5,12,2840,4096,-1256,-30.6640625
14,5,13,14075,8192,5883,71.81396484375
14,5,14,2187,16384,-14197,-86.651611328125
14,5,15,5985,32768,-26783,-81.7352294921875
14,6,1,0,2,-2,-100.0
14,6,2,4,4,0,0.0
14,6,3,3,8,-5,-62.5
14,6,4,5,16,-11,-68.75
14,6,5,6,32,-26,-81.25
14,6,6,46,64,-18,-28.125
14,6,7,9,128,-119,-92.96875
14,6,8,169,256,-87,-33.984375
14,6,9,117,512,-395,-77.1484375
14,6,10,6465,1024,5441,531.34765625
14,6,11,3032,2048,984,48.046875
14,6,12,7140,4096,3044,74.31640625
14,6,13,4703,8192,-3489,-42.59033203125
14,6,14,33958,16384,17574,107.26318359375
14,6,15,41538,32768,8770,26.763916015625
14,7,1,0,2,-2,-100.0
14,7,2,2,4,-2,-50.0
14,7,3,4,8,-4,-50.0
14,7,4,3,16,-13,-81.25
14,7,5,83,32,51,159.375
14,7,6,71,64,7,10.9375
14,7,7,36,128,-92,-71.875
14,7,8,45,256,-211,-82.421875
14,7,9,614,512,102,19.921875
14,7,10,929,1024,-95,-9.27734375
14,7,11,223,2048,-1825,-89.111328125
14,7,12,4580,4096,484,11.81640625
14,7,13,7338,8192,-854,-10.4248046875
14,7,14,1171,16384,-15213,-92.852783203125
14,7,15,3814,32768,-28954,-88.360595703125
14,8,1,0,2,-2,-100.0
14,8,2,1,4,-3,-75.0
14,8,3,2,8,-6,-75.0
14,8,4,11,16,-5,-31.25
14,8,5,155,32,123,384.375
14,8,6,42,64,-22,-34.375
14,8,7,36,128,-92,-71.875
14,8,8,347,256,91,35.546875
14,8,9,380,512,-132,-25.78125
14,8,10,88,1024,-936,-91.40625
14,8,11,1301,2048,-747,-36.474609375
14,8,12,23762,4096,19666,480.126953125
14,8,13,1413,8192,-6779,-82.75146484375
14,8,14,10490,16384,-5894,-35.97412109375
14,8,15,871,32768,-31897,-97.3419189453125
14,9,1,0,2,-2,-100.0
14,9,2,1,4,-3,-75.0
14,9,3,2,8,-6,-75.0
14,9,4,8,16,-8,-50.0
14,9,5,30,32,-2,-6.25
14,9,6,95,64,31,48.4375
14,9,7,28,128,-100,-78.125
14,9,8,338,256,82,32.03125
14,9,9,31,512,-481,-93.9453125
14,9,10,149,1024,-875,-85.44921875
14,9,11,4961,2048,2913,142.236328125
14,9,12,1466,4096,-2630,-64.208984375
14,9,13,2607,8192,-5585,-68.17626953125
14,9,14,27267,16384,10883,66.424560546875
14,9,15,73090,32768,40322,123.052978515625
14,10,1,0,2,-2,-100.0
14,10,2,3,4,-1,-25.0
14,10,3,4,8,-4,-50.0
14,10,4,16,16,0,0.0
14,10,5,65,32,33,103.125
14,10,6,79,64,15,23.4375
14,10,7,40,128,-88,-68.75
14,10,8,340,256,84,32.8125
14,10,9,35,512,-477,-93.1640625
14,10,10,664,1024,-360,-35.15625
14,10,11,550,2048,-1498,-73.14453125
14,10,12,6497,4096,2401,58.6181640625
14,10,13,1179,8192,-7013,-85.60791015625
14,10,14,6568,16384,-9816,-59.912109375
14,10,15,8013,32768,-24755,-75.5462646484375
14,11,1,0,2,-2,-100.0
14,11,2,1,4,-3,-75.0
14,11,3,4,8,-4,-50.0
14,11,4,19,16,3,18.75
14,11,5,40,32,8,25.0
14,11,6,99,64,35,54.6875
14,11,7,116,128,-12,-9.375
14,11,8,9,256,-247,-96.484375
14,11,9,370,512,-142,-27.734375
14,11,10,92,1024,-932,-91.015625
14,11,11,401,2048,-1647,-80.419921875
14,11,12,4354,4096,258,6.298828125
14,11,13,430,8192,-7762,-94.7509765625
14,11,14,4744,16384,-11640,-71.044921875
14,11,15,34814,32768,2046,6.243896484375
14,12,1,0,2,-2,-100.0
14,12,2,3,4,-1,-25.0
14,12,3,2,8,-6,-75.0
14,12,4,29,16,13,81.25
14,12,5,15,32,-17,-53.125
14,12,6,8,64,-56,-87.5
14,12,7,91,128,-37,-28.90625
14,12,8,11,256,-245,-95.703125
14,12,9,155,512,-357,-69.7265625
14,12,10,629,1024,-395,-38.57421875
14,12,11,422,2048,-1626,-79.39453125
14,12,12,4554,4096,458,11.181640625
14,12,13,25,8192,-8167,-99.69482421875
14,12,14,38886,16384,22502,137.34130859375
14,12,15,78363,32768,45595,139.1448974609375
14,13,1,0,2,-2,-100.0
14,13,2,2,4,-2,-50.0
14,13,3,2,8,-6,-75.0
14,13,4,54,16,38,237.5
14,13,5,59,32,27,84.375
14,13,6,42,64,-22,-34.375
14,13,7,140,128,12,9.375
14,13,8,810,256,554,216.40625
14,13,9,272,512,-240,-46.875
14,13,10,1038,1024,14,1.3671875
14,13,11,5172,2048,3124,152.5390625
14,13,12,3345,4096,-751,-18.3349609375
14,13,13,11854,8192,3662,44.7021484375
14,13,14,13800,16384,-2584,-15.771484375
14,13,15,6045,32768,-26723,-81.5521240234375
14,14,1,0,2,-2,-100.0
14,14,2,1,4,-3,-75.0
14,14,3,9,8,1,12.5
14,14,4,4,16,-12,-75.0
14,14,5,6,32,-26,-81.25
14,14,6,18,64,-46,-71.875
14,14,7,31,128,-97,-75.78125
14,14,8,82,256,-174,-67.96875
14,14,9,322,512,-190,-37.109375
14,14,10,1141,1024,117,11.42578125
14,14,11,1835,2048,-213,-10.400390625
14,14,12,3377,4096,-719,-17.5537109375
14,14,13,12343,8192,4151,50.67138671875
14,14,14,1414,16384,-14970,-91.36962890625
14,14,15,15494,32768,-17274,-52.716064453125
15,1,1,0,2,-2,-100.0
15,1,2,2,4,-2,-50.0
15,1,3,2,8,-6,-75.0
15,1,4,12,16,-4,-25.0
15,1,5,50,32,18,56.25
15,1,6,22,64,-42,-65.625
15,1,7,80,128,-48,-37.5
15,1,8,8,256,-248,-96.875
15,1,9,339,512,-173,-33.7890625
15,1,10,1058,1024,34,3.3203125
15,1,11,2231,2048,183,8.935546875
15,1,12,1389,4096,-2707,-66.0888671875
15,1,13,17108,8192,8916,108.837890625
15,1,14,3907,16384,-12477,-76.153564453125
15,1,15,17534,32768,-15234,-46.490478515625
15,2,1,0,2,-2,-100.0
15,2,2,1,4,-3,-75.0
15,2,3,7,8,-1,-12.5
15,2,4,6,16,-10,-62.5
15,2,5,34,32,2,6.25
15,2,6,66,64,2,3.125
15,2,7,120,128,-8,-6.25
15,2,8,62,256,-194,-75.78125
15,2,9,103,512,-409,-79.8828125
15,2,10,142,1024,-882,-86.1328125
15,2,11,1228,2048,-820,-40.0390625
15,2,12,3990,4096,-106,-2.587890625
15,2,13,12670,8192,4478,54.6630859375
15,2,14,9563,16384,-6821,-41.632080078125
15,2,15,10942,32768,-21826,-66.607666015625
15,3,1,0,2,-2,-100.0
15,3,2,2,4,-2,-50.0
15,3,3,3,8,-5,-62.5
15,3,4,8,16,-8,-50.0
15,3,5,9,32,-23,-71.875
15,3,6,45,64,-19,-29.6875
15,3,7,125,128,-3,-2.34375
15,3,8,983,256,727,283.984375
15,3,9,752,512,240,46.875
15,3,10,639,1024,-385,-37.59765625
15,3,11,2268,2048,220,10.7421875
15,3,12,537,4096,-3559,-86.8896484375
15,3,13,4042,8192,-4150,-50.6591796875
15,3,14,41769,16384,25385,154.937744140625
15,3,15,1327,32768,-31441,-95.9503173828125
15,4,1,0,2,-2,-100.0
15,4,2,2,4,-2,-50.0
15,4,3,3,8,-5,-62.5
15,4,4,12,16,-4,-25.0
15,4,5,10,32,-22,-68.75
15,4,6,28,64,-36,-56.25
15,4,7,316,128,188,146.875
15,4,8,59,256,-197,-76.953125
15,4,9,178,512,-334,-65.234375
15,4,10,97,1024,-927,-90.52734375
15,4,11,1509,2048,-539,-26.318359375
15,4,12,4228,4096,132,3.22265625
15,4,13,3952,8192,-4240,-51.7578125
15,4,14,75464,16384,59080,360.595703125
15,4,15,10967,32768,-21801,-66.5313720703125
15,5,1,0,2,-2,-100.0
15,5,2,2,4,-2,-50.0
15,5,3,2,8,-6,-75.0
15,5,4,7,16,-9,-56.25
15,5,5,65,32,33,103.125
15,5,6,13,64,-51,-79.6875
15,5,7,81,128,-47,-36.71875
15,5,8,26,256,-230,-89.84375
15,5,9,1422,512,910,177.734375
15,5,10,1110,1024,86,8.3984375
15,5,11,2661,2048,613,29.931640625
15,5,12,4386,4096,290,7.080078125
15,5,13,8575,8192,383,4.67529296875
15,5,14,15985,16384,-399,-2.435302734375
15,5,15,62078,32768,29310,89.447021484375
15,6,1,0,2,-2,-100.0
15,6,2,2,4,-2,-50.0
15,6,3,2,8,-6,-75.0
15,6,4,9,16,-7,-43.75
15,6,5,41,32,9,28.125
15,6,6,36,64,-28,-43.75
15,6,7,92,128,-36,-28.125
15,6,8,24,256,-232,-90.625
15,6,9,250,512,-262,-51.171875
15,6,10,899,1024,-125,-12.20703125
15,6,11,941,2048,-1107,-54.052734375
15,6,12,8201,4096,4105,100.2197265625
15,6,13,840,8192,-7352,-89.74609375
15,6,14,29500,16384,13116,80.0537109375
15,6,15,2986,32768,-29782,-90.887451171875
15,7,1,0,2,-2,-100.0
15,7,2,1,4,-3,-75.0
15,7,3,4,8,-4,-50.0
15,7,4,30,16,14,87.5
15,7,5,36,32,4,12.5
15,7,6,36,64,-28,-43.75
15,7,7,84,128,-44,-34.375
15,7,8,153,256,-103,-40.234375
15,7,9,745,512,233,45.5078125
15,7,10,543,1024,-481,-46.97265625
15,7,11,316,2048,-1732,-84.5703125
15,7,12,1055,4096,-3041,-74.2431640625
15,7,13,12734,8192,4542,55.4443359375
15,7,14,1904,16384,-14480,-88.37890625
15,7,15,11119,32768,-21649,-66.0675048828125
15,8,1,0,2,-2,-100.0
15,8,2,2,4,-2,-50.0
15,8,3,7,8,-1,-12.5
15,8,4,8,16,-8,-50.0
15,8,5,24,32,-8,-25.0
15,8,6,31,64,-33,-51.5625
15,8,7,45,128,-83,-64.84375
15,8,8,157,256,-99,-38.671875
15,8,9,975,512,463,90.4296875
15,8,10,280,1024,-744,-72.65625
15,8,11,323,2048,-1725,-84.228515625
15,8,12,715,4096,-3381,-82.5439453125
15,8,13,7550,8192,-642,-7.8369140625
15,8,14,54400,16384,38016,232.03125
15,8,15,6466,32768,-26302,-80.267333984375
15,9,1,0,2,-2,-100.0
15,9,2,1,4,-3,-75.0
15,9,3,2,8,-6,-75.0
15,9,4,6,16,-10,-62.5
15,9,5,36,32,4,12.5
15,9,6,106,64,42,65.625
15,9,7,77,128,-51,-39.84375
15,9,8,49,256,-207,-80.859375
15,9,9,1609,512,1097,214.2578125
15,9,10,1622,1024,598,58.3984375
15,9,11,145,2048,-1903,-92.919921875
15,9,12,12589,4096,8493,207.3486328125
15,9,13,163,8192,-8029,-98.01025390625
15,9,14,44302,16384,27918,170.39794921875
15,9,15,100329,32768,67561,206.1798095703125
15,10,1,0,2,-2,-100.0
15,10,2,1,4,-3,-75.0
15,10,3,5,8,-3,-37.5
15,10,4,11,16,-5,-31.25
15,10,5,60,32,28,87.5
15,10,6,15,64,-49,-76.5625
15,10,7,106,128,-22,-17.1875
15,10,8,172,256,-84,-32.8125
15,10,9,441,512,-71,-13.8671875
15,10,10,779,1024,-245,-23.92578125
15,10,11,2016,2048,-32,-1.5625
15,10,12,504,4096,-3592,-87.6953125
15,10,13,6698,8192,-1494,-18.2373046875
15,10,14,18424,16384,2040,12.451171875
15,10,15,9870,32768,-22898,-69.879150390625
15,11,1,0,2,-2,-100.0
15,11,2,1,4,-3,-75.0
15,11,3,5,8,-3,-37.5
15,11,4,13,16,-3,-18.75
15,11,5,21,32,-11,-34.375
15,11,6,63,64,-1,-1.5625
15,11,7,93,128,-35,-27.34375
15,11,8,456,256,200,78.125
15,11,9,90,512,-422,-82.421875
15,11,10,1342,1024,318,31.0546875
15,11,11,4723,2048,2675,130.615234375
15,11,12,1303,4096,-2793,-68.1884765625
15,11,13,9326,8192,1134,13.8427734375
15,11,14,12192,16384,-4192,-25.5859375
15,11,15,35276,32768,2508,7.65380859375
15,12,1,0,2,-2,-100.0
15,12,2,4,4,0,0.0
15,12,3,3,8,-5,-62.5
15,12,4,16,16,0,0.0
15,12,5,70,32,38,118.75
15,12,6,120,64,56,87.5
15,12,7,536,128,408,318.75
15,12,8,53,256,-203,-79.296875
15,12,9,398,512,-114,-22.265625
15,12,10,642,1024,-382,-37.3046875
15,12,11,445,2048,-1603,-78.271484375
15,12,12,2240,4096,-1856,-45.3125
15,12,13,4886,8192,-3306,-40.3564453125
15,12,14,25063,16384,8679,52.972412109375
15,12,15,17774,32768,-14994,-45.758056640625
15,13,1,0,2,-2,-100.0
15,13,2,2,4,-2,-50.0
15,13,3,2,8,-6,-75.0
15,13,4,6,16,-10,-62.5
15,13,5,45,32,13,40.625
15,13,6,13,64,-51,-79.6875
15,13,7,39,128,-89,-69.53125
15,13,8,115,256,-141,-55.078125
15,13,9,33,512,-479,-93.5546875
15,13,10,173,1024,-851,-83.10546875
15,13,11,10797,2048,8749,427.197265625
15,13,12,156,4096,-3940,-96.19140625
15,13,13,8330,8192,138,1.6845703125
15,13,14,69097,16384,52713,321.734619140625
15,13,15,103514,32768,70746,215.899658203125
15,14,1,0,2,-2,-100.0
15,14,2,1,4,-3,-75.0
15,14,3,8,8,0,0.0
15,14,4,3,16,-13,-81.25
15,14,5,19,32,-13,-40.625
15,14,6,8,64,-56,-87.5
15,14,7,179,128,51,39.84375
15,14,8,55,256,-201,-78.515625
15,14,9,913,512,401,78.3203125
15,14,10,284,1024,-740,-72.265625
15,14,11,14,2048,-2034,-99.31640625
15,14,12,2390,4096,-1706,-41.650390625
15,14,13,5865,8192,-2327,-28.40576171875
15,14,14,3531,16384,-12853,-78.448486328125
15,14,15,23575,32768,-9193,-28.0548095703125
15,15,1,0,2,-2,-100.0
15,15,2,1,4,-3,-75.0
15,15,3,17,8,9,112.5
15,15,4,30,16,14,87.5
15,15,5,7,32,-25,-78.125
15,15,6,23,64,-41,-64.0625
15,15,7,43,128,-85,-66.40625
15,15,8,46,256,-210,-82.03125
15,15,9,134,512,-378,-73.828125
15,15,10,381,1024,-643,-62.79296875
15,15,11,1753,2048,-295,-14.404296875
15,15,12,2137,4096,-1959,-47.8271484375
15,15,13,7823,8192,-369,-4.50439453125
15,15,14,5942,16384,-10442,-63.73291015625
15,15,15,34458,32768,1690,5.157470703125
16,1,1,0,2,-2,-100.0
16,1,2,1,4,-3,-75.0
16,1,3,14,8,6,75.0
16,1,4,13,16,-3,-18.75
16,1,5,81,32,49,153.125
16,1,6,12,64,-52,-81.25
16,1,7,16,128,-112,-87.5
16,1,8,1050,256,794,310.15625
16,1,9,83,512,-429,-83.7890625
16,1,10,558,1024,-466,-45.5078125
16,1,11,3598,2048,1550,75.68359375
16,1,12,429,4096,-3667,-89.5263671875
16,1,13,164,8192,-8028,-97.998046875
16,1,14,11141,16384,-5243,-32.000732421875
16,1,15,71133,32768,38365,117.0806884765625
16,2,1,0,2,-2,-100.0
16,2,2,1,4,-3,-75.0
16,2,3,18,8,10,125.0
16,2,4,9,16,-7,-43.75
16,2,5,4,32,-28,-87.5
16,2,6,12,64,-52,-81.25
16,2,7,221,128,93,72.65625
16,2,8,338,256,82,32.03125
16,2,9,207,512,-305,-59.5703125
16,2,10,259,1024,-765,-74.70703125
16,2,11,42,2048,-2006,-97.94921875
16,2,12,7061,4096,2965,72.3876953125
16,2,13,2021,8192,-6171,-75.32958984375
16,2,14,5568,16384,-10816,-66.015625
16,2,15,3897,32768,-28871,-88.1072998046875
16,3,1,0,2,-2,-100.0
16,3,2,1,4,-3,-75.0
16,3,3,11,8,3,37.5
16,3,4,11,16,-5,-31.25
16,3,5,83,32,51,159.375
16,3,6,18,64,-46,-71.875
16,3,7,40,128,-88,-68.75
16,3,8,271,256,15,5.859375
16,3,9,258,512,-254,-49.609375
16,3,10,1557,1024,533,52.05078125
16,3,11,2864,2048,816,39.84375
16,3,12,4269,4096,173,4.2236328125
16,3,13,3542,8192,-4650,-56.7626953125
16,3,14,13755,16384,-2629,-16.046142578125
16,3,15,115662,32768,82894,252.972412109375
16,4,1,0,2,-2,-100.0
16,4,2,1,4,-3,-75.0
16,4,3,4,8,-4,-50.0
16,4,4,16,16,0,0.0
16,4,5,68,32,36,112.5
16,4,6,11,64,-53,-82.8125
16,4,7,29,128,-99,-77.34375
16,4,8,1096,256,840,328.125
16,4,9,234,512,-278,-54.296875
16,4,10,565,1024,-459,-44.82421875
16,4,11,621,2048,-1427,-69.677734375
16,4,12,2857,4096,-1239,-30.2490234375
16,4,13,9267,8192,1075,13.12255859375
16,4,14,17838,16384,1454,8.87451171875
16,4,15,28503,32768,-4265,-13.0157470703125
16,5,1,0,2,-2,-100.0
16,5,2,1,4,-3,-75.0
16,5,3,5,8,-3,-37.5
16,5,4,24,16,8,50.0
16,5,5,41,32,9,28.125
16,5,6,27,64,-37,-57.8125
16,5,7,113,128,-15,-11.71875
16,5,8,165,256,-91,-35.546875
16,5,9,140,512,-372,-72.65625
16,5,10,378,1024,-646,-63.0859375
16,5,11,318,2048,-1730,-84.47265625
16,5,12,3199,4096,-897,-21.8994140625
16,5,13,8250,8192,58,0.7080078125
16,5,14,29215,16384,12831,78.314208984375
16,5,15,3527,32768,-29241,-89.2364501953125
16,6,1,0,2,-2,-100.0
16,6,2,3,4,-1,-25.0
16,6,3,5,8,-3,-37.5
16,6,4,17,16,1,6.25
16,6,5,9,32,-23,-71.875
16,6,6,16,64,-48,-75.0
16,6,7,21,128,-107,-83.59375
16,6,8,273,256,17,6.640625
16,6,9,249,512,-263,-51.3671875
16,6,10,588,1024,-436,-42.578125
16,6,11,320,2048,-1728,-84.375
16,6,12,17476,4096,13380,326.66015625
16,6,13,3805,8192,-4387,-53.55224609375
16,6,14,3339,16384,-13045,-79.620361328125
16,6,15,10522,32768,-22246,-67.889404296875
16,7,1,0,2,-2,-100.0
16,7,2,1,4,-3,-75.0
16,7,3,4,8,-4,-50.0
16,7,4,26,16,10,62.5
16,7,5,46,32,14,43.75
16,7,6,50,64,-14,-21.875
16,7,7,73,128,-55,-42.96875
16,7,8,547,256,291,113.671875
16,7,9,29,512,-483,-94.3359375
16,7,10,1076,1024,52,5.078125
16,7,11,6821,2048,4773,233.056640625
16,7,12,4458,4096,362,8.837890625
16,7,13,4442,8192,-3750,-45.7763671875
16,7,14,19274,16384,2890,17.63916015625
16,7,15,13320,32768,-19448,-59.3505859375
16,8,1,0,2,-2,-100.0
16,8,2,1,4,-3,-75.0
16,8,3,10,8,2,25.0
16,8,4,8,16,-8,-50.0
16,8,5,55,32,23,71.875
16,8,6,7,64,-57,-89.0625
16,8,7,60,128,-68,-53.125
16,8,8,314,256,58,22.65625
16,8,9,1163,512,651,127.1484375
16,8,10,1172,1024,148,14.453125
16,8,11,285,2048,-1763,-86.083984375
16,8,12,665,4096,-3431,-83.7646484375
16,8,13,18319,8192,10127,123.62060546875
16,8,14,48270,16384,31886,194.61669921875
16,8,15,79795,32768,47027,143.5150146484375
16,9,1,0,2,-2,-100.0
16,9,2,1,4,-3,-75.0
16,9,3,26,8,18,225.0
16,9,4,17,16,1,6.25
16,9,5,8,32,-24,-75.0
16,9,6,68,64,4,6.25
16,9,7,144,128,16,12.5
16,9,8,115,256,-141,-55.078125
16,9,9,1041,512,529,103.3203125
16,9,10,112,1024,-912,-89.0625
16,9,11,5161,2048,3113,152.001953125
16,9,12,2331,4096,-1765,-43.0908203125
16,9,13,839,8192,-7353,-89.75830078125
16,9,14,1438,16384,-14946,-91.22314453125
16,9,15,7098,32768,-25670,-78.338623046875
16,10,1,0,2,-2,-100.0
16,10,2,3,4,-1,-25.0
16,10,3,2,8,-6,-75.0
16,10,4,40,16,24,150.0
16,10,5,49,32,17,53.125
16,10,6,84,64,20,31.25
16,10,7,21,128,-107,-83.59375
16,10,8,144,256,-112,-43.75
16,10,9,322,512,-190,-37.109375
16,10,10,4682,1024,3658,357.2265625
16,10,11,1277,2048,-771,-37.646484375
16,10,12,879,4096,-3217,-78.5400390625
16,10,13,4254,8192,-3938,-48.0712890625
16,10,14,13,16384,-16371,-99.920654296875
16,10,15,37679,32768,4911,14.9871826171875
16,11,1,0,2,-2,-100.0
16,11,2,1,4,-3,-75.0
16,11,3,3,8,-5,-62.5
16,11,4,11,16,-5,-31.25
16,11,5,46,32,14,43.75
16,11,6,10,64,-54,-84.375
16,11,7,125,128,-3,-2.34375
16,11,8,522,256,266,103.90625
16,11,9,167,512,-345,-67.3828125
16,11,10,1009,1024,-15,-1.46484375
16,11,11,551,2048,-1497,-73.095703125
16,11,12,14904,4096,10808,263.8671875
16,11,13,32866,8192,24674,301.1962890625
16,11,14,10924,16384,-5460,-33.3251953125
16,11,15,58397,32768,25629,78.2135009765625
16,12,1,0,2,-2,-100.0
16,12,2,1,4,-3,-75.0
16,12,3,6,8,-2,-25.0
16,12,4,12,16,-4,-25.0
16,12,5,12,32,-20,-62.5
16,12,6,31,64,-33,-51.5625
16,12,7,79,128,-49,-38.28125
16,12,8,23,256,-233,-91.015625
16,12,9,138,512,-374,-73.046875
16,12,10,246,1024,-778,-75.9765625
16,12,11,906,2048,-1142,-55.76171875
16,12,12,2468,4096,-1628,-39.74609375
16,12,13,8260,8192,68,0.830078125
16,12,14,11614,16384,-4770,-29.11376953125
16,12,15,46493,32768,13725,41.8853759765625
16,13,1,0,2,-2,-100.0
16,13,2,2,4,-2,-50.0
16,13,3,7,8,-1,-12.5
16,13,4,47,16,31,193.75
16,13,5,17,32,-15,-46.875
16,13,6,36,64,-28,-43.75
16,13,7,18,128,-110,-85.9375
16,13,8,204,256,-52,-20.3125
16,13,9,778,512,266,51.953125
16,13,10,201,1024,-823,-80.37109375
16,13,11,1008,2048,-1040,-50.78125
16,13,12,2336,4096,-1760,-42.96875
16,13,13,4788,8192,-3404,-41.552734375
16,13,14,12759,16384,-3625,-22.125244140625
16,13,15,41260,32768,8492,25.91552734375
16,14,1,0,2,-2,-100.0
16,14,2,1,4,-3,-75.0
16,14,3,5,8,-3,-37.5
16,14,4,7,16,-9,-56.25
16,14,5,33,32,1,3.125
16,14,6,69,64,5,7.8125
16,14,7,59,128,-69,-53.90625
16,14,8,217,256,-39,-15.234375
16,14,9,150,512,-362,-70.703125
16,14,10,569,1024,-455,-44.43359375
16,14,11,55,2048,-1993,-97.314453125
16,14,12,3209,4096,-887,-21.6552734375
16,14,13,11473,8192,3281,40.05126953125
16,14,14,27774,16384,11390,69.51904296875
16,14,15,53525,32768,20757,63.3453369140625
16,15,1,0,2,-2,-100.0
16,15,2,1,4,-3,-75.0
16,15,3,5,8,-3,-37.5
16,15,4,6,16,-10,-62.5
16,15,5,20,32,-12,-37.5
16,15,6,127,64,63,98.4375
16,15,7,208,128,80,62.5
16,15,8,135,256,-121,-47.265625
16,15,9,736,512,224,43.75
16,15,10,1116,1024,92,8.984375
16,15,11,2108,2048,60,2.9296875
16,15,12,3232,4096,-864,-21.09375
16,15,13,3970,8192,-4222,-51.5380859375
16,15,14,5084,16384,-11300,-68.9697265625
16,15,15,24482,32768,-8286,-25.286865234375
16,16,1,0,2,-2,-100.0
16,16,2,1,4,-3,-75.0
16,16,3,10,8,2,25.0
16,16,4,50,16,34,212.5
16,16,5,22,32,-10,-31.25
16,16,6,16,64,-48,-75.0
16,16,7,117,128,-11,-8.59375
16,16,8,201,256,-55,-21.484375
16,16,9,2020,512,1508,294.53125
16,16,10,551,1024,-473,-46.19140625
16,16,11,5068,2048,3020,147.4609375
16,16,12,3587,4096,-509,-12.4267578125
16,16,13,8844,8192,652,7.958984375
16,16,14,47340,16384,30956,188.9404296875
16,16,15,17367,32768,-15401,-47.0001220703125
17,1,1,0,2,-2,-100.0
17,1,2,1,4,-3,-75.0
17,1,3,4,8,-4,-50.0
17,1,4,7,16,-9,-56.25
17,1,5,7,32,-25,-78.125
17,1,6,14,64,-50,-78.125
17,1,7,29,128,-99,-77.34375
17,1,8,18,256,-238,-92.96875
17,1,9,167,512,-345,-67.3828125
17,1,10,2123,1024,1099,107.32421875
17,1,11,2201,2048,153,7.470703125
17,1,12,1564,4096,-2532,-61.81640625
17,1,13,4444,8192,-3748,-45.751953125
17,1,14,37048,16384,20664,126.123046875
17,1,15,32745,32768,-23,-0.0701904296875
17,2,1,0,2,-2,-100.0
17,2,2,2,4,-2,-50.0
17,2,3,2,8,-6,-75.0
17,2,4,6,16,-10,-62.5
17,2,5,16,32,-16,-50.0
17,2,6,27,64,-37,-57.8125
17,2,7,208,128,80,62.5
17,2,8,14,256,-242,-94.53125
17,2,9,424,512,-88,-17.1875
17,2,10,319,1024,-705,-68.84765625
17,2,11,417,2048,-1631,-79.638671875
17,2,12,19175,4096,15079,368.1396484375
17,2,13,20786,8192,12594,153.7353515625
17,2,14,71429,16384,55045,335.968017578125
17,2,15,16356,32768,-16412,-50.08544921875
17,3,1,0,2,-2,-100.0
17,3,2,1,4,-3,-75.0
17,3,3,10,8,2,25.0
17,3,4,26,16,10,62.5
17,3,5,16,32,-16,-50.0
17,3,6,14,64,-50,-78.125
17,3,7,23,128,-105,-82.03125
17,3,8,43,256,-213,-83.203125
17,3,9,542,512,30,5.859375
17,3,10,2689,1024,1665,162.59765625
17,3,11,705,2048,-1343,-65.576171875
17,3,12,379,4096,-3717,-90.7470703125
17,3,13,4727,8192,-3465,-42.29736328125
17,3,14,15907,16384,-477,-2.911376953125
17,3,15,36137,32768,3369,10.2813720703125
17,4,1,0,2,-2,-100.0
17,4,2,2,4,-2,-50.0
17,4,3,3,8,-5,-62.5
17,4,4,8,16,-8,-50.0
17,4,5,34,32,2,6.25
17,4,6,35,64,-29,-45.3125
17,4,7,33,128,-95,-74.21875
17,4,8,53,256,-203,-79.296875
17,4,9,18,512,-494,-96.484375
17,4,10,45,1024,-979,-95.60546875
17,4,11,5000,2048,2952,144.140625
17,4,12,3322,4096,-774,-18.896484375
17,4,13,4604,8192,-3588,-43.798828125
17,4,14,37111,16384,20727,126.507568359375
17,4,15,49061,32768,16293,49.7222900390625
17,5,1,0,2,-2,-100.0
17,5,2,1,4,-3,-75.0
17,5,3,4,8,-4,-50.0
17,5,4,5,16,-11,-68.75
17,5,5,32,32,0,0.0
17,5,6,108,64,44,68.75
17,5,7,38,128,-90,-70.3125
17,5,8,7,256,-249,-97.265625
17,5,9,160,512,-352,-68.75
17,5,10,1605,1024,581,56.73828125
17,5,11,148,2048,-1900,-92.7734375
17,5,12,550,4096,-3546,-86.572265625
17,5,13,7203,8192,-989,-12.07275390625
17,5,14,29167,16384,12783,78.021240234375
17,5,15,54255,32768,21487,65.5731201171875
17,6,1,0,2,-2,-100.0
17,6,2,1,4,-3,-75.0
17,6,3,4,8,-4,-50.0
17,6,4,5,16,-11,-68.75
17,6,5,16,32,-16,-50.0
17,6,6,102,64,38,59.375
17,6,7,492,128,364,284.375
17,6,8,297,256,41,16.015625
17,6,9,1571,512,1059,206.8359375
17,6,10,2282,1024,1258,122.8515625
17,6,11,6722,2048,4674,228.22265625
17,6,12,16832,4096,12736,310.9375
17,6,13,7389,8192,-803,-9.80224609375
17,6,14,23925,16384,7541,46.026611328125
17,6,15,5315,32768,-27453,-83.7799072265625
17,7,1,0,2,-2,-100.0
17,7,2,1,4,-3,-75.0
17,7,3,2,8,-6,-75.0
17,7,4,12,16,-4,-25.0
17,7,5,52,32,20,62.5
17,7,6,94,64,30,46.875
17,7,7,162,128,34,26.5625
17,7,8,552,256,296,115.625
17,7,9,298,512,-214,-41.796875
17,7,10,12,1024,-1012,-98.828125
17,7,11,1983,2048,-65,-3.173828125
17,7,12,2313,4096,-1783,-43.5302734375
17,7,13,6471,8192,-1721,-21.00830078125
17,7,14,11327,16384,-5057,-30.865478515625
17,7,15,102003,32768,69235,211.2884521484375
17,8,1,0,2,-2,-100.0
17,8,2,1,4,-3,-75.0
17,8,3,10,8,2,25.0
17,8,4,33,16,17,106.25
17,8,5,4,32,-28,-87.5
17,8,6,188,64,124,193.75
17,8,7,27,128,-101,-78.90625
17,8,8,241,256,-15,-5.859375
17,8,9,312,512,-200,-39.0625
17,8,10,2599,1024,1575,153.80859375
17,8,11,3408,2048,1360,66.40625
17,8,12,2936,4096,-1160,-28.3203125
17,8,13,13118,8192,4926,60.1318359375
17,8,14,26517,16384,10133,61.846923828125
17,8,15,7956,32768,-24812,-75.72021484375
17,9,1,0,2,-2,-100.0
17,9,2,2,4,-2,-50.0
17,9,3,4,8,-4,-50.0
17,9,4,8,16,-8,-50.0
17,9,5,31,32,-1,-3.125
17,9,6,16,64,-48,-75.0
17,9,7,47,128,-81,-63.28125
17,9,8,661,256,405,158.203125
17,9,9,358,512,-154,-30.078125
17,9,10,1270,1024,246,24.0234375
17,9,11,1482,2048,-566,-27.63671875
17,9,12,647,4096,-3449,-84.2041015625
17,9,13,915,8192,-7277,-88.83056640625
17,9,14,22563,16384,6179,37.713623046875
17,9,15,59216,32768,26448,80.712890625
17,10,1,0,2,-2,-100.0
17,10,2,1,4,-3,-75.0
17,10,3,3,8,-5,-62.5
17,10,4,10,16,-6,-37.5
17,10,5,28,32,-4,-12.5
17,10,6,26,64,-38,-59.375
17,10,7,18,128,-110,-85.9375
17,10,8,150,256,-106,-41.40625
17,10,9,680,512,168,32.8125
17,10,10,453,1024,-571,-55.76171875
17,10,11,1957,2048,-91,-4.443359375
17,10,12,12896,4096,8800,214.84375
17,10,13,4985,8192,-3207,-39.14794921875
17,10,14,16310,16384,-74,-0.45166015625
17,10,15,38144,32768,5376,16.40625
17,11,1,0,2,-2,-100.0
17,11,2,4,4,0,0.0
17,11,3,2,8,-6,-75.0
17,11,4,31,16,15,93.75
17,11,5,4,32,-28,-87.5
17,11,6,5,64,-59,-92.1875
17,11,7,94,128,-34,-26.5625
17,11,8,691,256,435,169.921875
17,11,9,72,512,-440,-85.9375
17,11,10,439,1024,-585,-57.12890625
17,11,11,4014,2048,1966,95.99609375
17,11,12,4002,4096,-94,-2.294921875
17,11,13,25712,8192,17520,213.8671875
17,11,14,8547,16384,-7837,-47.833251953125
17,11,15,33328,32768,560,1.708984375
17,12,1,0,2,-2,-100.0
17,12,2,2,4,-2,-50.0
17,12,3,10,8,2,25.0
17,12,4,16,16,0,0.0
17,12,5,43,32,11,34.375
17,12,6,16,64,-48,-75.0
17,12,7,92,128,-36,-28.125
17,12,8,304,256,48,18.75
17,12,9,882,512,370,72.265625
17,12,10,85,1024,-939,-91.69921875
17,12,11,3214,2048,1166,56.93359375
17,12,12,1905,4096,-2191,-53.4912109375
17,12,13,15341,8192,7149,87.26806640625
17,12,14,25889,16384,9505,58.013916015625
17,12,15,25828,32768,-6940,-21.17919921875
17,13,1,0,2,-2,-100.0
17,13,2,2,4,-2,-50.0
17,13,3,11,8,3,37.5
17,13,4,4,16,-12,-75.0
17,13,5,74,32,42,131.25
17,13,6,41,64,-23,-35.9375
17,13,7,12,128,-116,-90.625
17,13,8,763,256,507,198.046875
17,13,9,681,512,169,33.0078125
17,13,10,382,1024,-642,-62.6953125
17,13,11,2373,2048,325,15.869140625
17,13,12,8183,4096,4087,99.7802734375
17,13,13,294,8192,-7898,-96.4111328125
17,13,14,9671,16384,-6713,-40.972900390625
17,13,15,19753,32768,-13015,-39.7186279296875
17,14,1,0,2,-2,-100.0
17,14,2,2,4,-2,-50.0
17,14,3,12,8,4,50.0
17,14,4,14,16,-2,-12.5
17,14,5,17,32,-15,-46.875
17,14,6,23,64,-41,-64.0625
17,14,7,138,128,10,7.8125
17,14,8,724,256,468,182.8125
17,14,9,409,512,-103,-20.1171875
17,14,10,263,1024,-761,-74.31640625
17,14,11,1753,2048,-295,-14.404296875
17,14,12,5962,4096,1866,45.556640625
17,14,13,7952,8192,-240,-2.9296875
17,14,14,58839,16384,42455,259.124755859375
17,14,15,32924,32768,156,0.47607421875
17,15,1,0,2,-2,-100.0
17,15,2,1,4,-3,-75.0
17,15,3,9,8,1,12.5
17,15,4,12,16,-4,-25.0
17,15,5,15,32,-17,-53.125
17,15,6,11,64,-53,-82.8125
17,15,7,164,128,36,28.125
17,15,8,976,256,720,281.25
17,15,9,910,512,398,77.734375
17,15,10,136,1024,-888,-86.71875
17,15,11,1075,2048,-973,-47.509765625
17,15,12,17203,4096,13107,319.9951171875
17,15,13,9440,8192,1248,15.234375
17,15,14,16143,16384,-241,-1.470947265625
17,15,15,18033,32768,-14735,-44.9676513671875
17,16,1,0,2,-2,-100.0
17,16,2,1,4,-3,-75.0
17,16,3,2,8,-6,-75.0
17,16,4,16,16,0,0.0
17,16,5,26,32,-6,-18.75
17,16,6,104,64,40,62.5
17,16,7,60,128,-68,-53.125
17,16,8,47,256,-209,-81.640625
17,16,9,1499,512,987,192.7734375
17,16,10,1269,1024,245,23.92578125
17,16,11,4044,2048,1996,97.4609375
17,16,12,5019,4096,923,22.5341796875
17,16,13,8583,8192,391,4.77294921875
17,16,14,24018,16384,7634,46.59423828125
17,16,15,63594,32768,30826,94.073486328125
17,17,1,0,2,-2,-100.0
17,17,2,3,4,-1,-25.0
17,17,3,2,8,-6,-75.0
17,17,4,3,16,-13,-81.25
17,17,5,88,32,56,175.0
17,17,6,21,64,-43,-67.1875
17,17,7,154,128,26,20.3125
17,17,8,375,256,119,46.484375
17,17,9,926,512,414,80.859375
17,17,10,39,1024,-985,-96.19140625
17,17,11,7121,2048,5073,247.705078125
17,17,12,2065,4096,-2031,-49.5849609375
17,17,13,3258,8192,-4934,-60.2294921875
17,17,14,55152,16384,38768,236.62109375
17,17,15,36663,32768,3895,11.8865966796875
18,1,1,0,2,-2,-100.0
18,1,2,1,4,-3,-75.0
18,1,3,2,8,-6,-75.0
18,1,4,36,16,20,125.0
18,1,5,19,32,-13,-40.625
18,1,6,85,64,21,32.8125
18,1,7,65,128,-63,-49.21875
18,1,8,296,256,40,15.625
18,1,9,125,512,-387,-75.5859375
18,1,10,1091,1024,67,6.54296875
18,1,11,4642,2048,2594,126.66015625
18,1,12,6864,4096,2768,67.578125
18,1,13,357,8192,-7835,-95.64208984375
18,1,14,97,16384,-16287,-99.407958984375
18,1,15,34865,32768,2097,6.3995361328125
18,2,1,0,2,-2,-100.0
18,2,2,3,4,-1,-25.0
18,2,3,4,8,-4,-50.0
18,2,4,15,16,-1,-6.25
18,2,5,24,32,-8,-25.0
18,2,6,18,64,-46,-71.875
18,2,7,6,128,-122,-95.3125
18,2,8,43,256,-213,-83.203125
18,2,9,197,512,-315,-61.5234375
18,2,10,1261,1024,237,23.14453125
18,2,11,533,2048,-1515,-73.974609375
18,2,12,694,4096,-3402,-83.056640625
18,2,13,8880,8192,688,8.3984375
18,2,14,6324,16384,-10060,-61.4013671875
18,2,15,1350,32768,-31418,-95.880126953125
18,3,1,0,2,-2,-100.0
18,3,2,1,4,-3,-75.0
18,3,3,6,8,-2,-25.0
18,3,4,5,16,-11,-68.75
18,3,5,29,32,-3,-9.375
18,3,6,119,64,55,85.9375
18,3,7,6,128,-122,-95.3125
18,3,8,378,256,122,47.65625
18,3,9,94,512,-418,-81.640625
18,3,10,17,1024,-1007,-98.33984375
18,3,11,1283,2048,-765,-37.353515625
18,3,12,660,4096,-3436,-83.88671875
18,3,13,5612,8192,-2580,-31.494140625
18,3,14,228,16384,-16156,-98.6083984375
18,3,15,17408,32768,-15360,-46.875
18,4,1,0,2,-2,-100.0
18,4,2,5,4,1,25.0
18,4,3,5,8,-3,-37.5
18,4,4,10,16,-6,-37.5
18,4,5,28,32,-4,-12.5
18,4,6,20,64,-44,-68.75
18,4,7,398,128,270,210.9375
18,4,8,922,256,666,260.15625
18,4,9,260,512,-252,-49.21875
18,4,10,822,1024,-202,-19.7265625
18,4,11,357,2048,-1691,-82.568359375
18,4,12,260,4096,-3836,-93.65234375
18,4,13,2747,8192,-5445,-66.46728515625
18,4,14,29473,16384,13089,79.888916015625
18,4,15,36708,32768,3940,12.02392578125
18,5,1,0,2,-2,-100.0
18,5,2,2,4,-2,-50.0
18,5,3,13,8,5,62.5
18,5,4,3,16,-13,-81.25
18,5,5,5,32,-27,-84.375
18,5,6,28,64,-36,-56.25
18,5,7,25,128,-103,-80.46875
18,5,8,554,256,298,116.40625
18,5,9,225,512,-287,-56.0546875
18,5,10,1242,1024,218,21.2890625
18,5,11,1362,2048,-686,-33.49609375
18,5,12,1836,4096,-2260,-55.17578125
18,5,13,1379,8192,-6813,-83.16650390625
18,5,14,18009,16384,1625,9.918212890625
18,5,15,18768,32768,-14000,-42.724609375
18,6,1,0,2,-2,-100.0
18,6,2,8,4,4,100.0
18,6,3,2,8,-6,-75.0
18,6,4,3,16,-13,-81.25
18,6,5,7,32,-25,-78.125
18,6,6,14,64,-50,-78.125
18,6,7,201,128,73,57.03125
18,6,8,232,256,-24,-9.375
18,6,9,114,512,-398,-77.734375
18,6,10,896,1024,-128,-12.5
18,6,11,5535,2048,3487,170.263671875
18,6,12,6795,4096,2699,65.8935546875
18,6,13,1890,8192,-6302,-76.9287109375
18,6,14,34474,16384,18090,110.41259765625
18,6,15,13624,32768,-19144,-58.4228515625
18,7,1,0,2,-2,-100.0
18,7,2,3,4,-1,-25.0
18,7,3,13,8,5,62.5
18,7,4,16,16,0,0.0
18,7,5,4,32,-28,-87.5
18,7,6,31,64,-33,-51.5625
18,7,7,338,128,210,164.0625
18,7,8,886,256,630,246.09375
18,7,9,210,512,-302,-58.984375
18,7,10,2169,1024,1145,111.81640625
18,7,11,4886,2048,2838,138.57421875
18,7,12,654,4096,-3442,-84.033203125
18,7,13,4567,8192,-3625,-44.25048828125
18,7,14,679,16384,-15705,-95.855712890625
18,7,15,14980,32768,-17788,-54.28466796875
18,8,1,0,2,-2,-100.0
18,8,2,4,4,0,0.0
18,8,3,4,8,-4,-50.0
18,8,4,25,16,9,56.25
18,8,5,36,32,4,12.5
18,8,6,46,64,-18,-28.125
18,8,7,141,128,13,10.15625
18,8,8,205,256,-51,-19.921875
18,8,9,380,512,-132,-25.78125
18,8,10,589,1024,-435,-42.48046875
18,8,11,6455,2048,4407,215.185546875
18,8,12,1977,4096,-2119,-51.7333984375
18,8,13,12223,8192,4031,49.20654296875
18,8,14,51102,16384,34718,211.90185546875
18,8,15,3143,32768,-29625,-90.4083251953125
18,9,1,0,2,-2,-100.0
18,9,2,2,4,-2,-50.0
18,9,3,3,8,-5,-62.5
18,9,4,11,16,-5,-31.25
18,9,5,18,32,-14,-43.75
18,9,6,113,64,49,76.5625
18,9,7,245,128,117,91.40625
18,9,8,339,256,83,32.421875
18,9,9,169,512,-343,-66.9921875
18,9,10,3110,1024,2086,203.7109375
18,9,11,311,2048,-1737,-84.814453125
18,9,12,550,4096,-3546,-86.572265625
18,9,13,20185,8192,11993,146.39892578125
18,9,14,7713,16384,-8671,-52.923583984375
18,9,15,21308,32768,-11460,-34.97314453125
18,10,1,0,2,-2,-100.0
18,10,2,1,4,-3,-75.0
18,10,3,8,8,0,0.0
18,10,4,45,16,29,181.25
18,10,5,65,32,33,103.125
18,10,6,91,64,27,42.1875
18,10,7,59,128,-69,-53.90625
18,10,8,62,256,-194,-75.78125
18,10,9,1851,512,1339,261.5234375
18,10,10,277,1024,-747,-72.94921875
18,10,11,882,2048,-1166,-56.93359375
18,10,12,4126,4096,30,0.732421875
18,10,13,9151,8192,959,11.70654296875
18,10,14,9610,16384,-6774,-41.34521484375
18,10,15,60479,32768,27711,84.5672607421875
18,11,1,0,2,-2,-100.0
18,11,2,1,4,-3,-75.0
18,11,3,17,8,9,112.5
18,11,4,14,16,-2,-12.5
18,11,5,11,32,-21,-65.625
18,11,6,91,64,27,42.1875
18,11,7,8,128,-120,-93.75
18,11,8,507,256,251,98.046875
18,11,9,272,512,-240,-46.875
18,11,10,281,1024,-743,-72.55859375
18,11,11,1023,2048,-1025,-50.048828125
18,11,12,2075,4096,-2021,-49.3408203125
18,11,13,5694,8192,-2498,-30.4931640625
18,11,14,992,16384,-15392,-93.9453125
18,11,15,45084,32768,12316,37.58544921875
18,12,1,0,2,-2,-100.0
18,12,2,1,4,-3,-75.0
18,12,3,5,8,-3,-37.5
18,12,4,6,16,-10,-62.5
18,12,5,9,32,-23,-71.875
18,12,6,15,64,-49,-76.5625
18,12,7,46,128,-82,-64.0625
18,12,8,12,256,-244,-95.3125
18,12,9,335,512,-177,-34.5703125
18,12,10,612,1024,-412,-40.234375
18,12,11,745,2048,-1303,-63.623046875
18,12,12,4624,4096,528,12.890625
18,12,13,22946,8192,14754,180.1025390625
18,12,14,8418,16384,-7966,-48.62060546875
18,12,15,21444,32768,-11324,-34.55810546875
18,13,1,0,2,-2,-100.0
18,13,2,1,4,-3,-75.0
18,13,3,2,8,-6,-75.0
18,13,4,8,16,-8,-50.0
18,13,5,30,32,-2,-6.25
18,13,6,8,64,-56,-87.5
18,13,7,38,128,-90,-70.3125
18,13,8,771,256,515,201.171875
18,13,9,63,512,-449,-87.6953125
18,13,10,2401,1024,1377,134.47265625
18,13,11,5031,2048,2983,145.654296875
18,13,12,3508,4096,-588,-14.35546875
18,13,13,13560,8192,5368,65.52734375
18,13,14,94267,16384,77883,475.360107421875
18,13,15,3951,32768,-28817,-87.9425048828125
18,14,1,0,2,-2,-100.0
18,14,2,3,4,-1,-25.0
18,14,3,3,8,-5,-62.5
18,14,4,6,16,-10,-62.5
18,14,5,21,32,-11,-34.375
18,14,6,107,64,43,67.1875
18,14,7,34,128,-94,-73.4375
18,14,8,561,256,305,119.140625
18,14,9,165,512,-347,-67.7734375
18,14,10,646,1024,-378,-36.9140625
18,14,11,2495,2048,447,21.826171875
18,14,12,6648,4096,2552,62.3046875
18,14,13,7673,8192,-519,-6.33544921875
18,14,14,33332,16384,16948,103.4423828125
18,14,15,16057,32768,-16711,-50.9979248046875
18,15,1,0,2,-2,-100.0
18,15,2,1,4,-3,-75.0
18,15,3,3,8,-5,-62.5
18,15,4,13,16,-3,-18.75
18,15,5,13,32,-19,-59.375
18,15,6,56,64,-8,-12.5
18,15,7,60,128,-68,-53.125
18,15,8,197,256,-59,-23.046875
18,15,9,267,512,-245,-47.8515625
18,15,10,2112,1024,1088,106.25
18,15,11,947,2048,-1101,-53.759765625
18,15,12,14243,4096,10147,247.7294921875
18,15,13,914,8192,-7278,-88.8427734375
18,15,14,35058,16384,18674,113.97705078125
18,15,15,4175,32768,-28593,-87.2589111328125
18,16,1,0,2,-2,-100.0
18,16,2,2,4,-2,-50.0
18,16,3,2,8,-6,-75.0
18,16,4,15,16,-1,-6.25
18,16,5,55,32,23,71.875
18,16,6,9,64,-55,-85.9375
18,16,7,145,128,17,13.28125
18,16,8,145,256,-111,-43.359375
18,16,9,97,512,-415,-81.0546875
18,16,10,116,1024,-908,-88.671875
18,16,11,5408,2048,3360,164.0625
18,16,12,585,4096,-3511,-85.7177734375
18,16,13,364,8192,-7828,-95.556640625
18,16,14,19171,16384,2787,17.010498046875
18,16,15,52550,32768,19782,60.369873046875
18,17,1,0,2,-2,-100.0
18,17,2,4,4,0,0.0
18,17,3,2,8,-6,-75.0
18,17,4,8,16,-8,-50.0
18,17,5,6,32,-26,-81.25
18,17,6,14,64,-50,-78.125
18,17,7,189,128,61,47.65625
18,17,8,401,256,145,56.640625
18,17,9,1042,512,530,103.515625
18,17,10,1696,1024,672,65.625
18,17,11,1432,2048,-616,-30.078125
18,17,12,2693,4096,-1403,-34.2529296875
18,17,13,14888,8192,6696,81.73828125
18,17,14,13630,16384,-2754,-16.80908203125
18,17,15,23101,32768,-9667,-29.5013427734375
18,18,1,0,2,-2,-100.0
18,18,2,2,4,-2,-50.0
18,18,3,3,8,-5,-62.5
18,18,4,4,16,-12,-75.0
18,18,5,16,32,-16,-50.0
18,18,6,47,64,-17,-26.5625
18,18,7,81,128,-47,-36.71875
18,18,8,572,256,316,123.4375
18,18,9,33,512,-479,-93.5546875
18,18,10,3579,1024,2555,249.51171875
18,18,11,1638,2048,-410,-20.01953125
18,18,12,6503,4096,2407,58.7646484375
18,18,13,12515,8192,4323,52.77099609375
18,18,14,10810,16384,-5574,-34.02099609375
18,18,15,13122,32768,-19646,-59.954833984375
19,1,1,0,2,-2,-100.0
19,1,2,2,4,-2,-50.0
19,1,3,9,8,1,12.5
19,1,4,4,16,-12,-75.0
19,1,5,19,32,-13,-40.625
19,1,6,12,64,-52,-81.25
19,1,7,30,128,-98,-76.5625
19,1,8,31,256,-225,-87.890625
19,1,9,37,512,-475,-92.7734375
19,1,10,390,1024,-634,-61.9140625
19,1,11,260,2048,-1788,-87.3046875
19,1,12,739,4096,-3357,-81.9580078125
19,1,13,8668,8192,476,5.810546875
19,1,14,1084,16384,-15300,-93.3837890625
19,1,15,22085,32768,-10683,-32.6019287109375
19,2,1,0,2,-2,-100.0
19,2,2,3,4,-1,-25.0
19,2,3,2,8,-6,-75.0
19,2,4,3,16,-13,-81.25
19,2,5,25,32,-7,-21.875
19,2,6,146,64,82,128.125
19,2,7,285,128,157,122.65625
19,2,8,41,256,-215,-83.984375
19,2,9,86,512,-426,-83.203125
19,2,10,718,1024,-306,-29.8828125
19,2,11,214,2048,-1834,-89.55078125
19,2,12,1184,4096,-2912,-71.09375
19,2,13,6620,8192,-1572,-19.189453125
19,2,14,20790,16384,4406,26.89208984375
19,2,15,21216,32768,-11552,-35.25390625
19,3,1,0,2,-2,-100.0
19,3,2,1,4,-3,-75.0
19,3,3,8,8,0,0.0
19,3,4,3,16,-13,-81.25
19,3,5,5,32,-27,-84.375
19,3,6,7,64,-57,-89.0625
19,3,7,311,128,183,142.96875
19,3,8,1157,256,901,351.953125
19,3,9,717,512,205,40.0390625
19,3,10,279,1024,-745,-72.75390625
19,3,11,3688,2048,1640,80.078125
19,3,12,917,4096,-3179,-77.6123046875
19,3,13,1716,8192,-6476,-79.052734375
19,3,14,17051,16384,667,4.071044921875
19,3,15,24920,32768,-7848,-23.9501953125
19,4,1,0,2,-2,-100.0
19,4,2,1,4,-3,-75.0
19,4,3,2,8,-6,-75.0
19,4,4,6,16,-10,-62.5
19,4,5,35,32,3,9.375
19,4,6,79,64,15,23.4375
19,4,7,7,128,-121,-94.53125
19,4,8,315,256,59,23.046875
19,4,9,1082,512,570,111.328125
19,4,10,228,1024,-796,-77.734375
19,4,11,213,2048,-1835,-89.599609375
19,4,12,7036,4096,2940,71.77734375
19,4,13,5707,8192,-2485,-30.33447265625
19,4,14,25435,16384,9051,55.242919921875
19,4,15,22464,32768,-10304,-31.4453125
19,5,1,0,2,-2,-100.0
19,5,2,1,4,-3,-75.0
19,5,3,8,8,0,0.0
19,5,4,5,16,-11,-68.75
19,5,5,4,32,-28,-87.5
19,5,6,37,64,-27,-42.1875
19,5,7,69,128,-59,-46.09375
19,5,8,147,256,-109,-42.578125
19,5,9,850,512,338,66.015625
19,5,10,1047,1024,23,2.24609375
19,5,11,1071,2048,-977,-47.705078125
19,5,12,196,4096,-3900,-95.21484375
19,5,13,15938,8192,7746,94.5556640625
19,5,14,1279,16384,-15105,-92.193603515625
19,5,15,17043,32768,-15725,-47.9888916015625
19,6,1,0,2,-2,-100.0
19,6,2,6,4,2,50.0
19,6,3,6,8,-2,-25.0
19,6,4,13,16,-3,-18.75
19,6,5,29,32,-3,-9.375
19,6,6,124,64,60,93.75
19,6,7,149,128,21,16.40625
19,6,8,272,256,16,6.25
19,6,9,68,512,-444,-86.71875
19,6,10,79,1024,-945,-92.28515625
19,6,11,3300,2048,1252,61.1328125
19,6,12,8216,4096,4120,100.5859375
19,6,13,20,8192,-8172,-99.755859375
19,6,14,6384,16384,-10000,-61.03515625
19,6,15,5447,32768,-27321,-83.3770751953125
19,7,1,0,2,-2,-100.0
19,7,2,1,4,-3,-75.0
19,7,3,5,8,-3,-37.5
19,7,4,6,16,-10,-62.5
19,7,5,35,32,3,9.375
19,7,6,87,64,23,35.9375
19,7,7,17,128,-111,-86.71875
19,7,8,647,256,391,152.734375
19,7,9,66,512,-446,-87.109375
19,7,10,140,1024,-884,-86.328125
19,7,11,217,2048,-1831,-89.404296875
19,7,12,1421,4096,-2675,-65.3076171875
19,7,13,262,8192,-7930,-96.8017578125
19,7,14,3689,16384,-12695,-77.484130859375
19,7,15,50098,32768,17330,52.886962890625
19,8,1,0,2,-2,-100.0
19,8,2,1,4,-3,-75.0
19,8,3,3,8,-5,-62.5
19,8,4,58,16,42,262.5
19,8,5,31,32,-1,-3.125
19,8,6,25,64,-39,-60.9375
19,8,7,33,128,-95,-74.21875
19,8,8,377,256,121,47.265625
19,8,9,151,512,-361,-70.5078125
19,8,10,3792,1024,2768,270.3125
19,8,11,10814,2048,8766,428.02734375
19,8,12,1984,4096,-2112,-51.5625
19,8,13,8844,8192,652,7.958984375
19,8,14,8098,16384,-8286,-50.57373046875
19,8,15,4415,32768,-28353,-86.5264892578125
19,9,1,0,2,-2,-100.0
19,9,2,3,4,-1,-25.0
19,9,3,12,8,4,50.0
19,9,4,9,16,-7,-43.75
19,9,5,135,32,103,321.875
19,9,6,55,64,-9,-14.0625
19,9,7,28,128,-100,-78.125
19,9,8,228,256,-28,-10.9375
19,9,9,113,512,-399,-77.9296875
19,9,10,252,1024,-772,-75.390625
19,9,11,183,2048,-1865,-91.064453125
19,9,12,1992,4096,-2104,-51.3671875
19,9,13,11826,8192,3634,44.3603515625
19,9,14,24040,16384,7656,46.728515625
19,9,15,4032,32768,-28736,-87.6953125
19,10,1,0,2,-2,-100.0
19,10,2,1,4,-3,-75.0
19,10,3,6,8,-2,-25.0
19,10,4,10,16,-6,-37.5
19,10,5,7,32,-25,-78.125
19,10,6,90,64,26,40.625
19,10,7,18,128,-110,-85.9375
19,10,8,40,256,-216,-84.375
19,10,9,248,512,-264,-51.5625
19,10,10,361,1024,-663,-64.74609375
19,10,11,835,2048,-1213,-59.228515625
19,10,12,10542,4096,6446,157.373046875
19,10,13,276,8192,-7916,-96.630859375
19,10,14,26404,16384,10020,61.1572265625
19,10,15,20680,32768,-12088,-36.8896484375
19,11,1,0,2,-2,-100.0
19,11,2,1,4,-3,-75.0
19,11,3,15,8,7,87.5
19,11,4,30,16,14,87.5
19,11,5,22,32,-10,-31.25
19,11,6,131,64,67,104.6875
19,11,7,74,128,-54,-42.1875
19,11,8,358,256,102,39.84375
19,11,9,144,512,-368,-71.875
19,11,10,119,1024,-905,-88.37890625
19,11,11,1145,2048,-903,-44.091796875
19,11,12,336,4096,-3760,-91.796875
19,11,13,1385,8192,-6807,-83.09326171875
19,11,14,5333,16384,-11051,-67.449951171875
19,11,15,1605,32768,-31163,-95.1019287109375
19,12,1,0,2,-2,-100.0
19,12,2,1,4,-3,-75.0
19,12,3,2,8,-6,-75.0
19,12,4,7,16,-9,-56.25
19,12,5,28,32,-4,-12.5
19,12,6,45,64,-19,-29.6875
19,12,7,47,128,-81,-63.28125
19,12,8,156,256,-100,-39.0625
19,12,9,240,512,-272,-53.125
19,12,10,470,1024,-554,-54.1015625
19,12,11,492,2048,-1556,-75.9765625
19,12,12,2343,4096,-1753,-42.7978515625
19,12,13,2824,8192,-5368,-65.52734375
19,12,14,20075,16384,3691,22.528076171875
19,12,15,4021,32768,-28747,-87.7288818359375
19,13,1,0,2,-2,-100.0
19,13,2,9,4,5,125.0
19,13,3,5,8,-3,-37.5
19,13,4,36,16,20,125.0
19,13,5,40,32,8,25.0
19,13,6,64,64,0,0.0
19,13,7,67,128,-61,-47.65625
19,13,8,407,256,151,58.984375
19,13,9,257,512,-255,-49.8046875
19,13,10,342,1024,-682,-66.6015625
19,13,11,688,2048,-1360,-66.40625
19,13,12,8702,4096,4606,112.451171875
19,13,13,3477,8192,-4715,-57.55615234375
19,13,14,4829,16384,-11555,-70.526123046875
19,13,15,1730,32768,-31038,-94.720458984375
19,14,1,0,2,-2,-100.0
19,14,2,1,4,-3,-75.0
19,14,3,3,8,-5,-62.5
19,14,4,3,16,-13,-81.25
19,14,5,94,32,62,193.75
19,14,6,16,64,-48,-75.0
19,14,7,52,128,-76,-59.375
19,14,8,124,256,-132,-51.5625
19,14,9,1644,512,1132,221.09375
19,14,10,29,1024,-995,-97.16796875
19,14,11,2742,2048,694,33.88671875
19,14,12,21644,4096,17548,428.41796875
19,14,13,1647,8192,-6545,-79.89501953125
19,14,14,2419,16384,-13965,-85.235595703125
19,14,15,26569,32768,-6199,-18.9178466796875
19,15,1,0,2,-2,-100.0
19,15,2,1,4,-3,-75.0
19,15,3,5,8,-3,-37.5
19,15,4,24,16,8,50.0
19,15,5,10,32,-22,-68.75
19,15,6,75,64,11,17.1875
19,15,7,73,128,-55,-42.96875
19,15,8,47,256,-209,-81.640625
19,15,9,1757,512,1245,243.1640625
19,15,10,2233,1024,1209,118.06640625
19,15,11,2784,2048,736,35.9375
19,15,12,5309,4096,1213,29.6142578125
19,15,13,4133,8192,-4059,-49.54833984375
19,15,14,27569,16384,11185,68.267822265625
19,15,15,9907,32768,-22861,-69.7662353515625
19,16,1,0,2,-2,-100.0
19,16,2,1,4,-3,-75.0
19,16,3,13,8,5,62.5
19,16,4,6,16,-10,-62.5
19,16,5,86,32,54,168.75
19,16,6,15,64,-49,-76.5625
19,16,7,140,128,12,9.375
19,16,8,402,256,146,57.03125
19,16,9,27,512,-485,-94.7265625
19,16,10,439,1024,-585,-57.12890625
19,16,11,1746,2048,-302,-14.74609375
19,16,12,3591,4096,-505,-12.3291015625
19,16,13,6456,8192,-1736,-21.19140625
19,16,14,9410,16384,-6974,-42.56591796875
19,16,15,35110,32768,2342,7.147216796875
19,17,1,0,2,-2,-100.0
19,17,2,2,4,-2,-50.0
19,17,3,13,8,5,62.5
19,17,4,6,16,-10,-62.5
19,17,5,17,32,-15,-46.875
19,17,6,10,64,-54,-84.375
19,17,7,100,128,-28,-21.875
19,17,8,325,256,69,26.953125
19,17,9,730,512,218,42.578125
19,17,10,407,1024,-617,-60.25390625
19,17,11,618,2048,-1430,-69.82421875
19,17,12,2992,4096,-1104,-26.953125
19,17,13,5176,8192,-3016,-36.81640625
19,17,14,3880,16384,-12504,-76.318359375
19,17,15,47137,32768,14369,43.8507080078125
19,18,1,0,2,-2,-100.0
19,18,2,1,4,-3,-75.0
19,18,3,2,8,-6,-75.0
19,18,4,22,16,6,37.5
19,18,5,29,32,-3,-9.375
19,18,6,40,64,-24,-37.5
19,18,7,131,128,3,2.34375
19,18,8,47,256,-209,-81.640625
19,18,9,1038,512,526,102.734375
19,18,10,123,1024,-901,-87.98828125
19,18,11,1718,2048,-330,-16.11328125
19,18,12,824,4096,-3272,-79.8828125
19,18,13,6885,8192,-1307,-15.95458984375
19,18,14,26398,16384,10014,61.12060546875
19,18,15,7702,32768,-25066,-76.495361328125
19,19,1,0,2,-2,-100.0
19,19,2,3,4,-1,-25.0
19,19,3,8,8,0,0.0
19,19,4,7,16,-9,-56.25
19,19,5,32,32,0,0.0
19,19,6,45,64,-19,-29.6875
19,19,7,238,128,110,85.9375
19,19,8,679,256,423,165.234375
19,19,9,108,512,-404,-78.90625
19,19,10,1927,1024,903,88.18359375
19,19,11,992,2048,-1056,-51.5625
19,19,12,6134,4096,2038,49.755859375
19,19,13,3498,8192,-4694,-57.2998046875
19,19,14,25522,16384,9138,55.77392578125
19,19,15,1126,32768,-31642,-96.563720703125
20,1,1,0,2,-2,-100.0
20,1,2,1,4,-3,-75.0
20,1,3,2,8,-6,-75.0
20,1,4,10,16,-6,-37.5
20,1,5,8,32,-24,-75.0
20,1,6,114,64,50,78.125
20,1,7,663,128,535,417.96875
20,1,8,171,256,-85,-33.203125
20,1,9,138,512,-374,-73.046875
20,1,10,2372,1024,1348,131.640625
20,1,11,4630,2048,2582,126.07421875
20,1,12,291,4096,-3805,-92.8955078125
20,1,13,11225,8192,3033,37.02392578125
20,1,14,12544,16384,-3840,-23.4375
20,1,15,43796,32768,11028,33.65478515625
20,2,1,0,2,-2,-100.0
20,2,2,4,4,0,0.0
20,2,3,11,8,3,37.5
20,2,4,3,16,-13,-81.25
20,2,5,15,32,-17,-53.125
20,2,6,236,64,172,268.75
20,2,7,122,128,-6,-4.6875
20,2,8,160,256,-96,-37.5
20,2,9,314,512,-198,-38.671875
20,2,10,1179,1024,155,15.13671875
20,2,11,465,2048,-1583,-77.294921875
20,2,12,1391,4096,-2705,-66.0400390625
20,2,13,2466,8192,-5726,-69.8974609375
20,2,14,25363,16384,8979,54.803466796875
20,2,15,17448,32768,-15320,-46.7529296875
20,3,1,0,2,-2,-100.0
20,3,2,1,4,-3,-75.0
20,3,3,2,8,-6,-75.0
20,3,4,29,16,13,81.25
20,3,5,162,32,130,406.25
20,3,6,8,64,-56,-87.5
20,3,7,113,128,-15,-11.71875
20,3,8,274,256,18,7.03125
20,3,9,365,512,-147,-28.7109375
20,3,10,661,1024,-363,-35.44921875
20,3,11,273,2048,-1775,-86.669921875
20,3,12,19055,4096,14959,365.2099609375
20,3,13,14943,8192,6751,82.40966796875
20,3,14,14476,16384,-1908,-11.6455078125
20,3,15,58140,32768,25372,77.42919921875
20,4,1,0,2,-2,-100.0
20,4,2,1,4,-3,-75.0
20,4,3,2,8,-6,-75.0
20,4,4,5,16,-11,-68.75
20,4,5,22,32,-10,-31.25
20,4,6,171,64,107,167.1875
20,4,7,61,128,-67,-52.34375
20,4,8,339,256,83,32.421875
20,4,9,540,512,28,5.46875
20,4,10,6058,1024,5034,491.6015625
20,4,11,8356,2048,6308,308.0078125
20,4,12,6873,4096,2777,67.7978515625
20,4,13,3915,8192,-4277,-52.20947265625
20,4,14,52506,16384,36122,220.47119140625
20,4,15,14219,32768,-18549,-56.6070556640625
20,5,1,0,2,-2,-100.0
20,5,2,1,4,-3,-75.0
20,5,3,2,8,-6,-75.0
20,5,4,15,16,-1,-6.25
20,5,5,47,32,15,46.875
20,5,6,120,64,56,87.5
20,5,7,146,128,18,14.0625
20,5,8,278,256,22,8.59375
20,5,9,120,512,-392,-76.5625
20,5,10,1601,1024,577,56.34765625
20,5,11,591,2048,-1457,-71.142578125
20,5,12,1460,4096,-2636,-64.35546875
20,5,13,17032,8192,8840,107.91015625
20,5,14,434,16384,-15950,-97.35107421875
20,5,15,31273,32768,-1495,-4.5623779296875
20,6,1,0,2,-2,-100.0
20,6,2,1,4,-3,-75.0
20,6,3,3,8,-5,-62.5
20,6,4,55,16,39,243.75
20,6,5,8,32,-24,-75.0
20,6,6,18,64,-46,-71.875
20,6,7,179,128,51,39.84375
20,6,8,343,256,87,33.984375
20,6,9,20,512,-492,-96.09375
20,6,10,1485,1024,461,45.01953125
20,6,11,100,2048,-1948,-95.1171875
20,6,12,7116,4096,3020,73.73046875
20,6,13,6264,8192,-1928,-23.53515625
20,6,14,25632,16384,9248,56.4453125
20,6,15,71770,32768,39002,119.024658203125
20,7,1,0,2,-2,-100.0
20,7,2,2,4,-2,-50.0
20,7,3,7,8,-1,-12.5
20,7,4,3,16,-13,-81.25
20,7,5,9,32,-23,-71.875
20,7,6,103,64,39,60.9375
20,7,7,225,128,97,75.78125
20,7,8,118,256,-138,-53.90625
20,7,9,1346,512,834,162.890625
20,7,10,256,1024,-768,-75.0
20,7,11,956,2048,-1092,-53.3203125
20,7,12,993,4096,-3103,-75.7568359375
20,7,13,5460,8192,-2732,-33.349609375
20,7,14,24247,16384,7863,47.991943359375
20,7,15,16520,32768,-16248,-49.5849609375
20,8,1,0,2,-2,-100.0
20,8,2,2,4,-2,-50.0
20,8,3,4,8,-4,-50.0
20,8,4,15,16,-1,-6.25
20,8,5,26,32,-6,-18.75
20,8,6,66,64,2,3.125
20,8,7,87,128,-41,-32.03125
20,8,8,56,256,-200,-78.125
20,8,9,35,512,-477,-93.1640625
20,8,10,334,1024,-690,-67.3828125
20,8,11,721,2048,-1327,-64.794921875
20,8,12,1733,4096,-2363,-57.6904296875
20,8,13,5666,8192,-2526,-30.8349609375
20,8,14,4465,16384,-11919,-72.747802734375
20,8,15,181022,32768,148254,452.435302734375
20,9,1,0,2,-2,-100.0
20,9,2,1,4,-3,-75.0
20,9,3,9,8,1,12.5
20,9,4,4,16,-12,-75.0
20,9,5,11,32,-21,-65.625
20,9,6,62,64,-2,-3.125
20,9,7,385,128,257,200.78125
20,9,8,375,256,119,46.484375
20,9,9,1189,512,677,132.2265625
20,9,10,170,1024,-854,-83.3984375
20,9,11,2480,2048,432,21.09375
20,9,12,342,4096,-3754,-91.650390625
20,9,13,827,8192,-7365,-89.90478515625
20,9,14,11477,16384,-4907,-29.949951171875
20,9,15,18233,32768,-14535,-44.3572998046875
20,10,1,0,2,-2,-100.0
20,10,2,1,4,-3,-75.0
20,10,3,2,8,-6,-75.0
20,10,4,7,16,-9,-56.25
20,10,5,15,32,-17,-53.125
20,10,6,86,64,22,34.375
20,10,7,448,128,320,250.0
20,10,8,826,256,570,222.65625
20,10,9,597,512,85,16.6015625
20,10,10,2103,1024,1079,105.37109375
20,10,11,779,2048,-1269,-61.962890625
20,10,12,20704,4096,16608,405.46875
20,10,13,1960,8192,-6232,-76.07421875
20,10,14,19152,16384,2768,16.89453125
20,10,15,36751,32768,3983,12.1551513671875
20,11,1,0,2,-2,-100.0
20,11,2,3,4,-1,-25.0
20,11,3,9,8,1,12.5
20,11,4,4,16,-12,-75.0
20,11,5,41,32,9,28.125
20,11,6,23,64,-41,-64.0625
20,11,7,31,128,-97,-75.78125
20,11,8,74,256,-182,-71.09375
20,11,9,815,512,303,59.1796875
20,11,10,116,1024,-908,-88.671875
20,11,11,1382,2048,-666,-32.51953125
20,11,12,2405,4096,-1691,-41.2841796875
20,11,13,1497,8192,-6695,-81.72607421875
20,11,14,1432,16384,-14952,-91.259765625
20,11,15,52647,32768,19879,60.6658935546875
20,12,1,0,2,-2,-100.0
20,12,2,1,4,-3,-75.0
20,12,3,3,8,-5,-62.5
20,12,4,4,16,-12,-75.0
20,12,5,26,32,-6,-18.75
20,12,6,25,64,-39,-60.9375
20,12,7,57,128,-71,-55.46875
20,12,8,258,256,2,0.78125
20,12,9,95,512,-417,-81.4453125
20,12,10,47,1024,-977,-95.41015625
20,12,11,1609,2048,-439,-21.435546875
20,12,12,4816,4096,720,17.578125
20,12,13,3148,8192,-5044,-61.572265625
20,12,14,1677,16384,-14707,-89.764404296875
20,12,15,22740,32768,-10028,-30.60302734375
20,13,1,0,2,-2,-100.0
20,13,2,1,4,-3,-75.0
20,13,3,3,8,-5,-62.5
20,13,4,27,16,11,68.75
20,13,5,19,32,-13,-40.625
20,13,6,11,64,-53,-82.8125
20,13,7,101,128,-27,-21.09375
20,13,8,29,256,-227,-88.671875
20,13,9,181,512,-331,-64.6484375
20,13,10,22,1024,-1002,-97.8515625
20,13,11,193,2048,-1855,-90.576171875
20,13,12,524,4096,-3572,-87.20703125
20,13,13,20575,8192,12383,151.15966796875
20,13,14,3602,16384,-12782,-78.01513671875
20,13,15,7900,32768,-24868,-75.89111328125
20,14,1,0,2,-2,-100.0
20,14,2,1,4,-3,-75.0
20,14,3,5,8,-3,-37.5
20,14,4,36,16,20,125.0
20,14,5,25,32,-7,-21.875
20,14,6,150,64,86,134.375
20,14,7,110,128,-18,-14.0625
20,14,8,428,256,172,67.1875
20,14,9,146,512,-366,-71.484375
20,14,10,1026,1024,2,0.1953125
20,14,11,986,2048,-1062,-51.85546875
20,14,12,611,4096,-3485,-85.0830078125
20,14,13,20125,8192,11933,145.66650390625
20,14,14,38671,16384,22287,136.029052734375
20,14,15,110784,32768,78016,238.0859375
20,15,1,0,2,-2,-100.0
20,15,2,2,4,-2,-50.0
20,15,3,18,8,10,125.0
20,15,4,26,16,10,62.5
20,15,5,13,32,-19,-59.375
20,15,6,7,64,-57,-89.0625
20,15,7,173,128,45,35.15625
20,15,8,73,256,-183,-71.484375
20,15,9,395,512,-117,-22.8515625
20,15,10,53,1024,-971,-94.82421875
20,15,11,1241,2048,-807,-39.404296875
20,15,12,1752,4096,-2344,-57.2265625
20,15,13,7469,8192,-723,-8.82568359375
20,15,14,30267,16384,13883,84.735107421875
20,15,15,102305,32768,69537,212.2100830078125
20,16,1,0,2,-2,-100.0
20,16,2,1,4,-3,-75.0
20,16,3,9,8,1,12.5
20,16,4,15,16,-1,-6.25
20,16,5,4,32,-28,-87.5
20,16,6,21,64,-43,-67.1875
20,16,7,197,128,69,53.90625
20,16,8,136,256,-120,-46.875
20,16,9,17,512,-495,-96.6796875
20,16,10,412,1024,-612,-59.765625
20,16,11,1206,2048,-842,-41.11328125
20,16,12,5726,4096,1630,39.794921875
20,16,13,14704,8192,6512,79.4921875
20,16,14,4039,16384,-12345,-75.347900390625
20,16,15,126642,32768,93874,286.480712890625
20,17,1,0,2,-2,-100.0
20,17,2,1,4,-3,-75.0
20,17,3,6,8,-2,-25.0
20,17,4,7,16,-9,-56.25
20,17,5,42,32,10,31.25
20,17,6,42,64,-22,-34.375
20,17,7,56,128,-72,-56.25
20,17,8,403,256,147,57.421875
20,17,9,371,512,-141,-27.5390625
20,17,10,19,1024,-1005,-98.14453125
20,17,11,665,2048,-1383,-67.529296875
20,17,12,2647,4096,-1449,-35.3759765625
20,17,13,11202,8192,3010,36.7431640625
20,17,14,36564,16384,20180,123.1689453125
20,17,15,1675,32768,-31093,-94.8883056640625
20,18,1,0,2,-2,-100.0
20,18,2,1,4,-3,-75.0
20,18,3,11,8,3,37.5
20,18,4,10,16,-6,-37.5
20,18,5,27,32,-5,-15.625
20,18,6,7,64,-57,-89.0625
20,18,7,18,128,-110,-85.9375
20,18,8,205,256,-51,-19.921875
20,18,9,333,512,-179,-34.9609375
20,18,10,335,1024,-689,-67.28515625
20,18,11,938,2048,-1110,-54.19921875
20,18,12,2872,4096,-1224,-29.8828125
20,18,13,494,8192,-7698,-93.9697265625
20,18,14,4007,16384,-12377,-75.543212890625
20,18,15,59393,32768,26625,81.2530517578125
20,19,1,0,2,-2,-100.0
20,19,2,1,4,-3,-75.0
20,19,3,6,8,-2,-25.0
20,19,4,22,16,6,37.5
20,19,5,26,32,-6,-18.75
20,19,6,95,64,31,48.4375
20,19,7,262,128,134,104.6875
20,19,8,360,256,104,40.625
20,19,9,9,512,-503,-98.2421875
20,19,10,4050,1024,3026,295.5078125
20,19,11,2462,2048,414,20.21484375
20,19,12,5879,4096,1783,43.5302734375
20,19,13,8826,8192,634,7.7392578125
20,19,14,4096,16384,-12288,-75.0
20,19,15,50119,32768,17351,52.9510498046875
20,20,1,0,2,-2,-100.0
20,20,2,3,4,-1,-25.0
20,20,3,4,8,-4,-50.0
20,20,4,6,16,-10,-62.5
20,20,5,51,32,19,59.375
20,20,6,42,64,-22,-34.375
20,20,7,154,128,26,20.3125
20,20,8,58,256,-198,-77.34375
20,20,9,392,512,-120,-23.4375
20,20,10,1920,1024,896,87.5
20,20,11,1012,2048,-1036,-50.5859375
20,20,12,10632,4096,6536,159.5703125
20,20,13,30157,8192,21965,268.12744140625
20,20,14,9068,16384,-7316,-44.6533203125
20,20,15,48993,32768,16225,49.5147705078125
21,1,1,0,2,-2,-100.0
21,1,2,5,4,1,25.0
21,1,3,4,8,-4,-50.0
21,1,4,3,16,-13,-81.25
21,1,5,54,32,22,68.75
21,1,6,85,64,21,32.8125
21,1,7,112,128,-16,-12.5
21,1,8,254,256,-2,-0.78125
21,1,9,665,512,153,29.8828125
21,1,10,1496,1024,472,46.09375
21,1,11,2226,2048,178,8.69140625
21,1,12,1940,4096,-2156,-52.63671875
21,1,13,1032,8192,-7160,-87.40234375
21,1,14,32171,16384,15787,96.356201171875
21,1,15,2677,32768,-30091,-91.8304443359375
21,2,1,0,2,-2,-100.0
21,2,2,1,4,-3,-75.0
21,2,3,5,8,-3,-37.5
21,2,4,5,16,-11,-68.75
21,2,5,8,32,-24,-75.0
21,2,6,52,64,-12,-18.75
21,2,7,317,128,189,147.65625
21,2,8,143,256,-113,-44.140625
21,2,9,173,512,-339,-66.2109375
21,2,10,1760,1024,736,71.875
21,2,11,4908,2048,2860,139.6484375
21,2,12,511,4096,-3585,-87.5244140625
21,2,13,4713,8192,-3479,-42.46826171875
21,2,14,11505,16384,-4879,-29.779052734375
21,2,15,5419,32768,-27349,-83.4625244140625
21,3,1,0,2,-2,-100.0
21,3,2,1,4,-3,-75.0
21,3,3,6,8,-2,-25.0
21,3,4,16,16,0,0.0
21,3,5,22,32,-10,-31.25
21,3,6,195,64,131,204.6875
21,3,7,77,128,-51,-39.84375
21,3,8,57,256,-199,-77.734375
21,3,9,98,512,-414,-80.859375
21,3,10,623,1024,-401,-39.16015625
21,3,11,1169,2048,-879,-42.919921875
21,3,12,7594,4096,3498,85.400390625
21,3,13,9399,8192,1207,14.73388671875
21,3,14,10238,16384,-6146,-37.51220703125
21,3,15,18047,32768,-14721,-44.9249267578125
21,4,1,0,2,-2,-100.0
21,4,2,1,4,-3,-75.0
21,4,3,12,8,4,50.0
21,4,4,6,16,-10,-62.5
21,4,5,20,32,-12,-37.5
21,4,6,25,64,-39,-60.9375
21,4,7,231,128,103,80.46875
21,4,8,351,256,95,37.109375
21,4,9,1346,512,834,162.890625
21,4,10,712,1024,-312,-30.46875
21,4,11,2660,2048,612,29.8828125
21,4,12,2301,4096,-1795,-43.8232421875
21,4,13,17362,8192,9170,111.9384765625
21,4,14,21116,16384,4732,28.8818359375
21,4,15,35026,32768,2258,6.890869140625
21,5,1,0,2,-2,-100.0
21,5,2,4,4,0,0.0
21,5,3,5,8,-3,-37.5
21,5,4,8,16,-8,-50.0
21,5,5,13,32,-19,-59.375
21,5,6,97,64,33,51.5625
21,5,7,349,128,221,172.65625
21,5,8,109,256,-147,-57.421875
21,5,9,162,512,-350,-68.359375
21,5,10,1980,1024,956,93.359375
21,5,11,254,2048,-1794,-87.59765625
21,5,12,11788,4096,7692,187.79296875
21,5,13,5524,8192,-2668,-32.568359375
21,5,14,36506,16384,20122,122.81494140625
21,5,15,33687,32768,919,2.8045654296875
21,6,1,0,2,-2,-100.0
21,6,2,1,4,-3,-75.0
21,6,3,2,8,-6,-75.0
21,6,4,3,16,-13,-81.25
21,6,5,21,32,-11,-34.375
21,6,6,24,64,-40,-62.5
21,6,7,94,128,-34,-26.5625
21,6,8,119,256,-137,-53.515625
21,6,9,702,512,190,37.109375
21,6,10,195,1024,-829,-80.95703125
21,6,11,33,2048,-2015,-98.388671875
21,6,12,7748,4096,3652,89.16015625
21,6,13,2043,8192,-6149,-75.06103515625
21,6,14,3899,16384,-12485,-76.202392578125
21,6,15,4446,32768,-28322,-86.431884765625
21,7,1,0,2,-2,-100.0
21,7,2,1,4,-3,-75.0
21,7,3,4,8,-4,-50.0
21,7,4,11,16,-5,-31.25
21,7,5,13,32,-19,-59.375
21,7,6,185,64,121,189.0625
21,7,7,11,128,-117,-91.40625
21,7,8,17,256,-239,-93.359375
21,7,9,176,512,-336,-65.625
21,7,10,253,1024,-771,-75.29296875
21,7,11,190,2048,-1858,-90.72265625
21,7,12,221,4096,-3875,-94.6044921875
21,7,13,3034,8192,-5158,-62.9638671875
21,7,14,1888,16384,-14496,-88.4765625
21,7,15,7215,32768,-25553,-77.9815673828125
21,8,1,0,2,-2,-100.0
21,8,2,1,4,-3,-75.0
21,8,3,3,8,-5,-62.5
21,8,4,7,16,-9,-56.25
21,8,5,9,32,-23,-71.875
21,8,6,28,64,-36,-56.25
21,8,7,183,128,55,42.96875
21,8,8,573,256,317,123.828125
21,8,9,83,512,-429,-83.7890625
21,8,10,2632,1024,1608,157.03125
21,8,11,4291,2048,2243,109.521484375
21,8,12,12361,4096,8265,201.7822265625
21,8,13,15389,8192,7197,87.85400390625
21,8,14,750,16384,-15634,-95.42236328125
21,8,15,23436,32768,-9332,-28.47900390625
21,9,1,0,2,-2,-100.0
21,9,2,1,4,-3,-75.0
21,9,3,4,8,-4,-50.0
21,9,4,7,16,-9,-56.25
21,9,5,27,32,-5,-15.625
21,9,6,23,64,-41,-64.0625
21,9,7,10,128,-118,-92.1875
21,9,8,46,256,-210,-82.03125
21,9,9,14,512,-498,-97.265625
21,9,10,879,1024,-145,-14.16015625
21,9,11,233,2048,-1815,-88.623046875
21,9,12,2189,4096,-1907,-46.5576171875
21,9,13,93,8192,-8099,-98.86474609375
21,9,14,1941,16384,-14443,-88.153076171875
21,9,15,31423,32768,-1345,-4.1046142578125
21,10,1,0,2,-2,-100.0
21,10,2,1,4,-3,-75.0
21,10,3,3,8,-5,-62.5
21,10,4,5,16,-11,-68.75
21,10,5,55,32,23,71.875
21,10,6,322,64,258,403.125
21,10,7,30,128,-98,-76.5625
21,10,8,130,256,-126,-49.21875
21,10,9,134,512,-378,-73.828125
21,10,10,1038,1024,14,1.3671875
21,10,11,7905,2048,5857,285.986328125
21,10,12,1843,4096,-2253,-55.0048828125
21,10,13,1705,8192,-6487,-79.18701171875
21,10,14,8117,16384,-8267,-50.457763671875
21,10,15,78852,32768,46084,140.63720703125
21,11,1,0,2,-2,-100.0
21,11,2,4,4,0,0.0
21,11,3,2,8,-6,-75.0
21,11,4,11,16,-5,-31.25
21,11,5,12,32,-20,-62.5
21,11,6,26,64,-38,-59.375
21,11,7,174,128,46,35.9375
21,11,8,522,256,266,103.90625
21,11,9,179,512,-333,-65.0390625
21,11,10,1877,1024,853,83.30078125
21,11,11,2983,2048,935,45.654296875
21,11,12,3803,4096,-293,-7.1533203125
21,11,13,6018,8192,-2174,-26.5380859375
21,11,14,4469,16384,-11915,-72.723388671875
21,11,15,28386,32768,-4382,-13.372802734375
21,12,1,0,2,-2,-100.0
21,12,2,2,4,-2,-50.0
21,12,3,4,8,-4,-50.0
21,12,4,39,16,23,143.75
21,12,5,88,32,56,175.0
21,12,6,66,64,2,3.125
21,12,7,56,128,-72,-56.25
21,12,8,244,256,-12,-4.6875
21,12,9,350,512,-162,-31.640625
21,12,10,1382,1024,358,34.9609375
21,12,11,3535,2048,1487,72.607421875
21,12,12,1574,4096,-2522,-61.572265625
21,12,13,19733,8192,11541,140.88134765625
21,12,14,9020,16384,-7364,-44.9462890625
21,12,15,37349,32768,4581,13.9801025390625
21,13,1,0,2,-2,-100.0
21,13,2,3,4,-1,-25.0
21,13,3,11,8,3,37.5
21,13,4,3,16,-13,-81.25
21,13,5,59,32,27,84.375
21,13,6,74,64,10,15.625
21,13,7,283,128,155,121.09375
21,13,8,335,256,79,30.859375
21,13,9,120,512,-392,-76.5625
21,13,10,3322,1024,2298,224.4140625
21,13,11,4107,2048,2059,100.537109375
21,13,12,1567,4096,-2529,-61.7431640625
21,13,13,2380,8192,-5812,-70.947265625
21,13,14,7713,16384,-8671,-52.923583984375
21,13,15,20184,32768,-12584,-38.4033203125
21,14,1,0,2,-2,-100.0
21,14,2,3,4,-1,-25.0
21,14,3,6,8,-2,-25.0
21,14,4,9,16,-7,-43.75
21,14,5,4,32,-28,-87.5
21,14,6,56,64,-8,-12.5
21,14,7,173,128,45,35.15625
21,14,8,113,256,-143,-55.859375
21,14,9,598,512,86,16.796875
21,14,10,84,1024,-940,-91.796875
21,14,11,991,2048,-1057,-51.611328125
21,14,12,3854,4096,-242,-5.908203125
21,14,13,14033,8192,5841,71.30126953125
21,14,14,35893,16384,19509,119.073486328125
21,14,15,120831,32768,88063,268.7469482421875
21,15,1,0,2,-2,-100.0
21,15,2,2,4,-2,-50.0
21,15,3,2,8,-6,-75.0
21,15,4,7,16,-9,-56.25
21,15,5,17,32,-15,-46.875
21,15,6,60,64,-4,-6.25
21,15,7,7,128,-121,-94.53125
21,15,8,16,256,-240,-93.75
21,15,9,432,512,-80,-15.625
21,15,10,99,1024,-925,-90.33203125
21,15,11,1665,2048,-383,-18.701171875
21,15,12,10205,4096,6109,149.1455078125
21,15,13,19974,8192,11782,143.8232421875
21,15,14,20154,16384,3770,23.01025390625
21,15,15,12009,32768,-20759,-63.3514404296875
21,16,1,0,2,-2,-100.0
21,16,2,2,4,-2,-50.0
21,16,3,10,8,2,25.0
21,16,4,14,16,-2,-12.5
21,16,5,7,32,-25,-78.125
21,16,6,85,64,21,32.8125
21,16,7,15,128,-113,-88.28125
21,16,8,51,256,-205,-80.078125
21,16,9,519,512,7,1.3671875
21,16,10,1373,1024,349,34.08203125
21,16,11,1139,2048,-909,-44.384765625
21,16,12,4556,4096,460,11.23046875
21,16,13,3220,8192,-4972,-60.693359375
21,16,14,8971,16384,-7413,-45.245361328125
21,16,15,1497,32768,-31271,-95.4315185546875
21,17,1,0,2,-2,-100.0
21,17,2,5,4,1,25.0
21,17,3,2,8,-6,-75.0
21,17,4,6,16,-10,-62.5
21,17,5,23,32,-9,-28.125
21,17,6,7,64,-57,-89.0625
21,17,7,102,128,-26,-20.3125
21,17,8,393,256,137,53.515625
21,17,9,630,512,118,23.046875
21,17,10,215,1024,-809,-79.00390625
21,17,11,2162,2048,114,5.56640625
21,17,12,2192,4096,-1904,-46.484375
21,17,13,4481,8192,-3711,-45.30029296875
21,17,14,5127,16384,-11257,-68.707275390625
21,17,15,6901,32768,-25867,-78.9398193359375
21,18,1,0,2,-2,-100.0
21,18,2,1,4,-3,-75.0
21,18,3,2,8,-6,-75.0
21,18,4,19,16,3,18.75
21,18,5,17,32,-15,-46.875
21,18,6,13,64,-51,-79.6875
21,18,7,64,128,-64,-50.0
21,18,8,236,256,-20,-7.8125
21,18,9,69,512,-443,-86.5234375
21,18,10,1823,1024,799,78.02734375
21,18,11,3867,2048,1819,88.818359375
21,18,12,815,4096,-3281,-80.1025390625
21,18,13,9659,8192,1467,17.90771484375
21,18,14,1592,16384,-14792,-90.283203125
21,18,15,10833,32768,-21935,-66.9403076171875
21,19,1,0,2,-2,-100.0
21,19,2,1,4,-3,-75.0
21,19,3,6,8,-2,-25.0
21,19,4,11,16,-5,-31.25
21,19,5,34,32,2,6.25
21,19,6,52,64,-12,-18.75
21,19,7,143,128,15,11.71875
21,19,8,16,256,-240,-93.75
21,19,9,127,512,-385,-75.1953125
21,19,10,131,1024,-893,-87.20703125
21,19,11,3380,2048,1332,65.0390625
21,19,12,10573,4096,6477,158.1298828125
21,19,13,482,8192,-7710,-94.1162109375
21,19,14,7429,16384,-8955,-54.656982421875
21,19,15,73939,32768,41171,125.6439208984375
21,20,1,0,2,-2,-100.0
21,20,2,2,4,-2,-50.0
21,20,3,6,8,-2,-25.0
21,20,4,5,16,-11,-68.75
21,20,5,17,32,-15,-46.875
21,20,6,9,64,-55,-85.9375
21,20,7,165,128,37,28.90625
21,20,8,86,256,-170,-66.40625
21,20,9,600,512,88,17.1875
21,20,10,923,1024,-101,-9.86328125
21,20,11,5064,2048,3016,147.265625
21,20,12,58,4096,-4038,-98.583984375
21,20,13,515,8192,-7677,-93.71337890625
21,20,14,5301,16384,-11083,-67.645263671875
21,20,15,5931,32768,-26837,-81.9000244140625
21,21,1,0,2,-2,-100.0
21,21,2,5,4,1,25.0
21,21,3,7,8,-1,-12.5
21,21,4,35,16,19,118.75
21,21,5,14,32,-18,-56.25
21,21,6,79,64,15,23.4375
21,21,7,147,128,19,14.84375
21,21,8,158,256,-98,-38.28125
21,21,9,821,512,309,60.3515625
21,21,10,286,1024,-738,-72.0703125
21,21,11,320,2048,-1728,-84.375
21,21,12,1596,4096,-2500,-61.03515625
21,21,13,252,8192,-7940,-96.923828125
21,21,14,1867,16384,-14517,-88.604736328125
21,21,15,103770,32768,71002,216.680908203125
22,1,1,0,2,-2,-100.0
22,1,2,1,4,-3,-75.0
22,1,3,2,8,-6,-75.0
22,1,4,17,16,1,6.25
22,1,5,10,32,-22,-68.75
22,1,6,68,64,4,6.25
22,1,7,126,128,-2,-1.5625
22,1,8,103,256,-153,-59.765625
22,1,9,372,512,-140,-27.34375
22,1,10,117,1024,-907,-88.57421875
22,1,11,1597,2048,-451,-22.021484375
22,1,12,3993,4096,-103,-2.5146484375
22,1,13,8471,8192,279,3.40576171875
22,1,14,15884,16384,-500,-3.0517578125
22,1,15,38777,32768,6009,18.3380126953125
22,2,1,0,2,-2,-100.0
22,2,2,1,4,-3,-75.0
22,2,3,5,8,-3,-37.5
22,2,4,5,16,-11,-68.75
22,2,5,52,32,20,62.5
22,2,6,72,64,8,12.5
22,2,7,13,128,-115,-89.84375
22,2,8,557,256,301,117.578125
22,2,9,457,512,-55,-10.7421875
22,2,10,69,1024,-955,-93.26171875
22,2,11,1615,2048,-433,-21.142578125
22,2,12,989,4096,-3107,-75.8544921875
22,2,13,1842,8192,-6350,-77.5146484375
22,2,14,747,16384,-15637,-95.440673828125
22,2,15,27732,32768,-5036,-15.36865234375
22,3,1,0,2,-2,-100.0
22,3,2,1,4,-3,-75.0
22,3,3,2,8,-6,-75.0
22,3,4,10,16,-6,-37.5
22,3,5,26,32,-6,-18.75
22,3,6,12,64,-52,-81.25
22,3,7,17,128,-111,-86.71875
22,3,8,58,256,-198,-77.34375
22,3,9,733,512,221,43.1640625
22,3,10,651,1024,-373,-36.42578125
22,3,11,61,2048,-1987,-97.021484375
22,3,12,1664,4096,-2432,-59.375
22,3,13,553,8192,-7639,-93.24951171875
22,3,14,1182,16384,-15202,-92.78564453125
22,3,15,5191,32768,-27577,-84.1583251953125
22,4,1,0,2,-2,-100.0
22,4,2,2,4,-2,-50.0
22,4,3,2,8,-6,-75.0
22,4,4,26,16,10,62.5
22,4,5,19,32,-13,-40.625
22,4,6,25,64,-39,-60.9375
22,4,7,107,128,-21,-16.40625
22,4,8,189,256,-67,-26.171875
22,4,9,202,512,-310,-60.546875
22,4,10,348,1024,-676,-66.015625
22,4,11,114,2048,-1934,-94.43359375
22,4,12,10842,4096,6746,164.697265625
22,4,13,12655,8192,4463,54.47998046875
22,4,14,6240,16384,-10144,-61.9140625
22,4,15,83266,32768,50498,154.107666015625
22,5,1,0,2,-2,-100.0
22,5,2,1,4,-3,-75.0
22,5,3,2,8,-6,-75.0
22,5,4,11,16,-5,-31.25
22,5,5,10,32,-22,-68.75
22,5,6,31,64,-33,-51.5625
22,5,7,191,128,63,49.21875
22,5,8,164,256,-92,-35.9375
22,5,9,804,512,292,57.03125
22,5,10,708,1024,-316,-30.859375
22,5,11,1760,2048,-288,-14.0625
22,5,12,216,4096,-3880,-94.7265625
22,5,13,8970,8192,778,9.4970703125
22,5,14,10215,16384,-6169,-37.652587890625
22,5,15,17538,32768,-15230,-46.478271484375
22,6,1,0,2,-2,-100.0
22,6,2,2,4,-2,-50.0
22,6,3,3,8,-5,-62.5
22,6,4,22,16,6,37.5
22,6,5,32,32,0,0.0
22,6,6,38,64,-26,-40.625
22,6,7,224,128,96,75.0
22,6,8,52,256,-204,-79.6875
22,6,9,485,512,-27,-5.2734375
22,6,10,408,1024,-616,-60.15625
22,6,11,1392,2048,-656,-32.03125
22,6,12,3070,4096,-1026,-25.048828125
22,6,13,4937,8192,-3255,-39.73388671875
22,6,14,1987,16384,-14397,-87.872314453125
22,6,15,5976,32768,-26792,-81.7626953125
22,7,1,0,2,-2,-100.0
22,7,2,6,4,2,50.0
22,7,3,7,8,-1,-12.5
22,7,4,8,16,-8,-50.0
22,7,5,7,32,-25,-78.125
22,7,6,51,64,-13,-20.3125
22,7,7,67,128,-61,-47.65625
22,7,8,413,256,157,61.328125
22,7,9,283,512,-229,-44.7265625
22,7,10,377,1024,-647,-63.18359375
22,7,11,394,2048,-1654,-80.76171875
22,7,12,268,4096,-3828,-93.45703125
22,7,13,153,8192,-8039,-98.13232421875
22,7,14,15186,16384,-1198,-7.31201171875
22,7,15,20817,32768,-11951,-36.4715576171875
22,8,1,0,2,-2,-100.0
22,8,2,1,4,-3,-75.0
22,8,3,3,8,-5,-62.5
22,8,4,10,16,-6,-37.5
22,8,5,5,32,-27,-84.375
22,8,6,5,64,-59,-92.1875
22,8,7,89,128,-39,-30.46875
22,8,8,141,256,-115,-44.921875
22,8,9,243,512,-269,-52.5390625
22,8,10,387,1024,-637,-62.20703125
22,8,11,9356,2048,7308,356.8359375
22,8,12,409,4096,-3687,-90.0146484375
22,8,13,6536,8192,-1656,-20.21484375
22,8,14,6041,16384,-10343,-63.128662109375
22,8,15,6290,32768,-26478,-80.804443359375
22,9,1,0,2,-2,-100.0
22,9,2,3,4,-1,-25.0
22,9,3,3,8,-5,-62.5
22,9,4,32,16,16,100.0
22,9,5,55,32,23,71.875
22,9,6,74,64,10,15.625
22,9,7,256,128,128,100.0
22,9,8,895,256,639,249.609375
22,9,9,2539,512,2027,395.8984375
22,9,10,110,1024,-914,-89.2578125
22,9,11,2273,2048,225,10.986328125
22,9,12,1603,4096,-2493,-60.8642578125
22,9,13,23263,8192,15071,183.97216796875
22,9,14,7801,16384,-8583,-52.386474609375
22,9,15,7179,32768,-25589,-78.0914306640625
22,10,1,0,2,-2,-100.0
22,10,2,6,4,2,50.0
22,10,3,4,8,-4,-50.0
22,10,4,3,16,-13,-81.25
22,10,5,7,32,-25,-78.125
22,10,6,50,64,-14,-21.875
22,10,7,168,128,40,31.25
22,10,8,38,256,-218,-85.15625
22,10,9,323,512,-189,-36.9140625
22,10,10,587,1024,-437,-42.67578125
22,10,11,162,2048,-1886,-92.08984375
22,10,12,819,4096,-3277,-80.0048828125
22,10,13,33982,8192,25790,314.8193359375
22,10,14,1659,16384,-14725,-89.874267578125
22,10,15,19755,32768,-13013,-39.7125244140625
22,11,1,0,2,-2,-100.0
22,11,2,1,4,-3,-75.0
22,11,3,10,8,2,25.0
22,11,4,8,16,-8,-50.0
22,11,5,67,32,35,109.375
22,11,6,31,64,-33,-51.5625
22,11,7,225,128,97,75.78125
22,11,8,50,256,-206,-80.46875
22,11,9,863,512,351,68.5546875
22,11,10,1523,1024,499,48.73046875
22,11,11,3436,2048,1388,67.7734375
22,11,12,5399,4096,1303,31.8115234375
22,11,13,4741,8192,-3451,-42.12646484375
22,11,14,11679,16384,-4705,-28.717041015625
22,11,15,30448,32768,-2320,-7.080078125
22,12,1,0,2,-2,-100.0
22,12,2,1,4,-3,-75.0
22,12,3,2,8,-6,-75.0
22,12,4,3,16,-13,-81.25
22,12,5,4,32,-28,-87.5
22,12,6,85,64,21,32.8125
22,12,7,47,128,-81,-63.28125
22,12,8,59,256,-197,-76.953125
22,12,9,18,512,-494,-96.484375
22,12,10,3946,1024,2922,285.3515625
22,12,11,5156,2048,3108,151.7578125
22,12,12,3382,4096,-714,-17.431640625
22,12,13,11603,8192,3411,41.63818359375
22,12,14,18860,16384,2476,15.1123046875
22,12,15,9829,32768,-22939,-70.0042724609375
22,13,1,0,2,-2,-100.0
22,13,2,3,4,-1,-25.0
22,13,3,3,8,-5,-62.5
22,13,4,35,16,19,118.75
22,13,5,18,32,-14,-43.75
22,13,6,22,64,-42,-65.625
22,13,7,74,128,-54,-42.1875
22,13,8,74,256,-182,-71.09375
22,13,9,2031,512,1519,296.6796875
22,13,10,39,1024,-985,-96.19140625
22,13,11,1322,2048,-726,-35.44921875
22,13,12,355,4096,-3741,-91.3330078125
22,13,13,193,8192,-7999,-97.64404296875
22,13,14,17354,16384,970,5.92041015625
22,13,15,110112,32768,77344,236.03515625
22,14,1,0,2,-2,-100.0
22,14,2,3,4,-1,-25.0
22,14,3,5,8,-3,-37.5
22,14,4,6,16,-10,-62.5
22,14,5,21,32,-11,-34.375
22,14,6,20,64,-44,-68.75
22,14,7,241,128,113,88.28125
22,14,8,62,256,-194,-75.78125
22,14,9,39,512,-473,-92.3828125
22,14,10,956,1024,-68,-6.640625
22,14,11,4417,2048,2369,115.673828125
22,14,12,4629,4096,533,13.0126953125
22,14,13,1549,8192,-6643,-81.09130859375
22,14,14,46810,16384,30426,185.70556640625
22,14,15,10422,32768,-22346,-68.194580078125
22,15,1,0,2,-2,-100.0
22,15,2,1,4,-3,-75.0
22,15,3,2,8,-6,-75.0
22,15,4,7,16,-9,-56.25
22,15,5,13,32,-19,-59.375
22,15,6,5,64,-59,-92.1875
22,15,7,208,128,80,62.5
22,15,8,15,256,-241,-94.140625
22,15,9,1306,512,794,155.078125
22,15,10,174,1024,-850,-83.0078125
22,15,11,1050,2048,-998,-48.73046875
22,15,12,134,4096,-3962,-96.728515625
22,15,13,15612,8192,7420,90.576171875
22,15,14,3930,16384,-12454,-76.01318359375
22,15,15,160947,32768,128179,391.1712646484375
22,16,1,0,2,-2,-100.0
22,16,2,1,4,-3,-75.0
22,16,3,3,8,-5,-62.5
22,16,4,20,16,4,25.0
22,16,5,17,32,-15,-46.875
22,16,6,127,64,63,98.4375
22,16,7,8,128,-120,-93.75
22,16,8,1132,256,876,342.1875
22,16,9,120,512,-392,-76.5625
22,16,10,157,1024,-867,-84.66796875
22,16,11,762,2048,-1286,-62.79296875
22,16,12,15570,4096,11474,280.126953125
22,16,13,6661,8192,-1531,-18.68896484375
22,16,14,28195,16384,11811,72.088623046875
22,16,15,708,32768,-32060,-97.83935546875
22,17,1,0,2,-2,-100.0
22,17,2,1,4,-3,-75.0
22,17,3,4,8,-4,-50.0
22,17,4,9,16,-7,-43.75
22,17,5,55,32,23,71.875
22,17,6,77,64,13,20.3125
22,17,7,197,128,69,53.90625
22,17,8,57,256,-199,-77.734375
22,17,9,1086,512,574,112.109375
22,17,10,92,1024,-932,-91.015625
22,17,11,3290,2048,1242,60.64453125
22,17,12,519,4096,-3577,-87.3291015625
22,17,13,3811,8192,-4381,-53.47900390625
22,17,14,26305,16384,9921,60.552978515625
22,17,15,80358,32768,47590,145.233154296875
22,18,1,0,2,-2,-100.0
22,18,2,2,4,-2,-50.0
22,18,3,2,8,-6,-75.0
22,18,4,5,16,-11,-68.75
22,18,5,14,32,-18,-56.25
22,18,6,7,64,-57,-89.0625
22,18,7,147,128,19,14.84375
22,18,8,233,256,-23,-8.984375
22,18,9,192,512,-320,-62.5
22,18,10,4242,1024,3218,314.2578125
22,18,11,28,2048,-2020,-98.6328125
22,18,12,5707,4096,1611,39.3310546875
22,18,13,34150,8192,25958,316.8701171875
22,18,14,15212,16384,-1172,-7.1533203125
22,18,15,10882,32768,-21886,-66.790771484375
22,19,1,0,2,-2,-100.0
22,19,2,3,4,-1,-25.0
22,19,3,5,8,-3,-37.5
22,19,4,3,16,-13,-81.25
22,19,5,17,32,-15,-46.875
22,19,6,49,64,-15,-23.4375
22,19,7,44,128,-84,-65.625
22,19,8,922,256,666,260.15625
22,19,9,55,512,-457,-89.2578125
22,19,10,558,1024,-466,-45.5078125
22,19,11,2525,2048,477,23.291015625
22,19,12,2992,4096,-1104,-26.953125
22,19,13,8073,8192,-119,-1.45263671875
22,19,14,2800,16384,-13584,-82.91015625
22,19,15,15763,32768,-17005,-51.8951416015625
22,20,1,0,2,-2,-100.0
22,20,2,5,4,1,25.0
22,20,3,2,8,-6,-75.0
22,20,4,7,16,-9,-56.25
22,20,5,84,32,52,162.5
22,20,6,10,64,-54,-84.375
22,20,7,21,128,-107,-83.59375
22,20,8,321,256,65,25.390625
22,20,9,268,512,-244,-47.65625
22,20,10,4288,1024,3264,318.75
22,20,11,1825,2048,-223,-10.888671875
22,20,12,4041,4096,-55,-1.3427734375
22,20,13,12322,8192,4130,50.4150390625
22,20,14,19366,16384,2982,18.20068359375
22,20,15,20169,32768,-12599,-38.4490966796875
22,21,1,0,2,-2,-100.0
22,21,2,2,4,-2,-50.0
22,21,3,3,8,-5,-62.5
22,21,4,15,16,-1,-6.25
22,21,5,46,32,14,43.75
22,21,6,41,64,-23,-35.9375
22,21,7,190,128,62,48.4375
22,21,8,624,256,368,143.75
22,21,9,564,512,52,10.15625
22,21,10,843,1024,-181,-17.67578125
22,21,11,732,2048,-1316,-64.2578125
22,21,12,1725,4096,-2371,-57.8857421875
22,21,13,8108,8192,-84,-1.025390625
22,21,14,52151,16384,35767,218.304443359375
22,21,15,37427,32768,4659,14.2181396484375
22,22,1,0,2,-2,-100.0
22,22,2,3,4,-1,-25.0
22,22,3,18,8,10,125.0
22,22,4,7,16,-9,-56.25
22,22,5,33,32,1,3.125
22,22,6,43,64,-21,-32.8125
22,22,7,18,128,-110,-85.9375
22,22,8,898,256,642,250.78125
22,22,9,33,512,-479,-93.5546875
22,22,10,1294,1024,270,26.3671875
22,22,11,2667,2048,619,30.224609375
22,22,12,4289,4096,193,4.7119140625
22,22,13,8193,8192,1,0.01220703125
22,22,14,16409,16384,25,0.152587890625
22,22,15,92500,32768,59732,182.28759765625
23,1,1,0,2,-2,-100.0
23,1,2,1,4,-3,-75.0
23,1,3,3,8,-5,-62.5
23,1,4,7,16,-9,-56.25
23,1,5,54,32,22,68.75
23,1,6,6,64,-58,-90.625
23,1,7,7,128,-121,-94.53125
23,1,8,929,256,673,262.890625
23,1,9,104,512,-408,-79.6875
23,1,10,1783,1024,759,74.12109375
23,1,11,2966,2048,918,44.82421875
23,1,12,9284,4096,5188,126.66015625
23,1,13,1528,8192,-6664,-81.34765625
23,1,14,2383,16384,-14001,-85.455322265625
23,1,15,56785,32768,24017,73.2940673828125
23,2,1,0,2,-2,-100.0
23,2,2,2,4,-2,-50.0
23,2,3,3,8,-5,-62.5
23,2,4,17,16,1,6.25
23,2,5,27,32,-5,-15.625
23,2,6,23,64,-41,-64.0625
23,2,7,32,128,-96,-75.0
23,2,8,28,256,-228,-89.0625
23,2,9,811,512,299,58.3984375
23,2,10,1283,1024,259,25.29296875
23,2,11,279,2048,-1769,-86.376953125
23,2,12,1643,4096,-2453,-59.8876953125
23,2,13,14681,8192,6489,79.21142578125
23,2,14,20171,16384,3787,23.114013671875
23,2,15,47922,32768,15154,46.246337890625
23,3,1,0,2,-2,-100.0
23,3,2,1,4,-3,-75.0
23,3,3,2,8,-6,-75.0
23,3,4,6,16,-10,-62.5
23,3,5,46,32,14,43.75
23,3,6,63,64,-1,-1.5625
23,3,7,16,128,-112,-87.5
23,3,8,485,256,229,89.453125
23,3,9,200,512,-312,-60.9375
23,3,10,599,1024,-425,-41.50390625
23,3,11,1415,2048,-633,-30.908203125
23,3,12,710,4096,-3386,-82.666015625
23,3,13,689,8192,-7503,-91.58935546875
23,3,14,30389,16384,14005,85.479736328125
23,3,15,36986,32768,4218,12.872314453125
23,4,1,0,2,-2,-100.0
23,4,2,2,4,-2,-50.0
23,4,3,5,8,-3,-37.5
23,4,4,14,16,-2,-12.5
23,4,5,7,32,-25,-78.125
23,4,6,27,64,-37,-57.8125
23,4,7,667,128,539,421.09375
23,4,8,17,256,-239,-93.359375
23,4,9,349,512,-163,-31.8359375
23,4,10,1566,1024,542,52.9296875
23,4,11,4510,2048,2462,120.21484375
23,4,12,6097,4096,2001,48.8525390625
23,4,13,12411,8192,4219,51.50146484375
23,4,14,25840,16384,9456,57.71484375
23,4,15,40964,32768,8196,25.01220703125
23,5,1,0,2,-2,-100.0
23,5,2,1,4,-3,-75.0
23,5,3,3,8,-5,-62.5
23,5,4,6,16,-10,-62.5
23,5,5,17,32,-15,-46.875
23,5,6,61,64,-3,-4.6875
23,5,7,207,128,79,61.71875
23,5,8,114,256,-142,-55.46875
23,5,9,1463,512,951,185.7421875
23,5,10,285,1024,-739,-72.16796875
23,5,11,460,2048,-1588,-77.5390625
23,5,12,9329,4096,5233,127.7587890625
23,5,13,12880,8192,4688,57.2265625
23,5,14,7547,16384,-8837,-53.936767578125
23,5,15,18417,32768,-14351,-43.7957763671875
23,6,1,0,2,-2,-100.0
23,6,2,1,4,-3,-75.0
23,6,3,6,8,-2,-25.0
23,6,4,3,16,-13,-81.25
23,6,5,35,32,3,9.375
23,6,6,40,64,-24,-37.5
23,6,7,40,128,-88,-68.75
23,6,8,51,256,-205,-80.078125
23,6,9,55,512,-457,-89.2578125
23,6,10,445,1024,-579,-56.54296875
23,6,11,546,2048,-1502,-73.33984375
23,6,12,6607,4096,2511,61.3037109375
23,6,13,3324,8192,-4868,-59.423828125
23,6,14,11306,16384,-5078,-30.99365234375
23,6,15,8378,32768,-24390,-74.432373046875
23,7,1,0,2,-2,-100.0
23,7,2,3,4,-1,-25.0
23,7,3,10,8,2,25.0
23,7,4,4,16,-12,-75.0
23,7,5,17,32,-15,-46.875
23,7,6,26,64,-38,-59.375
23,7,7,52,128,-76,-59.375
23,7,8,41,256,-215,-83.984375
23,7,9,482,512,-30,-5.859375
23,7,10,1143,1024,119,11.62109375
23,7,11,87,2048,-1961,-95.751953125
23,7,12,2731,4096,-1365,-33.3251953125
23,7,13,223,8192,-7969,-97.27783203125
23,7,14,1916,16384,-14468,-88.3056640625
23,7,15,2267,32768,-30501,-93.0816650390625
23,8,1,0,2,-2,-100.0
23,8,2,1,4,-3,-75.0
23,8,3,2,8,-6,-75.0
23,8,4,5,16,-11,-68.75
23,8,5,10,32,-22,-68.75
23,8,6,17,64,-47,-73.4375
23,8,7,72,128,-56,-43.75
23,8,8,175,256,-81,-31.640625
23,8,9,44,512,-468,-91.40625
23,8,10,1104,1024,80,7.8125
23,8,11,1315,2048,-733,-35.791015625
23,8,12,9821,4096,5725,139.7705078125
23,8,13,12742,8192,4550,55.5419921875
23,8,14,14789,16384,-1595,-9.735107421875
23,8,15,28769,32768,-3999,-12.2039794921875
23,9,1,0,2,-2,-100.0
23,9,2,2,4,-2,-50.0
23,9,3,10,8,2,25.0
23,9,4,15,16,-1,-6.25
23,9,5,10,32,-22,-68.75
23,9,6,26,64,-38,-59.375
23,9,7,36,128,-92,-71.875
23,9,8,59,256,-197,-76.953125
23,9,9,1524,512,1012,197.65625
23,9,10,1211,1024,187,18.26171875
23,9,11,1267,2048,-781,-38.134765625
23,9,12,125,4096,-3971,-96.9482421875
23,9,13,507,8192,-7685,-93.81103515625
23,9,14,49210,16384,32826,200.35400390625
23,9,15,16379,32768,-16389,-50.0152587890625
23,10,1,0,2,-2,-100.0
23,10,2,1,4,-3,-75.0
23,10,3,6,8,-2,-25.0
23,10,4,10,16,-6,-37.5
23,10,5,7,32,-25,-78.125
23,10,6,36,64,-28,-43.75
23,10,7,279,128,151,117.96875
23,10,8,417,256,161,62.890625
23,10,9,143,512,-369,-72.0703125
23,10,10,292,1024,-732,-71.484375
23,10,11,2794,2048,746,36.42578125
23,10,12,440,4096,-3656,-89.2578125
23,10,13,7570,8192,-622,-7.5927734375
23,10,14,3141,16384,-13243,-80.828857421875
23,10,15,32591,32768,-177,-0.5401611328125
23,11,1,0,2,-2,-100.0
23,11,2,2,4,-2,-50.0
23,11,3,15,8,7,87.5
23,11,4,9,16,-7,-43.75
23,11,5,81,32,49,153.125
23,11,6,140,64,76,118.75
23,11,7,296,128,168,131.25
23,11,8,105,256,-151,-58.984375
23,11,9,2278,512,1766,344.921875
23,11,10,647,1024,-377,-36.81640625
23,11,11,1302,2048,-746,-36.42578125
23,11,12,1383,4096,-2713,-66.2353515625
23,11,13,10706,8192,2514,30.6884765625
23,11,14,60356,16384,43972,268.3837890625
23,11,15,3054,32768,-29714,-90.679931640625
23,12,1,0,2,-2,-100.0
23,12,2,2,4,-2,-50.0
23,12,3,8,8,0,0.0
23,12,4,14,16,-2,-12.5
23,12,5,72,32,40,125.0
23,12,6,35,64,-29,-45.3125
23,12,7,34,128,-94,-73.4375
23,12,8,156,256,-100,-39.0625
23,12,9,134,512,-378,-73.828125
23,12,10,538,1024,-486,-47.4609375
23,12,11,2522,2048,474,23.14453125
23,12,12,8717,4096,4621,112.8173828125
23,12,13,17426,8192,9234,112.7197265625
23,12,14,14635,16384,-1749,-10.675048828125
23,12,15,54311,32768,21543,65.7440185546875
23,13,1,0,2,-2,-100.0
23,13,2,1,4,-3,-75.0
23,13,3,2,8,-6,-75.0
23,13,4,23,16,7,43.75
23,13,5,37,32,5,15.625
23,13,6,93,64,29,45.3125
23,13,7,42,128,-86,-67.1875
23,13,8,55,256,-201,-78.515625
23,13,9,172,512,-340,-66.40625
23,13,10,796,1024,-228,-22.265625
23,13,11,1299,2048,-749,-36.572265625
23,13,12,928,4096,-3168,-77.34375
23,13,13,14134,8192,5942,72.5341796875
23,13,14,2286,16384,-14098,-86.04736328125
23,13,15,19173,32768,-13595,-41.4886474609375
23,14,1,0,2,-2,-100.0
23,14,2,1,4,-3,-75.0
23,14,3,3,8,-5,-62.5
23,14,4,18,16,2,12.5
23,14,5,8,32,-24,-75.0
23,14,6,132,64,68,106.25
23,14,7,32,128,-96,-75.0
23,14,8,255,256,-1,-0.390625
23,14,9,500,512,-12,-2.34375
23,14,10,2247,1024,1223,119.43359375
23,14,11,3693,2048,1645,80.322265625
23,14,12,4209,4096,113,2.7587890625
23,14,13,5526,8192,-2666,-32.5439453125
23,14,14,22378,16384,5994,36.58447265625
23,14,15,10141,32768,-22627,-69.0521240234375
23,15,1,0,2,-2,-100.0
23,15,2,1,4,-3,-75.0
23,15,3,8,8,0,0.0
23,15,4,17,16,1,6.25
23,15,5,50,32,18,56.25
23,15,6,80,64,16,25.0
23,15,7,587,128,459,358.59375
23,15,8,30,256,-226,-88.28125
23,15,9,42,512,-470,-91.796875
23,15,10,956,1024,-68,-6.640625
23,15,11,424,2048,-1624,-79.296875
23,15,12,9007,4096,4911,119.8974609375
23,15,13,4506,8192,-3686,-44.9951171875
23,15,14,37706,16384,21322,130.13916015625
23,15,15,42132,32768,9364,28.57666015625
23,16,1,0,2,-2,-100.0
23,16,2,2,4,-2,-50.0
23,16,3,5,8,-3,-37.5
23,16,4,13,16,-3,-18.75
23,16,5,4,32,-28,-87.5
23,16,6,17,64,-47,-73.4375
23,16,7,285,128,157,122.65625
23,16,8,240,256,-16,-6.25
23,16,9,801,512,289,56.4453125
23,16,10,252,1024,-772,-75.390625
23,16,11,2676,2048,628,30.6640625
23,16,12,3540,4096,-556,-13.57421875
23,16,13,719,8192,-7473,-91.22314453125
23,16,14,17353,16384,969,5.914306640625
23,16,15,8140,32768,-24628,-75.15869140625
23,17,1,0,2,-2,-100.0
23,17,2,1,4,-3,-75.0
23,17,3,2,8,-6,-75.0
23,17,4,17,16,1,6.25
23,17,5,9,32,-23,-71.875
23,17,6,146,64,82,128.125
23,17,7,17,128,-111,-86.71875
23,17,8,299,256,43,16.796875
23,17,9,623,512,111,21.6796875
23,17,10,374,1024,-650,-63.4765625
23,17,11,1179,2048,-869,-42.431640625
23,17,12,3470,4096,-626,-15.283203125
23,17,13,2841,8192,-5351,-65.31982421875
23,17,14,21983,16384,5599,34.173583984375
23,17,15,65256,32768,32488,99.1455078125
23,18,1,0,2,-2,-100.0
23,18,2,2,4,-2,-50.0
23,18,3,19,8,11,137.5
23,18,4,14,16,-2,-12.5
23,18,5,30,32,-2,-6.25
23,18,6,6,64,-58,-90.625
23,18,7,71,128,-57,-44.53125
23,18,8,81,256,-175,-68.359375
23,18,9,76,512,-436,-85.15625
23,18,10,146,1024,-878,-85.7421875
23,18,11,702,2048,-1346,-65.72265625
23,18,12,6546,4096,2450,59.814453125
23,18,13,7489,8192,-703,-8.58154296875
23,18,14,74025,16384,57641,351.812744140625
23,18,15,7088,32768,-25680,-78.369140625
23,19,1,0,2,-2,-100.0
23,19,2,2,4,-2,-50.0
23,19,3,9,8,1,12.5
23,19,4,47,16,31,193.75
23,19,5,8,32,-24,-75.0
23,19,6,14,64,-50,-78.125
23,19,7,49,128,-79,-61.71875
23,19,8,165,256,-91,-35.546875
23,19,9,223,512,-289,-56.4453125
23,19,10,1807,1024,783,76.46484375
23,19,11,5314,2048,3266,159.47265625
23,19,12,1201,4096,-2895,-70.6787109375
23,19,13,5886,8192,-2306,-28.1494140625
23,19,14,4116,16384,-12268,-74.8779296875
23,19,15,1547,32768,-31221,-95.2789306640625
23,20,1,0,2,-2,-100.0
23,20,2,2,4,-2,-50.0
23,20,3,7,8,-1,-12.5
23,20,4,7,16,-9,-56.25
23,20,5,7,32,-25,-78.125
23,20,6,228,64,164,256.25
23,20,7,103,128,-25,-19.53125
23,20,8,33,256,-223,-87.109375
23,20,9,963,512,451,88.0859375
23,20,10,256,1024,-768,-75.0
23,20,11,955,2048,-1093,-53.369140625
23,20,12,1534,4096,-2562,-62.548828125
23,20,13,5771,8192,-2421,-29.55322265625
23,20,14,18114,16384,1730,10.55908203125
23,20,15,43387,32768,10619,32.4066162109375
23,21,1,0,2,-2,-100.0
23,21,2,2,4,-2,-50.0
23,21,3,5,8,-3,-37.5
23,21,4,10,16,-6,-37.5
23,21,5,21,32,-11,-34.375
23,21,6,60,64,-4,-6.25
23,21,7,14,128,-114,-89.0625
23,21,8,96,256,-160,-62.5
23,21,9,742,512,230,44.921875
23,21,10,735,1024,-289,-28.22265625
23,21,11,1918,2048,-130,-6.34765625
23,21,12,3379,4096,-717,-17.5048828125
23,21,13,1461,8192,-6731,-82.16552734375
23,21,14,789,16384,-15595,-95.184326171875
23,21,15,9485,32768,-23283,-71.0540771484375
23,22,1,0,2,-2,-100.0
23,22,2,2,4,-2,-50.0
23,22,3,4,8,-4,-50.0
23,22,4,12,16,-4,-25.0
23,22,5,12,32,-20,-62.5
23,22,6,63,64,-1,-1.5625
23,22,7,205,128,77,60.15625
23,22,8,49,256,-207,-80.859375
23,22,9,114,512,-398,-77.734375
23,22,10,1355,1024,331,32.32421875
23,22,11,417,2048,-1631,-79.638671875
23,22,12,83,4096,-4013,-97.9736328125
23,22,13,9344,8192,1152,14.0625
23,22,14,55367,16384,38983,237.933349609375
23,22,15,40974,32768,8206,25.042724609375
23,23,1,0,2,-2,-100.0
23,23,2,1,4,-3,-75.0
23,23,3,5,8,-3,-37.5
23,23,4,14,16,-2,-12.5
23,23,5,20,32,-12,-37.5
23,23,6,15,64,-49,-76.5625
23,23,7,80,128,-48,-37.5
23,23,8,199,256,-57,-22.265625
23,23,9,222,512,-290,-56.640625
23,23,10,443,1024,-581,-56.73828125
23,23,11,1364,2048,-684,-33.3984375
23,23,12,3090,4096,-1006,-24.560546875
23,23,13,12322,8192,4130,50.4150390625
23,23,14,19897,16384,3513,21.441650390625
23,23,15,31015,32768,-1753,-5.3497314453125
24,1,1,0,2,-2,-100.0
24,1,2,1,4,-3,-75.0
24,1,3,3,8,-5,-62.5
24,1,4,3,16,-13,-81.25
24,1,5,21,32,-11,-34.375
24,1,6,19,64,-45,-70.3125
24,1,7,204,128,76,59.375
24,1,8,46,256,-210,-82.03125
24,1,9,778,512,266,51.953125
24,1,10,3877,1024,2853,278.61328125
24,1,11,2445,2048,397,19.384765625
24,1,12,1062,4096,-3034,-74.072265625
24,1,13,1138,8192,-7054,-86.1083984375
24,1,14,23964,16384,7580,46.2646484375
24,1,15,130869,32768,98101,299.3804931640625
24,2,1,0,2,-2,-100.0
24,2,2,2,4,-2,-50.0
24,2,3,4,8,-4,-50.0
24,2,4,4,16,-12,-75.0
24,2,5,62,32,30,93.75
24,2,6,31,64,-33,-51.5625
24,2,7,453,128,325,253.90625
24,2,8,470,256,214,83.59375
24,2,9,776,512,264,51.5625
24,2,10,48,1024,-976,-95.3125
24,2,11,751,2048,-1297,-63.330078125
24,2,12,1851,4096,-2245,-54.8095703125
24,2,13,35957,8192,27765,338.92822265625
24,2,14,8849,16384,-7535,-45.989990234375
24,2,15,19335,32768,-13433,-40.9942626953125
24,3,1,0,2,-2,-100.0
24,3,2,4,4,0,0.0
24,3,3,22,8,14,175.0
24,3,4,4,16,-12,-75.0
24,3,5,76,32,44,137.5
24,3,6,83,64,19,29.6875
24,3,7,100,128,-28,-21.875
24,3,8,132,256,-124,-48.4375
24,3,9,411,512,-101,-19.7265625
24,3,10,922,1024,-102,-9.9609375
24,3,11,513,2048,-1535,-74.951171875
24,3,12,8216,4096,4120,100.5859375
24,3,13,547,8192,-7645,-93.32275390625
24,3,14,27295,16384,10911,66.595458984375
24,3,15,7443,32768,-25325,-77.2857666015625
24,4,1,0,2,-2,-100.0
24,4,2,2,4,-2,-50.0
24,4,3,4,8,-4,-50.0
24,4,4,20,16,4,25.0
24,4,5,55,32,23,71.875
24,4,6,98,64,34,53.125
24,4,7,47,128,-81,-63.28125
24,4,8,691,256,435,169.921875
24,4,9,74,512,-438,-85.546875
24,4,10,498,1024,-526,-51.3671875
24,4,11,681,2048,-1367,-66.748046875
24,4,12,4064,4096,-32,-0.78125
24,4,13,7981,8192,-211,-2.57568359375
24,4,14,6554,16384,-9830,-59.99755859375
24,4,15,20122,32768,-12646,-38.592529296875
24,5,1,0,2,-2,-100.0
24,5,2,1,4,-3,-75.0
24,5,3,3,8,-5,-62.5
24,5,4,8,16,-8,-50.0
24,5,5,27,32,-5,-15.625
24,5,6,5,64,-59,-92.1875
24,5,7,51,128,-77,-60.15625
24,5,8,421,256,165,64.453125
24,5,9,535,512,23,4.4921875
24,5,10,437,1024,-587,-57.32421875
24,5,11,1813,2048,-235,-11.474609375
24,5,12,6445,4096,2349,57.3486328125
24,5,13,8661,8192,469,5.72509765625
24,5,14,5529,16384,-10855,-66.253662109375
24,5,15,118463,32768,85695,261.5203857421875
24,6,1,0,2,-2,-100.0
24,6,2,1,4,-3,-75.0
24,6,3,2,8,-6,-75.0
24,6,4,7,16,-9,-56.25
24,6,5,49,32,17,53.125
24,6,6,104,64,40,62.5
24,6,7,204,128,76,59.375
24,6,8,529,256,273,106.640625
24,6,9,309,512,-203,-39.6484375
24,6,10,2453,1024,1429,139.55078125
24,6,11,3695,2048,1647,80.419921875
24,6,12,6432,4096,2336,57.03125
24,6,13,5240,8192,-2952,-36.03515625
24,6,14,12937,16384,-3447,-21.038818359375
24,6,15,9837,32768,-22931,-69.9798583984375
24,7,1,0,2,-2,-100.0
24,7,2,1,4,-3,-75.0
24,7,3,6,8,-2,-25.0
24,7,4,33,16,17,106.25
24,7,5,76,32,44,137.5
24,7,6,22,64,-42,-65.625
24,7,7,108,128,-20,-15.625
24,7,8,88,256,-168,-65.625
24,7,9,294,512,-218,-42.578125
24,7,10,2048,1024,1024,100.0
24,7,11,3419,2048,1371,66.943359375
24,7,12,6620,4096,2524,61.62109375
24,7,13,1407,8192,-6785,-82.82470703125
24,7,14,8346,16384,-8038,-49.06005859375
24,7,15,19000,32768,-13768,-42.0166015625
24,8,1,0,2,-2,-100.0
24,8,2,1,4,-3,-75.0
24,8,3,2,8,-6,-75.0
24,8,4,9,16,-7,-43.75
24,8,5,32,32,0,0.0
24,8,6,97,64,33,51.5625
24,8,7,192,128,64,50.0
24,8,8,52,256,-204,-79.6875
24,8,9,1237,512,725,141.6015625
24,8,10,224,1024,-800,-78.125
24,8,11,742,2048,-1306,-63.76953125
24,8,12,7560,4096,3464,84.5703125
24,8,13,1884,8192,-6308,-77.001953125
24,8,14,412,16384,-15972,-97.4853515625
24,8,15,17545,32768,-15223,-46.4569091796875
24,9,1,0,2,-2,-100.0
24,9,2,2,4,-2,-50.0
24,9,3,4,8,-4,-50.0
24,9,4,12,16,-4,-25.0
24,9,5,23,32,-9,-28.125
24,9,6,21,64,-43,-67.1875
24,9,7,31,128,-97,-75.78125
24,9,8,42,256,-214,-83.59375
24,9,9,128,512,-384,-75.0
24,9,10,1367,1024,343,33.49609375
24,9,11,298,2048,-1750,-85.44921875
24,9,12,10019,4096,5923,144.6044921875
24,9,13,15482,8192,7290,88.9892578125
24,9,14,6547,16384,-9837,-60.040283203125
24,9,15,4746,32768,-28022,-85.516357421875
24,10,1,0,2,-2,-100.0
24,10,2,3,4,-1,-25.0
24,10,3,12,8,4,50.0
24,10,4,30,16,14,87.5
24,10,5,23,32,-9,-28.125
24,10,6,5,64,-59,-92.1875
24,10,7,371,128,243,189.84375
24,10,8,95,256,-161,-62.890625
24,10,9,199,512,-313,-61.1328125
24,10,10,2522,1024,1498,146.2890625
24,10,11,4972,2048,2924,142.7734375
24,10,12,849,4096,-3247,-79.2724609375
24,10,13,1388,8192,-6804,-83.056640625
24,10,14,1614,16384,-14770,-90.14892578125
24,10,15,48566,32768,15798,48.211669921875
24,11,1,0,2,-2,-100.0
24,11,2,1,4,-3,-75.0
24,11,3,6,8,-2,-25.0
24,11,4,38,16,22,137.5
24,11,5,10,32,-22,-68.75
24,11,6,32,64,-32,-50.0
24,11,7,63,128,-65,-50.78125
24,11,8,118,256,-138,-53.90625
24,11,9,413,512,-99,-19.3359375
24,11,10,202,1024,-822,-80.2734375
24,11,11,2045,2048,-3,-0.146484375
24,11,12,7063,4096,2967,72.4365234375
24,11,13,29823,8192,21631,264.05029296875
24,11,14,5526,16384,-10858,-66.27197265625
24,11,15,30053,32768,-2715,-8.2855224609375
24,12,1,0,2,-2,-100.0
24,12,2,2,4,-2,-50.0
24,12,3,2,8,-6,-75.0
24,12,4,6,16,-10,-62.5
24,12,5,37,32,5,15.625
24,12,6,11,64,-53,-82.8125
24,12,7,138,128,10,7.8125
24,12,8,112,256,-144,-56.25
24,12,9,900,512,388,75.78125
24,12,10,437,1024,-587,-57.32421875
24,12,11,593,2048,-1455,-71.044921875
24,12,12,966,4096,-3130,-76.416015625
24,12,13,146,8192,-8046,-98.2177734375
24,12,14,67472,16384,51088,311.81640625
24,12,15,10316,32768,-22452,-68.51806640625
24,13,1,0,2,-2,-100.0
24,13,2,8,4,4,100.0
24,13,3,6,8,-2,-25.0
24,13,4,18,16,2,12.5
24,13,5,17,32,-15,-46.875
24,13,6,181,64,117,182.8125
24,13,7,20,128,-108,-84.375
24,13,8,253,256,-3,-1.171875
24,13,9,193,512,-319,-62.3046875
24,13,10,363,1024,-661,-64.55078125
24,13,11,2478,2048,430,20.99609375
24,13,12,7886,4096,3790,92.529296875
24,13,13,6165,8192,-2027,-24.74365234375
24,13,14,75039,16384,58655,358.001708984375
24,13,15,12473,32768,-20295,-61.9354248046875
24,14,1,0,2,-2,-100.0
24,14,2,1,4,-3,-75.0
24,14,3,5,8,-3,-37.5
24,14,4,27,16,11,68.75
24,14,5,58,32,26,81.25
24,14,6,11,64,-53,-82.8125
24,14,7,35,128,-93,-72.65625
24,14,8,256,256,0,0.0
24,14,9,1443,512,931,181.8359375
24,14,10,842,1024,-182,-17.7734375
24,14,11,8589,2048,6541,319.384765625
24,14,12,1622,4096,-2474,-60.400390625
24,14,13,9650,8192,1458,17.7978515625
24,14,14,4878,16384,-11506,-70.22705078125
24,14,15,53634,32768,20866,63.677978515625
24,15,1,0,2,-2,-100.0
24,15,2,2,4,-2,-50.0
24,15,3,3,8,-5,-62.5
24,15,4,8,16,-8,-50.0
24,15,5,49,32,17,53.125
24,15,6,57,64,-7,-10.9375
24,15,7,217,128,89,69.53125
24,15,8,123,256,-133,-51.953125
24,15,9,49,512,-463,-90.4296875
24,15,10,1087,1024,63,6.15234375
24,15,11,597,2048,-1451,-70.849609375
24,15,12,675,4096,-3421,-83.5205078125
24,15,13,10147,8192,1955,23.86474609375
24,15,14,3715,16384,-12669,-77.325439453125
24,15,15,11873,32768,-20895,-63.7664794921875
24,16,1,0,2,-2,-100.0
24,16,2,1,4,-3,-75.0
24,16,3,7,8,-1,-12.5
24,16,4,19,16,3,18.75
24,16,5,6,32,-26,-81.25
24,16,6,40,64,-24,-37.5
24,16,7,561,128,433,338.28125
24,16,8,110,256,-146,-57.03125
24,16,9,654,512,142,27.734375
24,16,10,608,1024,-416,-40.625
24,16,11,1427,2048,-621,-30.322265625
24,16,12,4507,4096,411,10.0341796875
24,16,13,390,8192,-7802,-95.2392578125
24,16,14,2203,16384,-14181,-86.553955078125
24,16,15,9730,32768,-23038,-70.306396484375
24,17,1,0,2,-2,-100.0
24,17,2,2,4,-2,-50.0
24,17,3,16,8,8,100.0
24,17,4,9,16,-7,-43.75
24,17,5,57,32,25,78.125
24,17,6,135,64,71,110.9375
24,17,7,355,128,227,177.34375
24,17,8,219,256,-37,-14.453125
24,17,9,105,512,-407,-79.4921875
24,17,10,1817,1024,793,77.44140625
24,17,11,3122,2048,1074,52.44140625
24,17,12,963,4096,-3133,-76.4892578125
24,17,13,1872,8192,-6320,-77.1484375
24,17,14,5534,16384,-10850,-66.22314453125
24,17,15,7456,32768,-25312,-77.24609375
24,18,1,0,2,-2,-100.0
24,18,2,1,4,-3,-75.0
24,18,3,3,8,-5,-62.5
24,18,4,7,16,-9,-56.25
24,18,5,16,32,-16,-50.0
24,18,6,5,64,-59,-92.1875
24,18,7,215,128,87,67.96875
24,18,8,7,256,-249,-97.265625
24,18,9,543,512,31,6.0546875
24,18,10,1023,1024,-1,-0.09765625
24,18,11,255,2048,-1793,-87.548828125
24,18,12,424,4096,-3672,-89.6484375
24,18,13,16329,8192,8137,99.32861328125
24,18,14,9489,16384,-6895,-42.083740234375
24,18,15,81570,32768,48802,148.931884765625
24,19,1,0,2,-2,-100.0
24,19,2,1,4,-3,-75.0
24,19,3,6,8,-2,-25.0
24,19,4,11,16,-5,-31.25
24,19,5,35,32,3,9.375
24,19,6,107,64,43,67.1875
24,19,7,38,128,-90,-70.3125
24,19,8,32,256,-224,-87.5
24,19,9,507,512,-5,-0.9765625
24,19,10,1490,1024,466,45.5078125
24,19,11,4723,2048,2675,130.615234375
24,19,12,1574,4096,-2522,-61.572265625
24,19,13,7281,8192,-911,-11.12060546875
24,19,14,540,16384,-15844,-96.7041015625
24,19,15,29682,32768,-3086,-9.417724609375
24,20,1,0,2,-2,-100.0
24,20,2,1,4,-3,-75.0
24,20,3,5,8,-3,-37.5
24,20,4,4,16,-12,-75.0
24,20,5,99,32,67,209.375
24,20,6,7,64,-57,-89.0625
24,20,7,20,128,-108,-84.375
24,20,8,35,256,-221,-86.328125
24,20,9,493,512,-19,-3.7109375
24,20,10,753,1024,-271,-26.46484375
24,20,11,2563,2048,515,25.146484375
24,20,12,7965,4096,3869,94.4580078125
24,20,13,17973,8192,9781,119.39697265625
24,20,14,16510,16384,126,0.76904296875
24,20,15,8948,32768,-23820,-72.69287109375
24,21,1,0,2,-2,-100.0
24,21,2,1,4,-3,-75.0
24,21,3,2,8,-6,-75.0
24,21,4,3,16,-13,-81.25
24,21,5,4,32,-28,-87.5
24,21,6,7,64,-57,-89.0625
24,21,7,20,128,-108,-84.375
24,21,8,577,256,321,125.390625
24,21,9,247,512,-265,-51.7578125
24,21,10,933,1024,-91,-8.88671875
24,21,11,1543,2048,-505,-24.658203125
24,21,12,212,4096,-3884,-94.82421875
24,21,13,1051,8192,-7141,-87.17041015625
24,21,14,5127,16384,-11257,-68.707275390625
24,21,15,22206,32768,-10562,-32.232666015625
24,22,1,0,2,-2,-100.0
24,22,2,3,4,-1,-25.0
24,22,3,2,8,-6,-75.0
24,22,4,9,16,-7,-43.75
24,22,5,41,32,9,28.125
24,22,6,11,64,-53,-82.8125
24,22,7,9,128,-119,-92.96875
24,22,8,216,256,-40,-15.625
24,22,9,508,512,-4,-0.78125
24,22,10,349,1024,-675,-65.91796875
24,22,11,3111,2048,1063,51.904296875
24,22,12,365,4096,-3731,-91.0888671875
24,22,13,22206,8192,14014,171.0693359375
24,22,14,637,16384,-15747,-96.112060546875
24,22,15,21579,32768,-11189,-34.1461181640625
24,23,1,0,2,-2,-100.0
24,23,2,3,4,-1,-25.0
24,23,3,2,8,-6,-75.0
24,23,4,12,16,-4,-25.0
24,23,5,42,32,10,31.25
24,23,6,165,64,101,157.8125
24,23,7,97,128,-31,-24.21875
24,23,8,177,256,-79,-30.859375
24,23,9,283,512,-229,-44.7265625
24,23,10,85,1024,-939,-91.69921875
24,23,11,712,2048,-1336,-65.234375
24,23,12,8545,4096,4449,108.6181640625
24,23,13,22,8192,-8170,-99.7314453125
24,23,14,3218,16384,-13166,-80.35888671875
24,23,15,6338,32768,-26430,-80.657958984375
24,24,1,0,2,-2,-100.0
24,24,2,2,4,-2,-50.0
24,24,3,4,8,-4,-50.0
24,24,4,38,16,22,137.5
24,24,5,9,32,-23,-71.875
24,24,6,24,64,-40,-62.5
24,24,7,101,128,-27,-21.09375
24,24,8,365,256,109,42.578125
24,24,9,238,512,-274,-53.515625
24,24,10,1358,1024,334,32.6171875
24,24,11,569,2048,-1479,-72.216796875
24,24,12,3951,4096,-145,-3.5400390625
24,24,13,16371,8192,8179,99.84130859375
24,24,14,21273,16384,4889,29.840087890625
24,24,15,41739,32768,8971,27.3773193359375
25,1,1,0,2,-2,-100.0
25,1,2,1,4,-3,-75.0
25,1,3,3,8,-5,-62.5
25,1,4,37,16,21,131.25
25,1,5,13,32,-19,-59.375
25,1,6,84,64,20,31.25
25,1,7,100,128,-28,-21.875
25,1,8,220,256,-36,-14.0625
25,1,9,127,512,-385,-75.1953125
25,1,10,2165,1024,1141,111.42578125
25,1,11,2394,2048,346,16.89453125
25,1,12,981,4096,-3115,-76.0498046875
25,1,13,12728,8192,4536,55.37109375
25,1,14,14710,16384,-1674,-10.21728515625
25,1,15,641,32768,-32127,-98.0438232421875
25,2,1,0,2,-2,-100.0
25,2,2,1,4,-3,-75.0
25,2,3,7,8,-1,-12.5
25,2,4,11,16,-5,-31.25
25,2,5,37,32,5,15.625
25,2,6,307,64,243,379.6875
25,2,7,272,128,144,112.5
25,2,8,558,256,302,117.96875
25,2,9,384,512,-128,-25.0
25,2,10,737,1024,-287,-28.02734375
25,2,11,491,2048,-1557,-76.025390625
25,2,12,261,4096,-3835,-93.6279296875
25,2,13,994,8192,-7198,-87.8662109375
25,2,14,17718,16384,1334,8.14208984375
25,2,15,16657,32768,-16111,-49.1668701171875
25,3,1,0,2,-2,-100.0
25,3,2,2,4,-2,-50.0
25,3,3,4,8,-4,-50.0
25,3,4,11,16,-5,-31.25
25,3,5,18,32,-14,-43.75
25,3,6,30,64,-34,-53.125
25,3,7,204,128,76,59.375
25,3,8,56,256,-200,-78.125
25,3,9,31,512,-481,-93.9453125
25,3,10,236,1024,-788,-76.953125
25,3,11,3021,2048,973,47.509765625
25,3,12,3472,4096,-624,-15.234375
25,3,13,4967,8192,-3225,-39.36767578125
25,3,14,7472,16384,-8912,-54.39453125
25,3,15,19030,32768,-13738,-41.925048828125
25,4,1,0,2,-2,-100.0
25,4,2,2,4,-2,-50.0
25,4,3,3,8,-5,-62.5
25,4,4,19,16,3,18.75
25,4,5,30,32,-2,-6.25
25,4,6,104,64,40,62.5
25,4,7,230,128,102,79.6875
25,4,8,148,256,-108,-42.1875
25,4,9,835,512,323,63.0859375
25,4,10,1206,1024,182,17.7734375
25,4,11,1682,2048,-366,-17.87109375
25,4,12,1452,4096,-2644,-64.55078125
25,4,13,3099,8192,-5093,-62.17041015625
25,4,14,40373,16384,23989,146.417236328125
25,4,15,7929,32768,-24839,-75.8026123046875
25,5,1,0,2,-2,-100.0
25,5,2,2,4,-2,-50.0
25,5,3,3,8,-5,-62.5
25,5,4,74,16,58,362.5
25,5,5,80,32,48,150.0
25,5,6,38,64,-26,-40.625
25,5,7,8,128,-120,-93.75
25,5,8,153,256,-103,-40.234375
25,5,9,1336,512,824,160.9375
25,5,10,415,1024,-609,-59.47265625
25,5,11,3666,2048,1618,79.00390625
25,5,12,171,4096,-3925,-95.8251953125
25,5,13,17850,8192,9658,117.8955078125
25,5,14,3254,16384,-13130,-80.13916015625
25,5,15,19441,32768,-13327,-40.6707763671875
25,6,1,0,2,-2,-100.0
25,6,2,1,4,-3,-75.0
25,6,3,7,8,-1,-12.5
25,6,4,3,16,-13,-81.25
25,6,5,33,32,1,3.125
25,6,6,7,64,-57,-89.0625
25,6,7,35,128,-93,-72.65625
25,6,8,1150,256,894,349.21875
25,6,9,397,512,-115,-22.4609375
25,6,10,975,1024,-49,-4.78515625
25,6,11,447,2048,-1601,-78.173828125
25,6,12,1647,4096,-2449,-59.7900390625
25,6,13,375,8192,-7817,-95.42236328125
25,6,14,21043,16384,4659,28.436279296875
25,6,15,11569,32768,-21199,-64.6942138671875
25,7,1,0,2,-2,-100.0
25,7,2,1,4,-3,-75.0
25,7,3,5,8,-3,-37.5
25,7,4,11,16,-5,-31.25
25,7,5,30,32,-2,-6.25
25,7,6,20,64,-44,-68.75
25,7,7,57,128,-71,-55.46875
25,7,8,88,256,-168,-65.625
25,7,9,486,512,-26,-5.078125
25,7,10,1096,1024,72,7.03125
25,7,11,6755,2048,4707,229.833984375
25,7,12,6177,4096,2081,50.8056640625
25,7,13,258,8192,-7934,-96.8505859375
25,7,14,4753,16384,-11631,-70.989990234375
25,7,15,12380,32768,-20388,-62.21923828125
25,8,1,0,2,-2,-100.0
25,8,2,2,4,-2,-50.0
25,8,3,9,8,1,12.5
25,8,4,10,16,-6,-37.5
25,8,5,13,32,-19,-59.375
25,8,6,37,64,-27,-42.1875
25,8,7,46,128,-82,-64.0625
25,8,8,148,256,-108,-42.1875
25,8,9,1092,512,580,113.28125
25,8,10,578,1024,-446,-43.5546875
25,8,11,963,2048,-1085,-52.978515625
25,8,12,2419,4096,-1677,-40.9423828125
25,8,13,17919,8192,9727,118.73779296875
25,8,14,2334,16384,-14050,-85.75439453125
25,8,15,12114,32768,-20654,-63.031005859375
25,9,1,0,2,-2,-100.0
25,9,2,1,4,-3,-75.0
25,9,3,2,8,-6,-75.0
25,9,4,21,16,5,31.25
25,9,5,36,32,4,12.5
25,9,6,83,64,19,29.6875
25,9,7,325,128,197,153.90625
25,9,8,226,256,-30,-11.71875
25,9,9,1483,512,971,189.6484375
25,9,10,103,1024,-921,-89.94140625
25,9,11,3961,2048,1913,93.408203125
25,9,12,4848,4096,752,18.359375
25,9,13,17254,8192,9062,110.6201171875
25,9,14,7660,16384,-8724,-53.2470703125
25,9,15,2627,32768,-30141,-91.9830322265625
25,10,1,0,2,-2,-100.0
25,10,2,2,4,-2,-50.0
25,10,3,4,8,-4,-50.0
25,10,4,14,16,-2,-12.5
25,10,5,60,32,28,87.5
25,10,6,15,64,-49,-76.5625
25,10,7,61,128,-67,-52.34375
25,10,8,127,256,-129,-50.390625
25,10,9,12,512,-500,-97.65625
25,10,10,1664,1024,640,62.5
25,10,11,1462,2048,-586,-28.61328125
25,10,12,2813,4096,-1283,-31.3232421875
25,10,13,25951,8192,17759,216.78466796875
25,10,14,2248,16384,-14136,-86.279296875
25,10,15,5520,32768,-27248,-83.154296875
25,11,1,0,2,-2,-100.0
25,11,2,2,4,-2,-50.0
25,11,3,4,8,-4,-50.0
25,11,4,12,16,-4,-25.0
25,11,5,42,32,10,31.25
25,11,6,14,64,-50,-78.125
25,11,7,9,128,-119,-92.96875
25,11,8,147,256,-109,-42.578125
25,11,9,727,512,215,41.9921875
25,11,10,830,1024,-194,-18.9453125
25,11,11,2181,2048,133,6.494140625
25,11,12,3973,4096,-123,-3.0029296875
25,11,13,243,8192,-7949,-97.03369140625
25,11,14,30952,16384,14568,88.916015625
25,11,15,65140,32768,32372,98.79150390625
25,12,1,0,2,-2,-100.0
25,12,2,1,4,-3,-75.0
25,12,3,3,8,-5,-62.5
25,12,4,22,16,6,37.5
25,12,5,42,32,10,31.25
25,12,6,33,64,-31,-48.4375
25,12,7,15,128,-113,-88.28125
25,12,8,398,256,142,55.46875
25,12,9,487,512,-25,-4.8828125
25,12,10,535,1024,-489,-47.75390625
25,12,11,2005,2048,-43,-2.099609375
25,12,12,3370,4096,-726,-17.724609375
25,12,13,1465,8192,-6727,-82.11669921875
25,12,14,8567,16384,-7817,-47.711181640625
25,12,15,34308,32768,1540,4.69970703125
25,13,1,0,2,-2,-100.0
25,13,2,1,4,-3,-75.0
25,13,3,6,8,-2,-25.0
25,13,4,6,16,-10,-62.5
25,13,5,65,32,33,103.125
25,13,6,61,64,-3,-4.6875
25,13,7,74,128,-54,-42.1875
25,13,8,73,256,-183,-71.484375
25,13,9,729,512,217,42.3828125
25,13,10,120,1024,-904,-88.28125
25,13,11,1524,2048,-524,-25.5859375
25,13,12,6216,4096,2120,51.7578125
25,13,13,4926,8192,-3266,-39.8681640625
25,13,14,33720,16384,17336,105.810546875
25,13,15,15152,32768,-17616,-53.759765625
25,14,1,0,2,-2,-100.0
25,14,2,7,4,3,75.0
25,14,3,2,8,-6,-75.0
25,14,4,5,16,-11,-68.75
25,14,5,4,32,-28,-87.5
25,14,6,67,64,3,4.6875
25,14,7,280,128,152,118.75
25,14,8,544,256,288,112.5
25,14,9,435,512,-77,-15.0390625
25,14,10,405,1024,-619,-60.44921875
25,14,11,700,2048,-1348,-65.8203125
25,14,12,4828,4096,732,17.87109375
25,14,13,21943,8192,13751,167.85888671875
25,14,14,68632,16384,52248,318.896484375
25,14,15,103753,32768,70985,216.6290283203125
25,15,1,0,2,-2,-100.0
25,15,2,1,4,-3,-75.0
25,15,3,5,8,-3,-37.5
25,15,4,3,16,-13,-81.25
25,15,5,15,32,-17,-53.125
25,15,6,82,64,18,28.125
25,15,7,223,128,95,74.21875
25,15,8,156,256,-100,-39.0625
25,15,9,1605,512,1093,213.4765625
25,15,10,1506,1024,482,47.0703125
25,15,11,856,2048,-1192,-58.203125
25,15,12,5893,4096,1797,43.8720703125
25,15,13,7589,8192,-603,-7.36083984375
25,15,14,13981,16384,-2403,-14.666748046875
25,15,15,12702,32768,-20066,-61.236572265625
25,16,1,0,2,-2,-100.0
25,16,2,3,4,-1,-25.0
25,16,3,4,8,-4,-50.0
25,16,4,17,16,1,6.25
25,16,5,34,32,2,6.25
25,16,6,35,64,-29,-45.3125
25,16,7,33,128,-95,-74.21875
25,16,8,246,256,-10,-3.90625
25,16,9,472,512,-40,-7.8125
25,16,10,1612,1024,588,57.421875
25,16,11,1466,2048,-582,-28.41796875
25,16,12,1398,4096,-2698,-65.869140625
25,16,13,5898,8192,-2294,-28.0029296875
25,16,14,11243,16384,-5141,-31.378173828125
25,16,15,32008,32768,-760,-2.3193359375
25,17,1,0,2,-2,-100.0
25,17,2,5,4,1,25.0
25,17,3,8,8,0,0.0
25,17,4,8,16,-8,-50.0
25,17,5,8,32,-24,-75.0
25,17,6,5,64,-59,-92.1875
25,17,7,12,128,-116,-90.625
25,17,8,105,256,-151,-58.984375
25,17,9,474,512,-38,-7.421875
25,17,10,2208,1024,1184,115.625
25,17,11,1051,2048,-997,-48.681640625
25,17,12,12119,4096,8023,195.8740234375
25,17,13,1004,8192,-7188,-87.744140625
25,17,14,25360,16384,8976,54.78515625
25,17,15,34936,32768,2168,6.6162109375
25,18,1,0,2,-2,-100.0
25,18,2,2,4,-2,-50.0
25,18,3,2,8,-6,-75.0
25,18,4,4,16,-12,-75.0
25,18,5,13,32,-19,-59.375
25,18,6,79,64,15,23.4375
25,18,7,46,128,-82,-64.0625
25,18,8,127,256,-129,-50.390625
25,18,9,190,512,-322,-62.890625
25,18,10,533,1024,-491,-47.94921875
25,18,11,1404,2048,-644,-31.4453125
25,18,12,1511,4096,-2585,-63.1103515625
25,18,13,28571,8192,20379,248.76708984375
25,18,14,2134,16384,-14250,-86.97509765625
25,18,15,48815,32768,16047,48.9715576171875
25,19,1,0,2,-2,-100.0
25,19,2,1,4,-3,-75.0
25,19,3,6,8,-2,-25.0
25,19,4,18,16,2,12.5
25,19,5,6,32,-26,-81.25
25,19,6,36,64,-28,-43.75
25,19,7,35,128,-93,-72.65625
25,19,8,370,256,114,44.53125
25,19,9,228,512,-284,-55.46875
25,19,10,2046,1024,1022,99.8046875
25,19,11,1565,2048,-483,-23.583984375
25,19,12,4110,4096,14,0.341796875
25,19,13,6465,8192,-1727,-21.08154296875
25,19,14,33706,16384,17322,105.72509765625
25,19,15,13432,32768,-19336,-59.0087890625
25,20,1,0,2,-2,-100.0
25,20,2,1,4,-3,-75.0
25,20,3,2,8,-6,-75.0
25,20,4,8,16,-8,-50.0
25,20,5,96,32,64,200.0
25,20,6,12,64,-52,-81.25
25,20,7,9,128,-119,-92.96875
25,20,8,271,256,15,5.859375
25,20,9,440,512,-72,-14.0625
25,20,10,2659,1024,1635,159.66796875
25,20,11,445,2048,-1603,-78.271484375
25,20,12,16606,4096,12510,305.419921875
25,20,13,10259,8192,2067,25.23193359375
25,20,14,24331,16384,7947,48.504638671875
25,20,15,59269,32768,26501,80.8746337890625
25,21,1,0,2,-2,-100.0
25,21,2,1,4,-3,-75.0
25,21,3,2,8,-6,-75.0
25,21,4,13,16,-3,-18.75
25,21,5,20,32,-12,-37.5
25,21,6,55,64,-9,-14.0625
25,21,7,124,128,-4,-3.125
25,21,8,51,256,-205,-80.078125
25,21,9,351,512,-161,-31.4453125
25,21,10,879,1024,-145,-14.16015625
25,21,11,2057,2048,9,0.439453125
25,21,12,11546,4096,7450,181.884765625
25,21,13,621,8192,-7571,-92.41943359375
25,21,14,2222,16384,-14162,-86.43798828125
25,21,15,26084,32768,-6684,-20.39794921875
25,22,1,0,2,-2,-100.0
25,22,2,2,4,-2,-50.0
25,22,3,3,8,-5,-62.5
25,22,4,3,16,-13,-81.25
25,22,5,22,32,-10,-31.25
25,22,6,107,64,43,67.1875
25,22,7,53,128,-75,-58.59375
25,22,8,146,256,-110,-42.96875
25,22,9,421,512,-91,-17.7734375
25,22,10,2297,1024,1273,124.31640625
25,22,11,216,2048,-1832,-89.453125
25,22,12,3415,4096,-681,-16.6259765625
25,22,13,853,8192,-7339,-89.58740234375
25,22,14,5083,16384,-11301,-68.975830078125
25,22,15,3602,32768,-29166,-89.007568359375
25,23,1,0,2,-2,-100.0
25,23,2,1,4,-3,-75.0
25,23,3,9,8,1,12.5
25,23,4,10,16,-6,-37.5
25,23,5,57,32,25,78.125
25,23,6,23,64,-41,-64.0625
25,23,7,215,128,87,67.96875
25,23,8,327,256,71,27.734375
25,23,9,134,512,-378,-73.828125
25,23,10,517,1024,-507,-49.51171875
25,23,11,1414,2048,-634,-30.95703125
25,23,12,1865,4096,-2231,-54.4677734375
25,23,13,8108,8192,-84,-1.025390625
25,23,14,7825,16384,-8559,-52.239990234375
25,23,15,9200,32768,-23568,-71.923828125
25,24,1,0,2,-2,-100.0
25,24,2,1,4,-3,-75.0
25,24,3,6,8,-2,-25.0
25,24,4,8,16,-8,-50.0
25,24,5,54,32,22,68.75
25,24,6,74,64,10,15.625
25,24,7,52,128,-76,-59.375
25,24,8,211,256,-45,-17.578125
25,24,9,535,512,23,4.4921875
25,24,10,627,1024,-397,-38.76953125
25,24,11,1926,2048,-122,-5.95703125
25,24,12,3626,4096,-470,-11.474609375
25,24,13,1546,8192,-6646,-81.1279296875
25,24,14,3682,16384,-12702,-77.52685546875
25,24,15,42395,32768,9627,29.3792724609375
25,25,1,0,2,-2,-100.0
25,25,2,1,4,-3,-75.0
25,25,3,2,8,-6,-75.0
25,25,4,15,16,-1,-6.25
25,25,5,4,32,-28,-87.5
25,25,6,17,64,-47,-73.4375
25,25,7,103,128,-25,-19.53125
25,25,8,36,256,-220,-85.9375
25,25,9,762,512,250,48.828125
25,25,10,1195,1024,171,16.69921875
25,25,11,1609,2048,-439,-21.435546875
25,25,12,3705,4096,-391,-9.5458984375
25,25,13,2624,8192,-5568,-67.96875
25,25,14,7906,16384,-8478,-51.74560546875
25,25,15,63146,32768,30378,92.706298828125
26,1,1,0,2,-2,-100.0
26,1,2,4,4,0,0.0
26,1,3,2,8,-6,-75.0
26,1,4,16,16,0,0.0
26,1,5,9,32,-23,-71.875
26,1,6,100,64,36,56.25
26,1,7,394,128,266,207.8125
26,1,8,244,256,-12,-4.6875
26,1,9,963,512,451,88.0859375
26,1,10,1004,1024,-20,-1.953125
26,1,11,1012,2048,-1036,-50.5859375
26,1,12,866,4096,-3230,-78.857421875
26,1,13,2106,8192,-6086,-74.2919921875
26,1,14,14106,16384,-2278,-13.90380859375
26,1,15,3080,32768,-29688,-90.6005859375
26,2,1,0,2,-2,-100.0
26,2,2,2,4,-2,-50.0
26,2,3,3,8,-5,-62.5
26,2,4,5,16,-11,-68.75
26,2,5,15,32,-17,-53.125
26,2,6,32,64,-32,-50.0
26,2,7,65,128,-63,-49.21875
26,2,8,740,256,484,189.0625
26,2,9,13,512,-499,-97.4609375
26,2,10,588,1024,-436,-42.578125
26,2,11,282,2048,-1766,-86.23046875
26,2,12,2638,4096,-1458,-35.595703125
26,2,13,5487,8192,-2705,-33.02001953125
26,2,14,5757,16384,-10627,-64.862060546875
26,2,15,152015,32768,119247,363.9129638671875
26,3,1,0,2,-2,-100.0
26,3,2,4,4,0,0.0
26,3,3,15,8,7,87.5
26,3,4,13,16,-3,-18.75
26,3,5,17,32,-15,-46.875
26,3,6,112,64,48,75.0
26,3,7,294,128,166,129.6875
26,3,8,414,256,158,61.71875
26,3,9,778,512,266,51.953125
26,3,10,237,1024,-787,-76.85546875
26,3,11,1266,2048,-782,-38.18359375
26,3,12,3129,4096,-967,-23.6083984375
26,3,13,8058,8192,-134,-1.6357421875
26,3,14,7811,16384,-8573,-52.325439453125
26,3,15,15726,32768,-17042,-52.008056640625
26,4,1,0,2,-2,-100.0
26,4,2,1,4,-3,-75.0
26,4,3,15,8,7,87.5
26,4,4,4,16,-12,-75.0
26,4,5,50,32,18,56.25
26,4,6,12,64,-52,-81.25
26,4,7,169,128,41,32.03125
26,4,8,45,256,-211,-82.421875
26,4,9,99,512,-413,-80.6640625
26,4,10,39,1024,-985,-96.19140625
26,4,11,1344,2048,-704,-34.375
26,4,12,3651,4096,-445,-10.8642578125
26,4,13,7417,8192,-775,-9.46044921875
26,4,14,9272,16384,-7112,-43.408203125
26,4,15,25383,32768,-7385,-22.5372314453125
26,5,1,0,2,-2,-100.0
26,5,2,1,4,-3,-75.0
26,5,3,4,8,-4,-50.0
26,5,4,5,16,-11,-68.75
26,5,5,4,32,-28,-87.5
26,5,6,43,64,-21,-32.8125
26,5,7,117,128,-11,-8.59375
26,5,8,106,256,-150,-58.59375
26,5,9,330,512,-182,-35.546875
26,5,10,1132,1024,108,10.546875
26,5,11,363,2048,-1685,-82.275390625
26,5,12,961,4096,-3135,-76.5380859375
26,5,13,1185,8192,-7007,-85.53466796875
26,5,14,62918,16384,46534,284.02099609375
26,5,15,25088,32768,-7680,-23.4375
26,6,1,0,2,-2,-100.0
26,6,2,1,4,-3,-75.0
26,6,3,9,8,1,12.5
26,6,4,8,16,-8,-50.0
26,6,5,32,32,0,0.0
26,6,6,17,64,-47,-73.4375
26,6,7,151,128,23,17.96875
26,6,8,606,256,350,136.71875
26,6,9,563,512,51,9.9609375
26,6,10,1140,1024,116,11.328125
26,6,11,5097,2048,3049,148.876953125
26,6,12,1767,4096,-2329,-56.8603515625
26,6,13,151,8192,-8041,-98.15673828125
26,6,14,11116,16384,-5268,-32.1533203125
26,6,15,11570,32768,-21198,-64.691162109375
26,7,1,0,2,-2,-100.0
26,7,2,1,4,-3,-75.0
26,7,3,2,8,-6,-75.0
26,7,4,26,16,10,62.5
26,7,5,4,32,-28,-87.5
26,7,6,38,64,-26,-40.625
26,7,7,122,128,-6,-4.6875
26,7,8,505,256,249,97.265625
26,7,9,131,512,-381,-74.4140625
26,7,10,1211,1024,187,18.26171875
26,7,11,4875,2048,2827,138.037109375
26,7,12,2310,4096,-1786,-43.603515625
26,7,13,6514,8192,-1678,-20.4833984375
26,7,14,53841,16384,37457,228.619384765625
26,7,15,26757,32768,-6011,-18.3441162109375
26,8,1,0,2,-2,-100.0
26,8,2,5,4,1,25.0
26,8,3,13,8,5,62.5
26,8,4,3,16,-13,-81.25
26,8,5,98,32,66,206.25
26,8,6,29,64,-35,-54.6875
26,8,7,25,128,-103,-80.46875
26,8,8,528,256,272,106.25
26,8,9,1960,512,1448,282.8125
26,8,10,1204,1024,180,17.578125
26,8,11,218,2048,-1830,-89.35546875
26,8,12,6285,4096,2189,53.4423828125
26,8,13,1805,8192,-6387,-77.96630859375
26,8,14,968,16384,-15416,-94.091796875
26,8,15,23897,32768,-8871,-27.0721435546875
26,9,1,0,2,-2,-100.0
26,9,2,3,4,-1,-25.0
26,9,3,20,8,12,150.0
26,9,4,3,16,-13,-81.25
26,9,5,48,32,16,50.0
26,9,6,14,64,-50,-78.125
26,9,7,120,128,-8,-6.25
26,9,8,26,256,-230,-89.84375
26,9,9,377,512,-135,-26.3671875
26,9,10,101,1024,-923,-90.13671875
26,9,11,2218,2048,170,8.30078125
26,9,12,6309,4096,2213,54.0283203125
26,9,13,2820,8192,-5372,-65.576171875
26,9,14,9737,16384,-6647,-40.570068359375
26,9,15,9840,32768,-22928,-69.970703125
26,10,1,0,2,-2,-100.0
26,10,2,4,4,0,0.0
26,10,3,2,8,-6,-75.0
26,10,4,24,16,8,50.0
26,10,5,48,32,16,50.0
26,10,6,119,64,55,85.9375
26,10,7,77,128,-51,-39.84375
26,10,8,37,256,-219,-85.546875
26,10,9,550,512,38,7.421875
26,10,10,839,1024,-185,-18.06640625
26,10,11,614,2048,-1434,-70.01953125
26,10,12,3386,4096,-710,-17.333984375
26,10,13,1735,8192,-6457,-78.82080078125
26,10,14,9516,16384,-6868,-41.9189453125
26,10,15,68954,32768,36186,110.430908203125
26,11,1,0,2,-2,-100.0
26,11,2,1,4,-3,-75.0
26,11,3,2,8,-6,-75.0
26,11,4,17,16,1,6.25
26,11,5,5,32,-27,-84.375
26,11,6,6,64,-58,-90.625
26,11,7,151,128,23,17.96875
26,11,8,13,256,-243,-94.921875
26,11,9,646,512,134,26.171875
26,11,10,2672,1024,1648,160.9375
26,11,11,7831,2048,5783,282.373046875
26,11,12,5690,4096,1594,38.916015625
26,11,13,7543,8192,-649,-7.92236328125
26,11,14,35210,16384,18826,114.90478515625
26,11,15,66170,32768,33402,101.934814453125
26,12,1,0,2,-2,-100.0
26,12,2,1,4,-3,-75.0
26,12,3,2,8,-6,-75.0
26,12,4,26,16,10,62.5
26,12,5,12,32,-20,-62.5
26,12,6,105,64,41,64.0625
26,12,7,150,128,22,17.1875
26,12,8,698,256,442,172.65625
26,12,9,57,512,-455,-88.8671875
26,12,10,599,1024,-425,-41.50390625
26,12,11,1397,2048,-651,-31.787109375
26,12,12,2499,4096,-1597,-38.9892578125
26,12,13,2430,8192,-5762,-70.3369140625
26,12,14,13055,16384,-3329,-20.318603515625
26,12,15,34106,32768,1338,4.083251953125
26,13,1,0,2,-2,-100.0
26,13,2,4,4,0,0.0
26,13,3,11,8,3,37.5
26,13,4,3,16,-13,-81.25
26,13,5,91,32,59,184.375
26,13,6,157,64,93,145.3125
26,13,7,96,128,-32,-25.0
26,13,8,291,256,35,13.671875
26,13,9,92,512,-420,-82.03125
26,13,10,3271,1024,2247,219.43359375
26,13,11,1608,2048,-440,-21.484375
26,13,12,1762,4096,-2334,-56.982421875
26,13,13,1359,8192,-6833,-83.41064453125
26,13,14,42758,16384,26374,160.97412109375
26,13,15,16221,32768,-16547,-50.4974365234375
26,14,1,0,2,-2,-100.0
26,14,2,1,4,-3,-75.0
26,14,3,4,8,-4,-50.0
26,14,4,19,16,3,18.75
26,14,5,27,32,-5,-15.625
26,14,6,8,64,-56,-87.5
26,14,7,64,128,-64,-50.0
26,14,8,16,256,-240,-93.75
26,14,9,320,512,-192,-37.5
26,14,10,9,1024,-1015,-99.12109375
26,14,11,5560,2048,3512,171.484375
26,14,12,3839,4096,-257,-6.2744140625
26,14,13,331,8192,-7861,-95.95947265625
26,14,14,12878,16384,-3506,-21.39892578125
26,14,15,17321,32768,-15447,-47.1405029296875
26,15,1,0,2,-2,-100.0
26,15,2,1,4,-3,-75.0
26,15,3,6,8,-2,-25.0
26,15,4,3,16,-13,-81.25
26,15,5,44,32,12,37.5
26,15,6,122,64,58,90.625
26,15,7,91,128,-37,-28.90625
26,15,8,66,256,-190,-74.21875
26,15,9,111,512,-401,-78.3203125
26,15,10,799,1024,-225,-21.97265625
26,15,11,1912,2048,-136,-6.640625
26,15,12,3772,4096,-324,-7.91015625
26,15,13,7761,8192,-431,-5.26123046875
26,15,14,9617,16384,-6767,-41.302490234375
26,15,15,31718,32768,-1050,-3.204345703125
26,16,1,0,2,-2,-100.0
26,16,2,3,4,-1,-25.0
26,16,3,10,8,2,25.0
26,16,4,5,16,-11,-68.75
26,16,5,21,32,-11,-34.375
26,16,6,99,64,35,54.6875
26,16,7,255,128,127,99.21875
26,16,8,550,256,294,114.84375
26,16,9,89,512,-423,-82.6171875
26,16,10,178,1024,-846,-82.6171875
26,16,11,796,2048,-1252,-61.1328125
26,16,12,1391,4096,-2705,-66.0400390625
26,16,13,9239,8192,1047,12.78076171875
26,16,14,14080,16384,-2304,-14.0625
26,16,15,15963,32768,-16805,-51.2847900390625
26,17,1,0,2,-2,-100.0
26,17,2,1,4,-3,-75.0
26,17,3,8,8,0,0.0
26,17,4,37,16,21,131.25
26,17,5,14,32,-18,-56.25
26,17,6,67,64,3,4.6875
26,17,7,156,128,28,21.875
26,17,8,414,256,158,61.71875
26,17,9,960,512,448,87.5
26,17,10,82,1024,-942,-91.9921875
26,17,11,1780,2048,-268,-13.0859375
26,17,12,282,4096,-3814,-93.115234375
26,17,13,5081,8192,-3111,-37.97607421875
26,17,14,17616,16384,1232,7.51953125
26,17,15,4382,32768,-28386,-86.627197265625
26,18,1,0,2,-2,-100.0
26,18,2,2,4,-2,-50.0
26,18,3,14,8,6,75.0
26,18,4,10,16,-6,-37.5
26,18,5,47,32,15,46.875
26,18,6,29,64,-35,-54.6875
26,18,7,124,128,-4,-3.125
26,18,8,139,256,-117,-45.703125
26,18,9,269,512,-243,-47.4609375
26,18,10,139,1024,-885,-86.42578125
26,18,11,1155,2048,-893,-43.603515625
26,18,12,113,4096,-3983,-97.2412109375
26,18,13,146,8192,-8046,-98.2177734375
26,18,14,18161,16384,1777,10.845947265625
26,18,15,56697,32768,23929,73.0255126953125
26,19,1,0,2,-2,-100.0
26,19,2,2,4,-2,-50.0
26,19,3,9,8,1,12.5
26,19,4,33,16,17,106.25
26,19,5,11,32,-21,-65.625
26,19,6,18,64,-46,-71.875
26,19,7,79,128,-49,-38.28125
26,19,8,332,256,76,29.6875
26,19,9,228,512,-284,-55.46875
26,19,10,910,1024,-114,-11.1328125
26,19,11,3629,2048,1581,77.197265625
26,19,12,904,4096,-3192,-77.9296875
26,19,13,20565,8192,12373,151.03759765625
26,19,14,18033,16384,1649,10.064697265625
26,19,15,9203,32768,-23565,-71.9146728515625
26,20,1,0,2,-2,-100.0
26,20,2,2,4,-2,-50.0
26,20,3,2,8,-6,-75.0
26,20,4,7,16,-9,-56.25
26,20,5,63,32,31,96.875
26,20,6,35,64,-29,-45.3125
26,20,7,119,128,-9,-7.03125
26,20,8,192,256,-64,-25.0
26,20,9,69,512,-443,-86.5234375
26,20,10,229,1024,-795,-77.63671875
26,20,11,37,2048,-2011,-98.193359375
26,20,12,7745,4096,3649,89.0869140625
26,20,13,27643,8192,19451,237.43896484375
26,20,14,4309,16384,-12075,-73.699951171875
26,20,15,11975,32768,-20793,-63.4552001953125
26,21,1,0,2,-2,-100.0
26,21,2,2,4,-2,-50.0
26,21,3,2,8,-6,-75.0
26,21,4,4,16,-12,-75.0
26,21,5,35,32,3,9.375
26,21,6,14,64,-50,-78.125
26,21,7,103,128,-25,-19.53125
26,21,8,222,256,-34,-13.28125
26,21,9,199,512,-313,-61.1328125
26,21,10,459,1024,-565,-55.17578125
26,21,11,594,2048,-1454,-70.99609375
26,21,12,1606,4096,-2490,-60.791015625
26,21,13,3439,8192,-4753,-58.02001953125
26,21,14,10945,16384,-5439,-33.197021484375
26,21,15,25580,32768,-7188,-21.93603515625
26,22,1,0,2,-2,-100.0
26,22,2,1,4,-3,-75.0
26,22,3,6,8,-2,-25.0
26,22,4,8,16,-8,-50.0
26,22,5,88,32,56,175.0
26,22,6,17,64,-47,-73.4375
26,22,7,139,128,11,8.59375
26,22,8,354,256,98,38.28125
26,22,9,1933,512,1421,277.5390625
26,22,10,316,1024,-708,-69.140625
26,22,11,2302,2048,254,12.40234375
26,22,12,3151,4096,-945,-23.0712890625
26,22,13,10358,8192,2166,26.4404296875
26,22,14,19156,16384,2772,16.9189453125
26,22,15,24410,32768,-8358,-25.506591796875
26,23,1,0,2,-2,-100.0
26,23,2,3,4,-1,-25.0
26,23,3,8,8,0,0.0
26,23,4,3,16,-13,-81.25
26,23,5,13,32,-19,-59.375
26,23,6,27,64,-37,-57.8125
26,23,7,84,128,-44,-34.375
26,23,8,710,256,454,177.34375
26,23,9,87,512,-425,-83.0078125
26,23,10,1117,1024,93,9.08203125
26,23,11,2183,2048,135,6.591796875
26,23,12,1361,4096,-2735,-66.7724609375
26,23,13,560,8192,-7632,-93.1640625
26,23,14,2054,16384,-14330,-87.46337890625
26,23,15,7228,32768,-25540,-77.94189453125
26,24,1,0,2,-2,-100.0
26,24,2,1,4,-3,-75.0
26,24,3,3,8,-5,-62.5
26,24,4,11,16,-5,-31.25
26,24,5,16,32,-16,-50.0
26,24,6,24,64,-40,-62.5
26,24,7,29,128,-99,-77.34375
26,24,8,46,256,-210,-82.03125
26,24,9,156,512,-356,-69.53125
26,24,10,202,1024,-822,-80.2734375
26,24,11,1031,2048,-1017,-49.658203125
26,24,12,173,4096,-3923,-95.7763671875
26,24,13,818,8192,-7374,-90.0146484375
26,24,14,2936,16384,-13448,-82.080078125
26,24,15,48927,32768,16159,49.3133544921875
26,25,1,0,2,-2,-100.0
26,25,2,1,4,-3,-75.0
26,25,3,3,8,-5,-62.5
26,25,4,29,16,13,81.25
26,25,5,13,32,-19,-59.375
26,25,6,5,64,-59,-92.1875
26,25,7,383,128,255,199.21875
26,25,8,7,256,-249,-97.265625
26,25,9,746,512,234,45.703125
26,25,10,450,1024,-574,-56.0546875
26,25,11,481,2048,-1567,-76.513671875
26,25,12,881,4096,-3215,-78.4912109375
26,25,13,14506,8192,6314,77.0751953125
26,25,14,437,16384,-15947,-97.332763671875
26,25,15,69029,32768,36261,110.6597900390625
26,26,1,0,2,-2,-100.0
26,26,2,2,4,-2,-50.0
26,26,3,9,8,1,12.5
26,26,4,4,16,-12,-75.0
26,26,5,16,32,-16,-50.0
26,26,6,56,64,-8,-12.5
26,26,7,157,128,29,22.65625
26,26,8,200,256,-56,-21.875
26,26,9,23,512,-489,-95.5078125
26,26,10,565,1024,-459,-44.82421875
26,26,11,162,2048,-1886,-92.08984375
26,26,12,6130,4096,2034,49.658203125
26,26,13,971,8192,-7221,-88.14697265625
26,26,14,943,16384,-15441,-94.244384765625
26,26,15,21315,32768,-11453,-34.9517822265625
27,1,1,0,2,-2,-100.0
27,1,2,3,4,-1,-25.0
27,1,3,2,8,-6,-75.0
27,1,4,23,16,7,43.75
27,1,5,58,32,26,81.25
27,1,6,47,64,-17,-26.5625
27,1,7,6,128,-122,-95.3125
27,1,8,176,256,-80,-31.25
27,1,9,297,512,-215,-41.9921875
27,1,10,286,1024,-738,-72.0703125
27,1,11,2044,2048,-4,-0.1953125
27,1,12,2825,4096,-1271,-31.0302734375
27,1,13,256,8192,-7936,-96.875
27,1,14,23477,16384,7093,43.292236328125
27,1,15,30598,32768,-2170,-6.622314453125
27,2,1,0,2,-2,-100.0
27,2,2,3,4,-1,-25.0
27,2,3,16,8,8,100.0
27,2,4,7,16,-9,-56.25
27,2,5,91,32,59,184.375
27,2,6,150,64,86,134.375
27,2,7,45,128,-83,-64.84375
27,2,8,410,256,154,60.15625
27,2,9,236,512,-276,-53.90625
27,2,10,1214,1024,190,18.5546875
27,2,11,2356,2048,308,15.0390625
27,2,12,5428,4096,1332,32.51953125
27,2,13,5912,8192,-2280,-27.83203125
27,2,14,1192,16384,-15192,-92.724609375
27,2,15,14704,32768,-18064,-55.126953125
27,3,1,0,2,-2,-100.0
27,3,2,3,4,-1,-25.0
27,3,3,2,8,-6,-75.0
27,3,4,17,16,1,6.25
27,3,5,32,32,0,0.0
27,3,6,11,64,-53,-82.8125
27,3,7,340,128,212,165.625
27,3,8,647,256,391,152.734375
27,3,9,139,512,-373,-72.8515625
27,3,10,45,1024,-979,-95.60546875
27,3,11,3396,2048,1348,65.8203125
27,3,12,97,4096,-3999,-97.6318359375
27,3,13,487,8192,-7705,-94.05517578125
27,3,14,796,16384,-15588,-95.1416015625
27,3,15,1827,32768,-30941,-94.4244384765625
27,4,1,0,2,-2,-100.0
27,4,2,3,4,-1,-25.0
27,4,3,3,8,-5,-62.5
27,4,4,6,16,-10,-62.5
27,4,5,32,32,0,0.0
27,4,6,53,64,-11,-17.1875
27,4,7,154,128,26,20.3125
27,4,8,48,256,-208,-81.25
27,4,9,153,512,-359,-70.1171875
27,4,10,1491,1024,467,45.60546875
27,4,11,3318,2048,1270,62.01171875
27,4,12,9016,4096,4920,120.1171875
27,4,13,17504,8192,9312,113.671875
27,4,14,1075,16384,-15309,-93.438720703125
27,4,15,46855,32768,14087,42.9901123046875
27,5,1,0,2,-2,-100.0
27,5,2,4,4,0,0.0
27,5,3,7,8,-1,-12.5
27,5,4,15,16,-1,-6.25
27,5,5,26,32,-6,-18.75
27,5,6,76,64,12,18.75
27,5,7,143,128,15,11.71875
27,5,8,379,256,123,48.046875
27,5,9,78,512,-434,-84.765625
27,5,10,355,1024,-669,-65.33203125
27,5,11,1169,2048,-879,-42.919921875
27,5,12,684,4096,-3412,-83.30078125
27,5,13,2928,8192,-5264,-64.2578125
27,5,14,3224,16384,-13160,-80.322265625
27,5,15,30672,32768,-2096,-6.396484375
27,6,1,0,2,-2,-100.0
27,6,2,2,4,-2,-50.0
27,6,3,17,8,9,112.5
27,6,4,13,16,-3,-18.75
27,6,5,14,32,-18,-56.25
27,6,6,65,64,1,1.5625
27,6,7,104,128,-24,-18.75
27,6,8,138,256,-118,-46.09375
27,6,9,741,512,229,44.7265625
27,6,10,798,1024,-226,-22.0703125
27,6,11,483,2048,-1565,-76.416015625
27,6,12,5827,4096,1731,42.2607421875
27,6,13,2375,8192,-5817,-71.00830078125
27,6,14,8720,16384,-7664,-46.77734375
27,6,15,26718,32768,-6050,-18.463134765625
27,7,1,0,2,-2,-100.0
27,7,2,2,4,-2,-50.0
27,7,3,2,8,-6,-75.0
27,7,4,9,16,-7,-43.75
27,7,5,21,32,-11,-34.375
27,7,6,14,64,-50,-78.125
27,7,7,78,128,-50,-39.0625
27,7,8,224,256,-32,-12.5
27,7,9,211,512,-301,-58.7890625
27,7,10,9,1024,-1015,-99.12109375
27,7,11,13429,2048,11381,555.712890625
27,7,12,524,4096,-3572,-87.20703125
27,7,13,8550,8192,358,4.3701171875
27,7,14,44061,16384,27677,168.927001953125
27,7,15,4073,32768,-28695,-87.5701904296875
27,8,1,0,2,-2,-100.0
27,8,2,2,4,-2,-50.0
27,8,3,12,8,4,50.0
27,8,4,17,16,1,6.25
27,8,5,4,32,-28,-87.5
27,8,6,17,64,-47,-73.4375
27,8,7,29,128,-99,-77.34375
27,8,8,65,256,-191,-74.609375
27,8,9,273,512,-239,-46.6796875
27,8,10,1362,1024,338,33.0078125
27,8,11,724,2048,-1324,-64.6484375
27,8,12,1277,4096,-2819,-68.8232421875
27,8,13,2657,8192,-5535,-67.56591796875
27,8,14,7882,16384,-8502,-51.89208984375
27,8,15,16080,32768,-16688,-50.927734375
27,9,1,0,2,-2,-100.0
27,9,2,1,4,-3,-75.0
27,9,3,6,8,-2,-25.0
27,9,4,30,16,14,87.5
27,9,5,37,32,5,15.625
27,9,6,66,64,2,3.125
27,9,7,121,128,-7,-5.46875
27,9,8,279,256,23,8.984375
27,9,9,409,512,-103,-20.1171875
27,9,10,2913,1024,1889,184.47265625
27,9,11,3013,2048,965,47.119140625
27,9,12,247,4096,-3849,-93.9697265625
27,9,13,2186,8192,-6006,-73.3154296875
27,9,14,41550,16384,25166,153.60107421875
27,9,15,36728,32768,3960,12.0849609375
27,10,1,0,2,-2,-100.0
27,10,2,1,4,-3,-75.0
27,10,3,10,8,2,25.0
27,10,4,13,16,-3,-18.75
27,10,5,5,32,-27,-84.375
27,10,6,111,64,47,73.4375
27,10,7,87,128,-41,-32.03125
27,10,8,367,256,111,43.359375
27,10,9,646,512,134,26.171875
27,10,10,295,1024,-729,-71.19140625
27,10,11,7398,2048,5350,261.23046875
27,10,12,1525,4096,-2571,-62.7685546875
27,10,13,6432,8192,-1760,-21.484375
27,10,14,10090,16384,-6294,-38.41552734375
27,10,15,13156,32768,-19612,-59.85107421875
27,11,1,0,2,-2,-100.0
27,11,2,2,4,-2,-50.0
27,11,3,9,8,1,12.5
27,11,4,5,16,-11,-68.75
27,11,5,10,32,-22,-68.75
27,11,6,25,64,-39,-60.9375
27,11,7,100,128,-28,-21.875
27,11,8,301,256,45,17.578125
27,11,9,491,512,-21,-4.1015625
27,11,10,1775,1024,751,73.33984375
27,11,11,1271,2048,-777,-37.939453125
27,11,12,2592,4096,-1504,-36.71875
27,11,13,9736,8192,1544,18.84765625
27,11,14,20613,16384,4229,25.811767578125
27,11,15,736,32768,-32032,-97.75390625
27,12,1,0,2,-2,-100.0
27,12,2,2,4,-2,-50.0
27,12,3,7,8,-1,-12.5
27,12,4,3,16,-13,-81.25
27,12,5,10,32,-22,-68.75
27,12,6,55,64,-9,-14.0625
27,12,7,87,128,-41,-32.03125
27,12,8,21,256,-235,-91.796875
27,12,9,224,512,-288,-56.25
27,12,10,899,1024,-125,-12.20703125
27,12,11,1889,2048,-159,-7.763671875
27,12,12,328,4096,-3768,-91.9921875
27,12,13,6477,8192,-1715,-20.93505859375
27,12,14,375,16384,-16009,-97.711181640625
27,12,15,42228,32768,9460,28.86962890625
27,13,1,0,2,-2,-100.0
27,13,2,2,4,-2,-50.0
27,13,3,4,8,-4,-50.0
27,13,4,6,16,-10,-62.5
27,13,5,53,32,21,65.625
27,13,6,85,64,21,32.8125
27,13,7,123,128,-5,-3.90625
27,13,8,460,256,204,79.6875
27,13,9,511,512,-1,-0.1953125
27,13,10,267,1024,-757,-73.92578125
27,13,11,808,2048,-1240,-60.546875
27,13,12,654,4096,-3442,-84.033203125
27,13,13,13938,8192,5746,70.1416015625
27,13,14,16876,16384,492,3.0029296875
27,13,15,763,32768,-32005,-97.6715087890625
27,14,1,0,2,-2,-100.0
27,14,2,3,4,-1,-25.0
27,14,3,13,8,5,62.5
27,14,4,16,16,0,0.0
27,14,5,17,32,-15,-46.875
27,14,6,151,64,87,135.9375
27,14,7,30,128,-98,-76.5625
27,14,8,313,256,57,22.265625
27,14,9,1116,512,604,117.96875
27,14,10,1324,1024,300,29.296875
27,14,11,859,2048,-1189,-58.056640625
27,14,12,2037,4096,-2059,-50.2685546875
27,14,13,3568,8192,-4624,-56.4453125
27,14,14,9411,16384,-6973,-42.559814453125
27,14,15,26392,32768,-6376,-19.4580078125
27,15,1,0,2,-2,-100.0
27,15,2,1,4,-3,-75.0
27,15,3,3,8,-5,-62.5
27,15,4,3,16,-13,-81.25
27,15,5,65,32,33,103.125
27,15,6,34,64,-30,-46.875
27,15,7,87,128,-41,-32.03125
27,15,8,520,256,264,103.125
27,15,9,30,512,-482,-94.140625
27,15,10,28,1024,-996,-97.265625
27,15,11,1522,2048,-526,-25.68359375
27,15,12,1161,4096,-2935,-71.6552734375
27,15,13,17634,8192,9442,115.2587890625
27,15,14,930,16384,-15454,-94.32373046875
27,15,15,28848,32768,-3920,-11.962890625
27,16,1,0,2,-2,-100.0
27,16,2,1,4,-3,-75.0
27,16,3,8,8,0,0.0
27,16,4,21,16,5,31.25
27,16,5,17,32,-15,-46.875
27,16,6,187,64,123,192.1875
27,16,7,198,128,70,54.6875
27,16,8,148,256,-108,-42.1875
27,16,9,484,512,-28,-5.46875
27,16,10,808,1024,-216,-21.09375
27,16,11,2971,2048,923,45.068359375
27,16,12,853,4096,-3243,-79.1748046875
27,16,13,6284,8192,-1908,-23.291015625
27,16,14,10840,16384,-5544,-33.837890625
27,16,15,11313,32768,-21455,-65.4754638671875
27,17,1,0,2,-2,-100.0
27,17,2,4,4,0,0.0
27,17,3,12,8,4,50.0
27,17,4,14,16,-2,-12.5
27,17,5,29,32,-3,-9.375
27,17,6,7,64,-57,-89.0625
27,17,7,61,128,-67,-52.34375
27,17,8,45,256,-211,-82.421875
27,17,9,76,512,-436,-85.15625
27,17,10,2459,1024,1435,140.13671875
27,17,11,3223,2048,1175,57.373046875
27,17,12,12315,4096,8219,200.6591796875
27,17,13,15027,8192,6835,83.43505859375
27,17,14,22377,16384,5993,36.578369140625
27,17,15,17615,32768,-15153,-46.2432861328125
27,18,1,0,2,-2,-100.0
27,18,2,2,4,-2,-50.0
27,18,3,2,8,-6,-75.0
27,18,4,13,16,-3,-18.75
27,18,5,35,32,3,9.375
27,18,6,14,64,-50,-78.125
27,18,7,57,128,-71,-55.46875
27,18,8,339,256,83,32.421875
27,18,9,76,512,-436,-85.15625
27,18,10,654,1024,-370,-36.1328125
27,18,11,807,2048,-1241,-60.595703125
27,18,12,1944,4096,-2152,-52.5390625
27,18,13,10803,8192,2611,31.87255859375
27,18,14,22286,16384,5902,36.02294921875
27,18,15,39102,32768,6334,19.329833984375
27,19,1,0,2,-2,-100.0
27,19,2,1,4,-3,-75.0
27,19,3,3,8,-5,-62.5
27,19,4,12,16,-4,-25.0
27,19,5,33,32,1,3.125
27,19,6,31,64,-33,-51.5625
27,19,7,72,128,-56,-43.75
27,19,8,316,256,60,23.4375
27,19,9,276,512,-236,-46.09375
27,19,10,4441,1024,3417,333.69140625
27,19,11,4808,2048,2760,134.765625
27,19,12,2447,4096,-1649,-40.2587890625
27,19,13,788,8192,-7404,-90.380859375
27,19,14,6740,16384,-9644,-58.8623046875
27,19,15,52975,32768,20207,61.6668701171875
27,20,1,0,2,-2,-100.0
27,20,2,2,4,-2,-50.0
27,20,3,5,8,-3,-37.5
27,20,4,4,16,-12,-75.0
27,20,5,19,32,-13,-40.625
27,20,6,75,64,11,17.1875
27,20,7,39,128,-89,-69.53125
27,20,8,106,256,-150,-58.59375
27,20,9,267,512,-245,-47.8515625
27,20,10,1518,1024,494,48.2421875
27,20,11,1461,2048,-587,-28.662109375
27,20,12,8460,4096,4364,106.54296875
27,20,13,589,8192,-7603,-92.81005859375
27,20,14,3414,16384,-12970,-79.16259765625
27,20,15,1311,32768,-31457,-95.9991455078125
27,21,1,0,2,-2,-100.0
27,21,2,1,4,-3,-75.0
27,21,3,3,8,-5,-62.5
27,21,4,24,16,8,50.0
27,21,5,57,32,25,78.125
27,21,6,84,64,20,31.25
27,21,7,27,128,-101,-78.90625
27,21,8,64,256,-192,-75.0
27,21,9,1036,512,524,102.34375
27,21,10,396,1024,-628,-61.328125
27,21,11,5722,2048,3674,179.39453125
27,21,12,856,4096,-3240,-79.1015625
27,21,13,12370,8192,4178,51.0009765625
27,21,14,6996,16384,-9388,-57.2998046875
27,21,15,1699,32768,-31069,-94.8150634765625
27,22,1,0,2,-2,-100.0
27,22,2,2,4,-2,-50.0
27,22,3,8,8,0,0.0
27,22,4,3,16,-13,-81.25
27,22,5,19,32,-13,-40.625
27,22,6,12,64,-52,-81.25
27,22,7,195,128,67,52.34375
27,22,8,110,256,-146,-57.03125
27,22,9,1710,512,1198,233.984375
27,22,10,1112,1024,88,8.59375
27,22,11,163,2048,-1885,-92.041015625
27,22,12,5818,4096,1722,42.041015625
27,22,13,7519,8192,-673,-8.21533203125
27,22,14,3885,16384,-12499,-76.287841796875
27,22,15,115654,32768,82886,252.947998046875
27,23,1,0,2,-2,-100.0
27,23,2,1,4,-3,-75.0
27,23,3,10,8,2,25.0
27,23,4,5,16,-11,-68.75
27,23,5,23,32,-9,-28.125
27,23,6,68,64,4,6.25
27,23,7,49,128,-79,-61.71875
27,23,8,114,256,-142,-55.46875
27,23,9,818,512,306,59.765625
27,23,10,422,1024,-602,-58.7890625
27,23,11,1786,2048,-262,-12.79296875
27,23,12,1274,4096,-2822,-68.896484375
27,23,13,4696,8192,-3496,-42.67578125
27,23,14,52595,16384,36211,221.014404296875
27,23,15,22877,32768,-9891,-30.1849365234375
27,24,1,0,2,-2,-100.0
27,24,2,5,4,1,25.0
27,24,3,4,8,-4,-50.0
27,24,4,20,16,4,25.0
27,24,5,38,32,6,18.75
27,24,6,33,64,-31,-48.4375
27,24,7,66,128,-62,-48.4375
27,24,8,96,256,-160,-62.5
27,24,9,473,512,-39,-7.6171875
27,24,10,2472,1024,1448,141.40625
27,24,11,5728,2048,3680,179.6875
27,24,12,1906,4096,-2190,-53.466796875
27,24,13,8628,8192,436,5.322265625
27,24,14,10425,16384,-5959,-36.370849609375
27,24,15,62201,32768,29433,89.8223876953125
27,25,1,0,2,-2,-100.0
27,25,2,1,4,-3,-75.0
27,25,3,9,8,1,12.5
27,25,4,4,16,-12,-75.0
27,25,5,28,32,-4,-12.5
27,25,6,50,64,-14,-21.875
27,25,7,442,128,314,245.3125
27,25,8,379,256,123,48.046875
27,25,9,672,512,160,31.25
27,25,10,369,1024,-655,-63.96484375
27,25,11,195,2048,-1853,-90.478515625
27,25,12,403,4096,-3693,-90.1611328125
27,25,13,1880,8192,-6312,-77.05078125
27,25,14,15791,16384,-593,-3.619384765625
27,25,15,25900,32768,-6868,-20.95947265625
27,26,1,0,2,-2,-100.0
27,26,2,1,4,-3,-75.0
27,26,3,9,8,1,12.5
27,26,4,22,16,6,37.5
27,26,5,12,32,-20,-62.5
27,26,6,109,64,45,70.3125
27,26,7,87,128,-41,-32.03125
27,26,8,283,256,27,10.546875
27,26,9,290,512,-222,-43.359375
27,26,10,697,1024,-327,-31.93359375
27,26,11,157,2048,-1891,-92.333984375
27,26,12,3907,4096,-189,-4.6142578125
27,26,13,11723,8192,3531,43.10302734375
27,26,14,14526,16384,-1858,-11.34033203125
27,26,15,3972,32768,-28796,-87.87841796875
27,27,1,0,2,-2,-100.0
27,27,2,1,4,-3,-75.0
27,27,3,10,8,2,25.0
27,27,4,13,16,-3,-18.75
27,27,5,15,32,-17,-53.125
27,27,6,111,64,47,73.4375
27,27,7,64,128,-64,-50.0
27,27,8,122,256,-134,-52.34375
27,27,9,241,512,-271,-52.9296875
27,27,10,139,1024,-885,-86.42578125
27,27,11,184,2048,-1864,-91.015625
27,27,12,13710,4096,9614,234.716796875
27,27,13,473,8192,-7719,-94.22607421875
27,27,14,44877,16384,28493,173.907470703125
27,27,15,104648,32768,71880,219.3603515625
28,1,1,0,2,-2,-100.0
28,1,2,2,4,-2,-50.0
28,1,3,5,8,-3,-37.5
28,1,4,12,16,-4,-25.0
28,1,5,6,32,-26,-81.25
28,1,6,86,64,22,34.375
28,1,7,231,128,103,80.46875
28,1,8,87,256,-169,-66.015625
28,1,9,93,512,-419,-81.8359375
28,1,10,1074,1024,50,4.8828125
28,1,11,530,2048,-1518,-74.12109375
28,1,12,205,4096,-3891,-94.9951171875
28,1,13,9751,8192,1559,19.03076171875
28,1,14,32037,16384,15653,95.538330078125
28,1,15,8128,32768,-24640,-75.1953125
28,2,1,0,2,-2,-100.0
28,2,2,2,4,-2,-50.0
28,2,3,4,8,-4,-50.0
28,2,4,9,16,-7,-43.75
28,2,5,4,32,-28,-87.5
28,2,6,5,64,-59,-92.1875
28,2,7,65,128,-63,-49.21875
28,2,8,14,256,-242,-94.53125
28,2,9,831,512,319,62.3046875
28,2,10,890,1024,-134,-13.0859375
28,2,11,1722,2048,-326,-15.91796875
28,2,12,138,4096,-3958,-96.630859375
28,2,13,4970,8192,-3222,-39.3310546875
28,2,14,25106,16384,8722,53.23486328125
28,2,15,1236,32768,-31532,-96.22802734375
28,3,1,0,2,-2,-100.0
28,3,2,2,4,-2,-50.0
28,3,3,2,8,-6,-75.0
28,3,4,18,16,2,12.5
28,3,5,17,32,-15,-46.875
28,3,6,112,64,48,75.0
28,3,7,47,128,-81,-63.28125
28,3,8,29,256,-227,-88.671875
28,3,9,1039,512,527,102.9296875
28,3,10,376,1024,-648,-63.28125
28,3,11,1450,2048,-598,-29.19921875
28,3,12,11483,4096,7387,180.3466796875
28,3,13,157,8192,-8035,-98.08349609375
28,3,14,9846,16384,-6538,-39.90478515625
28,3,15,20296,32768,-12472,-38.0615234375
28,4,1,0,2,-2,-100.0
28,4,2,4,4,0,0.0
28,4,3,8,8,0,0.0
28,4,4,7,16,-9,-56.25
28,4,5,25,32,-7,-21.875
28,4,6,126,64,62,96.875
28,4,7,150,128,22,17.1875
28,4,8,93,256,-163,-63.671875
28,4,9,132,512,-380,-74.21875
28,4,10,81,1024,-943,-92.08984375
28,4,11,2419,2048,371,18.115234375
28,4,12,3589,4096,-507,-12.3779296875
28,4,13,11883,8192,3691,45.05615234375
28,4,14,23688,16384,7304,44.580078125
28,4,15,80020,32768,47252,144.20166015625
28,5,1,0,2,-2,-100.0
28,5,2,4,4,0,0.0
28,5,3,7,8,-1,-12.5
28,5,4,12,16,-4,-25.0
28,5,5,49,32,17,53.125
28,5,6,5,64,-59,-92.1875
28,5,7,268,128,140,109.375
28,5,8,158,256,-98,-38.28125
28,5,9,1169,512,657,128.3203125
28,5,10,394,1024,-630,-61.5234375
28,5,11,26,2048,-2022,-98.73046875
28,5,12,75,4096,-4021,-98.1689453125
28,5,13,15724,8192,7532,91.943359375
28,5,14,7270,16384,-9114,-55.62744140625
28,5,15,22923,32768,-9845,-30.0445556640625
28,6,1,0,2,-2,-100.0
28,6,2,1,4,-3,-75.0
28,6,3,14,8,6,75.0
28,6,4,3,16,-13,-81.25
28,6,5,9,32,-23,-71.875
28,6,6,14,64,-50,-78.125
28,6,7,87,128,-41,-32.03125
28,6,8,29,256,-227,-88.671875
28,6,9,502,512,-10,-1.953125
28,6,10,541,1024,-483,-47.16796875
28,6,11,3609,2048,1561,76.220703125
28,6,12,13826,4096,9730,237.548828125
28,6,13,3738,8192,-4454,-54.3701171875
28,6,14,2109,16384,-14275,-87.127685546875
28,6,15,131962,32768,99194,302.716064453125
28,7,1,0,2,-2,-100.0
28,7,2,3,4,-1,-25.0
28,7,3,4,8,-4,-50.0
28,7,4,32,16,16,100.0
28,7,5,158,32,126,393.75
28,7,6,48,64,-16,-25.0
28,7,7,66,128,-62,-48.4375
28,7,8,32,256,-224,-87.5
28,7,9,383,512,-129,-25.1953125
28,7,10,92,1024,-932,-91.015625
28,7,11,175,2048,-1873,-91.455078125
28,7,12,8046,4096,3950,96.435546875
28,7,13,5255,8192,-2937,-35.85205078125
28,7,14,1940,16384,-14444,-88.1591796875
28,7,15,25780,32768,-6988,-21.32568359375
28,8,1,0,2,-2,-100.0
28,8,2,1,4,-3,-75.0
28,8,3,16,8,8,100.0
28,8,4,5,16,-11,-68.75
28,8,5,71,32,39,121.875
28,8,6,63,64,-1,-1.5625
28,8,7,169,128,41,32.03125
28,8,8,139,256,-117,-45.703125
28,8,9,251,512,-261,-50.9765625
28,8,10,177,1024,-847,-82.71484375
28,8,11,6820,2048,4772,233.0078125
28,8,12,2492,4096,-1604,-39.16015625
28,8,13,436,8192,-7756,-94.677734375
28,8,14,4457,16384,-11927,-72.796630859375
28,8,15,14908,32768,-17860,-54.50439453125
28,9,1,0,2,-2,-100.0
28,9,2,2,4,-2,-50.0
28,9,3,13,8,5,62.5
28,9,4,3,16,-13,-81.25
28,9,5,11,32,-21,-65.625
28,9,6,25,64,-39,-60.9375
28,9,7,126,128,-2,-1.5625
28,9,8,103,256,-153,-59.765625
28,9,9,494,512,-18,-3.515625
28,9,10,145,1024,-879,-85.83984375
28,9,11,2480,2048,432,21.09375
28,9,12,3085,4096,-1011,-24.6826171875
28,9,13,1462,8192,-6730,-82.1533203125
28,9,14,760,16384,-15624,-95.361328125
28,9,15,55192,32768,22424,68.4326171875
28,10,1,0,2,-2,-100.0
28,10,2,1,4,-3,-75.0
28,10,3,2,8,-6,-75.0
28,10,4,8,16,-8,-50.0
28,10,5,6,32,-26,-81.25
28,10,6,16,64,-48,-75.0
28,10,7,38,128,-90,-70.3125
28,10,8,38,256,-218,-85.15625
28,10,9,87,512,-425,-83.0078125
28,10,10,3063,1024,2039,199.12109375
28,10,11,1198,2048,-850,-41.50390625
28,10,12,2723,4096,-1373,-33.5205078125
28,10,13,8006,8192,-186,-2.2705078125
28,10,14,7104,16384,-9280,-56.640625
28,10,15,19343,32768,-13425,-40.9698486328125
28,11,1,0,2,-2,-100.0
28,11,2,3,4,-1,-25.0
28,11,3,9,8,1,12.5
28,11,4,16,16,0,0.0
28,11,5,10,32,-22,-68.75
28,11,6,11,64,-53,-82.8125
28,11,7,25,128,-103,-80.46875
28,11,8,315,256,59,23.046875
28,11,9,597,512,85,16.6015625
28,11,10,854,1024,-170,-16.6015625
28,11,11,1612,2048,-436,-21.2890625
28,11,12,39,4096,-4057,-99.0478515625
28,11,13,7620,8192,-572,-6.982421875
28,11,14,19930,16384,3546,21.64306640625
28,11,15,95265,32768,62497,190.7257080078125
28,12,1,0,2,-2,-100.0
28,12,2,1,4,-3,-75.0
28,12,3,2,8,-6,-75.0
28,12,4,8,16,-8,-50.0
28,12,5,19,32,-13,-40.625
28,12,6,85,64,21,32.8125
28,12,7,77,128,-51,-39.84375
28,12,8,191,256,-65,-25.390625
28,12,9,707,512,195,38.0859375
28,12,10,486,1024,-538,-52.5390625
28,12,11,779,2048,-1269,-61.962890625
28,12,12,7077,4096,2981,72.7783203125
28,12,13,3321,8192,-4871,-59.46044921875
28,12,14,13704,16384,-2680,-16.357421875
28,12,15,1284,32768,-31484,-96.08154296875
28,13,1,0,2,-2,-100.0
28,13,2,2,4,-2,-50.0
28,13,3,4,8,-4,-50.0
28,13,4,29,16,13,81.25
28,13,5,12,32,-20,-62.5
28,13,6,15,64,-49,-76.5625
28,13,7,233,128,105,82.03125
28,13,8,560,256,304,118.75
28,13,9,832,512,320,62.5
28,13,10,299,1024,-725,-70.80078125
28,13,11,3819,2048,1771,86.474609375
28,13,12,112,4096,-3984,-97.265625
28,13,13,9883,8192,1691,20.64208984375
28,13,14,3061,16384,-13323,-81.317138671875
28,13,15,20297,32768,-12471,-38.0584716796875
28,14,1,0,2,-2,-100.0
28,14,2,1,4,-3,-75.0
28,14,3,5,8,-3,-37.5
28,14,4,3,16,-13,-81.25
28,14,5,31,32,-1,-3.125
28,14,6,23,64,-41,-64.0625
28,14,7,6,128,-122,-95.3125
28,14,8,103,256,-153,-59.765625
28,14,9,681,512,169,33.0078125
28,14,10,216,1024,-808,-78.90625
28,14,11,8790,2048,6742,329.19921875
28,14,12,1389,4096,-2707,-66.0888671875
28,14,13,10506,8192,2314,28.2470703125
28,14,14,3388,16384,-12996,-79.3212890625
28,14,15,12024,32768,-20744,-63.3056640625
28,15,1,0,2,-2,-100.0
28,15,2,2,4,-2,-50.0
28,15,3,9,8,1,12.5
28,15,4,15,16,-1,-6.25
28,15,5,44,32,12,37.5
28,15,6,47,64,-17,-26.5625
28,15,7,113,128,-15,-11.71875
28,15,8,219,256,-37,-14.453125
28,15,9,13,512,-499,-97.4609375
28,15,10,31,1024,-993,-96.97265625
28,15,11,3226,2048,1178,57.51953125
28,15,12,1124,4096,-2972,-72.55859375
28,15,13,18454,8192,10262,125.2685546875
28,15,14,4191,16384,-12193,-74.420166015625
28,15,15,53839,32768,21071,64.3035888671875
28,16,1,0,2,-2,-100.0
28,16,2,3,4,-1,-25.0
28,16,3,23,8,15,187.5
28,16,4,3,16,-13,-81.25
28,16,5,29,32,-3,-9.375
28,16,6,39,64,-25,-39.0625
28,16,7,20,128,-108,-84.375
28,16,8,138,256,-118,-46.09375
28,16,9,913,512,401,78.3203125
28,16,10,1848,1024,824,80.46875
28,16,11,2972,2048,924,45.1171875
28,16,12,5219,4096,1123,27.4169921875
28,16,13,3574,8192,-4618,-56.3720703125
28,16,14,7816,16384,-8568,-52.294921875
28,16,15,189,32768,-32579,-99.4232177734375
28,17,1,0,2,-2,-100.0
28,17,2,6,4,2,50.0
28,17,3,4,8,-4,-50.0
28,17,4,9,16,-7,-43.75
28,17,5,19,32,-13,-40.625
28,17,6,55,64,-9,-14.0625
28,17,7,182,128,54,42.1875
28,17,8,349,256,93,36.328125
28,17,9,464,512,-48,-9.375
28,17,10,2173,1024,1149,112.20703125
28,17,11,46,2048,-2002,-97.75390625
28,17,12,2123,4096,-1973,-48.1689453125
28,17,13,9857,8192,1665,20.32470703125
28,17,14,18466,16384,2082,12.70751953125
28,17,15,950,32768,-31818,-97.100830078125
28,18,1,0,2,-2,-100.0
28,18,2,1,4,-3,-75.0
28,18,3,5,8,-3,-37.5
28,18,4,3,16,-13,-81.25
28,18,5,56,32,24,75.0
28,18,6,21,64,-43,-67.1875
28,18,7,9,128,-119,-92.96875
28,18,8,35,256,-221,-86.328125
28,18,9,2717,512,2205,430.6640625
28,18,10,1480,1024,456,44.53125
28,18,11,5571,2048,3523,172.021484375
28,18,12,2368,4096,-1728,-42.1875
28,18,13,2957,8192,-5235,-63.90380859375
28,18,14,12711,16384,-3673,-22.418212890625
28,18,15,57328,32768,24560,74.951171875
28,19,1,0,2,-2,-100.0
28,19,2,2,4,-2,-50.0
28,19,3,8,8,0,0.0
28,19,4,3,16,-13,-81.25
28,19,5,34,32,2,6.25
28,19,6,15,64,-49,-76.5625
28,19,7,68,128,-60,-46.875
28,19,8,44,256,-212,-82.8125
28,19,9,321,512,-191,-37.3046875
28,19,10,224,1024,-800,-78.125
28,19,11,9991,2048,7943,387.841796875
28,19,12,679,4096,-3417,-83.4228515625
28,19,13,6036,8192,-2156,-26.318359375
28,19,14,16880,16384,496,3.02734375
28,19,15,38171,32768,5403,16.4886474609375
28,20,1,0,2,-2,-100.0
28,20,2,1,4,-3,-75.0
28,20,3,9,8,1,12.5
28,20,4,14,16,-2,-12.5
28,20,5,17,32,-15,-46.875
28,20,6,16,64,-48,-75.0
28,20,7,58,128,-70,-54.6875
28,20,8,331,256,75,29.296875
28,20,9,702,512,190,37.109375
28,20,10,382,1024,-642,-62.6953125
28,20,11,1851,2048,-197,-9.619140625
28,20,12,157,4096,-3939,-96.1669921875
28,20,13,15526,8192,7334,89.5263671875
28,20,14,17404,16384,1020,6.2255859375
28,20,15,70876,32768,38108,116.29638671875
28,21,1,0,2,-2,-100.0
28,21,2,2,4,-2,-50.0
28,21,3,2,8,-6,-75.0
28,21,4,6,16,-10,-62.5
28,21,5,29,32,-3,-9.375
28,21,6,105,64,41,64.0625
28,21,7,182,128,54,42.1875
28,21,8,30,256,-226,-88.28125
28,21,9,139,512,-373,-72.8515625
28,21,10,932,1024,-92,-8.984375
28,21,11,851,2048,-1197,-58.447265625
28,21,12,1796,4096,-2300,-56.15234375
28,21,13,6564,8192,-1628,-19.873046875
28,21,14,10891,16384,-5493,-33.526611328125
28,21,15,47762,32768,14994,45.758056640625
28,22,1,0,2,-2,-100.0
28,22,2,2,4,-2,-50.0
28,22,3,5,8,-3,-37.5
28,22,4,13,16,-3,-18.75
28,22,5,4,32,-28,-87.5
28,22,6,122,64,58,90.625
28,22,7,97,128,-31,-24.21875
28,22,8,444,256,188,73.4375
28,22,9,551,512,39,7.6171875
28,22,10,348,1024,-676,-66.015625
28,22,11,2753,2048,705,34.423828125
28,22,12,3875,4096,-221,-5.3955078125
28,22,13,586,8192,-7606,-92.8466796875
28,22,14,14357,16384,-2027,-12.371826171875
28,22,15,54819,32768,22051,67.2943115234375
28,23,1,0,2,-2,-100.0
28,23,2,1,4,-3,-75.0
28,23,3,7,8,-1,-12.5
28,23,4,66,16,50,312.5
28,23,5,59,32,27,84.375
28,23,6,46,64,-18,-28.125
28,23,7,61,128,-67,-52.34375
28,23,8,323,256,67,26.171875
28,23,9,523,512,11,2.1484375
28,23,10,832,1024,-192,-18.75
28,23,11,3605,2048,1557,76.025390625
28,23,12,2079,4096,-2017,-49.2431640625
28,23,13,1015,8192,-7177,-87.60986328125
28,23,14,2236,16384,-14148,-86.3525390625
28,23,15,955,32768,-31813,-97.0855712890625
28,24,1,0,2,-2,-100.0
28,24,2,1,4,-3,-75.0
28,24,3,10,8,2,25.0
28,24,4,5,16,-11,-68.75
28,24,5,132,32,100,312.5
28,24,6,10,64,-54,-84.375
28,24,7,36,128,-92,-71.875
28,24,8,73,256,-183,-71.484375
28,24,9,660,512,148,28.90625
28,24,10,2308,1024,1284,125.390625
28,24,11,714,2048,-1334,-65.13671875
28,24,12,466,4096,-3630,-88.623046875
28,24,13,5880,8192,-2312,-28.22265625
28,24,14,21212,16384,4828,29.4677734375
28,24,15,203,32768,-32565,-99.3804931640625
28,25,1,0,2,-2,-100.0
28,25,2,2,4,-2,-50.0
28,25,3,2,8,-6,-75.0
28,25,4,4,16,-12,-75.0
28,25,5,56,32,24,75.0
28,25,6,45,64,-19,-29.6875
28,25,7,36,128,-92,-71.875
28,25,8,140,256,-116,-45.3125
28,25,9,85,512,-427,-83.3984375
28,25,10,320,1024,-704,-68.75
28,25,11,5832,2048,3784,184.765625
28,25,12,2813,4096,-1283,-31.3232421875
28,25,13,4739,8192,-3453,-42.15087890625
28,25,14,9968,16384,-6416,-39.16015625
28,25,15,105,32768,-32663,-99.6795654296875
28,26,1,0,2,-2,-100.0
28,26,2,1,4,-3,-75.0
28,26,3,8,8,0,0.0
28,26,4,22,16,6,37.5
28,26,5,4,32,-28,-87.5
28,26,6,66,64,2,3.125
28,26,7,176,128,48,37.5
28,26,8,147,256,-109,-42.578125
28,26,9,257,512,-255,-49.8046875
28,26,10,160,1024,-864,-84.375
28,26,11,91,2048,-1957,-95.556640625
28,26,12,4349,4096,253,6.1767578125
28,26,13,7488,8192,-704,-8.59375
28,26,14,9187,16384,-7197,-43.927001953125
28,26,15,9370,32768,-23398,-71.405029296875
28,27,1,0,2,-2,-100.0
28,27,2,2,4,-2,-50.0
28,27,3,13,8,5,62.5
28,27,4,14,16,-2,-12.5
28,27,5,72,32,40,125.0
28,27,6,24,64,-40,-62.5
28,27,7,91,128,-37,-28.90625
28,27,8,213,256,-43,-16.796875
28,27,9,701,512,189,36.9140625
28,27,10,2064,1024,1040,101.5625
28,27,11,4154,2048,2106,102.83203125
28,27,12,5610,4096,1514,36.962890625
28,27,13,1116,8192,-7076,-86.376953125
28,27,14,70132,16384,53748,328.0517578125
28,27,15,16906,32768,-15862,-48.406982421875
28,28,1,0,2,-2,-100.0
28,28,2,2,4,-2,-50.0
28,28,3,3,8,-5,-62.5
28,28,4,3,16,-13,-81.25
28,28,5,4,32,-28,-87.5
28,28,6,14,64,-50,-78.125
28,28,7,109,128,-19,-14.84375
28,28,8,182,256,-74,-28.90625
28,28,9,36,512,-476,-92.96875
28,28,10,56,1024,-968,-94.53125
28,28,11,1175,2048,-873,-42.626953125
28,28,12,344,4096,-3752,-91.6015625
28,28,13,2032,8192,-6160,-75.1953125
28,28,14,7572,16384,-8812,-53.7841796875
28,28,15,16167,32768,-16601,-50.6622314453125
29,1,1,0,2,-2,-100.0
29,1,2,1,4,-3,-75.0
29,1,3,2,8,-6,-75.0
29,1,4,28,16,12,75.0
29,1,5,27,32,-5,-15.625
29,1,6,9,64,-55,-85.9375
29,1,7,68,128,-60,-46.875
29,1,8,106,256,-150,-58.59375
29,1,9,87,512,-425,-83.0078125
29,1,10,704,1024,-320,-31.25
29,1,11,374,2048,-1674,-81.73828125
29,1,12,4909,4096,813,19.8486328125
29,1,13,4317,8192,-3875,-47.30224609375
29,1,14,17962,16384,1578,9.63134765625
29,1,15,27867,32768,-4901,-14.9566650390625
29,2,1,0,2,-2,-100.0
29,2,2,2,4,-2,-50.0
29,2,3,8,8,0,0.0
29,2,4,46,16,30,187.5
29,2,5,31,32,-1,-3.125
29,2,6,84,64,20,31.25
29,2,7,145,128,17,13.28125
29,2,8,595,256,339,132.421875
29,2,9,161,512,-351,-68.5546875
29,2,10,523,1024,-501,-48.92578125
29,2,11,2978,2048,930,45.41015625
29,2,12,4780,4096,684,16.69921875
29,2,13,24025,8192,15833,193.27392578125
29,2,14,2955,16384,-13429,-81.964111328125
29,2,15,18046,32768,-14722,-44.927978515625
29,3,1,0,2,-2,-100.0
29,3,2,2,4,-2,-50.0
29,3,3,7,8,-1,-12.5
29,3,4,3,16,-13,-81.25
29,3,5,23,32,-9,-28.125
29,3,6,36,64,-28,-43.75
29,3,7,56,128,-72,-56.25
29,3,8,75,256,-181,-70.703125
29,3,9,52,512,-460,-89.84375
29,3,10,29,1024,-995,-97.16796875
29,3,11,1819,2048,-229,-11.181640625
29,3,12,103,4096,-3993,-97.4853515625
29,3,13,3828,8192,-4364,-53.271484375
29,3,14,35514,16384,19130,116.76025390625
29,3,15,45025,32768,12257,37.4053955078125
29,4,1,0,2,-2,-100.0
29,4,2,2,4,-2,-50.0
29,4,3,5,8,-3,-37.5
29,4,4,6,16,-10,-62.5
29,4,5,8,32,-24,-75.0
29,4,6,70,64,6,9.375
29,4,7,31,128,-97,-75.78125
29,4,8,143,256,-113,-44.140625
29,4,9,314,512,-198,-38.671875
29,4,10,883,1024,-141,-13.76953125
29,4,11,447,2048,-1601,-78.173828125
29,4,12,4543,4096,447,10.9130859375
29,4,13,707,8192,-7485,-91.36962890625
29,4,14,13100,16384,-3284,-20.0439453125
29,4,15,19961,32768,-12807,-39.0838623046875
29,5,1,0,2,-2,-100.0
29,5,2,3,4,-1,-25.0
29,5,3,2,8,-6,-75.0
29,5,4,35,16,19,118.75
29,5,5,4,32,-28,-87.5
29,5,6,14,64,-50,-78.125
29,5,7,65,128,-63,-49.21875
29,5,8,298,256,42,16.40625
29,5,9,68,512,-444,-86.71875
29,5,10,366,1024,-658,-64.2578125
29,5,11,523,2048,-1525,-74.462890625
29,5,12,1239,4096,-2857,-69.7509765625
29,5,13,10798,8192,2606,31.8115234375
29,5,14,10139,16384,-6245,-38.116455078125
29,5,15,10157,32768,-22611,-69.0032958984375
29,6,1,0,2,-2,-100.0
29,6,2,4,4,0,0.0
29,6,3,5,8,-3,-37.5
29,6,4,12,16,-4,-25.0
29,6,5,33,32,1,3.125
29,6,6,289,64,225,351.5625
29,6,7,69,128,-59,-46.09375
29,6,8,571,256,315,123.046875
29,6,9,369,512,-143,-27.9296875
29,6,10,1872,1024,848,82.8125
29,6,11,1781,2048,-267,-13.037109375
29,6,12,6903,4096,2807,68.5302734375
29,6,13,2604,8192,-5588,-68.212890625
29,6,14,12466,16384,-3918,-23.91357421875
29,6,15,12878,32768,-19890,-60.699462890625
29,7,1,0,2,-2,-100.0
29,7,2,2,4,-2,-50.0
29,7,3,3,8,-5,-62.5
29,7,4,6,16,-10,-62.5
29,7,5,16,32,-16,-50.0
29,7,6,13,64,-51,-79.6875
29,7,7,24,128,-104,-81.25
29,7,8,244,256,-12,-4.6875
29,7,9,93,512,-419,-81.8359375
29,7,10,1867,1024,843,82.32421875
29,7,11,151,2048,-1897,-92.626953125
29,7,12,708,4096,-3388,-82.71484375
29,7,13,3777,8192,-4415,-53.89404296875
29,7,14,1096,16384,-15288,-93.310546875
29,7,15,22862,32768,-9906,-30.230712890625
29,8,1,0,2,-2,-100.0
29,8,2,1,4,-3,-75.0
29,8,3,2,8,-6,-75.0
29,8,4,5,16,-11,-68.75
29,8,5,7,32,-25,-78.125
29,8,6,27,64,-37,-57.8125
29,8,7,70,128,-58,-45.3125
29,8,8,501,256,245,95.703125
29,8,9,279,512,-233,-45.5078125
29,8,10,548,1024,-476,-46.484375
29,8,11,1745,2048,-303,-14.794921875
29,8,12,1254,4096,-2842,-69.384765625
29,8,13,2494,8192,-5698,-69.5556640625
29,8,14,67027,16384,50643,309.100341796875
29,8,15,19164,32768,-13604,-41.51611328125
29,9,1,0,2,-2,-100.0
29,9,2,1,4,-3,-75.0
29,9,3,5,8,-3,-37.5
29,9,4,3,16,-13,-81.25
29,9,5,7,32,-25,-78.125
29,9,6,91,64,27,42.1875
29,9,7,108,128,-20,-15.625
29,9,8,313,256,57,22.265625
29,9,9,586,512,74,14.453125
29,9,10,1116,1024,92,8.984375
29,9,11,2923,2048,875,42.724609375
29,9,12,1943,4096,-2153,-52.5634765625
29,9,13,4235,8192,-3957,-48.30322265625
29,9,14,1218,16384,-15166,-92.56591796875
29,9,15,22064,32768,-10704,-32.666015625
29,10,1,0,2,-2,-100.0
29,10,2,1,4,-3,-75.0
29,10,3,5,8,-3,-37.5
29,10,4,3,16,-13,-81.25
29,10,5,10,32,-22,-68.75
29,10,6,72,64,8,12.5
29,10,7,109,128,-19,-14.84375
29,10,8,29,256,-227,-88.671875
29,10,9,149,512,-363,-70.8984375
29,10,10,514,1024,-510,-49.8046875
29,10,11,49,2048,-1999,-97.607421875
29,10,12,123,4096,-3973,-96.9970703125
29,10,13,57,8192,-8135,-99.30419921875
29,10,14,24718,16384,8334,50.86669921875
29,10,15,21520,32768,-11248,-34.326171875
29,11,1,0,2,-2,-100.0
29,11,2,6,4,2,50.0
29,11,3,13,8,5,62.5
29,11,4,5,16,-11,-68.75
29,11,5,18,32,-14,-43.75
29,11,6,184,64,120,187.5
29,11,7,80,128,-48,-37.5
29,11,8,80,256,-176,-68.75
29,11,9,1278,512,766,149.609375
29,11,10,369,1024,-655,-63.96484375
29,11,11,4379,2048,2331,113.818359375
29,11,12,259,4096,-3837,-93.6767578125
29,11,13,1128,8192,-7064,-86.23046875
29,11,14,43384,16384,27000,164.794921875
29,11,15,12527,32768,-20241,-61.7706298828125
29,12,1,0,2,-2,-100.0
29,12,2,1,4,-3,-75.0
29,12,3,15,8,7,87.5
29,12,4,4,16,-12,-75.0
29,12,5,36,32,4,12.5
29,12,6,43,64,-21,-32.8125
29,12,7,99,128,-29,-22.65625
29,12,8,509,256,253,98.828125
29,12,9,805,512,293,57.2265625
29,12,10,1148,1024,124,12.109375
29,12,11,1650,2048,-398,-19.43359375
29,12,12,5083,4096,987,24.0966796875
29,12,13,9829,8192,1637,19.98291015625
29,12,14,16424,16384,40,0.244140625
29,12,15,3098,32768,-29670,-90.545654296875
29,13,1,0,2,-2,-100.0
29,13,2,1,4,-3,-75.0
29,13,3,2,8,-6,-75.0
29,13,4,11,16,-5,-31.25
29,13,5,116,32,84,262.5
29,13,6,12,64,-52,-81.25
29,13,7,261,128,133,103.90625
29,13,8,252,256,-4,-1.5625
29,13,9,443,512,-69,-13.4765625
29,13,10,832,1024,-192,-18.75
29,13,11,801,2048,-1247,-60.888671875
29,13,12,679,4096,-3417,-83.4228515625
29,13,13,1131,8192,-7061,-86.19384765625
29,13,14,24154,16384,7770,47.42431640625
29,13,15,35036,32768,2268,6.92138671875
29,14,1,0,2,-2,-100.0
29,14,2,1,4,-3,-75.0
29,14,3,8,8,0,0.0
29,14,4,3,16,-13,-81.25
29,14,5,10,32,-22,-68.75
29,14,6,175,64,111,173.4375
29,14,7,479,128,351,274.21875
29,14,8,50,256,-206,-80.46875
29,14,9,134,512,-378,-73.828125
29,14,10,768,1024,-256,-25.0
29,14,11,4966,2048,2918,142.48046875
29,14,12,1084,4096,-3012,-73.53515625
29,14,13,4127,8192,-4065,-49.62158203125
29,14,14,1571,16384,-14813,-90.411376953125
29,14,15,27520,32768,-5248,-16.015625
29,15,1,0,2,-2,-100.0
29,15,2,3,4,-1,-25.0
29,15,3,18,8,10,125.0
29,15,4,3,16,-13,-81.25
29,15,5,50,32,18,56.25
29,15,6,14,64,-50,-78.125
29,15,7,177,128,49,38.28125
29,15,8,86,256,-170,-66.40625
29,15,9,292,512,-220,-42.96875
29,15,10,1161,1024,137,13.37890625
29,15,11,1300,2048,-748,-36.5234375
29,15,12,1757,4096,-2339,-57.1044921875
29,15,13,3502,8192,-4690,-57.2509765625
29,15,14,8937,16384,-7447,-45.452880859375
29,15,15,20780,32768,-11988,-36.58447265625
29,16,1,0,2,-2,-100.0
29,16,2,2,4,-2,-50.0
29,16,3,2,8,-6,-75.0
29,16,4,13,16,-3,-18.75
29,16,5,43,32,11,34.375
29,16,6,233,64,169,264.0625
29,16,7,9,128,-119,-92.96875
29,16,8,450,256,194,75.78125
29,16,9,345,512,-167,-32.6171875
29,16,10,39,1024,-985,-96.19140625
29,16,11,601,2048,-1447,-70.654296875
29,16,12,8475,4096,4379,106.9091796875
29,16,13,1143,8192,-7049,-86.04736328125
29,16,14,23846,16384,7462,45.54443359375
29,16,15,45675,32768,12907,39.3890380859375
29,17,1,0,2,-2,-100.0
29,17,2,2,4,-2,-50.0
29,17,3,14,8,6,75.0
29,17,4,12,16,-4,-25.0
29,17,5,37,32,5,15.625
29,17,6,53,64,-11,-17.1875
29,17,7,111,128,-17,-13.28125
29,17,8,17,256,-239,-93.359375
29,17,9,208,512,-304,-59.375
29,17,10,545,1024,-479,-46.77734375
29,17,11,9610,2048,7562,369.23828125
29,17,12,2004,4096,-2092,-51.07421875
29,17,13,925,8192,-7267,-88.70849609375
29,17,14,13120,16384,-3264,-19.921875
29,17,15,70441,32768,37673,114.9688720703125
29,18,1,0,2,-2,-100.0
29,18,2,1,4,-3,-75.0
29,18,3,3,8,-5,-62.5
29,18,4,9,16,-7,-43.75
29,18,5,13,32,-19,-59.375
29,18,6,153,64,89,139.0625
29,18,7,86,128,-42,-32.8125
29,18,8,139,256,-117,-45.703125
29,18,9,265,512,-247,-48.2421875
29,18,10,202,1024,-822,-80.2734375
29,18,11,5554,2048,3506,171.19140625
29,18,12,1219,4096,-2877,-70.2392578125
29,18,13,16723,8192,8531,104.13818359375
29,18,14,16421,16384,37,0.225830078125
29,18,15,27744,32768,-5024,-15.33203125
29,19,1,0,2,-2,-100.0
29,19,2,1,4,-3,-75.0
29,19,3,2,8,-6,-75.0
29,19,4,10,16,-6,-37.5
29,19,5,6,32,-26,-81.25
29,19,6,30,64,-34,-53.125
29,19,7,59,128,-69,-53.90625
29,19,8,134,256,-122,-47.65625
29,19,9,684,512,172,33.59375
29,19,10,290,1024,-734,-71.6796875
29,19,11,85,2048,-1963,-95.849609375
29,19,12,1437,4096,-2659,-64.9169921875
29,19,13,2995,8192,-5197,-63.43994140625
29,19,14,2287,16384,-14097,-86.041259765625
29,19,15,4076,32768,-28692,-87.56103515625
29,20,1,0,2,-2,-100.0
29,20,2,1,4,-3,-75.0
29,20,3,2,8,-6,-75.0
29,20,4,26,16,10,62.5
29,20,5,5,32,-27,-84.375
29,20,6,99,64,35,54.6875
29,20,7,281,128,153,119.53125
29,20,8,528,256,272,106.25
29,20,9,53,512,-459,-89.6484375
29,20,10,324,1024,-700,-68.359375
29,20,11,6976,2048,4928,240.625
29,20,12,6011,4096,1915,46.7529296875
29,20,13,15141,8192,6949,84.82666015625
29,20,14,14112,16384,-2272,-13.8671875
29,20,15,2632,32768,-30136,-91.9677734375
29,21,1,0,2,-2,-100.0
29,21,2,1,4,-3,-75.0
29,21,3,5,8,-3,-37.5
29,21,4,11,16,-5,-31.25
29,21,5,53,32,21,65.625
29,21,6,39,64,-25,-39.0625
29,21,7,65,128,-63,-49.21875
29,21,8,145,256,-111,-43.359375
29,21,9,298,512,-214,-41.796875
29,21,10,89,1024,-935,-91.30859375
29,21,11,1305,2048,-743,-36.279296875
29,21,12,731,4096,-3365,-82.1533203125
29,21,13,797,8192,-7395,-90.27099609375
29,21,14,67,16384,-16317,-99.591064453125
29,21,15,124724,32768,91956,280.62744140625
29,22,1,0,2,-2,-100.0
29,22,2,1,4,-3,-75.0
29,22,3,5,8,-3,-37.5
29,22,4,15,16,-1,-6.25
29,22,5,39,32,7,21.875
29,22,6,25,64,-39,-60.9375
29,22,7,208,128,80,62.5
29,22,8,62,256,-194,-75.78125
29,22,9,356,512,-156,-30.46875
29,22,10,760,1024,-264,-25.78125
29,22,11,838,2048,-1210,-59.08203125
29,22,12,2770,4096,-1326,-32.373046875
29,22,13,1039,8192,-7153,-87.31689453125
29,22,14,16418,16384,34,0.20751953125
29,22,15,5710,32768,-27058,-82.574462890625
29,23,1,0,2,-2,-100.0
29,23,2,1,4,-3,-75.0
29,23,3,2,8,-6,-75.0
29,23,4,34,16,18,112.5
29,23,5,22,32,-10,-31.25
29,23,6,10,64,-54,-84.375
29,23,7,9,128,-119,-92.96875
29,23,8,13,256,-243,-94.921875
29,23,9,27,512,-485,-94.7265625
29,23,10,437,1024,-587,-57.32421875
29,23,11,967,2048,-1081,-52.783203125
29,23,12,4290,4096,194,4.736328125
29,23,13,3735,8192,-4457,-54.40673828125
29,23,14,22282,16384,5898,35.99853515625
29,23,15,20565,32768,-12203,-37.2406005859375
29,24,1,0,2,-2,-100.0
29,24,2,2,4,-2,-50.0
29,24,3,18,8,10,125.0
29,24,4,6,16,-10,-62.5
29,24,5,40,32,8,25.0
29,24,6,202,64,138,215.625
29,24,7,248,128,120,93.75
29,24,8,140,256,-116,-45.3125
29,24,9,1337,512,825,161.1328125
29,24,10,546,1024,-478,-46.6796875
29,24,11,1471,2048,-577,-28.173828125
29,24,12,699,4096,-3397,-82.9345703125
29,24,13,1717,8192,-6475,-79.04052734375
29,24,14,4473,16384,-11911,-72.698974609375
29,24,15,5506,32768,-27262,-83.197021484375
29,25,1,0,2,-2,-100.0
29,25,2,1,4,-3,-75.0
29,25,3,8,8,0,0.0
29,25,4,3,16,-13,-81.25
29,25,5,43,32,11,34.375
29,25,6,67,64,3,4.6875
29,25,7,230,128,102,79.6875
29,25,8,396,256,140,54.6875
29,25,9,414,512,-98,-19.140625
29,25,10,1145,1024,121,11.81640625
29,25,11,1838,2048,-210,-10.25390625
29,25,12,3923,4096,-173,-4.2236328125
29,25,13,21467,8192,13275,162.04833984375
29,25,14,16616,16384,232,1.416015625
29,25,15,30565,32768,-2203,-6.7230224609375
29,26,1,0,2,-2,-100.0
29,26,2,1,4,-3,-75.0
29,26,3,10,8,2,25.0
29,26,4,32,16,16,100.0
29,26,5,9,32,-23,-71.875
29,26,6,93,64,29,45.3125
29,26,7,227,128,99,77.34375
29,26,8,288,256,32,12.5
29,26,9,793,512,281,54.8828125
29,26,10,1234,1024,210,20.5078125
29,26,11,1133,2048,-915,-44.677734375
29,26,12,2842,4096,-1254,-30.615234375
29,26,13,9371,8192,1179,14.39208984375
29,26,14,7837,16384,-8547,-52.166748046875
29,26,15,2146,32768,-30622,-93.450927734375
29,27,1,0,2,-2,-100.0
29,27,2,2,4,-2,-50.0
29,27,3,2,8,-6,-75.0
29,27,4,25,16,9,56.25
29,27,5,14,32,-18,-56.25
29,27,6,168,64,104,162.5
29,27,7,110,128,-18,-14.0625
29,27,8,7,256,-249,-97.265625
29,27,9,398,512,-114,-22.265625
29,27,10,2084,1024,1060,103.515625
29,27,11,3009,2048,961,46.923828125
29,27,12,3398,4096,-698,-17.041015625
29,27,13,12172,8192,3980,48.583984375
29,27,14,55816,16384,39432,240.673828125
29,27,15,82102,32768,49334,150.555419921875
29,28,1,0,2,-2,-100.0
29,28,2,2,4,-2,-50.0
29,28,3,6,8,-2,-25.0
29,28,4,42,16,26,162.5
29,28,5,20,32,-12,-37.5
29,28,6,20,64,-44,-68.75
29,28,7,19,128,-109,-85.15625
29,28,8,445,256,189,73.828125
29,28,9,344,512,-168,-32.8125
29,28,10,771,1024,-253,-24.70703125
29,28,11,2085,2048,37,1.806640625
29,28,12,3393,4096,-703,-17.1630859375
29,28,13,3444,8192,-4748,-57.958984375
29,28,14,16313,16384,-71,-0.433349609375
29,28,15,108035,32768,75267,229.6966552734375
29,29,1,0,2,-2,-100.0
29,29,2,2,4,-2,-50.0
29,29,3,2,8,-6,-75.0
29,29,4,7,16,-9,-56.25
29,29,5,10,32,-22,-68.75
29,29,6,27,64,-37,-57.8125
29,29,7,6,128,-122,-95.3125
29,29,8,338,256,82,32.03125
29,29,9,274,512,-238,-46.484375
29,29,10,2100,1024,1076,105.078125
29,29,11,1665,2048,-383,-18.701171875
29,29,12,14276,4096,10180,248.53515625
29,29,13,7990,8192,-202,-2.4658203125
29,29,14,22006,16384,5622,34.31396484375
29,29,15,127102,32768,94334,287.884521484375
30,1,1,0,2,-2,-100.0
30,1,2,1,4,-3,-75.0
30,1,3,7,8,-1,-12.5
30,1,4,8,16,-8,-50.0
30,1,5,39,32,7,21.875
30,1,6,16,64,-48,-75.0
30,1,7,179,128,51,39.84375
30,1,8,127,256,-129,-50.390625
30,1,9,402,512,-110,-21.484375
30,1,10,166,1024,-858,-83.7890625
30,1,11,4103,2048,2055,100.341796875
30,1,12,5261,4096,1165,28.4423828125
30,1,13,8824,8192,632,7.71484375
30,1,14,4567,16384,-11817,-72.125244140625
30,1,15,20985,32768,-11783,-35.9588623046875
30,2,1,0,2,-2,-100.0
30,2,2,1,4,-3,-75.0
30,2,3,7,8,-1,-12.5
30,2,4,3,16,-13,-81.25
30,2,5,67,32,35,109.375
30,2,6,28,64,-36,-56.25
30,2,7,102,128,-26,-20.3125
30,2,8,26,256,-230,-89.84375
30,2,9,307,512,-205,-40.0390625
30,2,10,1958,1024,934,91.2109375
30,2,11,921,2048,-1127,-55.029296875
30,2,12,2483,4096,-1613,-39.3798828125
30,2,13,14523,8192,6331,77.28271484375
30,2,14,3452,16384,-12932,-78.9306640625
30,2,15,22824,32768,-9944,-30.3466796875
30,3,1,0,2,-2,-100.0
30,3,2,1,4,-3,-75.0
30,3,3,9,8,1,12.5
30,3,4,23,16,7,43.75
30,3,5,52,32,20,62.5
30,3,6,88,64,24,37.5
30,3,7,66,128,-62,-48.4375
30,3,8,320,256,64,25.0
30,3,9,66,512,-446,-87.109375
30,3,10,20,1024,-1004,-98.046875
30,3,11,2088,2048,40,1.953125
30,3,12,1536,4096,-2560,-62.5
30,3,13,3722,8192,-4470,-54.5654296875
30,3,14,4225,16384,-12159,-74.212646484375
30,3,15,5906,32768,-26862,-81.976318359375
30,4,1,0,2,-2,-100.0
30,4,2,1,4,-3,-75.0
30,4,3,3,8,-5,-62.5
30,4,4,12,16,-4,-25.0
30,4,5,38,32,6,18.75
30,4,6,25,64,-39,-60.9375
30,4,7,105,128,-23,-17.96875
30,4,8,48,256,-208,-81.25
30,4,9,1032,512,520,101.5625
30,4,10,663,1024,-361,-35.25390625
30,4,11,872,2048,-1176,-57.421875
30,4,12,2148,4096,-1948,-47.55859375
30,4,13,4370,8192,-3822,-46.6552734375
30,4,14,1756,16384,-14628,-89.2822265625
30,4,15,42126,32768,9358,28.558349609375
30,5,1,0,2,-2,-100.0
30,5,2,1,4,-3,-75.0
30,5,3,13,8,5,62.5
30,5,4,28,16,12,75.0
30,5,5,63,32,31,96.875
30,5,6,76,64,12,18.75
30,5,7,20,128,-108,-84.375
30,5,8,151,256,-105,-41.015625
30,5,9,1091,512,579,113.0859375
30,5,10,292,1024,-732,-71.484375
30,5,11,6936,2048,4888,238.671875
30,5,12,5294,4096,1198,29.248046875
30,5,13,5875,8192,-2317,-28.28369140625
30,5,14,898,16384,-15486,-94.51904296875
30,5,15,665,32768,-32103,-97.9705810546875
30,6,1,0,2,-2,-100.0
30,6,2,2,4,-2,-50.0
30,6,3,5,8,-3,-37.5
30,6,4,12,16,-4,-25.0
30,6,5,8,32,-24,-75.0
30,6,6,15,64,-49,-76.5625
30,6,7,220,128,92,71.875
30,6,8,93,256,-163,-63.671875
30,6,9,299,512,-213,-41.6015625
30,6,10,401,1024,-623,-60.83984375
30,6,11,1795,2048,-253,-12.353515625
30,6,12,1064,4096,-3032,-74.0234375
30,6,13,12120,8192,3928,47.94921875
30,6,14,36255,16384,19871,121.282958984375
30,6,15,53687,32768,20919,63.8397216796875
30,7,1,0,2,-2,-100.0
30,7,2,4,4,0,0.0
30,7,3,3,8,-5,-62.5
30,7,4,6,16,-10,-62.5
30,7,5,58,32,26,81.25
30,7,6,21,64,-43,-67.1875
30,7,7,121,128,-7,-5.46875
30,7,8,122,256,-134,-52.34375
30,7,9,338,512,-174,-33.984375
30,7,10,1731,1024,707,69.04296875
30,7,11,296,2048,-1752,-85.546875
30,7,12,260,4096,-3836,-93.65234375
30,7,13,60,8192,-8132,-99.267578125
30,7,14,2995,16384,-13389,-81.719970703125
30,7,15,55032,32768,22264,67.9443359375
30,8,1,0,2,-2,-100.0
30,8,2,2,4,-2,-50.0
30,8,3,2,8,-6,-75.0
30,8,4,7,16,-9,-56.25
30,8,5,36,32,4,12.5
30,8,6,7,64,-57,-89.0625
30,8,7,197,128,69,53.90625
30,8,8,98,256,-158,-61.71875
30,8,9,52,512,-460,-89.84375
30,8,10,659,1024,-365,-35.64453125
30,8,11,785,2048,-1263,-61.669921875
30,8,12,1081,4096,-3015,-73.6083984375
30,8,13,13569,8192,5377,65.63720703125
30,8,14,5737,16384,-10647,-64.984130859375
30,8,15,113188,32768,80420,245.42236328125
30,9,1,0,2,-2,-100.0
30,9,2,4,4,0,0.0
30,9,3,20,8,12,150.0
30,9,4,3,16,-13,-81.25
30,9,5,4,32,-28,-87.5
30,9,6,43,64,-21,-32.8125
30,9,7,118,128,-10,-7.8125
30,9,8,311,256,55,21.484375
30,9,9,780,512,268,52.34375
30,9,10,925,1024,-99,-9.66796875
30,9,11,1691,2048,-357,-17.431640625
30,9,12,7441,4096,3345,81.6650390625
30,9,13,11181,8192,2989,36.48681640625
30,9,14,6380,16384,-10004,-61.0595703125
30,9,15,22092,32768,-10676,-32.58056640625
30,10,1,0,2,-2,-100.0
30,10,2,1,4,-3,-75.0
30,10,3,10,8,2,25.0
30,10,4,8,16,-8,-50.0
30,10,5,20,32,-12,-37.5
30,10,6,142,64,78,121.875
30,10,7,34,128,-94,-73.4375
30,10,8,339,256,83,32.421875
30,10,9,1414,512,902,176.171875
30,10,10,1520,1024,496,48.4375
30,10,11,1279,2048,-769,-37.548828125
30,10,12,6162,4096,2066,50.439453125
30,10,13,14993,8192,6801,83.02001953125
30,10,14,4659,16384,-11725,-71.563720703125
30,10,15,30666,32768,-2102,-6.414794921875
30,11,1,0,2,-2,-100.0
30,11,2,3,4,-1,-25.0
30,11,3,6,8,-2,-25.0
30,11,4,28,16,12,75.0
30,11,5,4,32,-28,-87.5
30,11,6,35,64,-29,-45.3125
30,11,7,85,128,-43,-33.59375
30,11,8,269,256,13,5.078125
30,11,9,10,512,-502,-98.046875
30,11,10,195,1024,-829,-80.95703125
30,11,11,366,2048,-1682,-82.12890625
30,11,12,8567,4096,4471,109.1552734375
30,11,13,191,8192,-8001,-97.66845703125
30,11,14,12336,16384,-4048,-24.70703125
30,11,15,9057,32768,-23711,-72.3602294921875
30,12,1,0,2,-2,-100.0
30,12,2,5,4,1,25.0
30,12,3,2,8,-6,-75.0
30,12,4,17,16,1,6.25
30,12,5,15,32,-17,-53.125
30,12,6,113,64,49,76.5625
30,12,7,80,128,-48,-37.5
30,12,8,402,256,146,57.03125
30,12,9,668,512,156,30.46875
30,12,10,1045,1024,21,2.05078125
30,12,11,1309,2048,-739,-36.083984375
30,12,12,3155,4096,-941,-22.9736328125
30,12,13,5284,8192,-2908,-35.498046875
30,12,14,4042,16384,-12342,-75.32958984375
30,12,15,6653,32768,-26115,-79.6966552734375
30,13,1,0,2,-2,-100.0
30,13,2,2,4,-2,-50.0
30,13,3,2,8,-6,-75.0
30,13,4,11,16,-5,-31.25
30,13,5,5,32,-27,-84.375
30,13,6,109,64,45,70.3125
30,13,7,64,128,-64,-50.0
30,13,8,535,256,279,108.984375
30,13,9,464,512,-48,-9.375
30,13,10,269,1024,-755,-73.73046875
30,13,11,1593,2048,-455,-22.216796875
30,13,12,607,4096,-3489,-85.1806640625
30,13,13,601,8192,-7591,-92.66357421875
30,13,14,27030,16384,10646,64.97802734375
30,13,15,2315,32768,-30453,-92.9351806640625
30,14,1,0,2,-2,-100.0
30,14,2,1,4,-3,-75.0
30,14,3,7,8,-1,-12.5
30,14,4,3,16,-13,-81.25
30,14,5,36,32,4,12.5
30,14,6,45,64,-19,-29.6875
30,14,7,257,128,129,100.78125
30,14,8,151,256,-105,-41.015625
30,14,9,333,512,-179,-34.9609375
30,14,10,483,1024,-541,-52.83203125
30,14,11,25,2048,-2023,-98.779296875
30,14,12,10016,4096,5920,144.53125
30,14,13,5900,8192,-2292,-27.978515625
30,14,14,17723,16384,1339,8.172607421875
30,14,15,11737,32768,-21031,-64.1815185546875
30,15,1,0,2,-2,-100.0
30,15,2,1,4,-3,-75.0
30,15,3,4,8,-4,-50.0
30,15,4,3,16,-13,-81.25
30,15,5,28,32,-4,-12.5
30,15,6,15,64,-49,-76.5625
30,15,7,122,128,-6,-4.6875
30,15,8,329,256,73,28.515625
30,15,9,704,512,192,37.5
30,15,10,4205,1024,3181,310.64453125
30,15,11,1905,2048,-143,-6.982421875
30,15,12,1722,4096,-2374,-57.958984375
30,15,13,7547,8192,-645,-7.87353515625
30,15,14,2898,16384,-13486,-82.31201171875
30,15,15,36198,32768,3430,10.467529296875
30,16,1,0,2,-2,-100.0
30,16,2,1,4,-3,-75.0
30,16,3,5,8,-3,-37.5
30,16,4,58,16,42,262.5
30,16,5,46,32,14,43.75
30,16,6,7,64,-57,-89.0625
30,16,7,43,128,-85,-66.40625
30,16,8,23,256,-233,-91.015625
30,16,9,1148,512,636,124.21875
30,16,10,1727,1024,703,68.65234375
30,16,11,1383,2048,-665,-32.470703125
30,16,12,306,4096,-3790,-92.529296875
30,16,13,5697,8192,-2495,-30.45654296875
30,16,14,27722,16384,11338,69.20166015625
30,16,15,7209,32768,-25559,-77.9998779296875
30,17,1,0,2,-2,-100.0
30,17,2,2,4,-2,-50.0
30,17,3,2,8,-6,-75.0
30,17,4,39,16,23,143.75
30,17,5,24,32,-8,-25.0
30,17,6,11,64,-53,-82.8125
30,17,7,58,128,-70,-54.6875
30,17,8,68,256,-188,-73.4375
30,17,9,180,512,-332,-64.84375
30,17,10,1157,1024,133,12.98828125
30,17,11,197,2048,-1851,-90.380859375
30,17,12,750,4096,-3346,-81.689453125
30,17,13,9787,8192,1595,19.47021484375
30,17,14,961,16384,-15423,-94.134521484375
30,17,15,5085,32768,-27683,-84.4818115234375
30,18,1,0,2,-2,-100.0
30,18,2,1,4,-3,-75.0
30,18,3,5,8,-3,-37.5
30,18,4,11,16,-5,-31.25
30,18,5,10,32,-22,-68.75
30,18,6,31,64,-33,-51.5625
30,18,7,162,128,34,26.5625
30,18,8,39,256,-217,-84.765625
30,18,9,520,512,8,1.5625
30,18,10,413,1024,-611,-59.66796875
30,18,11,1451,2048,-597,-29.150390625
30,18,12,13780,4096,9684,236.42578125
30,18,13,244,8192,-7948,-97.021484375
30,18,14,8645,16384,-7739,-47.235107421875
30,18,15,27493,32768,-5275,-16.0980224609375
30,19,1,0,2,-2,-100.0
30,19,2,2,4,-2,-50.0
30,19,3,15,8,7,87.5
30,19,4,17,16,1,6.25
30,19,5,35,32,3,9.375
30,19,6,140,64,76,118.75
30,19,7,24,128,-104,-81.25
30,19,8,382,256,126,49.21875
30,19,9,372,512,-140,-27.34375
30,19,10,863,1024,-161,-15.72265625
30,19,11,1900,2048,-148,-7.2265625
30,19,12,2138,4096,-1958,-47.802734375
30,19,13,18,8192,-8174,-99.7802734375
30,19,14,6283,16384,-10101,-61.651611328125
30,19,15,24632,32768,-8136,-24.8291015625
30,20,1,0,2,-2,-100.0
30,20,2,3,4,-1,-25.0
30,20,3,9,8,1,12.5
30,20,4,14,16,-2,-12.5
30,20,5,10,32,-22,-68.75
30,20,6,70,64,6,9.375
30,20,7,34,128,-94,-73.4375
30,20,8,17,256,-239,-93.359375
30,20,9,365,512,-147,-28.7109375
30,20,10,1183,1024,159,15.52734375
30,20,11,151,2048,-1897,-92.626953125
30,20,12,190,4096,-3906,-95.361328125
30,20,13,2141,8192,-6051,-73.86474609375
30,20,14,17759,16384,1375,8.392333984375
30,20,15,79978,32768,47210,144.073486328125
30,21,1,0,2,-2,-100.0
30,21,2,1,4,-3,-75.0
30,21,3,6,8,-2,-25.0
30,21,4,15,16,-1,-6.25
30,21,5,40,32,8,25.0
30,21,6,76,64,12,18.75
30,21,7,7,128,-121,-94.53125
30,21,8,118,256,-138,-53.90625
30,21,9,515,512,3,0.5859375
30,21,10,1896,1024,872,85.15625
30,21,11,1800,2048,-248,-12.109375
30,21,12,5113,4096,1017,24.8291015625
30,21,13,14685,8192,6493,79.26025390625
30,21,14,40452,16384,24068,146.8994140625
30,21,15,39706,32768,6938,21.173095703125
30,22,1,0,2,-2,-100.0
30,22,2,2,4,-2,-50.0
30,22,3,2,8,-6,-75.0
30,22,4,12,16,-4,-25.0
30,22,5,35,32,3,9.375
30,22,6,10,64,-54,-84.375
30,22,7,16,128,-112,-87.5
30,22,8,157,256,-99,-38.671875
30,22,9,330,512,-182,-35.546875
30,22,10,489,1024,-535,-52.24609375
30,22,11,2026,2048,-22,-1.07421875
30,22,12,971,4096,-3125,-76.2939453125
30,22,13,56340,8192,48148,587.744140625
30,22,14,36646,16384,20262,123.66943359375
30,22,15,64814,32768,32046,97.796630859375
30,23,1,0,2,-2,-100.0
30,23,2,2,4,-2,-50.0
30,23,3,7,8,-1,-12.5
30,23,4,13,16,-3,-18.75
30,23,5,119,32,87,271.875
30,23,6,41,64,-23,-35.9375
30,23,7,115,128,-13,-10.15625
30,23,8,817,256,561,219.140625
30,23,9,270,512,-242,-47.265625
30,23,10,344,1024,-680,-66.40625
30,23,11,1028,2048,-1020,-49.8046875
30,23,12,2446,4096,-1650,-40.283203125
30,23,13,1682,8192,-6510,-79.4677734375
30,23,14,7732,16384,-8652,-52.8076171875
30,23,15,54617,32768,21849,66.6778564453125
30,24,1,0,2,-2,-100.0
30,24,2,1,4,-3,-75.0
30,24,3,2,8,-6,-75.0
30,24,4,8,16,-8,-50.0
30,24,5,16,32,-16,-50.0
30,24,6,36,64,-28,-43.75
30,24,7,83,128,-45,-35.15625
30,24,8,20,256,-236,-92.1875
30,24,9,489,512,-23,-4.4921875
30,24,10,1426,1024,402,39.2578125
30,24,11,736,2048,-1312,-64.0625
30,24,12,6333,4096,2237,54.6142578125
30,24,13,11197,8192,3005,36.68212890625
30,24,14,6255,16384,-10129,-61.822509765625
30,24,15,882,32768,-31886,-97.308349609375
30,25,1,0,2,-2,-100.0
30,25,2,1,4,-3,-75.0
30,25,3,4,8,-4,-50.0
30,25,4,11,16,-5,-31.25
30,25,5,23,32,-9,-28.125
30,25,6,15,64,-49,-76.5625
30,25,7,184,128,56,43.75
30,25,8,210,256,-46,-17.96875
30,25,9,406,512,-106,-20.703125
30,25,10,1214,1024,190,18.5546875
30,25,11,290,2048,-1758,-85.83984375
30,25,12,2976,4096,-1120,-27.34375
30,25,13,11409,8192,3217,39.27001953125
30,25,14,46110,16384,29726,181.43310546875
30,25,15,168683,32768,135915,414.7796630859375
30,26,1,0,2,-2,-100.0
30,26,2,1,4,-3,-75.0
30,26,3,2,8,-6,-75.0
30,26,4,17,16,1,6.25
30,26,5,6,32,-26,-81.25
30,26,6,64,64,0,0.0
30,26,7,27,128,-101,-78.90625
30,26,8,994,256,738,288.28125
30,26,9,381,512,-131,-25.5859375
30,26,10,101,1024,-923,-90.13671875
30,26,11,2810,2048,762,37.20703125
30,26,12,1097,4096,-2999,-73.2177734375
30,26,13,4114,8192,-4078,-49.7802734375
30,26,14,5882,16384,-10502,-64.09912109375
30,26,15,18597,32768,-14171,-43.2464599609375
30,27,1,0,2,-2,-100.0
30,27,2,3,4,-1,-25.0
30,27,3,4,8,-4,-50.0
30,27,4,16,16,0,0.0
30,27,5,41,32,9,28.125
30,27,6,38,64,-26,-40.625
30,27,7,60,128,-68,-53.125
30,27,8,192,256,-64,-25.0
30,27,9,229,512,-283,-55.2734375
30,27,10,199,1024,-825,-80.56640625
30,27,11,56,2048,-1992,-97.265625
30,27,12,3290,4096,-806,-19.677734375
30,27,13,678,8192,-7514,-91.7236328125
30,27,14,29722,16384,13338,81.40869140625
30,27,15,10094,32768,-22674,-69.195556640625
30,28,1,0,2,-2,-100.0
30,28,2,1,4,-3,-75.0
30,28,3,2,8,-6,-75.0
30,28,4,26,16,10,62.5
30,28,5,156,32,124,387.5
30,28,6,102,64,38,59.375
30,28,7,122,128,-6,-4.6875
30,28,8,320,256,64,25.0
30,28,9,125,512,-387,-75.5859375
30,28,10,853,1024,-171,-16.69921875
30,28,11,4185,2048,2137,104.345703125
30,28,12,2733,4096,-1363,-33.2763671875
30,28,13,11106,8192,2914,35.5712890625
30,28,14,14620,16384,-1764,-10.7666015625
30,28,15,32646,32768,-122,-0.372314453125
30,29,1,0,2,-2,-100.0
30,29,2,1,4,-3,-75.0
30,29,3,4,8,-4,-50.0
30,29,4,3,16,-13,-81.25
30,29,5,30,32,-2,-6.25
30,29,6,64,64,0,0.0
30,29,7,59,128,-69,-53.90625
30,29,8,103,256,-153,-59.765625
30,29,9,136,512,-376,-73.4375
30,29,10,2314,1024,1290,125.9765625
30,29,11,1751,2048,-297,-14.501953125
30,29,12,2869,4096,-1227,-29.9560546875
30,29,13,4014,8192,-4178,-51.0009765625
30,29,14,64,16384,-16320,-99.609375
30,29,15,36366,32768,3598,10.980224609375
30,30,1,0,2,-2,-100.0
30,30,2,1,4,-3,-75.0
30,30,3,3,8,-5,-62.5
30,30,4,3,16,-13,-81.25
30,30,5,15,32,-17,-53.125
30,30,6,98,64,34,53.125
30,30,7,177,128,49,38.28125
30,30,8,183,256,-73,-28.515625
30,30,9,250,512,-262,-51.171875
30,30,10,435,1024,-589,-57.51953125
30,30,11,70,2048,-1978,-96.58203125
30,30,12,3534,4096,-562,-13.720703125
30,30,13,3296,8192,-4896,-59.765625
30,30,14,15424,16384,-960,-5.859375
30,30,15,104622,32768,71854,219.281005859375
31,1,1,0,2,-2,-100.0
31,1,2,2,4,-2,-50.0
31,1,3,4,8,-4,-50.0
31,1,4,3,16,-13,-81.25
31,1,5,24,32,-8,-25.0
31,1,6,35,64,-29,-45.3125
31,1,7,57,128,-71,-55.46875
31,1,8,65,256,-191,-74.609375
31,1,9,321,512,-191,-37.3046875
31,1,10,365,1024,-659,-64.35546875
31,1,11,1975,2048,-73,-3.564453125
31,1,12,2059,4096,-2037,-49.7314453125
31,1,13,13769,8192,5577,68.07861328125
31,1,14,2774,16384,-13610,-83.06884765625
31,1,15,389,32768,-32379,-98.8128662109375
31,2,1,0,2,-2,-100.0
31,2,2,1,4,-3,-75.0
31,2,3,5,8,-3,-37.5
31,2,4,18,16,2,12.5
31,2,5,59,32,27,84.375
31,2,6,35,64,-29,-45.3125
31,2,7,182,128,54,42.1875
31,2,8,390,256,134,52.34375
31,2,9,24,512,-488,-95.3125
31,2,10,72,1024,-952,-92.96875
31,2,11,4158,2048,2110,103.02734375
31,2,12,2614,4096,-1482,-36.181640625
31,2,13,6534,8192,-1658,-20.2392578125
31,2,14,6552,16384,-9832,-60.009765625
31,2,15,48886,32768,16118,49.188232421875
31,3,1,0,2,-2,-100.0
31,3,2,1,4,-3,-75.0
31,3,3,3,8,-5,-62.5
31,3,4,19,16,3,18.75
31,3,5,50,32,18,56.25
31,3,6,44,64,-20,-31.25
31,3,7,45,128,-83,-64.84375
31,3,8,62,256,-194,-75.78125
31,3,9,533,512,21,4.1015625
31,3,10,111,1024,-913,-89.16015625
31,3,11,608,2048,-1440,-70.3125
31,3,12,3829,4096,-267,-6.5185546875
31,3,13,170,8192,-8022,-97.9248046875
31,3,14,9559,16384,-6825,-41.656494140625
31,3,15,42730,32768,9962,30.401611328125
31,4,1,0,2,-2,-100.0
31,4,2,1,4,-3,-75.0
31,4,3,3,8,-5,-62.5
31,4,4,4,16,-12,-75.0
31,4,5,50,32,18,56.25
31,4,6,19,64,-45,-70.3125
31,4,7,252,128,124,96.875
31,4,8,43,256,-213,-83.203125
31,4,9,252,512,-260,-50.78125
31,4,10,637,1024,-387,-37.79296875
31,4,11,1298,2048,-750,-36.62109375
31,4,12,11774,4096,7678,187.451171875
31,4,13,7602,8192,-590,-7.2021484375
31,4,14,11886,16384,-4498,-27.45361328125
31,4,15,1128,32768,-31640,-96.5576171875
31,5,1,0,2,-2,-100.0
31,5,2,2,4,-2,-50.0
31,5,3,3,8,-5,-62.5
31,5,4,11,16,-5,-31.25
31,5,5,21,32,-11,-34.375
31,5,6,109,64,45,70.3125
31,5,7,142,128,14,10.9375
31,5,8,251,256,-5,-1.953125
31,5,9,128,512,-384,-75.0
31,5,10,254,1024,-770,-75.1953125
31,5,11,4226,2048,2178,106.34765625
31,5,12,12305,4096,8209,200.4150390625
31,5,13,12040,8192,3848,46.97265625
31,5,14,3877,16384,-12507,-76.336669921875
31,5,15,94157,32768,61389,187.3443603515625
31,6,1,0,2,-2,-100.0
31,6,2,2,4,-2,-50.0
31,6,3,4,8,-4,-50.0
31,6,4,7,16,-9,-56.25
31,6,5,93,32,61,190.625
31,6,6,78,64,14,21.875
31,6,7,31,128,-97,-75.78125
31,6,8,254,256,-2,-0.78125
31,6,9,1151,512,639,124.8046875
31,6,10,2239,1024,1215,118.65234375
31,6,11,1059,2048,-989,-48.291015625
31,6,12,3982,4096,-114,-2.783203125
31,6,13,17662,8192,9470,115.6005859375
31,6,14,8224,16384,-8160,-49.8046875
31,6,15,73450,32768,40682,124.151611328125
31,7,1,0,2,-2,-100.0
31,7,2,1,4,-3,-75.0
31,7,3,14,8,6,75.0
31,7,4,24,16,8,50.0
31,7,5,10,32,-22,-68.75
31,7,6,83,64,19,29.6875
31,7,7,46,128,-82,-64.0625
31,7,8,250,256,-6,-2.34375
31,7,9,307,512,-205,-40.0390625
31,7,10,1165,1024,141,13.76953125
31,7,11,233,2048,-1815,-88.623046875
31,7,12,2754,4096,-1342,-32.763671875
31,7,13,6600,8192,-1592,-19.43359375
31,7,14,13144,16384,-3240,-19.775390625
31,7,15,12824,32768,-19944,-60.8642578125
31,8,1,0,2,-2,-100.0
31,8,2,1,4,-3,-75.0
31,8,3,4,8,-4,-50.0
31,8,4,8,16,-8,-50.0
31,8,5,30,32,-2,-6.25
31,8,6,165,64,101,157.8125
31,8,7,63,128,-65,-50.78125
31,8,8,10,256,-246,-96.09375
31,8,9,108,512,-404,-78.90625
31,8,10,432,1024,-592,-57.8125
31,8,11,719,2048,-1329,-64.892578125
31,8,12,1571,4096,-2525,-61.6455078125
31,8,13,11784,8192,3592,43.84765625
31,8,14,18956,16384,2572,15.6982421875
31,8,15,20388,32768,-12380,-37.78076171875
31,9,1,0,2,-2,-100.0
31,9,2,1,4,-3,-75.0
31,9,3,5,8,-3,-37.5
31,9,4,11,16,-5,-31.25
31,9,5,7,32,-25,-78.125
31,9,6,39,64,-25,-39.0625
31,9,7,81,128,-47,-36.71875
31,9,8,78,256,-178,-69.53125
31,9,9,295,512,-217,-42.3828125
31,9,10,5271,1024,4247,414.74609375
31,9,11,1301,2048,-747,-36.474609375
31,9,12,3408,4096,-688,-16.796875
31,9,13,755,8192,-7437,-90.78369140625
31,9,14,2567,16384,-13817,-84.332275390625
31,9,15,25212,32768,-7556,-23.05908203125
31,10,1,0,2,-2,-100.0
31,10,2,1,4,-3,-75.0
31,10,3,4,8,-4,-50.0
31,10,4,52,16,36,225.0
31,10,5,4,32,-28,-87.5
31,10,6,61,64,-3,-4.6875
31,10,7,206,128,78,60.9375
31,10,8,249,256,-7,-2.734375
31,10,9,259,512,-253,-49.4140625
31,10,10,45,1024,-979,-95.60546875
31,10,11,3095,2048,1047,51.123046875
31,10,12,3339,4096,-757,-18.4814453125
31,10,13,3957,8192,-4235,-51.69677734375
31,10,14,7184,16384,-9200,-56.15234375
31,10,15,11968,32768,-20800,-63.4765625
31,11,1,0,2,-2,-100.0
31,11,2,4,4,0,0.0
31,11,3,4,8,-4,-50.0
31,11,4,21,16,5,31.25
31,11,5,4,32,-28,-87.5
31,11,6,29,64,-35,-54.6875
31,11,7,567,128,439,342.96875
31,11,8,138,256,-118,-46.09375
31,11,9,1436,512,924,180.46875
31,11,10,901,1024,-123,-12.01171875
31,11,11,2199,2048,151,7.373046875
31,11,12,1915,4096,-2181,-53.2470703125
31,11,13,38064,8192,29872,364.6484375
31,11,14,49332,16384,32948,201.0986328125
31,11,15,76109,32768,43341,132.2662353515625
31,12,1,0,2,-2,-100.0
31,12,2,1,4,-3,-75.0
31,12,3,3,8,-5,-62.5
31,12,4,3,16,-13,-81.25
31,12,5,26,32,-6,-18.75
31,12,6,17,64,-47,-73.4375
31,12,7,10,128,-118,-92.1875
31,12,8,245,256,-11,-4.296875
31,12,9,928,512,416,81.25
31,12,10,1060,1024,36,3.515625
31,12,11,490,2048,-1558,-76.07421875
31,12,12,70,4096,-4026,-98.291015625
31,12,13,27805,8192,19613,239.41650390625
31,12,14,11203,16384,-5181,-31.622314453125
31,12,15,13324,32768,-19444,-59.33837890625
31,13,1,0,2,-2,-100.0
31,13,2,3,4,-1,-25.0
31,13,3,2,8,-6,-75.0
31,13,4,4,16,-12,-75.0
31,13,5,47,32,15,46.875
31,13,6,96,64,32,50.0
31,13,7,60,128,-68,-53.125
31,13,8,653,256,397,155.078125
31,13,9,298,512,-214,-41.796875
31,13,10,628,1024,-396,-38.671875
31,13,11,1525,2048,-523,-25.537109375
31,13,12,2078,4096,-2018,-49.267578125
31,13,13,7557,8192,-635,-7.75146484375
31,13,14,18344,16384,1960,11.962890625
31,13,15,730,32768,-32038,-97.772216796875
31,14,1,0,2,-2,-100.0
31,14,2,3,4,-1,-25.0
31,14,3,3,8,-5,-62.5
31,14,4,5,16,-11,-68.75
31,14,5,26,32,-6,-18.75
31,14,6,98,64,34,53.125
31,14,7,30,128,-98,-76.5625
31,14,8,239,256,-17,-6.640625
31,14,9,297,512,-215,-41.9921875
31,14,10,430,1024,-594,-58.0078125
31,14,11,3169,2048,1121,54.736328125
31,14,12,2710,4096,-1386,-33.837890625
31,14,13,6250,8192,-1942,-23.7060546875
31,14,14,7310,16384,-9074,-55.38330078125
31,14,15,8159,32768,-24609,-75.1007080078125
31,15,1,0,2,-2,-100.0
31,15,2,1,4,-3,-75.0
31,15,3,10,8,2,25.0
31,15,4,13,16,-3,-18.75
31,15,5,27,32,-5,-15.625
31,15,6,87,64,23,35.9375
31,15,7,147,128,19,14.84375
31,15,8,473,256,217,84.765625
31,15,9,1493,512,981,191.6015625
31,15,10,891,1024,-133,-12.98828125
31,15,11,2982,2048,934,45.60546875
31,15,12,3661,4096,-435,-10.6201171875
31,15,13,15602,8192,7410,90.4541015625
31,15,14,21203,16384,4819,29.412841796875
31,15,15,13571,32768,-19197,-58.5845947265625
31,16,1,0,2,-2,-100.0
31,16,2,1,4,-3,-75.0
31,16,3,3,8,-5,-62.5
31,16,4,9,16,-7,-43.75
31,16,5,8,32,-24,-75.0
31,16,6,28,64,-36,-56.25
31,16,7,459,128,331,258.59375
31,16,8,284,256,28,10.9375
31,16,9,646,512,134,26.171875
31,16,10,683,1024,-341,-33.30078125
31,16,11,394,2048,-1654,-80.76171875
31,16,12,3639,4096,-457,-11.1572265625
31,16,13,3693,8192,-4499,-54.91943359375
31,16,14,1336,16384,-15048,-91.845703125
31,16,15,80717,32768,47949,146.3287353515625
31,17,1,0,2,-2,-100.0
31,17,2,2,4,-2,-50.0
31,17,3,6,8,-2,-25.0
31,17,4,3,16,-13,-81.25
31,17,5,61,32,29,90.625
31,17,6,26,64,-38,-59.375
31,17,7,30,128,-98,-76.5625
31,17,8,128,256,-128,-50.0
31,17,9,867,512,355,69.3359375
31,17,10,326,1024,-698,-68.1640625
31,17,11,1627,2048,-421,-20.556640625
31,17,12,299,4096,-3797,-92.7001953125
31,17,13,8494,8192,302,3.6865234375
31,17,14,68484,16384,52100,317.9931640625
31,17,15,24404,32768,-8364,-25.52490234375
31,18,1,0,2,-2,-100.0
31,18,2,6,4,2,50.0
31,18,3,9,8,1,12.5
31,18,4,68,16,52,325.0
31,18,5,12,32,-20,-62.5
31,18,6,120,64,56,87.5
31,18,7,357,128,229,178.90625
31,18,8,103,256,-153,-59.765625
31,18,9,1387,512,875,170.8984375
31,18,10,383,1024,-641,-62.59765625
31,18,11,6310,2048,4262,208.10546875
31,18,12,2413,4096,-1683,-41.0888671875
31,18,13,1777,8192,-6415,-78.30810546875
31,18,14,19852,16384,3468,21.1669921875
31,18,15,12323,32768,-20445,-62.3931884765625
31,19,1,0,2,-2,-100.0
31,19,2,3,4,-1,-25.0
31,19,3,13,8,5,62.5
31,19,4,17,16,1,6.25
31,19,5,23,32,-9,-28.125
31,19,6,8,64,-56,-87.5
31,19,7,6,128,-122,-95.3125
31,19,8,170,256,-86,-33.59375
31,19,9,256,512,-256,-50.0
31,19,10,1604,1024,580,56.640625
31,19,11,259,2048,-1789,-87.353515625
31,19,12,9981,4096,5885,143.6767578125
31,19,13,3498,8192,-4694,-57.2998046875
31,19,14,10134,16384,-6250,-38.14697265625
31,19,15,22711,32768,-10057,-30.6915283203125
31,20,1,0,2,-2,-100.0
31,20,2,1,4,-3,-75.0
31,20,3,7,8,-1,-12.5
31,20,4,7,16,-9,-56.25
31,20,5,12,32,-20,-62.5
31,20,6,12,64,-52,-81.25
31,20,7,79,128,-49,-38.28125
31,20,8,45,256,-211,-82.421875
31,20,9,268,512,-244,-47.65625
31,20,10,437,1024,-587,-57.32421875
31,20,11,2610,2048,562,27.44140625
31,20,12,2186,4096,-1910,-46.630859375
31,20,13,7664,8192,-528,-6.4453125
31,20,14,17983,16384,1599,9.759521484375
31,20,15,30294,32768,-2474,-7.550048828125
31,21,1,0,2,-2,-100.0
31,21,2,2,4,-2,-50.0
31,21,3,5,8,-3,-37.5
31,21,4,21,16,5,31.25
31,21,5,7,32,-25,-78.125
31,21,6,26,64,-38,-59.375
31,21,7,154,128,26,20.3125
31,21,8,324,256,68,26.5625
31,21,9,92,512,-420,-82.03125
31,21,10,778,1024,-246,-24.0234375
31,21,11,52,2048,-1996,-97.4609375
31,21,12,2905,4096,-1191,-29.0771484375
31,21,13,18868,8192,10676,130.322265625
31,21,14,796,16384,-15588,-95.1416015625
31,21,15,2112,32768,-30656,-93.5546875
31,22,1,0,2,-2,-100.0
31,22,2,1,4,-3,-75.0
31,22,3,14,8,6,75.0
31,22,4,16,16,0,0.0
31,22,5,9,32,-23,-71.875
31,22,6,48,64,-16,-25.0
31,22,7,125,128,-3,-2.34375
31,22,8,307,256,51,19.921875
31,22,9,853,512,341,66.6015625
31,22,10,3054,1024,2030,198.2421875
31,22,11,1915,2048,-133,-6.494140625
31,22,12,707,4096,-3389,-82.7392578125
31,22,13,4500,8192,-3692,-45.068359375
31,22,14,3917,16384,-12467,-76.092529296875
31,22,15,44039,32768,11271,34.3963623046875
31,23,1,0,2,-2,-100.0
31,23,2,2,4,-2,-50.0
31,23,3,4,8,-4,-50.0
31,23,4,7,16,-9,-56.25
31,23,5,21,32,-11,-34.375
31,23,6,45,64,-19,-29.6875
31,23,7,12,128,-116,-90.625
31,23,8,24,256,-232,-90.625
31,23,9,324,512,-188,-36.71875
31,23,10,511,1024,-513,-50.09765625
31,23,11,510,2048,-1538,-75.09765625
31,23,12,9531,4096,5435,132.6904296875
31,23,13,2167,8192,-6025,-73.54736328125
31,23,14,10034,16384,-6350,-38.75732421875
31,23,15,29259,32768,-3509,-10.7086181640625
31,24,1,0,2,-2,-100.0
31,24,2,1,4,-3,-75.0
31,24,3,2,8,-6,-75.0
31,24,4,13,16,-3,-18.75
31,24,5,7,32,-25,-78.125
31,24,6,31,64,-33,-51.5625
31,24,7,88,128,-40,-31.25
31,24,8,56,256,-200,-78.125
31,24,9,195,512,-317,-61.9140625
31,24,10,1854,1024,830,81.0546875
31,24,11,4203,2048,2155,105.224609375
31,24,12,1645,4096,-2451,-59.8388671875
31,24,13,6498,8192,-1694,-20.6787109375
31,24,14,6344,16384,-10040,-61.279296875
31,24,15,46098,32768,13330,40.679931640625
31,25,1,0,2,-2,-100.0
31,25,2,4,4,0,0.0
31,25,3,3,8,-5,-62.5
31,25,4,3,16,-13,-81.25
31,25,5,9,32,-23,-71.875
31,25,6,91,64,27,42.1875
31,25,7,9,128,-119,-92.96875
31,25,8,265,256,9,3.515625
31,25,9,136,512,-376,-73.4375
31,25,10,1858,1024,834,81.4453125
31,25,11,503,2048,-1545,-75.439453125
31,25,12,9604,4096,5508,134.47265625
31,25,13,15266,8192,7074,86.3525390625
31,25,14,27149,16384,10765,65.704345703125
31,25,15,8228,32768,-24540,-74.89013671875
31,26,1,0,2,-2,-100.0
31,26,2,2,4,-2,-50.0
31,26,3,11,8,3,37.5
31,26,4,4,16,-12,-75.0
31,26,5,21,32,-11,-34.375
31,26,6,18,64,-46,-71.875
31,26,7,181,128,53,41.40625
31,26,8,1065,256,809,316.015625
31,26,9,322,512,-190,-37.109375
31,26,10,614,1024,-410,-40.0390625
31,26,11,702,2048,-1346,-65.72265625
31,26,12,2016,4096,-2080,-50.78125
31,26,13,18780,8192,10588,129.248046875
31,26,14,10047,16384,-6337,-38.677978515625
31,26,15,9701,32768,-23067,-70.3948974609375
31,27,1,0,2,-2,-100.0
31,27,2,1,4,-3,-75.0
31,27,3,2,8,-6,-75.0
31,27,4,4,16,-12,-75.0
31,27,5,62,32,30,93.75
31,27,6,19,64,-45,-70.3125
31,27,7,278,128,150,117.1875
31,27,8,624,256,368,143.75
31,27,9,268,512,-244,-47.65625
31,27,10,5244,1024,4220,412.109375
31,27,11,260,2048,-1788,-87.3046875
31,27,12,2752,4096,-1344,-32.8125
31,27,13,1649,8192,-6543,-79.87060546875
31,27,14,15717,16384,-667,-4.071044921875
31,27,15,37953,32768,5185,15.8233642578125
31,28,1,0,2,-2,-100.0
31,28,2,5,4,1,25.0
31,28,3,4,8,-4,-50.0
31,28,4,39,16,23,143.75
31,28,5,78,32,46,143.75
31,28,6,47,64,-17,-26.5625
31,28,7,117,128,-11,-8.59375
31,28,8,1556,256,1300,507.8125
31,28,9,352,512,-160,-31.25
31,28,10,3868,1024,2844,277.734375
31,28,11,3021,2048,973,47.509765625
31,28,12,10787,4096,6691,163.3544921875
31,28,13,8592,8192,400,4.8828125
31,28,14,4981,16384,-11403,-69.598388671875
31,28,15,2238,32768,-30530,-93.170166015625
31,29,1,0,2,-2,-100.0
31,29,2,1,4,-3,-75.0
31,29,3,5,8,-3,-37.5
31,29,4,59,16,43,268.75
31,29,5,30,32,-2,-6.25
31,29,6,327,64,263,410.9375
31,29,7,290,128,162,126.5625
31,29,8,27,256,-229,-89.453125
31,29,9,46,512,-466,-91.015625
31,29,10,2224,1024,1200,117.1875
31,29,11,1111,2048,-937,-45.751953125
31,29,12,616,4096,-3480,-84.9609375
31,29,13,3259,8192,-4933,-60.21728515625
31,29,14,7896,16384,-8488,-51.806640625
31,29,15,7805,32768,-24963,-76.1810302734375
31,30,1,0,2,-2,-100.0
31,30,2,2,4,-2,-50.0
31,30,3,9,8,1,12.5
31,30,4,34,16,18,112.5
31,30,5,27,32,-5,-15.625
31,30,6,153,64,89,139.0625
31,30,7,215,128,87,67.96875
31,30,8,136,256,-120,-46.875
31,30,9,23,512,-489,-95.5078125
31,30,10,2637,1024,1613,157.51953125
31,30,11,1098,2048,-950,-46.38671875
31,30,12,6393,4096,2297,56.0791015625
31,30,13,1272,8192,-6920,-84.47265625
31,30,14,3677,16384,-12707,-77.557373046875
31,30,15,29491,32768,-3277,-10.0006103515625
31,31,1,0,2,-2,-100.0
31,31,2,2,4,-2,-50.0
31,31,3,4,8,-4,-50.0
31,31,4,20,16,4,25.0
31,31,5,28,32,-4,-12.5
31,31,6,138,64,74,115.625
31,31,7,202,128,74,57.8125
31,31,8,34,256,-222,-86.71875
31,31,9,1512,512,1000,195.3125
31,31,10,630,1024,-394,-38.4765625
31,31,11,7391,2048,5343,260.888671875
31,31,12,206,4096,-3890,-94.970703125
31,31,13,6253,8192,-1939,-23.66943359375
31,31,14,47421,16384,31037,189.434814453125
31,31,15,52660,32768,19892,60.70556640625
32,1,1,0,2,-2,-100.0
32,1,2,1,4,-3,-75.0
32,1,3,4,8,-4,-50.0
32,1,4,12,16,-4,-25.0
32,1,5,28,32,-4,-12.5
32,1,6,44,64,-20,-31.25
32,1,7,167,128,39,30.46875
32,1,8,34,256,-222,-86.71875
32,1,9,53,512,-459,-89.6484375
32,1,10,2764,1024,1740,169.921875
32,1,11,2844,2048,796,38.8671875
32,1,12,6699,4096,2603,63.5498046875
32,1,13,1967,8192,-6225,-75.98876953125
32,1,14,5209,16384,-11175,-68.206787109375
32,1,15,11617,32768,-21151,-64.5477294921875
32,2,1,0,2,-2,-100.0
32,2,2,1,4,-3,-75.0
32,2,3,6,8,-2,-25.0
32,2,4,20,16,4,25.0
32,2,5,25,32,-7,-21.875
32,2,6,6,64,-58,-90.625
32,2,7,184,128,56,43.75
32,2,8,100,256,-156,-60.9375
32,2,9,224,512,-288,-56.25
32,2,10,589,1024,-435,-42.48046875
32,2,11,3303,2048,1255,61.279296875
32,2,12,1335,4096,-2761,-67.4072265625
32,2,13,558,8192,-7634,-93.1884765625
32,2,14,5089,16384,-11295,-68.939208984375
32,2,15,3730,32768,-29038,-88.616943359375
32,3,1,0,2,-2,-100.0
32,3,2,1,4,-3,-75.0
32,3,3,2,8,-6,-75.0
32,3,4,11,16,-5,-31.25
32,3,5,15,32,-17,-53.125
32,3,6,29,64,-35,-54.6875
32,3,7,79,128,-49,-38.28125
32,3,8,139,256,-117,-45.703125
32,3,9,77,512,-435,-84.9609375
32,3,10,2419,1024,1395,136.23046875
32,3,11,8098,2048,6050,295.41015625
32,3,12,18335,4096,14239,347.6318359375
32,3,13,11930,8192,3738,45.6298828125
32,3,14,14443,16384,-1941,-11.846923828125
32,3,15,145356,32768,112588,343.59130859375
32,4,1,0,2,-2,-100.0
32,4,2,1,4,-3,-75.0
32,4,3,9,8,1,12.5
32,4,4,5,16,-11,-68.75
32,4,5,8,32,-24,-75.0
32,4,6,239,64,175,273.4375
32,4,7,12,128,-116,-90.625
32,4,8,222,256,-34,-13.28125
32,4,9,429,512,-83,-16.2109375
32,4,10,1612,1024,588,57.421875
32,4,11,3686,2048,1638,79.98046875
32,4,12,6266,4096,2170,52.978515625
32,4,13,14224,8192,6032,73.6328125
32,4,14,5623,16384,-10761,-65.679931640625
32,4,15,73820,32768,41052,125.28076171875
32,5,1,0,2,-2,-100.0
32,5,2,2,4,-2,-50.0
32,5,3,13,8,5,62.5
32,5,4,18,16,2,12.5
32,5,5,4,32,-28,-87.5
32,5,6,12,64,-52,-81.25
32,5,7,50,128,-78,-60.9375
32,5,8,76,256,-180,-70.3125
32,5,9,46,512,-466,-91.015625
32,5,10,322,1024,-702,-68.5546875
32,5,11,2206,2048,158,7.71484375
32,5,12,86,4096,-4010,-97.900390625
32,5,13,1752,8192,-6440,-78.61328125
32,5,14,15784,16384,-600,-3.662109375
32,5,15,40409,32768,7641,23.3184814453125
32,6,1,0,2,-2,-100.0
32,6,2,2,4,-2,-50.0
32,6,3,10,8,2,25.0
32,6,4,13,16,-3,-18.75
32,6,5,31,32,-1,-3.125
32,6,6,39,64,-25,-39.0625
32,6,7,51,128,-77,-60.15625
32,6,8,97,256,-159,-62.109375
32,6,9,802,512,290,56.640625
32,6,10,1817,1024,793,77.44140625
32,6,11,511,2048,-1537,-75.048828125
32,6,12,2305,4096,-1791,-43.7255859375
32,6,13,316,8192,-7876,-96.142578125
32,6,14,13434,16384,-2950,-18.00537109375
32,6,15,4810,32768,-27958,-85.321044921875
32,7,1,0,2,-2,-100.0
32,7,2,1,4,-3,-75.0
32,7,3,3,8,-5,-62.5
32,7,4,17,16,1,6.25
32,7,5,19,32,-13,-40.625
32,7,6,171,64,107,167.1875
32,7,7,63,128,-65,-50.78125
32,7,8,194,256,-62,-24.21875
32,7,9,2514,512,2002,391.015625
32,7,10,313,1024,-711,-69.43359375
32,7,11,448,2048,-1600,-78.125
32,7,12,193,4096,-3903,-95.2880859375
32,7,13,7392,8192,-800,-9.765625
32,7,14,14193,16384,-2191,-13.372802734375
32,7,15,12037,32768,-20731,-63.2659912109375
32,8,1,0,2,-2,-100.0
32,8,2,2,4,-2,-50.0
32,8,3,6,8,-2,-25.0
32,8,4,6,16,-10,-62.5
32,8,5,40,32,8,25.0
32,8,6,8,64,-56,-87.5
32,8,7,157,128,29,22.65625
32,8,8,55,256,-201,-78.515625
32,8,9,73,512,-439,-85.7421875
32,8,10,58,1024,-966,-94.3359375
32,8,11,162,2048,-1886,-92.08984375
32,8,12,4571,4096,475,11.5966796875
32,8,13,242,8192,-7950,-97.0458984375
32,8,14,11657,16384,-4727,-28.851318359375
32,8,15,139384,32768,106616,325.3662109375
32,9,1,0,2,-2,-100.0
32,9,2,1,4,-3,-75.0
32,9,3,16,8,8,100.0
32,9,4,26,16,10,62.5
32,9,5,79,32,47,146.875
32,9,6,90,64,26,40.625
32,9,7,77,128,-51,-39.84375
32,9,8,425,256,169,66.015625
32,9,9,157,512,-355,-69.3359375
32,9,10,270,1024,-754,-73.6328125
32,9,11,337,2048,-1711,-83.544921875
32,9,12,182,4096,-3914,-95.556640625
32,9,13,3798,8192,-4394,-53.6376953125
32,9,14,5938,16384,-10446,-63.75732421875
32,9,15,59597,32768,26829,81.8756103515625
32,10,1,0,2,-2,-100.0
32,10,2,1,4,-3,-75.0
32,10,3,10,8,2,25.0
32,10,4,3,16,-13,-81.25
32,10,5,46,32,14,43.75
32,10,6,154,64,90,140.625
32,10,7,35,128,-93,-72.65625
32,10,8,17,256,-239,-93.359375
32,10,9,299,512,-213,-41.6015625
32,10,10,2170,1024,1146,111.9140625
32,10,11,1488,2048,-560,-27.34375
32,10,12,1958,4096,-2138,-52.197265625
32,10,13,2230,8192,-5962,-72.7783203125
32,10,14,8015,16384,-8369,-51.080322265625
32,10,15,34751,32768,1983,6.0516357421875
32,11,1,0,2,-2,-100.0
32,11,2,2,4,-2,-50.0
32,11,3,7,8,-1,-12.5
32,11,4,15,16,-1,-6.25
32,11,5,12,32,-20,-62.5
32,11,6,12,64,-52,-81.25
32,11,7,281,128,153,119.53125
32,11,8,189,256,-67,-26.171875
32,11,9,696,512,184,35.9375
32,11,10,267,1024,-757,-73.92578125
32,11,11,2281,2048,233,11.376953125
32,11,12,150,4096,-3946,-96.337890625
32,11,13,71,8192,-8121,-99.13330078125
32,11,14,18747,16384,2363,14.422607421875
32,11,15,72918,32768,40150,122.528076171875
32,12,1,0,2,-2,-100.0
32,12,2,1,4,-3,-75.0
32,12,3,3,8,-5,-62.5
32,12,4,48,16,32,200.0
32,12,5,23,32,-9,-28.125
32,12,6,61,64,-3,-4.6875
32,12,7,253,128,125,97.65625
32,12,8,153,256,-103,-40.234375
32,12,9,65,512,-447,-87.3046875
32,12,10,988,1024,-36,-3.515625
32,12,11,409,2048,-1639,-80.029296875
32,12,12,1692,4096,-2404,-58.69140625
32,12,13,9573,8192,1381,16.85791015625
32,12,14,1188,16384,-15196,-92.7490234375
32,12,15,32094,32768,-674,-2.056884765625
32,13,1,0,2,-2,-100.0
32,13,2,3,4,-1,-25.0
32,13,3,2,8,-6,-75.0
32,13,4,18,16,2,12.5
32,13,5,45,32,13,40.625
32,13,6,130,64,66,103.125
32,13,7,78,128,-50,-39.0625
32,13,8,291,256,35,13.671875
32,13,9,796,512,284,55.46875
32,13,10,258,1024,-766,-74.8046875
32,13,11,2273,2048,225,10.986328125
32,13,12,5311,4096,1215,29.6630859375
32,13,13,7079,8192,-1113,-13.58642578125
32,13,14,166,16384,-16218,-98.98681640625
32,13,15,14294,32768,-18474,-56.378173828125
32,14,1,0,2,-2,-100.0
32,14,2,2,4,-2,-50.0
32,14,3,9,8,1,12.5
32,14,4,11,16,-5,-31.25
32,14,5,31,32,-1,-3.125
32,14,6,6,64,-58,-90.625
32,14,7,117,128,-11,-8.59375
32,14,8,32,256,-224,-87.5
32,14,9,557,512,45,8.7890625
32,14,10,582,1024,-442,-43.1640625
32,14,11,1539,2048,-509,-24.853515625
32,14,12,3018,4096,-1078,-26.318359375
32,14,13,1007,8192,-7185,-87.70751953125
32,14,14,3940,16384,-12444,-75.9521484375
32,14,15,34995,32768,2227,6.7962646484375
32,15,1,0,2,-2,-100.0
32,15,2,1,4,-3,-75.0
32,15,3,4,8,-4,-50.0
32,15,4,15,16,-1,-6.25
32,15,5,27,32,-5,-15.625
32,15,6,83,64,19,29.6875
32,15,7,380,128,252,196.875
32,15,8,45,256,-211,-82.421875
32,15,9,837,512,325,63.4765625
32,15,10,344,1024,-680,-66.40625
32,15,11,1378,2048,-670,-32.71484375
32,15,12,1194,4096,-2902,-70.849609375
32,15,13,5239,8192,-2953,-36.04736328125
32,15,14,10926,16384,-5458,-33.31298828125
32,15,15,6800,32768,-25968,-79.248046875
32,16,1,0,2,-2,-100.0
32,16,2,1,4,-3,-75.0
32,16,3,11,8,3,37.5
32,16,4,22,16,6,37.5
32,16,5,62,32,30,93.75
32,16,6,39,64,-25,-39.0625
32,16,7,204,128,76,59.375
32,16,8,241,256,-15,-5.859375
32,16,9,2175,512,1663,324.8046875
32,16,10,231,1024,-793,-77.44140625
32,16,11,7453,2048,5405,263.916015625
32,16,12,3966,4096,-130,-3.173828125
32,16,13,9721,8192,1529,18.66455078125
32,16,14,2513,16384,-13871,-84.661865234375
32,16,15,1755,32768,-31013,-94.6441650390625
32,17,1,0,2,-2,-100.0
32,17,2,2,4,-2,-50.0
32,17,3,8,8,0,0.0
32,17,4,5,16,-11,-68.75
32,17,5,17,32,-15,-46.875
32,17,6,60,64,-4,-6.25
32,17,7,345,128,217,169.53125
32,17,8,157,256,-99,-38.671875
32,17,9,1370,512,858,167.578125
32,17,10,24,1024,-1000,-97.65625
32,17,11,945,2048,-1103,-53.857421875
32,17,12,3551,4096,-545,-13.3056640625
32,17,13,8382,8192,190,2.3193359375
32,17,14,64988,16384,48604,296.6552734375
32,17,15,26017,32768,-6751,-20.6024169921875
32,18,1,0,2,-2,-100.0
32,18,2,1,4,-3,-75.0
32,18,3,26,8,18,225.0
32,18,4,11,16,-5,-31.25
32,18,5,56,32,24,75.0
32,18,6,130,64,66,103.125
32,18,7,201,128,73,57.03125
32,18,8,470,256,214,83.59375
32,18,9,1482,512,970,189.453125
32,18,10,291,1024,-733,-71.58203125
32,18,11,496,2048,-1552,-75.78125
32,18,12,2192,4096,-1904,-46.484375
32,18,13,1964,8192,-6228,-76.025390625
32,18,14,40,16384,-16344,-99.755859375
32,18,15,20279,32768,-12489,-38.1134033203125
32,19,1,0,2,-2,-100.0
32,19,2,7,4,3,75.0
32,19,3,12,8,4,50.0
32,19,4,8,16,-8,-50.0
32,19,5,4,32,-28,-87.5
32,19,6,267,64,203,317.1875
32,19,7,84,128,-44,-34.375
32,19,8,686,256,430,167.96875
32,19,9,203,512,-309,-60.3515625
32,19,10,1147,1024,123,12.01171875
32,19,11,722,2048,-1326,-64.74609375
32,19,12,2046,4096,-2050,-50.048828125
32,19,13,5506,8192,-2686,-32.7880859375
32,19,14,29712,16384,13328,81.34765625
32,19,15,10339,32768,-22429,-68.4478759765625
32,20,1,0,2,-2,-100.0
32,20,2,1,4,-3,-75.0
32,20,3,5,8,-3,-37.5
32,20,4,3,16,-13,-81.25
32,20,5,6,32,-26,-81.25
32,20,6,23,64,-41,-64.0625
32,20,7,200,128,72,56.25
32,20,8,329,256,73,28.515625
32,20,9,792,512,280,54.6875
32,20,10,787,1024,-237,-23.14453125
32,20,11,1825,2048,-223,-10.888671875
32,20,12,1703,4096,-2393,-58.4228515625
32,20,13,1578,8192,-6614,-80.7373046875
32,20,14,16776,16384,392,2.392578125
32,20,15,9975,32768,-22793,-69.5587158203125
32,21,1,0,2,-2,-100.0
32,21,2,1,4,-3,-75.0
32,21,3,11,8,3,37.5
32,21,4,8,16,-8,-50.0
32,21,5,23,32,-9,-28.125
32,21,6,40,64,-24,-37.5
32,21,7,22,128,-106,-82.8125
32,21,8,105,256,-151,-58.984375
32,21,9,51,512,-461,-90.0390625
32,21,10,339,1024,-685,-66.89453125
32,21,11,8450,2048,6402,312.59765625
32,21,12,240,4096,-3856,-94.140625
32,21,13,9101,8192,909,11.09619140625
32,21,14,22422,16384,6038,36.85302734375
32,21,15,73767,32768,40999,125.1190185546875
32,22,1,0,2,-2,-100.0
32,22,2,1,4,-3,-75.0
32,22,3,6,8,-2,-25.0
32,22,4,3,16,-13,-81.25
32,22,5,46,32,14,43.75
32,22,6,45,64,-19,-29.6875
32,22,7,236,128,108,84.375
32,22,8,437,256,181,70.703125
32,22,9,35,512,-477,-93.1640625
32,22,10,1323,1024,299,29.19921875
32,22,11,125,2048,-1923,-93.896484375
32,22,12,282,4096,-3814,-93.115234375
32,22,13,3963,8192,-4229,-51.62353515625
32,22,14,15341,16384,-1043,-6.365966796875
32,22,15,4015,32768,-28753,-87.7471923828125
32,23,1,0,2,-2,-100.0
32,23,2,1,4,-3,-75.0
32,23,3,2,8,-6,-75.0
32,23,4,5,16,-11,-68.75
32,23,5,23,32,-9,-28.125
32,23,6,6,64,-58,-90.625
32,23,7,65,128,-63,-49.21875
32,23,8,56,256,-200,-78.125
32,23,9,359,512,-153,-29.8828125
32,23,10,870,1024,-154,-15.0390625
32,23,11,475,2048,-1573,-76.806640625
32,23,12,458,4096,-3638,-88.818359375
32,23,13,3535,8192,-4657,-56.84814453125
32,23,14,3873,16384,-12511,-76.361083984375
32,23,15,2699,32768,-30069,-91.7633056640625
32,24,1,0,2,-2,-100.0
32,24,2,4,4,0,0.0
32,24,3,13,8,5,62.5
32,24,4,22,16,6,37.5
32,24,5,48,32,16,50.0
32,24,6,103,64,39,60.9375
32,24,7,16,128,-112,-87.5
32,24,8,225,256,-31,-12.109375
32,24,9,619,512,107,20.8984375
32,24,10,272,1024,-752,-73.4375
32,24,11,4846,2048,2798,136.62109375
32,24,12,3757,4096,-339,-8.2763671875
32,24,13,13889,8192,5697,69.54345703125
32,24,14,2885,16384,-13499,-82.391357421875
32,24,15,8948,32768,-23820,-72.69287109375
32,25,1,0,2,-2,-100.0
32,25,2,3,4,-1,-25.0
32,25,3,2,8,-6,-75.0
32,25,4,27,16,11,68.75
32,25,5,4,32,-28,-87.5
32,25,6,45,64,-19,-29.6875
32,25,7,44,128,-84,-65.625
32,25,8,181,256,-75,-29.296875
32,25,9,403,512,-109,-21.2890625
32,25,10,747,1024,-277,-27.05078125
32,25,11,876,2048,-1172,-57.2265625
32,25,12,282,4096,-3814,-93.115234375
32,25,13,16298,8192,8106,98.9501953125
32,25,14,44549,16384,28165,171.905517578125
32,25,15,43207,32768,10439,31.8572998046875
32,26,1,0,2,-2,-100.0
32,26,2,1,4,-3,-75.0
32,26,3,8,8,0,0.0
32,26,4,3,16,-13,-81.25
32,26,5,64,32,32,100.0
32,26,6,6,64,-58,-90.625
32,26,7,52,128,-76,-59.375
32,26,8,773,256,517,201.953125
32,26,9,1797,512,1285,250.9765625
32,26,10,430,1024,-594,-58.0078125
32,26,11,5723,2048,3675,179.443359375
32,26,12,685,4096,-3411,-83.2763671875
32,26,13,10737,8192,2545,31.06689453125
32,26,14,8003,16384,-8381,-51.153564453125
32,26,15,26590,32768,-6178,-18.853759765625
32,27,1,0,2,-2,-100.0
32,27,2,1,4,-3,-75.0
32,27,3,16,8,8,100.0
32,27,4,17,16,1,6.25
32,27,5,22,32,-10,-31.25
32,27,6,117,64,53,82.8125
32,27,7,162,128,34,26.5625
32,27,8,787,256,531,207.421875
32,27,9,372,512,-140,-27.34375
32,27,10,307,1024,-717,-70.01953125
32,27,11,933,2048,-1115,-54.443359375
32,27,12,6219,4096,2123,51.8310546875
32,27,13,3355,8192,-4837,-59.04541015625
32,27,14,18382,16384,1998,12.19482421875
32,27,15,17942,32768,-14826,-45.245361328125
32,28,1,0,2,-2,-100.0
32,28,2,3,4,-1,-25.0
32,28,3,2,8,-6,-75.0
32,28,4,33,16,17,106.25
32,28,5,20,32,-12,-37.5
32,28,6,94,64,30,46.875
32,28,7,93,128,-35,-27.34375
32,28,8,480,256,224,87.5
32,28,9,356,512,-156,-30.46875
32,28,10,14,1024,-1010,-98.6328125
32,28,11,3226,2048,1178,57.51953125
32,28,12,820,4096,-3276,-79.98046875
32,28,13,3555,8192,-4637,-56.60400390625
32,28,14,4988,16384,-11396,-69.5556640625
32,28,15,78187,32768,45419,138.6077880859375
32,29,1,0,2,-2,-100.0
32,29,2,3,4,-1,-25.0
32,29,3,4,8,-4,-50.0
32,29,4,3,16,-13,-81.25
32,29,5,18,32,-14,-43.75
32,29,6,86,64,22,34.375
32,29,7,23,128,-105,-82.03125
32,29,8,168,256,-88,-34.375
32,29,9,182,512,-330,-64.453125
32,29,10,2021,1024,997,97.36328125
32,29,11,1044,2048,-1004,-49.0234375
32,29,12,8682,4096,4586,111.962890625
32,29,13,4999,8192,-3193,-38.97705078125
32,29,14,14637,16384,-1747,-10.662841796875
32,29,15,1575,32768,-31193,-95.1934814453125
32,30,1,0,2,-2,-100.0
32,30,2,1,4,-3,-75.0
32,30,3,6,8,-2,-25.0
32,30,4,15,16,-1,-6.25
32,30,5,5,32,-27,-84.375
32,30,6,61,64,-3,-4.6875
32,30,7,118,128,-10,-7.8125
32,30,8,64,256,-192,-75.0
32,30,9,984,512,472,92.1875
32,30,10,1189,1024,165,16.11328125
32,30,11,1500,2048,-548,-26.7578125
32,30,12,4569,4096,473,11.5478515625
32,30,13,6028,8192,-2164,-26.416015625
32,30,14,4812,16384,-11572,-70.6298828125
32,30,15,21,32768,-32747,-99.9359130859375
32,31,1,0,2,-2,-100.0
32,31,2,4,4,0,0.0
32,31,3,9,8,1,12.5
32,31,4,3,16,-13,-81.25
32,31,5,12,32,-20,-62.5
32,31,6,56,64,-8,-12.5
32,31,7,89,128,-39,-30.46875
32,31,8,14,256,-242,-94.53125
32,31,9,71,512,-441,-86.1328125
32,31,10,760,1024,-264,-25.78125
32,31,11,3410,2048,1362,66.50390625
32,31,12,1296,4096,-2800,-68.359375
32,31,13,294,8192,-7898,-96.4111328125
32,31,14,7770,16384,-8614,-52.57568359375
32,31,15,8139,32768,-24629,-75.1617431640625
32,32,1,0,2,-2,-100.0
32,32,2,5,4,1,25.0
32,32,3,19,8,11,137.5
32,32,4,28,16,12,75.0
32,32,5,4,32,-28,-87.5
32,32,6,20,64,-44,-68.75
32,32,7,78,128,-50,-39.0625
32,32,8,323,256,67,26.171875
32,32,9,1206,512,694,135.546875
32,32,10,1071,1024,47,4.58984375
32,32,11,403,2048,-1645,-80.322265625
32,32,12,1622,4096,-2474,-60.400390625
32,32,13,1405,8192,-6787,-82.84912109375
32,32,14,20573,16384,4189,25.567626953125
32,32,15,42164,32768,9396,28.67431640625
33,1,1,0,2,-2,-100.0
33,1,2,3,4,-1,-25.0
33,1,3,11,8,3,37.5
33,1,4,7,16,-9,-56.25
33,1,5,90,32,58,181.25
33,1,6,111,64,47,73.4375
33,1,7,68,128,-60,-46.875
33,1,8,317,256,61,23.828125
33,1,9,1328,512,816,159.375
33,1,10,200,1024,-824,-80.46875
33,1,11,1120,2048,-928,-45.3125
33,1,12,671,4096,-3425,-83.6181640625
33,1,13,125,8192,-8067,-98.47412109375
33,1,14,23994,16384,7610,46.44775390625
33,1,15,2762,32768,-30006,-91.571044921875
33,2,1,0,2,-2,-100.0
33,2,2,5,4,1,25.0
33,2,3,20,8,12,150.0
33,2,4,4,16,-12,-75.0
33,2,5,11,32,-21,-65.625
33,2,6,10,64,-54,-84.375
33,2,7,16,128,-112,-87.5
33,2,8,68,256,-188,-73.4375
33,2,9,225,512,-287,-56.0546875
33,2,10,543,1024,-481,-46.97265625
33,2,11,3926,2048,1878,91.69921875
33,2,12,11164,4096,7068,172.55859375
33,2,13,1101,8192,-7091,-86.56005859375
33,2,14,47808,16384,31424,191.796875
33,2,15,25285,32768,-7483,-22.8363037109375
33,3,1,0,2,-2,-100.0
33,3,2,3,4,-1,-25.0
33,3,3,5,8,-3,-37.5
33,3,4,26,16,10,62.5
33,3,5,15,32,-17,-53.125
33,3,6,79,64,15,23.4375
33,3,7,173,128,45,35.15625
33,3,8,239,256,-17,-6.640625
33,3,9,582,512,70,13.671875
33,3,10,360,1024,-664,-64.84375
33,3,11,773,2048,-1275,-62.255859375
33,3,12,1154,4096,-2942,-71.826171875
33,3,13,20802,8192,12610,153.9306640625
33,3,14,7100,16384,-9284,-56.6650390625
33,3,15,2692,32768,-30076,-91.78466796875
33,4,1,0,2,-2,-100.0
33,4,2,2,4,-2,-50.0
33,4,3,3,8,-5,-62.5
33,4,4,7,16,-9,-56.25
33,4,5,130,32,98,306.25
33,4,6,105,64,41,64.0625
33,4,7,19,128,-109,-85.15625
33,4,8,519,256,263,102.734375
33,4,9,238,512,-274,-53.515625
33,4,10,712,1024,-312,-30.46875
33,4,11,9359,2048,7311,356.982421875
33,4,12,1341,4096,-2755,-67.2607421875
33,4,13,12287,8192,4095,49.98779296875
33,4,14,18762,16384,2378,14.51416015625
33,4,15,4699,32768,-28069,-85.6597900390625
33,5,1,0,2,-2,-100.0
33,5,2,1,4,-3,-75.0
33,5,3,2,8,-6,-75.0
33,5,4,29,16,13,81.25
33,5,5,8,32,-24,-75.0
33,5,6,121,64,57,89.0625
33,5,7,346,128,218,170.3125
33,5,8,7,256,-249,-97.265625
33,5,9,385,512,-127,-24.8046875
33,5,10,3814,1024,2790,272.4609375
33,5,11,3931,2048,1883,91.943359375
33,5,12,4812,4096,716,17.48046875
33,5,13,5465,8192,-2727,-33.28857421875
33,5,14,28734,16384,12350,75.37841796875
33,5,15,67798,32768,35030,106.903076171875
33,6,1,0,2,-2,-100.0
33,6,2,1,4,-3,-75.0
33,6,3,2,8,-6,-75.0
33,6,4,65,16,49,306.25
33,6,5,4,32,-28,-87.5
33,6,6,39,64,-25,-39.0625
33,6,7,52,128,-76,-59.375
33,6,8,867,256,611,238.671875
33,6,9,224,512,-288,-56.25
33,6,10,1221,1024,197,19.23828125
33,6,11,1749,2048,-299,-14.599609375
33,6,12,303,4096,-3793,-92.6025390625
33,6,13,1672,8192,-6520,-79.58984375
33,6,14,32332,16384,15948,97.3388671875
33,6,15,5491,32768,-27277,-83.2427978515625
33,7,1,0,2,-2,-100.0
33,7,2,2,4,-2,-50.0
33,7,3,7,8,-1,-12.5
33,7,4,29,16,13,81.25
33,7,5,40,32,8,25.0
33,7,6,133,64,69,107.8125
33,7,7,82,128,-46,-35.9375
33,7,8,211,256,-45,-17.578125
33,7,9,1210,512,698,136.328125
33,7,10,123,1024,-901,-87.98828125
33,7,11,1312,2048,-736,-35.9375
33,7,12,2119,4096,-1977,-48.2666015625
33,7,13,2059,8192,-6133,-74.86572265625
33,7,14,28224,16384,11840,72.265625
33,7,15,122420,32768,89652,273.59619140625
33,8,1,0,2,-2,-100.0
33,8,2,3,4,-1,-25.0
33,8,3,2,8,-6,-75.0
33,8,4,9,16,-7,-43.75
33,8,5,5,32,-27,-84.375
33,8,6,55,64,-9,-14.0625
33,8,7,153,128,25,19.53125
33,8,8,45,256,-211,-82.421875
33,8,9,1105,512,593,115.8203125
33,8,10,1174,1024,150,14.6484375
33,8,11,220,2048,-1828,-89.2578125
33,8,12,1641,4096,-2455,-59.9365234375
33,8,13,2159,8192,-6033,-73.64501953125
33,8,14,39469,16384,23085,140.899658203125
33,8,15,121983,32768,89215,272.2625732421875
33,9,1,0,2,-2,-100.0
33,9,2,1,4,-3,-75.0
33,9,3,2,8,-6,-75.0
33,9,4,3,16,-13,-81.25
33,9,5,15,32,-17,-53.125
33,9,6,52,64,-12,-18.75
33,9,7,71,128,-57,-44.53125
33,9,8,485,256,229,89.453125
33,9,9,516,512,4,0.78125
33,9,10,2127,1024,1103,107.71484375
33,9,11,160,2048,-1888,-92.1875
33,9,12,1106,4096,-2990,-72.998046875
33,9,13,2485,8192,-5707,-69.66552734375
33,9,14,1035,16384,-15349,-93.682861328125
33,9,15,16452,32768,-16316,-49.79248046875
33,10,1,0,2,-2,-100.0
33,10,2,1,4,-3,-75.0
33,10,3,9,8,1,12.5
33,10,4,3,16,-13,-81.25
33,10,5,50,32,18,56.25
33,10,6,64,64,0,0.0
33,10,7,52,128,-76,-59.375
33,10,8,114,256,-142,-55.46875
33,10,9,1053,512,541,105.6640625
33,10,10,1567,1024,543,53.02734375
33,10,11,771,2048,-1277,-62.353515625
33,10,12,8188,4096,4092,99.90234375
33,10,13,106,8192,-8086,-98.7060546875
33,10,14,1309,16384,-15075,-92.010498046875
33,10,15,30570,32768,-2198,-6.707763671875
33,11,1,0,2,-2,-100.0
33,11,2,2,4,-2,-50.0
33,11,3,3,8,-5,-62.5
33,11,4,20,16,4,25.0
33,11,5,12,32,-20,-62.5
33,11,6,76,64,12,18.75
33,11,7,12,128,-116,-90.625
33,11,8,149,256,-107,-41.796875
33,11,9,122,512,-390,-76.171875
33,11,10,1516,1024,492,48.046875
33,11,11,2475,2048,427,20.849609375
33,11,12,13706,4096,9610,234.619140625
33,11,13,15507,8192,7315,89.29443359375
33,11,14,83,16384,-16301,-99.493408203125
33,11,15,55168,32768,22400,68.359375
33,12,1,0,2,-2,-100.0
33,12,2,1,4,-3,-75.0
33,12,3,2,8,-6,-75.0
33,12,4,6,16,-10,-62.5
33,12,5,21,32,-11,-34.375
33,12,6,17,64,-47,-73.4375
33,12,7,65,128,-63,-49.21875
33,12,8,172,256,-84,-32.8125
33,12,9,729,512,217,42.3828125
33,12,10,849,1024,-175,-17.08984375
33,12,11,3168,2048,1120,54.6875
33,12,12,5972,4096,1876,45.80078125
33,12,13,2735,8192,-5457,-66.61376953125
33,12,14,21363,16384,4979,30.389404296875
33,12,15,10620,32768,-22148,-67.59033203125
33,13,1,0,2,-2,-100.0
33,13,2,1,4,-3,-75.0
33,13,3,18,8,10,125.0
33,13,4,12,16,-4,-25.0
33,13,5,121,32,89,278.125
33,13,6,149,64,85,132.8125
33,13,7,152,128,24,18.75
33,13,8,357,256,101,39.453125
33,13,9,350,512,-162,-31.640625
33,13,10,545,1024,-479,-46.77734375
33,13,11,554,2048,-1494,-72.94921875
33,13,12,11286,4096,7190,175.537109375
33,13,13,27323,8192,19131,233.53271484375
33,13,14,18787,16384,2403,14.666748046875
33,13,15,26651,32768,-6117,-18.6676025390625
33,14,1,0,2,-2,-100.0
33,14,2,2,4,-2,-50.0
33,14,3,2,8,-6,-75.0
33,14,4,7,16,-9,-56.25
33,14,5,11,32,-21,-65.625
33,14,6,30,64,-34,-53.125
33,14,7,20,128,-108,-84.375
33,14,8,1114,256,858,335.15625
33,14,9,1976,512,1464,285.9375
33,14,10,379,1024,-645,-62.98828125
33,14,11,950,2048,-1098,-53.61328125
33,14,12,1988,4096,-2108,-51.46484375
33,14,13,14375,8192,6183,75.47607421875
33,14,14,9251,16384,-7133,-43.536376953125
33,14,15,1866,32768,-30902,-94.305419921875
33,15,1,0,2,-2,-100.0
33,15,2,2,4,-2,-50.0
33,15,3,3,8,-5,-62.5
33,15,4,24,16,8,50.0
33,15,5,44,32,12,37.5
33,15,6,29,64,-35,-54.6875
33,15,7,31,128,-97,-75.78125
33,15,8,30,256,-226,-88.28125
33,15,9,51,512,-461,-90.0390625
33,15,10,106,1024,-918,-89.6484375
33,15,11,6379,2048,4331,211.474609375
33,15,12,8159,4096,4063,99.1943359375
33,15,13,25003,8192,16811,205.21240234375
33,15,14,42561,16384,26177,159.771728515625
33,15,15,29685,32768,-3083,-9.4085693359375
33,16,1,0,2,-2,-100.0
33,16,2,2,4,-2,-50.0
33,16,3,7,8,-1,-12.5
33,16,4,11,16,-5,-31.25
33,16,5,24,32,-8,-25.0
33,16,6,13,64,-51,-79.6875
33,16,7,48,128,-80,-62.5
33,16,8,58,256,-198,-77.34375
33,16,9,340,512,-172,-33.59375
33,16,10,280,1024,-744,-72.65625
33,16,11,265,2048,-1783,-87.060546875
33,16,12,25936,4096,21840,533.203125
33,16,13,8961,8192,769,9.38720703125
33,16,14,32962,16384,16578,101.18408203125
33,16,15,23538,32768,-9230,-28.167724609375
33,17,1,0,2,-2,-100.0
33,17,2,1,4,-3,-75.0
33,17,3,7,8,-1,-12.5
33,17,4,8,16,-8,-50.0
33,17,5,21,32,-11,-34.375
33,17,6,18,64,-46,-71.875
33,17,7,34,128,-94,-73.4375
33,17,8,624,256,368,143.75
33,17,9,73,512,-439,-85.7421875
33,17,10,745,1024,-279,-27.24609375
33,17,11,1421,2048,-627,-30.615234375
33,17,12,5803,4096,1707,41.6748046875
33,17,13,21566,8192,13374,163.2568359375
33,17,14,13891,16384,-2493,-15.216064453125
33,17,15,37674,32768,4906,14.971923828125
33,18,1,0,2,-2,-100.0
33,18,2,2,4,-2,-50.0
33,18,3,7,8,-1,-12.5
33,18,4,20,16,4,25.0
33,18,5,7,32,-25,-78.125
33,18,6,125,64,61,95.3125
33,18,7,75,128,-53,-41.40625
33,18,8,314,256,58,22.65625
33,18,9,723,512,211,41.2109375
33,18,10,61,1024,-963,-94.04296875
33,18,11,3156,2048,1108,54.1015625
33,18,12,2456,4096,-1640,-40.0390625
33,18,13,33629,8192,25437,310.51025390625
33,18,14,27776,16384,11392,69.53125
33,18,15,1469,32768,-31299,-95.5169677734375
33,19,1,0,2,-2,-100.0
33,19,2,4,4,0,0.0
33,19,3,13,8,5,62.5
33,19,4,13,16,-3,-18.75
33,19,5,14,32,-18,-56.25
33,19,6,34,64,-30,-46.875
33,19,7,134,128,6,4.6875
33,19,8,36,256,-220,-85.9375
33,19,9,1005,512,493,96.2890625
33,19,10,991,1024,-33,-3.22265625
33,19,11,124,2048,-1924,-93.9453125
33,19,12,5536,4096,1440,35.15625
33,19,13,10499,8192,2307,28.16162109375
33,19,14,6955,16384,-9429,-57.550048828125
33,19,15,16140,32768,-16628,-50.74462890625
33,20,1,0,2,-2,-100.0
33,20,2,1,4,-3,-75.0
33,20,3,6,8,-2,-25.0
33,20,4,15,16,-1,-6.25
33,20,5,166,32,134,418.75
33,20,6,58,64,-6,-9.375
33,20,7,224,128,96,75.0
33,20,8,59,256,-197,-76.953125
33,20,9,754,512,242,47.265625
33,20,10,442,1024,-582,-56.8359375
33,20,11,310,2048,-1738,-84.86328125
33,20,12,3390,4096,-706,-17.236328125
33,20,13,19486,8192,11294,137.8662109375
33,20,14,34243,16384,17859,109.002685546875
33,20,15,19192,32768,-13576,-41.4306640625
33,21,1,0,2,-2,-100.0
33,21,2,2,4,-2,-50.0
33,21,3,4,8,-4,-50.0
33,21,4,15,16,-1,-6.25
33,21,5,17,32,-15,-46.875
33,21,6,35,64,-29,-45.3125
33,21,7,9,128,-119,-92.96875
33,21,8,103,256,-153,-59.765625
33,21,9,160,512,-352,-68.75
33,21,10,534,1024,-490,-47.8515625
33,21,11,12088,2048,10040,490.234375
33,21,12,828,4096,-3268,-79.78515625
33,21,13,343,8192,-7849,-95.81298828125
33,21,14,4962,16384,-11422,-69.71435546875
33,21,15,1357,32768,-31411,-95.8587646484375
33,22,1,0,2,-2,-100.0
33,22,2,1,4,-3,-75.0
33,22,3,9,8,1,12.5
33,22,4,6,16,-10,-62.5
33,22,5,15,32,-17,-53.125
33,22,6,16,64,-48,-75.0
33,22,7,54,128,-74,-57.8125
33,22,8,418,256,162,63.28125
33,22,9,202,512,-310,-60.546875
33,22,10,48,1024,-976,-95.3125
33,22,11,3031,2048,983,47.998046875
33,22,12,14230,4096,10134,247.412109375
33,22,13,1573,8192,-6619,-80.79833984375
33,22,14,45663,16384,29279,178.704833984375
33,22,15,125459,32768,92691,282.8704833984375
33,23,1,0,2,-2,-100.0
33,23,2,1,4,-3,-75.0
33,23,3,24,8,16,200.0
33,23,4,23,16,7,43.75
33,23,5,13,32,-19,-59.375
33,23,6,84,64,20,31.25
33,23,7,55,128,-73,-57.03125
33,23,8,259,256,3,1.171875
33,23,9,299,512,-213,-41.6015625
33,23,10,635,1024,-389,-37.98828125
33,23,11,2868,2048,820,40.0390625
33,23,12,576,4096,-3520,-85.9375
33,23,13,34725,8192,26533,323.88916015625
33,23,14,11378,16384,-5006,-30.55419921875
33,23,15,75744,32768,42976,131.15234375
33,24,1,0,2,-2,-100.0
33,24,2,1,4,-3,-75.0
33,24,3,2,8,-6,-75.0
33,24,4,25,16,9,56.25
33,24,5,29,32,-3,-9.375
33,24,6,56,64,-8,-12.5
33,24,7,73,128,-55,-42.96875
33,24,8,559,256,303,118.359375
33,24,9,13,512,-499,-97.4609375
33,24,10,196,1024,-828,-80.859375
33,24,11,867,2048,-1181,-57.666015625
33,24,12,1868,4096,-2228,-54.39453125
33,24,13,15737,8192,7545,92.10205078125
33,24,14,470,16384,-15914,-97.13134765625
33,24,15,39761,32768,6993,21.3409423828125
33,25,1,0,2,-2,-100.0
33,25,2,1,4,-3,-75.0
33,25,3,17,8,9,112.5
33,25,4,25,16,9,56.25
33,25,5,60,32,28,87.5
33,25,6,110,64,46,71.875
33,25,7,552,128,424,331.25
33,25,8,205,256,-51,-19.921875
33,25,9,479,512,-33,-6.4453125
33,25,10,1342,1024,318,31.0546875
33,25,11,1646,2048,-402,-19.62890625
33,25,12,2795,4096,-1301,-31.7626953125
33,25,13,4916,8192,-3276,-39.990234375
33,25,14,9511,16384,-6873,-41.949462890625
33,25,15,187069,32768,154301,470.8892822265625
33,26,1,0,2,-2,-100.0
33,26,2,3,4,-1,-25.0
33,26,3,2,8,-6,-75.0
33,26,4,28,16,12,75.0
33,26,5,5,32,-27,-84.375
33,26,6,38,64,-26,-40.625
33,26,7,174,128,46,35.9375
33,26,8,387,256,131,51.171875
33,26,9,419,512,-93,-18.1640625
33,26,10,111,1024,-913,-89.16015625
33,26,11,1186,2048,-862,-42.08984375
33,26,12,928,4096,-3168,-77.34375
33,26,13,11959,8192,3767,45.98388671875
33,26,14,27367,16384,10983,67.034912109375
33,26,15,31002,32768,-1766,-5.389404296875
33,27,1,0,2,-2,-100.0
33,27,2,3,4,-1,-25.0
33,27,3,13,8,5,62.5
33,27,4,8,16,-8,-50.0
33,27,5,6,32,-26,-81.25
33,27,6,38,64,-26,-40.625
33,27,7,109,128,-19,-14.84375
33,27,8,174,256,-82,-32.03125
33,27,9,404,512,-108,-21.09375
33,27,10,1370,1024,346,33.7890625
33,27,11,1811,2048,-237,-11.572265625
33,27,12,63,4096,-4033,-98.4619140625
33,27,13,11000,8192,2808,34.27734375
33,27,14,79071,16384,62687,382.611083984375
33,27,15,7682,32768,-25086,-76.556396484375
33,28,1,0,2,-2,-100.0
33,28,2,1,4,-3,-75.0
33,28,3,3,8,-5,-62.5
33,28,4,9,16,-7,-43.75
33,28,5,48,32,16,50.0
33,28,6,5,64,-59,-92.1875
33,28,7,141,128,13,10.15625
33,28,8,339,256,83,32.421875
33,28,9,214,512,-298,-58.203125
33,28,10,4615,1024,3591,350.68359375
33,28,11,4677,2048,2629,128.369140625
33,28,12,2376,4096,-1720,-41.9921875
33,28,13,5959,8192,-2233,-27.25830078125
33,28,14,20027,16384,3643,22.235107421875
33,28,15,12765,32768,-20003,-61.0443115234375
33,29,1,0,2,-2,-100.0
33,29,2,1,4,-3,-75.0
33,29,3,8,8,0,0.0
33,29,4,48,16,32,200.0
33,29,5,10,32,-22,-68.75
33,29,6,191,64,127,198.4375
33,29,7,81,128,-47,-36.71875
33,29,8,471,256,215,83.984375
33,29,9,127,512,-385,-75.1953125
33,29,10,923,1024,-101,-9.86328125
33,29,11,2307,2048,259,12.646484375
33,29,12,2421,4096,-1675,-40.8935546875
33,29,13,13360,8192,5168,63.0859375
33,29,14,386,16384,-15998,-97.64404296875
33,29,15,12481,32768,-20287,-61.9110107421875
33,30,1,0,2,-2,-100.0
33,30,2,3,4,-1,-25.0
33,30,3,3,8,-5,-62.5
33,30,4,21,16,5,31.25
33,30,5,4,32,-28,-87.5
33,30,6,12,64,-52,-81.25
33,30,7,38,128,-90,-70.3125
33,30,8,612,256,356,139.0625
33,30,9,220,512,-292,-57.03125
33,30,10,1210,1024,186,18.1640625
33,30,11,4410,2048,2362,115.33203125
33,30,12,4048,4096,-48,-1.171875
33,30,13,13264,8192,5072,61.9140625
33,30,14,48390,16384,32006,195.34912109375
33,30,15,2644,32768,-30124,-91.93115234375
33,31,1,0,2,-2,-100.0
33,31,2,2,4,-2,-50.0
33,31,3,7,8,-1,-12.5
33,31,4,18,16,2,12.5
33,31,5,52,32,20,62.5
33,31,6,20,64,-44,-68.75
33,31,7,128,128,0,0.0
33,31,8,176,256,-80,-31.25
33,31,9,274,512,-238,-46.484375
33,31,10,2739,1024,1715,167.48046875
33,31,11,368,2048,-1680,-82.03125
33,31,12,9753,4096,5657,138.1103515625
33,31,13,6435,8192,-1757,-21.44775390625
33,31,14,6457,16384,-9927,-60.589599609375
33,31,15,14498,32768,-18270,-55.755615234375
33,32,1,0,2,-2,-100.0
33,32,2,1,4,-3,-75.0
33,32,3,2,8,-6,-75.0
33,32,4,4,16,-12,-75.0
33,32,5,16,32,-16,-50.0
33,32,6,37,64,-27,-42.1875
33,32,7,35,128,-93,-72.65625
33,32,8,161,256,-95,-37.109375
33,32,9,322,512,-190,-37.109375
33,32,10,2412,1024,1388,135.546875
33,32,11,166,2048,-1882,-91.89453125
33,32,12,4064,4096,-32,-0.78125
33,32,13,8812,8192,620,7.568359375
33,32,14,14774,16384,-1610,-9.82666015625
33,32,15,18444,32768,-14324,-43.71337890625
33,33,1,0,2,-2,-100.0
33,33,2,1,4,-3,-75.0
33,33,3,4,8,-4,-50.0
33,33,4,3,16,-13,-81.25
33,33,5,41,32,9,28.125
33,33,6,43,64,-21,-32.8125
33,33,7,51,128,-77,-60.15625
33,33,8,209,256,-47,-18.359375
33,33,9,617,512,105,20.5078125
33,33,10,234,1024,-790,-77.1484375
33,33,11,1704,2048,-344,-16.796875
33,33,12,104,4096,-3992,-97.4609375
33,33,13,19530,8192,11338,138.4033203125
33,33,14,3620,16384,-12764,-77.9052734375
33,33,15,31969,32768,-799,-2.4383544921875
34,1,1,0,2,-2,-100.0
34,1,2,1,4,-3,-75.0
34,1,3,12,8,4,50.0
34,1,4,8,16,-8,-50.0
34,1,5,15,32,-17,-53.125
34,1,6,29,64,-35,-54.6875
34,1,7,50,128,-78,-60.9375
34,1,8,605,256,349,136.328125
34,1,9,154,512,-358,-69.921875
34,1,10,281,1024,-743,-72.55859375
34,1,11,474,2048,-1574,-76.85546875
34,1,12,19782,4096,15686,382.958984375
34,1,13,1764,8192,-6428,-78.466796875
34,1,14,42440,16384,26056,159.033203125
34,1,15,43803,32768,11035,33.6761474609375
34,2,1,0,2,-2,-100.0
34,2,2,1,4,-3,-75.0
34,2,3,5,8,-3,-37.5
34,2,4,10,16,-6,-37.5
34,2,5,12,32,-20,-62.5
34,2,6,7,64,-57,-89.0625
34,2,7,116,128,-12,-9.375
34,2,8,364,256,108,42.1875
34,2,9,412,512,-100,-19.53125
34,2,10,614,1024,-410,-40.0390625
34,2,11,4531,2048,2483,121.240234375
34,2,12,3783,4096,-313,-7.6416015625
34,2,13,1765,8192,-6427,-78.45458984375
34,2,14,31662,16384,15278,93.24951171875
34,2,15,59180,32768,26412,80.60302734375
34,3,1,0,2,-2,-100.0
34,3,2,1,4,-3,-75.0
34,3,3,10,8,2,25.0
34,3,4,5,16,-11,-68.75
34,3,5,7,32,-25,-78.125
34,3,6,23,64,-41,-64.0625
34,3,7,45,128,-83,-64.84375
34,3,8,70,256,-186,-72.65625
34,3,9,394,512,-118,-23.046875
34,3,10,483,1024,-541,-52.83203125
34,3,11,920,2048,-1128,-55.078125
34,3,12,520,4096,-3576,-87.3046875
34,3,13,4702,8192,-3490,-42.6025390625
34,3,14,3392,16384,-12992,-79.296875
34,3,15,71119,32768,38351,117.0379638671875
34,4,1,0,2,-2,-100.0
34,4,2,1,4,-3,-75.0
34,4,3,5,8,-3,-37.5
34,4,4,10,16,-6,-37.5
34,4,5,5,32,-27,-84.375
34,4,6,53,64,-11,-17.1875
34,4,7,31,128,-97,-75.78125
34,4,8,373,256,117,45.703125
34,4,9,450,512,-62,-12.109375
34,4,10,1506,1024,482,47.0703125
34,4,11,1291,2048,-757,-36.962890625
34,4,12,1145,4096,-2951,-72.0458984375
34,4,13,3268,8192,-4924,-60.107421875
34,4,14,1538,16384,-14846,-90.61279296875
34,4,15,5791,32768,-26977,-82.3272705078125
34,5,1,0,2,-2,-100.0
34,5,2,1,4,-3,-75.0
34,5,3,3,8,-5,-62.5
34,5,4,9,16,-7,-43.75
34,5,5,136,32,104,325.0
34,5,6,28,64,-36,-56.25
34,5,7,21,128,-107,-83.59375
34,5,8,23,256,-233,-91.015625
34,5,9,575,512,63,12.3046875
34,5,10,3832,1024,2808,274.21875
34,5,11,798,2048,-1250,-61.03515625
34,5,12,2767,4096,-1329,-32.4462890625
34,5,13,723,8192,-7469,-91.17431640625
34,5,14,924,16384,-15460,-94.3603515625
34,5,15,33562,32768,794,2.423095703125
34,6,1,0,2,-2,-100.0
34,6,2,1,4,-3,-75.0
34,6,3,3,8,-5,-62.5
34,6,4,13,16,-3,-18.75
34,6,5,26,32,-6,-18.75
34,6,6,109,64,45,70.3125
34,6,7,163,128,35,27.34375
34,6,8,311,256,55,21.484375
34,6,9,428,512,-84,-16.40625
34,6,10,806,1024,-218,-21.2890625
34,6,11,2492,2048,444,21.6796875
34,6,12,3898,4096,-198,-4.833984375
34,6,13,16794,8192,8602,105.0048828125
34,6,14,4251,16384,-12133,-74.053955078125
34,6,15,60078,32768,27310,83.343505859375
34,7,1,0,2,-2,-100.0
34,7,2,1,4,-3,-75.0
34,7,3,9,8,1,12.5
34,7,4,9,16,-7,-43.75
34,7,5,51,32,19,59.375
34,7,6,12,64,-52,-81.25
34,7,7,299,128,171,133.59375
34,7,8,210,256,-46,-17.96875
34,7,9,343,512,-169,-33.0078125
34,7,10,390,1024,-634,-61.9140625
34,7,11,2231,2048,183,8.935546875
34,7,12,5396,4096,1300,31.73828125
34,7,13,1409,8192,-6783,-82.80029296875
34,7,14,9276,16384,-7108,-43.3837890625
34,7,15,16125,32768,-16643,-50.7904052734375
34,8,1,0,2,-2,-100.0
34,8,2,1,4,-3,-75.0
34,8,3,2,8,-6,-75.0
34,8,4,47,16,31,193.75
34,8,5,20,32,-12,-37.5
34,8,6,126,64,62,96.875
34,8,7,19,128,-109,-85.15625
34,8,8,234,256,-22,-8.59375
34,8,9,520,512,8,1.5625
34,8,10,217,1024,-807,-78.80859375
34,8,11,172,2048,-1876,-91.6015625
34,8,12,1105,4096,-2991,-73.0224609375
34,8,13,3071,8192,-5121,-62.51220703125
34,8,14,676,16384,-15708,-95.8740234375
34,8,15,23355,32768,-9413,-28.7261962890625
34,9,1,0,2,-2,-100.0
34,9,2,2,4,-2,-50.0
34,9,3,6,8,-2,-25.0
34,9,4,3,16,-13,-81.25
34,9,5,11,32,-21,-65.625
34,9,6,29,64,-35,-54.6875
34,9,7,47,128,-81,-63.28125
34,9,8,118,256,-138,-53.90625
34,9,9,224,512,-288,-56.25
34,9,10,131,1024,-893,-87.20703125
34,9,11,2156,2048,108,5.2734375
34,9,12,6983,4096,2887,70.4833984375
34,9,13,8924,8192,732,8.935546875
34,9,14,5809,16384,-10575,-64.544677734375
34,9,15,27932,32768,-4836,-14.75830078125
34,10,1,0,2,-2,-100.0
34,10,2,5,4,1,25.0
34,10,3,12,8,4,50.0
34,10,4,3,16,-13,-81.25
34,10,5,14,32,-18,-56.25
34,10,6,48,64,-16,-25.0
34,10,7,58,128,-70,-54.6875
34,10,8,132,256,-124,-48.4375
34,10,9,30,512,-482,-94.140625
34,10,10,302,1024,-722,-70.5078125
34,10,11,6202,2048,4154,202.83203125
34,10,12,7224,4096,3128,76.3671875
34,10,13,2098,8192,-6094,-74.3896484375
34,10,14,34916,16384,18532,113.1103515625
34,10,15,95681,32768,62913,191.9952392578125
34,11,1,0,2,-2,-100.0
34,11,2,1,4,-3,-75.0
34,11,3,2,8,-6,-75.0
34,11,4,4,16,-12,-75.0
34,11,5,6,32,-26,-81.25
34,11,6,55,64,-9,-14.0625
34,11,7,463,128,335,261.71875
34,11,8,49,256,-207,-80.859375
34,11,9,28,512,-484,-94.53125
34,11,10,2725,1024,1701,166.11328125
34,11,11,1223,2048,-825,-40.283203125
34,11,12,4315,4096,219,5.3466796875
34,11,13,7538,8192,-654,-7.9833984375
34,11,14,12312,16384,-4072,-24.853515625
34,11,15,2846,32768,-29922,-91.314697265625
34,12,1,0,2,-2,-100.0
34,12,2,2,4,-2,-50.0
34,12,3,26,8,18,225.0
34,12,4,27,16,11,68.75
34,12,5,31,32,-1,-3.125
34,12,6,177,64,113,176.5625
34,12,7,51,128,-77,-60.15625
34,12,8,50,256,-206,-80.46875
34,12,9,48,512,-464,-90.625
34,12,10,436,1024,-588,-57.421875
34,12,11,1700,2048,-348,-16.9921875
34,12,12,4660,4096,564,13.76953125
34,12,13,1998,8192,-6194,-75.6103515625
34,12,14,41874,16384,25490,155.57861328125
34,12,15,1924,32768,-30844,-94.12841796875
34,13,1,0,2,-2,-100.0
34,13,2,2,4,-2,-50.0
34,13,3,6,8,-2,-25.0
34,13,4,9,16,-7,-43.75
34,13,5,21,32,-11,-34.375
34,13,6,45,64,-19,-29.6875
34,13,7,145,128,17,13.28125
34,13,8,88,256,-168,-65.625
34,13,9,253,512,-259,-50.5859375
34,13,10,651,1024,-373,-36.42578125
34,13,11,239,2048,-1809,-88.330078125
34,13,12,330,4096,-3766,-91.943359375
34,13,13,15239,8192,7047,86.02294921875
34,13,14,2772,16384,-13612,-83.0810546875
34,13,15,8716,32768,-24052,-73.40087890625
34,14,1,0,2,-2,-100.0
34,14,2,1,4,-3,-75.0
34,14,3,4,8,-4,-50.0
34,14,4,17,16,1,6.25
34,14,5,40,32,8,25.0
34,14,6,59,64,-5,-7.8125
34,14,7,37,128,-91,-71.09375
34,14,8,346,256,90,35.15625
34,14,9,443,512,-69,-13.4765625
34,14,10,239,1024,-785,-76.66015625
34,14,11,388,2048,-1660,-81.0546875
34,14,12,6181,4096,2085,50.9033203125
34,14,13,2493,8192,-5699,-69.56787109375
34,14,14,51583,16384,35199,214.837646484375
34,14,15,18871,32768,-13897,-42.4102783203125
34,15,1,0,2,-2,-100.0
34,15,2,3,4,-1,-25.0
34,15,3,11,8,3,37.5
34,15,4,5,16,-11,-68.75
34,15,5,21,32,-11,-34.375
34,15,6,49,64,-15,-23.4375
34,15,7,182,128,54,42.1875
34,15,8,138,256,-118,-46.09375
34,15,9,354,512,-158,-30.859375
34,15,10,2340,1024,1316,128.515625
34,15,11,3824,2048,1776,86.71875
34,15,12,6238,4096,2142,52.294921875
34,15,13,967,8192,-7225,-88.19580078125
34,15,14,3211,16384,-13173,-80.401611328125
34,15,15,39702,32768,6934,21.160888671875
34,16,1,0,2,-2,-100.0
34,16,2,1,4,-3,-75.0
34,16,3,2,8,-6,-75.0
34,16,4,9,16,-7,-43.75
34,16,5,21,32,-11,-34.375
34,16,6,25,64,-39,-60.9375
34,16,7,72,128,-56,-43.75
34,16,8,127,256,-129,-50.390625
34,16,9,981,512,469,91.6015625
34,16,10,2239,1024,1215,118.65234375
34,16,11,5533,2048,3485,170.166015625
34,16,12,514,4096,-3582,-87.451171875
34,16,13,7851,8192,-341,-4.16259765625
34,16,14,21273,16384,4889,29.840087890625
34,16,15,9185,32768,-23583,-71.9696044921875
34,17,1,0,2,-2,-100.0
34,17,2,4,4,0,0.0
34,17,3,13,8,5,62.5
34,17,4,16,16,0,0.0
34,17,5,96,32,64,200.0
34,17,6,8,64,-56,-87.5
34,17,7,56,128,-72,-56.25
34,17,8,413,256,157,61.328125
34,17,9,299,512,-213,-41.6015625
34,17,10,452,1024,-572,-55.859375
34,17,11,2522,2048,474,23.14453125
34,17,12,4414,4096,318,7.763671875
34,17,13,5370,8192,-2822,-34.4482421875
34,17,14,1618,16384,-14766,-90.12451171875
34,17,15,6593,32768,-26175,-79.8797607421875
34,18,1,0,2,-2,-100.0
34,18,2,1,4,-3,-75.0
34,18,3,2,8,-6,-75.0
34,18,4,22,16,6,37.5
34,18,5,38,32,6,18.75
34,18,6,8,64,-56,-87.5
34,18,7,134,128,6,4.6875
34,18,8,107,256,-149,-58.203125
34,18,9,763,512,251,49.0234375
34,18,10,77,1024,-947,-92.48046875
34,18,11,1059,2048,-989,-48.291015625
34,18,12,869,4096,-3227,-78.7841796875
34,18,13,6725,8192,-1467,-17.90771484375
34,18,14,427,16384,-15957,-97.393798828125
34,18,15,17355,32768,-15413,-47.0367431640625
34,19,1,0,2,-2,-100.0
34,19,2,4,4,0,0.0
34,19,3,3,8,-5,-62.5
34,19,4,14,16,-2,-12.5
34,19,5,27,32,-5,-15.625
34,19,6,40,64,-24,-37.5
34,19,7,13,128,-115,-89.84375
34,19,8,313,256,57,22.265625
34,19,9,330,512,-182,-35.546875
34,19,10,520,1024,-504,-49.21875
34,19,11,26,2048,-2022,-98.73046875
34,19,12,3710,4096,-386,-9.423828125
34,19,13,5176,8192,-3016,-36.81640625
34,19,14,11250,16384,-5134,-31.33544921875
34,19,15,67198,32768,34430,105.072021484375
34,20,1,0,2,-2,-100.0
34,20,2,2,4,-2,-50.0
34,20,3,11,8,3,37.5
34,20,4,8,16,-8,-50.0
34,20,5,46,32,14,43.75
34,20,6,13,64,-51,-79.6875
34,20,7,213,128,85,66.40625
34,20,8,73,256,-183,-71.484375
34,20,9,816,512,304,59.375
34,20,10,1470,1024,446,43.5546875
34,20,11,829,2048,-1219,-59.521484375
34,20,12,6455,4096,2359,57.5927734375
34,20,13,3987,8192,-4205,-51.33056640625
34,20,14,24107,16384,7723,47.137451171875
34,20,15,46217,32768,13449,41.0430908203125
34,21,1,0,2,-2,-100.0
34,21,2,1,4,-3,-75.0
34,21,3,2,8,-6,-75.0
34,21,4,13,16,-3,-18.75
34,21,5,49,32,17,53.125
34,21,6,70,64,6,9.375
34,21,7,38,128,-90,-70.3125
34,21,8,251,256,-5,-1.953125
34,21,9,67,512,-445,-86.9140625
34,21,10,242,1024,-782,-76.3671875
34,21,11,2641,2048,593,28.955078125
34,21,12,3029,4096,-1067,-26.0498046875
34,21,13,5503,8192,-2689,-32.82470703125
34,21,14,2133,16384,-14251,-86.981201171875
34,21,15,14662,32768,-18106,-55.255126953125
34,22,1,0,2,-2,-100.0
34,22,2,1,4,-3,-75.0
34,22,3,7,8,-1,-12.5
34,22,4,3,16,-13,-81.25
34,22,5,83,32,51,159.375
34,22,6,108,64,44,68.75
34,22,7,63,128,-65,-50.78125
34,22,8,24,256,-232,-90.625
34,22,9,1295,512,783,152.9296875
34,22,10,344,1024,-680,-66.40625
34,22,11,43,2048,-2005,-97.900390625
34,22,12,9682,4096,5586,136.376953125
34,22,13,13209,8192,5017,61.24267578125
34,22,14,11777,16384,-4607,-28.118896484375
34,22,15,46899,32768,14131,43.1243896484375
34,23,1,0,2,-2,-100.0
34,23,2,1,4,-3,-75.0
34,23,3,2,8,-6,-75.0
34,23,4,9,16,-7,-43.75
34,23,5,24,32,-8,-25.0
34,23,6,27,64,-37,-57.8125
34,23,7,55,128,-73,-57.03125
34,23,8,38,256,-218,-85.15625
34,23,9,280,512,-232,-45.3125
34,23,10,135,1024,-889,-86.81640625
34,23,11,460,2048,-1588,-77.5390625
34,23,12,1784,4096,-2312,-56.4453125
34,23,13,1424,8192,-6768,-82.6171875
34,23,14,119,16384,-16265,-99.273681640625
34,23,15,1849,32768,-30919,-94.3572998046875
34,24,1,0,2,-2,-100.0
34,24,2,1,4,-3,-75.0
34,24,3,2,8,-6,-75.0
34,24,4,7,16,-9,-56.25
34,24,5,51,32,19,59.375
34,24,6,39,64,-25,-39.0625
34,24,7,372,128,244,190.625
34,24,8,562,256,306,119.53125
34,24,9,42,512,-470,-91.796875
34,24,10,77,1024,-947,-92.48046875
34,24,11,115,2048,-1933,-94.384765625
34,24,12,16146,4096,12050,294.189453125
34,24,13,6283,8192,-1909,-23.30322265625
34,24,14,1306,16384,-15078,-92.02880859375
34,24,15,7368,32768,-25400,-77.5146484375
34,25,1,0,2,-2,-100.0
34,25,2,1,4,-3,-75.0
34,25,3,4,8,-4,-50.0
34,25,4,35,16,19,118.75
34,25,5,24,32,-8,-25.0
34,25,6,67,64,3,4.6875
34,25,7,172,128,44,34.375
34,25,8,120,256,-136,-53.125
34,25,9,734,512,222,43.359375
34,25,10,200,1024,-824,-80.46875
34,25,11,487,2048,-1561,-76.220703125
34,25,12,2895,4096,-1201,-29.3212890625
34,25,13,10958,8192,2766,33.7646484375
34,25,14,1879,16384,-14505,-88.531494140625
34,25,15,63301,32768,30533,93.1793212890625
34,26,1,0,2,-2,-100.0
34,26,2,3,4,-1,-25.0
34,26,3,2,8,-6,-75.0
34,26,4,16,16,0,0.0
34,26,5,6,32,-26,-81.25
34,26,6,34,64,-30,-46.875
34,26,7,50,128,-78,-60.9375
34,26,8,462,256,206,80.46875
34,26,9,644,512,132,25.78125
34,26,10,710,1024,-314,-30.6640625
34,26,11,1739,2048,-309,-15.087890625
34,26,12,34,4096,-4062,-99.169921875
34,26,13,2602,8192,-5590,-68.2373046875
34,26,14,2498,16384,-13886,-84.75341796875
34,26,15,7519,32768,-25249,-77.0538330078125
34,27,1,0,2,-2,-100.0
34,27,2,2,4,-2,-50.0
34,27,3,3,8,-5,-62.5
34,27,4,17,16,1,6.25
34,27,5,21,32,-11,-34.375
34,27,6,7,64,-57,-89.0625
34,27,7,28,128,-100,-78.125
34,27,8,96,256,-160,-62.5
34,27,9,46,512,-466,-91.015625
34,27,10,6416,1024,5392,526.5625
34,27,11,904,2048,-1144,-55.859375
34,27,12,5600,4096,1504,36.71875
34,27,13,2466,8192,-5726,-69.8974609375
34,27,14,40738,16384,24354,148.64501953125
34,27,15,50832,32768,18064,55.126953125
34,28,1,0,2,-2,-100.0
34,28,2,2,4,-2,-50.0
34,28,3,5,8,-3,-37.5
34,28,4,3,16,-13,-81.25
34,28,5,44,32,12,37.5
34,28,6,45,64,-19,-29.6875
34,28,7,20,128,-108,-84.375
34,28,8,173,256,-83,-32.421875
34,28,9,12,512,-500,-97.65625
34,28,10,1277,1024,253,24.70703125
34,28,11,2764,2048,716,34.9609375
34,28,12,2660,4096,-1436,-35.05859375
34,28,13,52658,8192,44466,542.7978515625
34,28,14,41806,16384,25422,155.16357421875
34,28,15,181165,32768,148397,452.8717041015625
34,29,1,0,2,-2,-100.0
34,29,2,1,4,-3,-75.0
34,29,3,2,8,-6,-75.0
34,29,4,14,16,-2,-12.5
34,29,5,19,32,-13,-40.625
34,29,6,21,64,-43,-67.1875
34,29,7,724,128,596,465.625
34,29,8,32,256,-224,-87.5
34,29,9,292,512,-220,-42.96875
34,29,10,754,1024,-270,-26.3671875
34,29,11,1661,2048,-387,-18.896484375
34,29,12,382,4096,-3714,-90.673828125
34,29,13,2963,8192,-5229,-63.83056640625
34,29,14,2417,16384,-13967,-85.247802734375
34,29,15,55591,32768,22823,69.6502685546875
34,30,1,0,2,-2,-100.0
34,30,2,1,4,-3,-75.0
34,30,3,5,8,-3,-37.5
34,30,4,8,16,-8,-50.0
34,30,5,81,32,49,153.125
34,30,6,46,64,-18,-28.125
34,30,7,11,128,-117,-91.40625
34,30,8,216,256,-40,-15.625
34,30,9,548,512,36,7.03125
34,30,10,777,1024,-247,-24.12109375
34,30,11,1002,2048,-1046,-51.07421875
34,30,12,4128,4096,32,0.78125
34,30,13,2151,8192,-6041,-73.74267578125
34,30,14,10335,16384,-6049,-36.920166015625
34,30,15,17570,32768,-15198,-46.380615234375
34,31,1,0,2,-2,-100.0
34,31,2,1,4,-3,-75.0
34,31,3,3,8,-5,-62.5
34,31,4,3,16,-13,-81.25
34,31,5,49,32,17,53.125
34,31,6,29,64,-35,-54.6875
34,31,7,263,128,135,105.46875
34,31,8,26,256,-230,-89.84375
34,31,9,170,512,-342,-66.796875
34,31,10,938,1024,-86,-8.3984375
34,31,11,253,2048,-1795,-87.646484375
34,31,12,1289,4096,-2807,-68.5302734375
34,31,13,4953,8192,-3239,-39.53857421875
34,31,14,27179,16384,10795,65.887451171875
34,31,15,2109,32768,-30659,-93.5638427734375
34,32,1,0,2,-2,-100.0
34,32,2,1,4,-3,-75.0
34,32,3,2,8,-6,-75.0
34,32,4,3,16,-13,-81.25
34,32,5,11,32,-21,-65.625
34,32,6,31,64,-33,-51.5625
34,32,7,112,128,-16,-12.5
34,32,8,113,256,-143,-55.859375
34,32,9,199,512,-313,-61.1328125
34,32,10,358,1024,-666,-65.0390625
34,32,11,347,2048,-1701,-83.056640625
34,32,12,2497,4096,-1599,-39.0380859375
34,32,13,4037,8192,-4155,-50.72021484375
34,32,14,18643,16384,2259,13.787841796875
34,32,15,39787,32768,7019,21.4202880859375
34,33,1,0,2,-2,-100.0
34,33,2,5,4,1,25.0
34,33,3,14,8,6,75.0
34,33,4,10,16,-6,-37.5
34,33,5,4,32,-28,-87.5
34,33,6,54,64,-10,-15.625
34,33,7,124,128,-4,-3.125
34,33,8,592,256,336,131.25
34,33,9,116,512,-396,-77.34375
34,33,10,28,1024,-996,-97.265625
34,33,11,194,2048,-1854,-90.52734375
34,33,12,7128,4096,3032,74.0234375
34,33,13,5346,8192,-2846,-34.7412109375
34,33,14,16634,16384,250,1.52587890625
34,33,15,14399,32768,-18369,-56.0577392578125
34,34,1,0,2,-2,-100.0
34,34,2,2,4,-2,-50.0
34,34,3,2,8,-6,-75.0
34,34,4,9,16,-7,-43.75
34,34,5,60,32,28,87.5
34,34,6,63,64,-1,-1.5625
34,34,7,119,128,-9,-7.03125
34,34,8,226,256,-30,-11.71875
34,34,9,39,512,-473,-92.3828125
34,34,10,1106,1024,82,8.0078125
34,34,11,550,2048,-1498,-73.14453125
34,34,12,75,4096,-4021,-98.1689453125
34,34,13,7461,8192,-731,-8.92333984375
34,34,14,9674,16384,-6710,-40.95458984375
34,34,15,58415,32768,25647,78.2684326171875
35,1,1,0,2,-2,-100.0
35,1,2,2,4,-2,-50.0
35,1,3,3,8,-5,-62.5
35,1,4,6,16,-10,-62.5
35,1,5,12,32,-20,-62.5
35,1,6,108,64,44,68.75
35,1,7,48,128,-80,-62.5
35,1,8,359,256,103,40.234375
35,1,9,91,512,-421,-82.2265625
35,1,10,1827,1024,803,78.41796875
35,1,11,2293,2048,245,11.962890625
35,1,12,2391,4096,-1705,-41.6259765625
35,1,13,7522,8192,-670,-8.1787109375
35,1,14,16111,16384,-273,-1.666259765625
35,1,15,65635,32768,32867,100.3021240234375
35,2,1,0,2,-2,-100.0
35,2,2,2,4,-2,-50.0
35,2,3,2,8,-6,-75.0
35,2,4,4,16,-12,-75.0
35,2,5,55,32,23,71.875
35,2,6,99,64,35,54.6875
35,2,7,118,128,-10,-7.8125
35,2,8,156,256,-100,-39.0625
35,2,9,47,512,-465,-90.8203125
35,2,10,362,1024,-662,-64.6484375
35,2,11,534,2048,-1514,-73.92578125
35,2,12,2000,4096,-2096,-51.171875
35,2,13,5429,8192,-2763,-33.72802734375
35,2,14,16665,16384,281,1.715087890625
35,2,15,18058,32768,-14710,-44.891357421875
35,3,1,0,2,-2,-100.0
35,3,2,2,4,-2,-50.0
35,3,3,3,8,-5,-62.5
35,3,4,27,16,11,68.75
35,3,5,29,32,-3,-9.375
35,3,6,23,64,-41,-64.0625
35,3,7,48,128,-80,-62.5
35,3,8,66,256,-190,-74.21875
35,3,9,981,512,469,91.6015625
35,3,10,448,1024,-576,-56.25
35,3,11,1049,2048,-999,-48.779296875
35,3,12,3420,4096,-676,-16.50390625
35,3,13,34,8192,-8158,-99.5849609375
35,3,14,28958,16384,12574,76.74560546875
35,3,15,78240,32768,45472,138.76953125
35,4,1,0,2,-2,-100.0
35,4,2,5,4,1,25.0
35,4,3,15,8,7,87.5
35,4,4,14,16,-2,-12.5
35,4,5,14,32,-18,-56.25
35,4,6,16,64,-48,-75.0
35,4,7,12,128,-116,-90.625
35,4,8,329,256,73,28.515625
35,4,9,154,512,-358,-69.921875
35,4,10,228,1024,-796,-77.734375
35,4,11,76,2048,-1972,-96.2890625
35,4,12,4834,4096,738,18.017578125
35,4,13,2517,8192,-5675,-69.27490234375
35,4,14,9232,16384,-7152,-43.65234375
35,4,15,13155,32768,-19613,-59.8541259765625
35,5,1,0,2,-2,-100.0
35,5,2,3,4,-1,-25.0
35,5,3,2,8,-6,-75.0
35,5,4,14,16,-2,-12.5
35,5,5,8,32,-24,-75.0
35,5,6,8,64,-56,-87.5
35,5,7,21,128,-107,-83.59375
35,5,8,128,256,-128,-50.0
35,5,9,445,512,-67,-13.0859375
35,5,10,181,1024,-843,-82.32421875
35,5,11,302,2048,-1746,-85.25390625
35,5,12,6002,4096,1906,46.533203125
35,5,13,10147,8192,1955,23.86474609375
35,5,14,10244,16384,-6140,-37.4755859375
35,5,15,62841,32768,30073,91.7755126953125
35,6,1,0,2,-2,-100.0
35,6,2,2,4,-2,-50.0
35,6,3,6,8,-2,-25.0
35,6,4,18,16,2,12.5
35,6,5,49,32,17,53.125
35,6,6,77,64,13,20.3125
35,6,7,431,128,303,236.71875
35,6,8,502,256,246,96.09375
35,6,9,267,512,-245,-47.8515625
35,6,10,676,1024,-348,-33.984375
35,6,11,970,2048,-1078,-52.63671875
35,6,12,9428,4096,5332,130.17578125
35,6,13,13764,8192,5572,68.017578125
35,6,14,25386,16384,9002,54.94384765625
35,6,15,25044,32768,-7724,-23.57177734375
35,7,1,0,2,-2,-100.0
35,7,2,2,4,-2,-50.0
35,7,3,7,8,-1,-12.5
35,7,4,7,16,-9,-56.25
35,7,5,32,32,0,0.0
35,7,6,32,64,-32,-50.0
35,7,7,113,128,-15,-11.71875
35,7,8,153,256,-103,-40.234375
35,7,9,418,512,-94,-18.359375
35,7,10,45,1024,-979,-95.60546875
35,7,11,1253,2048,-795,-38.818359375
35,7,12,17665,4096,13569,331.2744140625
35,7,13,1228,8192,-6964,-85.009765625
35,7,14,7623,16384,-8761,-53.472900390625
35,7,15,2400,32768,-30368,-92.67578125
35,8,1,0,2,-2,-100.0
35,8,2,8,4,4,100.0
35,8,3,4,8,-4,-50.0
35,8,4,20,16,4,25.0
35,8,5,93,32,61,190.625
35,8,6,197,64,133,207.8125
35,8,7,98,128,-30,-23.4375
35,8,8,237,256,-19,-7.421875
35,8,9,697,512,185,36.1328125
35,8,10,1454,1024,430,41.9921875
35,8,11,160,2048,-1888,-92.1875
35,8,12,404,4096,-3692,-90.13671875
35,8,13,688,8192,-7504,-91.6015625
35,8,14,30616,16384,14232,86.865234375
35,8,15,64793,32768,32025,97.7325439453125
35,9,1,0,2,-2,-100.0
35,9,2,2,4,-2,-50.0
35,9,3,4,8,-4,-50.0
35,9,4,41,16,25,156.25
35,9,5,9,32,-23,-71.875
35,9,6,5,64,-59,-92.1875
35,9,7,423,128,295,230.46875
35,9,8,56,256,-200,-78.125
35,9,9,39,512,-473,-92.3828125
35,9,10,1002,1024,-22,-2.1484375
35,9,11,1537,2048,-511,-24.951171875
35,9,12,1945,4096,-2151,-52.5146484375
35,9,13,2073,8192,-6119,-74.69482421875
35,9,14,4584,16384,-11800,-72.021484375
35,9,15,49128,32768,16360,49.9267578125
35,10,1,0,2,-2,-100.0
35,10,2,1,4,-3,-75.0
35,10,3,7,8,-1,-12.5
35,10,4,7,16,-9,-56.25
35,10,5,6,32,-26,-81.25
35,10,6,9,64,-55,-85.9375
35,10,7,229,128,101,78.90625
35,10,8,25,256,-231,-90.234375
35,10,9,351,512,-161,-31.4453125
35,10,10,1124,1024,100,9.765625
35,10,11,1648,2048,-400,-19.53125
35,10,12,4753,4096,657,16.0400390625
35,10,13,15053,8192,6861,83.75244140625
35,10,14,10324,16384,-6060,-36.9873046875
35,10,15,18828,32768,-13940,-42.54150390625
35,11,1,0,2,-2,-100.0
35,11,2,3,4,-1,-25.0
35,11,3,7,8,-1,-12.5
35,11,4,22,16,6,37.5
35,11,5,33,32,1,3.125
35,11,6,30,64,-34,-53.125
35,11,7,114,128,-14,-10.9375
35,11,8,97,256,-159,-62.109375
35,11,9,642,512,130,25.390625
35,11,10,222,1024,-802,-78.3203125
35,11,11,594,2048,-1454,-70.99609375
35,11,12,3132,4096,-964,-23.53515625
35,11,13,15881,8192,7689,93.85986328125
35,11,14,22395,16384,6011,36.688232421875
35,11,15,10782,32768,-21986,-67.095947265625
35,12,1,0,2,-2,-100.0
35,12,2,3,4,-1,-25.0
35,12,3,2,8,-6,-75.0
35,12,4,16,16,0,0.0
35,12,5,17,32,-15,-46.875
35,12,6,18,64,-46,-71.875
35,12,7,25,128,-103,-80.46875
35,12,8,104,256,-152,-59.375
35,12,9,73,512,-439,-85.7421875
35,12,10,1976,1024,952,92.96875
35,12,11,1139,2048,-909,-44.384765625
35,12,12,8689,4096,4593,112.1337890625
35,12,13,807,8192,-7385,-90.14892578125
35,12,14,46943,16384,30559,186.517333984375
35,12,15,10920,32768,-21848,-66.6748046875
35,13,1,0,2,-2,-100.0
35,13,2,1,4,-3,-75.0
35,13,3,5,8,-3,-37.5
35,13,4,13,16,-3,-18.75
35,13,5,27,32,-5,-15.625
35,13,6,13,64,-51,-79.6875
35,13,7,46,128,-82,-64.0625
35,13,8,127,256,-129,-50.390625
35,13,9,944,512,432,84.375
35,13,10,3075,1024,2051,200.29296875
35,13,11,161,2048,-1887,-92.138671875
35,13,12,2484,4096,-1612,-39.35546875
35,13,13,1822,8192,-6370,-77.7587890625
35,13,14,14252,16384,-2132,-13.0126953125
35,13,15,6930,32768,-25838,-78.851318359375
35,14,1,0,2,-2,-100.0
35,14,2,1,4,-3,-75.0
35,14,3,5,8,-3,-37.5
35,14,4,8,16,-8,-50.0
35,14,5,8,32,-24,-75.0
35,14,6,37,64,-27,-42.1875
35,14,7,67,128,-61,-47.65625
35,14,8,259,256,3,1.171875
35,14,9,262,512,-250,-48.828125
35,14,10,2123,1024,1099,107.32421875
35,14,11,6074,2048,4026,196.58203125
35,14,12,6602,4096,2506,61.181640625
35,14,13,10214,8192,2022,24.6826171875
35,14,14,18132,16384,1748,10.6689453125
35,14,15,4101,32768,-28667,-87.4847412109375
35,15,1,0,2,-2,-100.0
35,15,2,1,4,-3,-75.0
35,15,3,4,8,-4,-50.0
35,15,4,17,16,1,6.25
35,15,5,47,32,15,46.875
35,15,6,115,64,51,79.6875
35,15,7,38,128,-90,-70.3125
35,15,8,44,256,-212,-82.8125
35,15,9,745,512,233,45.5078125
35,15,10,413,1024,-611,-59.66796875
35,15,11,196,2048,-1852,-90.4296875
35,15,12,12684,4096,8588,209.66796875
35,15,13,4427,8192,-3765,-45.95947265625
35,15,14,261,16384,-16123,-98.406982421875
35,15,15,38611,32768,5843,17.8314208984375
35,16,1,0,2,-2,-100.0
35,16,2,2,4,-2,-50.0
35,16,3,2,8,-6,-75.0
35,16,4,31,16,15,93.75
35,16,5,20,32,-12,-37.5
35,16,6,9,64,-55,-85.9375
35,16,7,39,128,-89,-69.53125
35,16,8,140,256,-116,-45.3125
35,16,9,67,512,-445,-86.9140625
35,16,10,1324,1024,300,29.296875
35,16,11,368,2048,-1680,-82.03125
35,16,12,1840,4096,-2256,-55.078125
35,16,13,1096,8192,-7096,-86.62109375
35,16,14,15804,16384,-580,-3.5400390625
35,16,15,16590,32768,-16178,-49.371337890625
35,17,1,0,2,-2,-100.0
35,17,2,1,4,-3,-75.0
35,17,3,27,8,19,237.5
35,17,4,6,16,-10,-62.5
35,17,5,9,32,-23,-71.875
35,17,6,224,64,160,250.0
35,17,7,288,128,160,125.0
35,17,8,469,256,213,83.203125
35,17,9,1155,512,643,125.5859375
35,17,10,166,1024,-858,-83.7890625
35,17,11,992,2048,-1056,-51.5625
35,17,12,1189,4096,-2907,-70.9716796875
35,17,13,8854,8192,662,8.0810546875
35,17,14,23475,16384,7091,43.280029296875
35,17,15,32004,32768,-764,-2.33154296875
35,18,1,0,2,-2,-100.0
35,18,2,3,4,-1,-25.0
35,18,3,10,8,2,25.0
35,18,4,28,16,12,75.0
35,18,5,13,32,-19,-59.375
35,18,6,36,64,-28,-43.75
35,18,7,32,128,-96,-75.0
35,18,8,43,256,-213,-83.203125
35,18,9,1484,512,972,189.84375
35,18,10,466,1024,-558,-54.4921875
35,18,11,5461,2048,3413,166.650390625
35,18,12,1928,4096,-2168,-52.9296875
35,18,13,1288,8192,-6904,-84.27734375
35,18,14,50054,16384,33670,205.50537109375
35,18,15,1420,32768,-31348,-95.66650390625
35,19,1,0,2,-2,-100.0
35,19,2,3,4,-1,-25.0
35,19,3,3,8,-5,-62.5
35,19,4,4,16,-12,-75.0
35,19,5,44,32,12,37.5
35,19,6,18,64,-46,-71.875
35,19,7,68,128,-60,-46.875
35,19,8,29,256,-227,-88.671875
35,19,9,592,512,80,15.625
35,19,10,1721,1024,697,68.06640625
35,19,11,741,2048,-1307,-63.818359375
35,19,12,4876,4096,780,19.04296875
35,19,13,942,8192,-7250,-88.5009765625
35,19,14,2825,16384,-13559,-82.757568359375
35,19,15,8298,32768,-24470,-74.676513671875
35,20,1,0,2,-2,-100.0
35,20,2,2,4,-2,-50.0
35,20,3,17,8,9,112.5
35,20,4,25,16,9,56.25
35,20,5,28,32,-4,-12.5
35,20,6,104,64,40,62.5
35,20,7,18,128,-110,-85.9375
35,20,8,33,256,-223,-87.109375
35,20,9,365,512,-147,-28.7109375
35,20,10,264,1024,-760,-74.21875
35,20,11,1233,2048,-815,-39.794921875
35,20,12,2175,4096,-1921,-46.8994140625
35,20,13,3414,8192,-4778,-58.3251953125
35,20,14,15540,16384,-844,-5.1513671875
35,20,15,37823,32768,5055,15.4266357421875
35,21,1,0,2,-2,-100.0
35,21,2,1,4,-3,-75.0
35,21,3,8,8,0,0.0
35,21,4,3,16,-13,-81.25
35,21,5,41,32,9,28.125
35,21,6,236,64,172,268.75
35,21,7,65,128,-63,-49.21875
35,21,8,297,256,41,16.015625
35,21,9,407,512,-105,-20.5078125
35,21,10,444,1024,-580,-56.640625
35,21,11,1478,2048,-570,-27.83203125
35,21,12,311,4096,-3785,-92.4072265625
35,21,13,10675,8192,2483,30.31005859375
35,21,14,3855,16384,-12529,-76.470947265625
35,21,15,34195,32768,1427,4.3548583984375
35,22,1,0,2,-2,-100.0
35,22,2,7,4,3,75.0
35,22,3,3,8,-5,-62.5
35,22,4,4,16,-12,-75.0
35,22,5,27,32,-5,-15.625
35,22,6,203,64,139,217.1875
35,22,7,830,128,702,548.4375
35,22,8,238,256,-18,-7.03125
35,22,9,728,512,216,42.1875
35,22,10,231,1024,-793,-77.44140625
35,22,11,1096,2048,-952,-46.484375
35,22,12,9729,4096,5633,137.5244140625
35,22,13,2168,8192,-6024,-73.53515625
35,22,14,10859,16384,-5525,-33.721923828125
35,22,15,3980,32768,-28788,-87.85400390625
35,23,1,0,2,-2,-100.0
35,23,2,1,4,-3,-75.0
35,23,3,8,8,0,0.0
35,23,4,11,16,-5,-31.25
35,23,5,43,32,11,34.375
35,23,6,62,64,-2,-3.125
35,23,7,128,128,0,0.0
35,23,8,280,256,24,9.375
35,23,9,1089,512,577,112.6953125
35,23,10,122,1024,-902,-88.0859375
35,23,11,597,2048,-1451,-70.849609375
35,23,12,3807,4096,-289,-7.0556640625
35,23,13,3125,8192,-5067,-61.85302734375
35,23,14,24908,16384,8524,52.0263671875
35,23,15,13830,32768,-18938,-57.794189453125
35,24,1,0,2,-2,-100.0
35,24,2,1,4,-3,-75.0
35,24,3,4,8,-4,-50.0
35,24,4,10,16,-6,-37.5
35,24,5,80,32,48,150.0
35,24,6,92,64,28,43.75
35,24,7,57,128,-71,-55.46875
35,24,8,27,256,-229,-89.453125
35,24,9,593,512,81,15.8203125
35,24,10,562,1024,-462,-45.1171875
35,24,11,3027,2048,979,47.802734375
35,24,12,31,4096,-4065,-99.2431640625
35,24,13,4491,8192,-3701,-45.17822265625
35,24,14,10399,16384,-5985,-36.529541015625
35,24,15,22393,32768,-10375,-31.6619873046875
35,25,1,0,2,-2,-100.0
35,25,2,1,4,-3,-75.0
35,25,3,4,8,-4,-50.0
35,25,4,6,16,-10,-62.5
35,25,5,26,32,-6,-18.75
35,25,6,69,64,5,7.8125
35,25,7,95,128,-33,-25.78125
35,25,8,232,256,-24,-9.375
35,25,9,243,512,-269,-52.5390625
35,25,10,1176,1024,152,14.84375
35,25,11,1869,2048,-179,-8.740234375
35,25,12,1366,4096,-2730,-66.650390625
35,25,13,14080,8192,5888,71.875
35,25,14,26996,16384,10612,64.7705078125
35,25,15,14770,32768,-17998,-54.925537109375
35,26,1,0,2,-2,-100.0
35,26,2,4,4,0,0.0
35,26,3,7,8,-1,-12.5
35,26,4,31,16,15,93.75
35,26,5,17,32,-15,-46.875
35,26,6,19,64,-45,-70.3125
35,26,7,53,128,-75,-58.59375
35,26,8,361,256,105,41.015625
35,26,9,911,512,399,77.9296875
35,26,10,631,1024,-393,-38.37890625
35,26,11,1334,2048,-714,-34.86328125
35,26,12,167,4096,-3929,-95.9228515625
35,26,13,1570,8192,-6622,-80.8349609375
35,26,14,2704,16384,-13680,-83.49609375
35,26,15,1599,32768,-31169,-95.1202392578125
35,27,1,0,2,-2,-100.0
35,27,2,5,4,1,25.0
35,27,3,3,8,-5,-62.5
35,27,4,29,16,13,81.25
35,27,5,143,32,111,346.875
35,27,6,34,64,-30,-46.875
35,27,7,30,128,-98,-76.5625
35,27,8,112,256,-144,-56.25
35,27,9,21,512,-491,-95.8984375
35,27,10,635,1024,-389,-37.98828125
35,27,11,1205,2048,-843,-41.162109375
35,27,12,21464,4096,17368,424.0234375
35,27,13,2451,8192,-5741,-70.08056640625
35,27,14,4428,16384,-11956,-72.9736328125
35,27,15,11488,32768,-21280,-64.94140625
35,28,1,0,2,-2,-100.0
35,28,2,1,4,-3,-75.0
35,28,3,6,8,-2,-25.0
35,28,4,8,16,-8,-50.0
35,28,5,8,32,-24,-75.0
35,28,6,24,64,-40,-62.5
35,28,7,107,128,-21,-16.40625
35,28,8,1577,256,1321,516.015625
35,28,9,564,512,52,10.15625
35,28,10,330,1024,-694,-67.7734375
35,28,11,184,2048,-1864,-91.015625
35,28,12,9611,4096,5515,134.6435546875
35,28,13,8474,8192,282,3.4423828125
35,28,14,43937,16384,27553,168.170166015625
35,28,15,28979,32768,-3789,-11.5631103515625
35,29,1,0,2,-2,-100.0
35,29,2,1,4,-3,-75.0
35,29,3,5,8,-3,-37.5
35,29,4,62,16,46,287.5
35,29,5,4,32,-28,-87.5
35,29,6,13,64,-51,-79.6875
35,29,7,46,128,-82,-64.0625
35,29,8,51,256,-205,-80.078125
35,29,9,29,512,-483,-94.3359375
35,29,10,553,1024,-471,-45.99609375
35,29,11,1952,2048,-96,-4.6875
35,29,12,12135,4096,8039,196.2646484375
35,29,13,3843,8192,-4349,-53.08837890625
35,29,14,26841,16384,10457,63.824462890625
35,29,15,8531,32768,-24237,-73.9654541015625
35,30,1,0,2,-2,-100.0
35,30,2,2,4,-2,-50.0
35,30,3,10,8,2,25.0
35,30,4,17,16,1,6.25
35,30,5,20,32,-12,-37.5
35,30,6,101,64,37,57.8125
35,30,7,43,128,-85,-66.40625
35,30,8,341,256,85,33.203125
35,30,9,16,512,-496,-96.875
35,30,10,550,1024,-474,-46.2890625
35,30,11,238,2048,-1810,-88.37890625
35,30,12,296,4096,-3800,-92.7734375
35,30,13,9243,8192,1051,12.82958984375
35,30,14,61350,16384,44966,274.45068359375
35,30,15,41663,32768,8895,27.1453857421875
35,31,1,0,2,-2,-100.0
35,31,2,1,4,-3,-75.0
35,31,3,2,8,-6,-75.0
35,31,4,3,16,-13,-81.25
35,31,5,134,32,102,318.75
35,31,6,21,64,-43,-67.1875
35,31,7,63,128,-65,-50.78125
35,31,8,912,256,656,256.25
35,31,9,97,512,-415,-81.0546875
35,31,10,688,1024,-336,-32.8125
35,31,11,2829,2048,781,38.134765625
35,31,12,2207,4096,-1889,-46.1181640625
35,31,13,4725,8192,-3467,-42.32177734375
35,31,14,679,16384,-15705,-95.855712890625
35,31,15,25704,32768,-7064,-21.5576171875
35,32,1,0,2,-2,-100.0
35,32,2,2,4,-2,-50.0
35,32,3,2,8,-6,-75.0
35,32,4,3,16,-13,-81.25
35,32,5,21,32,-11,-34.375
35,32,6,65,64,1,1.5625
35,32,7,70,128,-58,-45.3125
35,32,8,177,256,-79,-30.859375
35,32,9,742,512,230,44.921875
35,32,10,772,1024,-252,-24.609375
35,32,11,7194,2048,5146,251.26953125
35,32,12,6054,4096,1958,47.802734375
35,32,13,23131,8192,14939,182.36083984375
35,32,14,8113,16384,-8271,-50.482177734375
35,32,15,95213,32768,62445,190.5670166015625
35,33,1,0,2,-2,-100.0
35,33,2,1,4,-3,-75.0
35,33,3,4,8,-4,-50.0
35,33,4,17,16,1,6.25
35,33,5,5,32,-27,-84.375
35,33,6,98,64,34,53.125
35,33,7,22,128,-106,-82.8125
35,33,8,92,256,-164,-64.0625
35,33,9,970,512,458,89.453125
35,33,10,5462,1024,4438,433.3984375
35,33,11,3263,2048,1215,59.326171875
35,33,12,4101,4096,5,0.1220703125
35,33,13,14128,8192,5936,72.4609375
35,33,14,3733,16384,-12651,-77.215576171875
35,33,15,106751,32768,73983,225.7781982421875
35,34,1,0,2,-2,-100.0
35,34,2,1,4,-3,-75.0
35,34,3,5,8,-3,-37.5
35,34,4,8,16,-8,-50.0
35,34,5,6,32,-26,-81.25
35,34,6,65,64,1,1.5625
35,34,7,643,128,515,402.34375
35,34,8,694,256,438,171.09375
35,34,9,178,512,-334,-65.234375
35,34,10,305,1024,-719,-70.21484375
35,34,11,369,2048,-1679,-81.982421875
35,34,12,2720,4096,-1376,-33.59375
35,34,13,18027,8192,9835,120.05615234375
35,34,14,2767,16384,-13617,-83.111572265625
35,34,15,69582,32768,36814,112.347412109375
35,35,1,0,2,-2,-100.0
35,35,2,2,4,-2,-50.0
35,35,3,2,8,-6,-75.0
35,35,4,18,16,2,12.5
35,35,5,37,32,5,15.625
35,35,6,50,64,-14,-21.875
35,35,7,33,128,-95,-74.21875
35,35,8,545,256,289,112.890625
35,35,9,360,512,-152,-29.6875
35,35,10,503,1024,-521,-50.87890625
35,35,11,93,2048,-1955,-95.458984375
35,35,12,2768,4096,-1328,-32.421875
35,35,13,2141,8192,-6051,-73.86474609375
35,35,14,6778,16384,-9606,-58.63037109375
35,35,15,261,32768,-32507,-99.2034912109375
36,1,1,0,2,-2,-100.0
36,1,2,1,4,-3,-75.0
36,1,3,6,8,-2,-25.0
36,1,4,9,16,-7,-43.75
36,1,5,40,32,8,25.0
36,1,6,27,64,-37,-57.8125
36,1,7,160,128,32,25.0
36,1,8,23,256,-233,-91.015625
36,1,9,166,512,-346,-67.578125
36,1,10,1308,1024,284,27.734375
36,1,11,511,2048,-1537,-75.048828125
36,1,12,8302,4096,4206,102.685546875
36,1,13,11134,8192,2942,35.9130859375
36,1,14,656,16384,-15728,-95.99609375
36,1,15,13048,32768,-19720,-60.1806640625
36,2,1,0,2,-2,-100.0
36,2,2,1,4,-3,-75.0
36,2,3,3,8,-5,-62.5
36,2,4,4,16,-12,-75.0
36,2,5,37,32,5,15.625
36,2,6,52,64,-12,-18.75
36,2,7,149,128,21,16.40625
36,2,8,36,256,-220,-85.9375
36,2,9,604,512,92,17.96875
36,2,10,107,1024,-917,-89.55078125
36,2,11,7411,2048,5363,261.865234375
36,2,12,2947,4096,-1149,-28.0517578125
36,2,13,9269,8192,1077,13.14697265625
36,2,14,2629,16384,-13755,-83.953857421875
36,2,15,8744,32768,-24024,-73.3154296875
36,3,1,0,2,-2,-100.0
36,3,2,2,4,-2,-50.0
36,3,3,4,8,-4,-50.0
36,3,4,4,16,-12,-75.0
36,3,5,13,32,-19,-59.375
36,3,6,13,64,-51,-79.6875
36,3,7,467,128,339,264.84375
36,3,8,321,256,65,25.390625
36,3,9,405,512,-107,-20.8984375
36,3,10,1133,1024,109,10.64453125
36,3,11,2395,2048,347,16.943359375
36,3,12,1142,4096,-2954,-72.119140625
36,3,13,6691,8192,-1501,-18.32275390625
36,3,14,43842,16384,27458,167.59033203125
36,3,15,5103,32768,-27665,-84.4268798828125
36,4,1,0,2,-2,-100.0
36,4,2,1,4,-3,-75.0
36,4,3,5,8,-3,-37.5
36,4,4,9,16,-7,-43.75
36,4,5,19,32,-13,-40.625
36,4,6,61,64,-3,-4.6875
36,4,7,32,128,-96,-75.0
36,4,8,30,256,-226,-88.28125
36,4,9,1007,512,495,96.6796875
36,4,10,748,1024,-276,-26.953125
36,4,11,2228,2048,180,8.7890625
36,4,12,3302,4096,-794,-19.384765625
36,4,13,5719,8192,-2473,-30.18798828125
36,4,14,26789,16384,10405,63.507080078125
36,4,15,17218,32768,-15550,-47.454833984375
36,5,1,0,2,-2,-100.0
36,5,2,2,4,-2,-50.0
36,5,3,5,8,-3,-37.5
36,5,4,12,16,-4,-25.0
36,5,5,13,32,-19,-59.375
36,5,6,125,64,61,95.3125
36,5,7,228,128,100,78.125
36,5,8,46,256,-210,-82.03125
36,5,9,151,512,-361,-70.5078125
36,5,10,234,1024,-790,-77.1484375
36,5,11,2541,2048,493,24.072265625
36,5,12,4709,4096,613,14.9658203125
36,5,13,700,8192,-7492,-91.455078125
36,5,14,912,16384,-15472,-94.43359375
36,5,15,21203,32768,-11565,-35.2935791015625
36,6,1,0,2,-2,-100.0
36,6,2,1,4,-3,-75.0
36,6,3,15,8,7,87.5
36,6,4,53,16,37,231.25
36,6,5,12,32,-20,-62.5
36,6,6,23,64,-41,-64.0625
36,6,7,104,128,-24,-18.75
36,6,8,633,256,377,147.265625
36,6,9,538,512,26,5.078125
36,6,10,826,1024,-198,-19.3359375
36,6,11,119,2048,-1929,-94.189453125
36,6,12,657,4096,-3439,-83.9599609375
36,6,13,10350,8192,2158,26.3427734375
36,6,14,6762,16384,-9622,-58.72802734375
36,6,15,45612,32768,12844,39.19677734375
36,7,1,0,2,-2,-100.0
36,7,2,1,4,-3,-75.0
36,7,3,8,8,0,0.0
36,7,4,4,16,-12,-75.0
36,7,5,6,32,-26,-81.25
36,7,6,101,64,37,57.8125
36,7,7,167,128,39,30.46875
36,7,8,82,256,-174,-67.96875
36,7,9,10,512,-502,-98.046875
36,7,10,57,1024,-967,-94.43359375
36,7,11,960,2048,-1088,-53.125
36,7,12,3901,4096,-195,-4.7607421875
36,7,13,2666,8192,-5526,-67.4560546875
36,7,14,5889,16384,-10495,-64.056396484375
36,7,15,4752,32768,-28016,-85.498046875
36,8,1,0,2,-2,-100.0
36,8,2,4,4,0,0.0
36,8,3,13,8,5,62.5
36,8,4,17,16,1,6.25
36,8,5,13,32,-19,-59.375
36,8,6,5,64,-59,-92.1875
36,8,7,19,128,-109,-85.15625
36,8,8,131,256,-125,-48.828125
36,8,9,619,512,107,20.8984375
36,8,10,325,1024,-699,-68.26171875
36,8,11,274,2048,-1774,-86.62109375
36,8,12,5401,4096,1305,31.8603515625
36,8,13,1237,8192,-6955,-84.89990234375
36,8,14,5138,16384,-11246,-68.64013671875
36,8,15,48136,32768,15368,46.8994140625
36,9,1,0,2,-2,-100.0
36,9,2,2,4,-2,-50.0
36,9,3,9,8,1,12.5
36,9,4,21,16,5,31.25
36,9,5,7,32,-25,-78.125
36,9,6,119,64,55,85.9375
36,9,7,134,128,6,4.6875
36,9,8,190,256,-66,-25.78125
36,9,9,727,512,215,41.9921875
36,9,10,1884,1024,860,83.984375
36,9,11,205,2048,-1843,-89.990234375
36,9,12,931,4096,-3165,-77.2705078125
36,9,13,18049,8192,9857,120.32470703125
36,9,14,913,16384,-15471,-94.427490234375
36,9,15,148068,32768,115300,351.86767578125
36,10,1,0,2,-2,-100.0
36,10,2,1,4,-3,-75.0
36,10,3,2,8,-6,-75.0
36,10,4,25,16,9,56.25
36,10,5,22,32,-10,-31.25
36,10,6,65,64,1,1.5625
36,10,7,445,128,317,247.65625
36,10,8,224,256,-32,-12.5
36,10,9,956,512,444,86.71875
36,10,10,1159,1024,135,13.18359375
36,10,11,1158,2048,-890,-43.45703125
36,10,12,10516,4096,6420,156.73828125
36,10,13,11572,8192,3380,41.259765625
36,10,14,19915,16384,3531,21.551513671875
36,10,15,148,32768,-32620,-99.54833984375
36,11,1,0,2,-2,-100.0
36,11,2,1,4,-3,-75.0
36,11,3,2,8,-6,-75.0
36,11,4,14,16,-2,-12.5
36,11,5,39,32,7,21.875
36,11,6,26,64,-38,-59.375
36,11,7,11,128,-117,-91.40625
36,11,8,608,256,352,137.5
36,11,9,51,512,-461,-90.0390625
36,11,10,573,1024,-451,-44.04296875
36,11,11,1200,2048,-848,-41.40625
36,11,12,9244,4096,5148,125.68359375
36,11,13,6069,8192,-2123,-25.91552734375
36,11,14,6892,16384,-9492,-57.9345703125
36,11,15,521,32768,-32247,-98.4100341796875
36,12,1,0,2,-2,-100.0
36,12,2,1,4,-3,-75.0
36,12,3,2,8,-6,-75.0
36,12,4,10,16,-6,-37.5
36,12,5,22,32,-10,-31.25
36,12,6,25,64,-39,-60.9375
36,12,7,235,128,107,83.59375
36,12,8,10,256,-246,-96.09375
36,12,9,304,512,-208,-40.625
36,12,10,207,1024,-817,-79.78515625
36,12,11,444,2048,-1604,-78.3203125
36,12,12,10787,4096,6691,163.3544921875
36,12,13,4142,8192,-4050,-49.4384765625
36,12,14,16435,16384,51,0.311279296875
36,12,15,4013,32768,-28755,-87.7532958984375
36,13,1,0,2,-2,-100.0
36,13,2,1,4,-3,-75.0
36,13,3,8,8,0,0.0
36,13,4,5,16,-11,-68.75
36,13,5,30,32,-2,-6.25
36,13,6,149,64,85,132.8125
36,13,7,6,128,-122,-95.3125
36,13,8,169,256,-87,-33.984375
36,13,9,181,512,-331,-64.6484375
36,13,10,652,1024,-372,-36.328125
36,13,11,38,2048,-2010,-98.14453125
36,13,12,6233,4096,2137,52.1728515625
36,13,13,1763,8192,-6429,-78.47900390625
36,13,14,3156,16384,-13228,-80.7373046875
36,13,15,88161,32768,55393,169.0460205078125
36,14,1,0,2,-2,-100.0
36,14,2,2,4,-2,-50.0
36,14,3,3,8,-5,-62.5
36,14,4,8,16,-8,-50.0
36,14,5,4,32,-28,-87.5
36,14,6,33,64,-31,-48.4375
36,14,7,43,128,-85,-66.40625
36,14,8,181,256,-75,-29.296875
36,14,9,457,512,-55,-10.7421875
36,14,10,3770,1024,2746,268.1640625
36,14,11,330,2048,-1718,-83.88671875
36,14,12,4218,4096,122,2.978515625
36,14,13,11374,8192,3182,38.8427734375
36,14,14,6040,16384,-10344,-63.134765625
36,14,15,8115,32768,-24653,-75.2349853515625
36,15,1,0,2,-2,-100.0
36,15,2,3,4,-1,-25.0
36,15,3,2,8,-6,-75.0
36,15,4,4,16,-12,-75.0
36,15,5,26,32,-6,-18.75
36,15,6,5,64,-59,-92.1875
36,15,7,57,128,-71,-55.46875
36,15,8,19,256,-237,-92.578125
36,15,9,10,512,-502,-98.046875
36,15,10,946,1024,-78,-7.6171875
36,15,11,1291,2048,-757,-36.962890625
36,15,12,6339,4096,2243,54.7607421875
36,15,13,16108,8192,7916,96.630859375
36,15,14,11117,16384,-5267,-32.147216796875
36,15,15,21704,32768,-11064,-33.7646484375
36,16,1,0,2,-2,-100.0
36,16,2,1,4,-3,-75.0
36,16,3,3,8,-5,-62.5
36,16,4,11,16,-5,-31.25
36,16,5,58,32,26,81.25
36,16,6,68,64,4,6.25
36,16,7,146,128,18,14.0625
36,16,8,92,256,-164,-64.0625
36,16,9,155,512,-357,-69.7265625
36,16,10,1829,1024,805,78.61328125
36,16,11,2604,2048,556,27.1484375
36,16,12,5539,4096,1443,35.2294921875
36,16,13,2489,8192,-5703,-69.61669921875
36,16,14,16151,16384,-233,-1.422119140625
36,16,15,1227,32768,-31541,-96.2554931640625
36,17,1,0,2,-2,-100.0
36,17,2,1,4,-3,-75.0
36,17,3,6,8,-2,-25.0
36,17,4,35,16,19,118.75
36,17,5,18,32,-14,-43.75
36,17,6,18,64,-46,-71.875
36,17,7,253,128,125,97.65625
36,17,8,480,256,224,87.5
36,17,9,80,512,-432,-84.375
36,17,10,577,1024,-447,-43.65234375
36,17,11,3487,2048,1439,70.263671875
36,17,12,6175,4096,2079,50.7568359375
36,17,13,24512,8192,16320,199.21875
36,17,14,5987,16384,-10397,-63.458251953125
36,17,15,15521,32768,-17247,-52.6336669921875
36,18,1,0,2,-2,-100.0
36,18,2,6,4,2,50.0
36,18,3,11,8,3,37.5
36,18,4,15,16,-1,-6.25
36,18,5,9,32,-23,-71.875
36,18,6,38,64,-26,-40.625
36,18,7,80,128,-48,-37.5
36,18,8,1377,256,1121,437.890625
36,18,9,291,512,-221,-43.1640625
36,18,10,246,1024,-778,-75.9765625
36,18,11,1247,2048,-801,-39.111328125
36,18,12,7934,4096,3838,93.701171875
36,18,13,643,8192,-7549,-92.15087890625
36,18,14,245,16384,-16139,-98.504638671875
36,18,15,26124,32768,-6644,-20.27587890625
36,19,1,0,2,-2,-100.0
36,19,2,2,4,-2,-50.0
36,19,3,2,8,-6,-75.0
36,19,4,3,16,-13,-81.25
36,19,5,16,32,-16,-50.0
36,19,6,12,64,-52,-81.25
36,19,7,22,128,-106,-82.8125
36,19,8,746,256,490,191.40625
36,19,9,157,512,-355,-69.3359375
36,19,10,665,1024,-359,-35.05859375
36,19,11,1570,2048,-478,-23.33984375
36,19,12,328,4096,-3768,-91.9921875
36,19,13,21344,8192,13152,160.546875
36,19,14,6097,16384,-10287,-62.786865234375
36,19,15,12618,32768,-20150,-61.492919921875
36,20,1,0,2,-2,-100.0
36,20,2,1,4,-3,-75.0
36,20,3,3,8,-5,-62.5
36,20,4,7,16,-9,-56.25
36,20,5,21,32,-11,-34.375
36,20,6,29,64,-35,-54.6875
36,20,7,121,128,-7,-5.46875
36,20,8,30,256,-226,-88.28125
36,20,9,351,512,-161,-31.4453125
36,20,10,2136,1024,1112,108.59375
36,20,11,4883,2048,2835,138.427734375
36,20,12,338,4096,-3758,-91.748046875
36,20,13,29569,8192,21377,260.94970703125
36,20,14,27493,16384,11109,67.803955078125
36,20,15,8979,32768,-23789,-72.5982666015625
36,21,1,0,2,-2,-100.0
36,21,2,1,4,-3,-75.0
36,21,3,2,8,-6,-75.0
36,21,4,14,16,-2,-12.5
36,21,5,22,32,-10,-31.25
36,21,6,19,64,-45,-70.3125
36,21,7,58,128,-70,-54.6875
36,21,8,233,256,-23,-8.984375
36,21,9,406,512,-106,-20.703125
36,21,10,797,1024,-227,-22.16796875
36,21,11,1048,2048,-1000,-48.828125
36,21,12,5949,4096,1853,45.2392578125
36,21,13,3305,8192,-4887,-59.65576171875
36,21,14,40747,16384,24363,148.699951171875
36,21,15,52088,32768,19320,58.9599609375
36,22,1,0,2,-2,-100.0
36,22,2,2,4,-2,-50.0
36,22,3,2,8,-6,-75.0
36,22,4,3,16,-13,-81.25
36,22,5,4,32,-28,-87.5
36,22,6,32,64,-32,-50.0
36,22,7,57,128,-71,-55.46875
36,22,8,769,256,513,200.390625
36,22,9,152,512,-360,-70.3125
36,22,10,81,1024,-943,-92.08984375
36,22,11,84,2048,-1964,-95.8984375
36,22,12,2036,4096,-2060,-50.29296875
36,22,13,2892,8192,-5300,-64.697265625
36,22,14,19910,16384,3526,21.52099609375
36,22,15,4498,32768,-28270,-86.273193359375
36,23,1,0,2,-2,-100.0
36,23,2,2,4,-2,-50.0
36,23,3,10,8,2,25.0
36,23,4,21,16,5,31.25
36,23,5,25,32,-7,-21.875
36,23,6,66,64,2,3.125
36,23,7,52,128,-76,-59.375
36,23,8,57,256,-199,-77.734375
36,23,9,624,512,112,21.875
36,23,10,4316,1024,3292,321.484375
36,23,11,599,2048,-1449,-70.751953125
36,23,12,3250,4096,-846,-20.654296875
36,23,13,5516,8192,-2676,-32.666015625
36,23,14,20918,16384,4534,27.67333984375
36,23,15,7451,32768,-25317,-77.2613525390625
36,24,1,0,2,-2,-100.0
36,24,2,5,4,1,25.0
36,24,3,2,8,-6,-75.0
36,24,4,29,16,13,81.25
36,24,5,41,32,9,28.125
36,24,6,217,64,153,239.0625
36,24,7,77,128,-51,-39.84375
36,24,8,105,256,-151,-58.984375
36,24,9,581,512,69,13.4765625
36,24,10,220,1024,-804,-78.515625
36,24,11,2320,2048,272,13.28125
36,24,12,8348,4096,4252,103.80859375
36,24,13,8413,8192,221,2.69775390625
36,24,14,48992,16384,32608,199.0234375
36,24,15,19970,32768,-12798,-39.056396484375
36,25,1,0,2,-2,-100.0
36,25,2,6,4,2,50.0
36,25,3,2,8,-6,-75.0
36,25,4,12,16,-4,-25.0
36,25,5,39,32,7,21.875
36,25,6,87,64,23,35.9375
36,25,7,332,128,204,159.375
36,25,8,71,256,-185,-72.265625
36,25,9,912,512,400,78.125
36,25,10,914,1024,-110,-10.7421875
36,25,11,140,2048,-1908,-93.1640625
36,25,12,856,4096,-3240,-79.1015625
36,25,13,18928,8192,10736,131.0546875
36,25,14,14669,16384,-1715,-10.467529296875
36,25,15,19680,32768,-13088,-39.94140625
36,26,1,0,2,-2,-100.0
36,26,2,5,4,1,25.0
36,26,3,18,8,10,125.0
36,26,4,17,16,1,6.25
36,26,5,38,32,6,18.75
36,26,6,22,64,-42,-65.625
36,26,7,120,128,-8,-6.25
36,26,8,68,256,-188,-73.4375
36,26,9,1845,512,1333,260.3515625
36,26,10,94,1024,-930,-90.8203125
36,26,11,131,2048,-1917,-93.603515625
36,26,12,4057,4096,-39,-0.9521484375
36,26,13,1670,8192,-6522,-79.6142578125
36,26,14,9794,16384,-6590,-40.22216796875
36,26,15,5293,32768,-27475,-83.8470458984375
36,27,1,0,2,-2,-100.0
36,27,2,2,4,-2,-50.0
36,27,3,3,8,-5,-62.5
36,27,4,36,16,20,125.0
36,27,5,11,32,-21,-65.625
36,27,6,11,64,-53,-82.8125
36,27,7,57,128,-71,-55.46875
36,27,8,144,256,-112,-43.75
36,27,9,725,512,213,41.6015625
36,27,10,2137,1024,1113,108.69140625
36,27,11,698,2048,-1350,-65.91796875
36,27,12,2588,4096,-1508,-36.81640625
36,27,13,8895,8192,703,8.58154296875
36,27,14,44269,16384,27885,170.196533203125
36,27,15,15267,32768,-17501,-53.4088134765625
36,28,1,0,2,-2,-100.0
36,28,2,2,4,-2,-50.0
36,28,3,4,8,-4,-50.0
36,28,4,22,16,6,37.5
36,28,5,63,32,31,96.875
36,28,6,175,64,111,173.4375
36,28,7,30,128,-98,-76.5625
36,28,8,221,256,-35,-13.671875
36,28,9,167,512,-345,-67.3828125
36,28,10,577,1024,-447,-43.65234375
36,28,11,1865,2048,-183,-8.935546875
36,28,12,941,4096,-3155,-77.0263671875
36,28,13,8786,8192,594,7.2509765625
36,28,14,59363,16384,42979,262.322998046875
36,28,15,13827,32768,-18941,-57.8033447265625
36,29,1,0,2,-2,-100.0
36,29,2,5,4,1,25.0
36,29,3,10,8,2,25.0
36,29,4,14,16,-2,-12.5
36,29,5,12,32,-20,-62.5
36,29,6,51,64,-13,-20.3125
36,29,7,113,128,-15,-11.71875
36,29,8,371,256,115,44.921875
36,29,9,610,512,98,19.140625
36,29,10,197,1024,-827,-80.76171875
36,29,11,196,2048,-1852,-90.4296875
36,29,12,2272,4096,-1824,-44.53125
36,29,13,16016,8192,7824,95.5078125
36,29,14,30898,16384,14514,88.58642578125
36,29,15,60963,32768,28195,86.0443115234375
36,30,1,0,2,-2,-100.0
36,30,2,2,4,-2,-50.0
36,30,3,7,8,-1,-12.5
36,30,4,4,16,-12,-75.0
36,30,5,4,32,-28,-87.5
36,30,6,5,64,-59,-92.1875
36,30,7,226,128,98,76.5625
36,30,8,224,256,-32,-12.5
36,30,9,324,512,-188,-36.71875
36,30,10,1171,1024,147,14.35546875
36,30,11,602,2048,-1446,-70.60546875
36,30,12,8115,4096,4019,98.1201171875
36,30,13,10095,8192,1903,23.22998046875
36,30,14,56801,16384,40417,246.685791015625
36,30,15,6906,32768,-25862,-78.924560546875
36,31,1,0,2,-2,-100.0
36,31,2,1,4,-3,-75.0
36,31,3,6,8,-2,-25.0
36,31,4,3,16,-13,-81.25
36,31,5,31,32,-1,-3.125
36,31,6,59,64,-5,-7.8125
36,31,7,208,128,80,62.5
36,31,8,349,256,93,36.328125
36,31,9,412,512,-100,-19.53125
36,31,10,1659,1024,635,62.01171875
36,31,11,552,2048,-1496,-73.046875
36,31,12,1007,4096,-3089,-75.4150390625
36,31,13,18485,8192,10293,125.64697265625
36,31,14,17033,16384,649,3.961181640625
36,31,15,41066,32768,8298,25.323486328125
36,32,1,0,2,-2,-100.0
36,32,2,2,4,-2,-50.0
36,32,3,3,8,-5,-62.5
36,32,4,10,16,-6,-37.5
36,32,5,52,32,20,62.5
36,32,6,7,64,-57,-89.0625
36,32,7,10,128,-118,-92.1875
36,32,8,628,256,372,145.3125
36,32,9,209,512,-303,-59.1796875
36,32,10,482,1024,-542,-52.9296875
36,32,11,467,2048,-1581,-77.197265625
36,32,12,1477,4096,-2619,-63.9404296875
36,32,13,26247,8192,18055,220.39794921875
36,32,14,4236,16384,-12148,-74.1455078125
36,32,15,28509,32768,-4259,-12.9974365234375
36,33,1,0,2,-2,-100.0
36,33,2,3,4,-1,-25.0
36,33,3,11,8,3,37.5
36,33,4,4,16,-12,-75.0
36,33,5,15,32,-17,-53.125
36,33,6,31,64,-33,-51.5625
36,33,7,45,128,-83,-64.84375
36,33,8,36,256,-220,-85.9375
36,33,9,137,512,-375,-73.2421875
36,33,10,1340,1024,316,30.859375
36,33,11,5667,2048,3619,176.708984375
36,33,12,9289,4096,5193,126.7822265625
36,33,13,4617,8192,-3575,-43.64013671875
36,33,14,14670,16384,-1714,-10.46142578125
36,33,15,2833,32768,-29935,-91.3543701171875
36,34,1,0,2,-2,-100.0
36,34,2,1,4,-3,-75.0
36,34,3,11,8,3,37.5
36,34,4,16,16,0,0.0
36,34,5,42,32,10,31.25
36,34,6,163,64,99,154.6875
36,34,7,33,128,-95,-74.21875
36,34,8,128,256,-128,-50.0
36,34,9,180,512,-332,-64.84375
36,34,10,63,1024,-961,-93.84765625
36,34,11,3074,2048,1026,50.09765625
36,34,12,6969,4096,2873,70.1416015625
36,34,13,7567,8192,-625,-7.62939453125
36,34,14,1366,16384,-15018,-91.66259765625
36,34,15,46250,32768,13482,41.143798828125
36,35,1,0,2,-2,-100.0
36,35,2,2,4,-2,-50.0
36,35,3,7,8,-1,-12.5
36,35,4,7,16,-9,-56.25
36,35,5,11,32,-21,-65.625
36,35,6,88,64,24,37.5
36,35,7,102,128,-26,-20.3125
36,35,8,226,256,-30,-11.71875
36,35,9,528,512,16,3.125
36,35,10,437,1024,-587,-57.32421875
36,35,11,285,2048,-1763,-86.083984375
36,35,12,103,4096,-3993,-97.4853515625
36,35,13,7682,8192,-510,-6.2255859375
36,35,14,2125,16384,-14259,-87.030029296875
36,35,15,3820,32768,-28948,-88.34228515625
36,36,1,0,2,-2,-100.0
36,36,2,1,4,-3,-75.0
36,36,3,3,8,-5,-62.5
36,36,4,29,16,13,81.25
36,36,5,43,32,11,34.375
36,36,6,105,64,41,64.0625
36,36,7,17,128,-111,-86.71875
36,36,8,64,256,-192,-75.0
36,36,9,681,512,169,33.0078125
36,36,10,862,1024,-162,-15.8203125
36,36,11,818,2048,-1230,-60.05859375
36,36,12,1504,4096,-2592,-63.28125
36,36,13,190,8192,-8002,-97.6806640625
36,36,14,10987,16384,-5397,-32.940673828125
36,36,15,10492,32768,-22276,-67.98095703125
37,1,1,0,2,-2,-100.0
37,1,2,2,4,-2,-50.0
37,1,3,2,8,-6,-75.0
37,1,4,8,16,-8,-50.0
37,1,5,4,32,-28,-87.5
37,1,6,6,64,-58,-90.625
37,1,7,263,128,135,105.46875
37,1,8,254,256,-2,-0.78125
37,1,9,1629,512,1117,218.1640625
37,1,10,162,1024,-862,-84.1796875
37,1,11,1603,2048,-445,-21.728515625
37,1,12,10685,4096,6589,160.8642578125
37,1,13,21329,8192,13137,160.36376953125
37,1,14,7446,16384,-8938,-54.55322265625
37,1,15,59015,32768,26247,80.0994873046875
37,2,1,0,2,-2,-100.0
37,2,2,1,4,-3,-75.0
37,2,3,2,8,-6,-75.0
37,2,4,36,16,20,125.0
37,2,5,5,32,-27,-84.375
37,2,6,58,64,-6,-9.375
37,2,7,244,128,116,90.625
37,2,8,17,256,-239,-93.359375
37,2,9,80,512,-432,-84.375
37,2,10,259,1024,-765,-74.70703125
37,2,11,2476,2048,428,20.8984375
37,2,12,4576,4096,480,11.71875
37,2,13,363,8192,-7829,-95.56884765625
37,2,14,30463,16384,14079,85.931396484375
37,2,15,34909,32768,2141,6.5338134765625
37,3,1,0,2,-2,-100.0
37,3,2,3,4,-1,-25.0
37,3,3,11,8,3,37.5
37,3,4,13,16,-3,-18.75
37,3,5,42,32,10,31.25
37,3,6,7,64,-57,-89.0625
37,3,7,15,128,-113,-88.28125
37,3,8,238,256,-18,-7.03125
37,3,9,12,512,-500,-97.65625
37,3,10,2433,1024,1409,137.59765625
37,3,11,2338,2048,290,14.16015625
37,3,12,6496,4096,2400,58.59375
37,3,13,1851,8192,-6341,-77.40478515625
37,3,14,28886,16384,12502,76.30615234375
37,3,15,53575,32768,20807,63.4979248046875
37,4,1,0,2,-2,-100.0
37,4,2,7,4,3,75.0
37,4,3,5,8,-3,-37.5
37,4,4,5,16,-11,-68.75
37,4,5,51,32,19,59.375
37,4,6,20,64,-44,-68.75
37,4,7,26,128,-102,-79.6875
37,4,8,84,256,-172,-67.1875
37,4,9,442,512,-70,-13.671875
37,4,10,370,1024,-654,-63.8671875
37,4,11,503,2048,-1545,-75.439453125
37,4,12,6902,4096,2806,68.505859375
37,4,13,1069,8192,-7123,-86.95068359375
37,4,14,43101,16384,26717,163.067626953125
37,4,15,25640,32768,-7128,-21.7529296875
37,5,1,0,2,-2,-100.0
37,5,2,1,4,-3,-75.0
37,5,3,7,8,-1,-12.5
37,5,4,16,16,0,0.0
37,5,5,25,32,-7,-21.875
37,5,6,20,64,-44,-68.75
37,5,7,11,128,-117,-91.40625
37,5,8,74,256,-182,-71.09375
37,5,9,866,512,354,69.140625
37,5,10,125,1024,-899,-87.79296875
37,5,11,5673,2048,3625,177.001953125
37,5,12,1939,4096,-2157,-52.6611328125
37,5,13,11862,8192,3670,44.7998046875
37,5,14,12544,16384,-3840,-23.4375
37,5,15,5347,32768,-27421,-83.6822509765625
37,6,1,0,2,-2,-100.0
37,6,2,4,4,0,0.0
37,6,3,5,8,-3,-37.5
37,6,4,37,16,21,131.25
37,6,5,6,32,-26,-81.25
37,6,6,70,64,6,9.375
37,6,7,77,128,-51,-39.84375
37,6,8,253,256,-3,-1.171875
37,6,9,289,512,-223,-43.5546875
37,6,10,164,1024,-860,-83.984375
37,6,11,402,2048,-1646,-80.37109375
37,6,12,43,4096,-4053,-98.9501953125
37,6,13,5011,8192,-3181,-38.83056640625
37,6,14,5528,16384,-10856,-66.259765625
37,6,15,39496,32768,6728,20.5322265625
37,7,1,0,2,-2,-100.0
37,7,2,1,4,-3,-75.0
37,7,3,4,8,-4,-50.0
37,7,4,19,16,3,18.75
37,7,5,27,32,-5,-15.625
37,7,6,11,64,-53,-82.8125
37,7,7,15,128,-113,-88.28125
37,7,8,478,256,222,86.71875
37,7,9,520,512,8,1.5625
37,7,10,868,1024,-156,-15.234375
37,7,11,1824,2048,-224,-10.9375
37,7,12,4959,4096,863,21.0693359375
37,7,13,10466,8192,2274,27.7587890625
37,7,14,1904,16384,-14480,-88.37890625
37,7,15,1673,32768,-31095,-94.8944091796875
37,8,1,0,2,-2,-100.0
37,8,2,2,4,-2,-50.0
37,8,3,7,8,-1,-12.5
37,8,4,25,16,9,56.25
37,8,5,16,32,-16,-50.0
37,8,6,10,64,-54,-84.375
37,8,7,199,128,71,55.46875
37,8,8,287,256,31,12.109375
37,8,9,1253,512,741,144.7265625
37,8,10,796,1024,-228,-22.265625
37,8,11,1632,2048,-416,-20.3125
37,8,12,188,4096,-3908,-95.41015625
37,8,13,14144,8192,5952,72.65625
37,8,14,3009,16384,-13375,-81.634521484375
37,8,15,14073,32768,-18695,-57.0526123046875
37,9,1,0,2,-2,-100.0
37,9,2,2,4,-2,-50.0
37,9,3,5,8,-3,-37.5
37,9,4,8,16,-8,-50.0
37,9,5,49,32,17,53.125
37,9,6,296,64,232,362.5
37,9,7,130,128,2,1.5625
37,9,8,230,256,-26,-10.15625
37,9,9,261,512,-251,-49.0234375
37,9,10,201,1024,-823,-80.37109375
37,9,11,1298,2048,-750,-36.62109375
37,9,12,1426,4096,-2670,-65.185546875
37,9,13,2019,8192,-6173,-75.35400390625
37,9,14,775,16384,-15609,-95.269775390625
37,9,15,682,32768,-32086,-97.918701171875
37,10,1,0,2,-2,-100.0
37,10,2,1,4,-3,-75.0
37,10,3,3,8,-5,-62.5
37,10,4,6,16,-10,-62.5
37,10,5,16,32,-16,-50.0
37,10,6,12,64,-52,-81.25
37,10,7,144,128,16,12.5
37,10,8,513,256,257,100.390625
37,10,9,712,512,200,39.0625
37,10,10,15,1024,-1009,-98.53515625
37,10,11,4580,2048,2532,123.6328125
37,10,12,2282,4096,-1814,-44.287109375
37,10,13,500,8192,-7692,-93.896484375
37,10,14,9787,16384,-6597,-40.264892578125
37,10,15,83743,32768,50975,155.5633544921875
37,11,1,0,2,-2,-100.0
37,11,2,2,4,-2,-50.0
37,11,3,2,8,-6,-75.0
37,11,4,10,16,-6,-37.5
37,11,5,5,32,-27,-84.375
37,11,6,8,64,-56,-87.5
37,11,7,27,128,-101,-78.90625
37,11,8,259,256,3,1.171875
37,11,9,182,512,-330,-64.453125
37,11,10,738,1024,-286,-27.9296875
37,11,11,1776,2048,-272,-13.28125
37,11,12,1154,4096,-2942,-71.826171875
37,11,13,602,8192,-7590,-92.6513671875
37,11,14,6293,16384,-10091,-61.590576171875
37,11,15,14781,32768,-17987,-54.8919677734375
37,12,1,0,2,-2,-100.0
37,12,2,2,4,-2,-50.0
37,12,3,4,8,-4,-50.0
37,12,4,31,16,15,93.75
37,12,5,5,32,-27,-84.375
37,12,6,97,64,33,51.5625
37,12,7,432,128,304,237.5
37,12,8,915,256,659,257.421875
37,12,9,633,512,121,23.6328125
37,12,10,1477,1024,453,44.23828125
37,12,11,362,2048,-1686,-82.32421875
37,12,12,14088,4096,9992,243.9453125
37,12,13,15831,8192,7639,93.24951171875
37,12,14,199,16384,-16185,-98.785400390625
37,12,15,17641,32768,-15127,-46.1639404296875
37,13,1,0,2,-2,-100.0
37,13,2,1,4,-3,-75.0
37,13,3,4,8,-4,-50.0
37,13,4,6,16,-10,-62.5
37,13,5,9,32,-23,-71.875
37,13,6,29,64,-35,-54.6875
37,13,7,19,128,-109,-85.15625
37,13,8,384,256,128,50.0
37,13,9,1181,512,669,130.6640625
37,13,10,335,1024,-689,-67.28515625
37,13,11,2504,2048,456,22.265625
37,13,12,836,4096,-3260,-79.58984375
37,13,13,5162,8192,-3030,-36.9873046875
37,13,14,14916,16384,-1468,-8.9599609375
37,13,15,50714,32768,17946,54.766845703125
37,14,1,0,2,-2,-100.0
37,14,2,5,4,1,25.0
37,14,3,8,8,0,0.0
37,14,4,20,16,4,25.0
37,14,5,23,32,-9,-28.125
37,14,6,149,64,85,132.8125
37,14,7,270,128,142,110.9375
37,14,8,730,256,474,185.15625
37,14,9,763,512,251,49.0234375
37,14,10,202,1024,-822,-80.2734375
37,14,11,909,2048,-1139,-55.615234375
37,14,12,16215,4096,12119,295.8740234375
37,14,13,5257,8192,-2935,-35.82763671875
37,14,14,8915,16384,-7469,-45.587158203125
37,14,15,16466,32768,-16302,-49.749755859375
37,15,1,0,2,-2,-100.0
37,15,2,2,4,-2,-50.0
37,15,3,18,8,10,125.0
37,15,4,13,16,-3,-18.75
37,15,5,43,32,11,34.375
37,15,6,122,64,58,90.625
37,15,7,16,128,-112,-87.5
37,15,8,127,256,-129,-50.390625
37,15,9,132,512,-380,-74.21875
37,15,10,1175,1024,151,14.74609375
37,15,11,239,2048,-1809,-88.330078125
37,15,12,2055,4096,-2041,-49.8291015625
37,15,13,8253,8192,61,0.74462890625
37,15,14,3348,16384,-13036,-79.5654296875
37,15,15,47828,32768,15060,45.95947265625
37,16,1,0,2,-2,-100.0
37,16,2,1,4,-3,-75.0
37,16,3,2,8,-6,-75.0
37,16,4,13,16,-3,-18.75
37,16,5,70,32,38,118.75
37,16,6,37,64,-27,-42.1875
37,16,7,25,128,-103,-80.46875
37,16,8,71,256,-185,-72.265625
37,16,9,146,512,-366,-71.484375
37,16,10,146,1024,-878,-85.7421875
37,16,11,2612,2048,564,27.5390625
37,16,12,6799,4096,2703,65.9912109375
37,16,13,1735,8192,-6457,-78.82080078125
37,16,14,7743,16384,-8641,-52.740478515625
37,16,15,2954,32768,-29814,-90.985107421875
37,17,1,0,2,-2,-100.0
37,17,2,1,4,-3,-75.0
37,17,3,8,8,0,0.0
37,17,4,37,16,21,131.25
37,17,5,25,32,-7,-21.875
37,17,6,23,64,-41,-64.0625
37,17,7,445,128,317,247.65625
37,17,8,55,256,-201,-78.515625
37,17,9,806,512,294,57.421875
37,17,10,667,1024,-357,-34.86328125
37,17,11,1152,2048,-896,-43.75
37,17,12,1260,4096,-2836,-69.23828125
37,17,13,6713,8192,-1479,-18.05419921875
37,17,14,38877,16384,22493,137.286376953125
37,17,15,30503,32768,-2265,-6.9122314453125
37,18,1,0,2,-2,-100.0
37,18,2,3,4,-1,-25.0
37,18,3,8,8,0,0.0
37,18,4,6,16,-10,-62.5
37,18,5,50,32,18,56.25
37,18,6,8,64,-56,-87.5
37,18,7,15,128,-113,-88.28125
37,18,8,564,256,308,120.3125
37,18,9,1500,512,988,192.96875
37,18,10,1457,1024,433,42.28515625
37,18,11,1009,2048,-1039,-50.732421875
37,18,12,2795,4096,-1301,-31.7626953125
37,18,13,1270,8192,-6922,-84.4970703125
37,18,14,5503,16384,-10881,-66.412353515625
37,18,15,88460,32768,55692,169.95849609375
37,19,1,0,2,-2,-100.0
37,19,2,3,4,-1,-25.0
37,19,3,8,8,0,0.0
37,19,4,3,16,-13,-81.25
37,19,5,56,32,24,75.0
37,19,6,123,64,59,92.1875
37,19,7,82,128,-46,-35.9375
37,19,8,166,256,-90,-35.15625
37,19,9,201,512,-311,-60.7421875
37,19,10,658,1024,-366,-35.7421875
37,19,11,1169,2048,-879,-42.919921875
37,19,12,375,4096,-3721,-90.8447265625
37,19,13,9462,8192,1270,15.5029296875
37,19,14,7365,16384,-9019,-55.047607421875
37,19,15,14510,32768,-18258,-55.718994140625
37,20,1,0,2,-2,-100.0
37,20,2,1,4,-3,-75.0
37,20,3,5,8,-3,-37.5
37,20,4,16,16,0,0.0
37,20,5,43,32,11,34.375
37,20,6,58,64,-6,-9.375
37,20,7,58,128,-70,-54.6875
37,20,8,59,256,-197,-76.953125
37,20,9,127,512,-385,-75.1953125
37,20,10,797,1024,-227,-22.16796875
37,20,11,795,2048,-1253,-61.181640625
37,20,12,3729,4096,-367,-8.9599609375
37,20,13,10606,8192,2414,29.4677734375
37,20,14,30199,16384,13815,84.320068359375
37,20,15,3839,32768,-28929,-88.2843017578125
37,21,1,0,2,-2,-100.0
37,21,2,3,4,-1,-25.0
37,21,3,11,8,3,37.5
37,21,4,4,16,-12,-75.0
37,21,5,24,32,-8,-25.0
37,21,6,123,64,59,92.1875
37,21,7,24,128,-104,-81.25
37,21,8,879,256,623,243.359375
37,21,9,982,512,470,91.796875
37,21,10,456,1024,-568,-55.46875
37,21,11,274,2048,-1774,-86.62109375
37,21,12,4088,4096,-8,-0.1953125
37,21,13,18959,8192,10767,131.43310546875
37,21,14,17080,16384,696,4.248046875
37,21,15,10446,32768,-22322,-68.121337890625
37,22,1,0,2,-2,-100.0
37,22,2,5,4,1,25.0
37,22,3,10,8,2,25.0
37,22,4,52,16,36,225.0
37,22,5,23,32,-9,-28.125
37,22,6,210,64,146,228.125
37,22,7,60,128,-68,-53.125
37,22,8,157,256,-99,-38.671875
37,22,9,1054,512,542,105.859375
37,22,10,1524,1024,500,48.828125
37,22,11,999,2048,-1049,-51.220703125
37,22,12,5257,4096,1161,28.3447265625
37,22,13,8981,8192,789,9.63134765625
37,22,14,12205,16384,-4179,-25.506591796875
37,22,15,6854,32768,-25914,-79.083251953125
37,23,1,0,2,-2,-100.0
37,23,2,2,4,-2,-50.0
37,23,3,4,8,-4,-50.0
37,23,4,35,16,19,118.75
37,23,5,35,32,3,9.375
37,23,6,36,64,-28,-43.75
37,23,7,164,128,36,28.125
37,23,8,499,256,243,94.921875
37,23,9,2169,512,1657,323.6328125
37,23,10,3054,1024,2030,198.2421875
37,23,11,1012,2048,-1036,-50.5859375
37,23,12,663,4096,-3433,-83.8134765625
37,23,13,5119,8192,-3073,-37.51220703125
37,23,14,20510,16384,4126,25.18310546875
37,23,15,30506,32768,-2262,-6.903076171875
37,24,1,0,2,-2,-100.0
37,24,2,3,4,-1,-25.0
37,24,3,2,8,-6,-75.0
37,24,4,7,16,-9,-56.25
37,24,5,14,32,-18,-56.25
37,24,6,58,64,-6,-9.375
37,24,7,53,128,-75,-58.59375
37,24,8,907,256,651,254.296875
37,24,9,381,512,-131,-25.5859375
37,24,10,1814,1024,790,77.1484375
37,24,11,7291,2048,5243,256.005859375
37,24,12,6556,4096,2460,60.05859375
37,24,13,10400,8192,2208,26.953125
37,24,14,75,16384,-16309,-99.542236328125
37,24,15,79435,32768,46667,142.4163818359375
37,25,1,0,2,-2,-100.0
37,25,2,1,4,-3,-75.0
37,25,3,2,8,-6,-75.0
37,25,4,12,16,-4,-25.0
37,25,5,78,32,46,143.75
37,25,6,69,64,5,7.8125
37,25,7,45,128,-83,-64.84375
37,25,8,548,256,292,114.0625
37,25,9,84,512,-428,-83.59375
37,25,10,949,1024,-75,-7.32421875
37,25,11,2741,2048,693,33.837890625
37,25,12,2974,4096,-1122,-27.392578125
37,25,13,10218,8192,2026,24.7314453125
37,25,14,3396,16384,-12988,-79.2724609375
37,25,15,35223,32768,2455,7.4920654296875
37,26,1,0,2,-2,-100.0
37,26,2,5,4,1,25.0
37,26,3,2,8,-6,-75.0
37,26,4,13,16,-3,-18.75
37,26,5,28,32,-4,-12.5
37,26,6,13,64,-51,-79.6875
37,26,7,123,128,-5,-3.90625
37,26,8,488,256,232,90.625
37,26,9,115,512,-397,-77.5390625
37,26,10,782,1024,-242,-23.6328125
37,26,11,3721,2048,1673,81.689453125
37,26,12,3242,4096,-854,-20.849609375
37,26,13,1740,8192,-6452,-78.759765625
37,26,14,36543,16384,20159,123.040771484375
37,26,15,6492,32768,-26276,-80.18798828125
37,27,1,0,2,-2,-100.0
37,27,2,1,4,-3,-75.0
37,27,3,7,8,-1,-12.5
37,27,4,14,16,-2,-12.5
37,27,5,19,32,-13,-40.625
37,27,6,78,64,14,21.875
37,27,7,15,128,-113,-88.28125
37,27,8,101,256,-155,-60.546875
37,27,9,1136,512,624,121.875
37,27,10,320,1024,-704,-68.75
37,27,11,1294,2048,-754,-36.81640625
37,27,12,1573,4096,-2523,-61.5966796875
37,27,13,1622,8192,-6570,-80.2001953125
37,27,14,5570,16384,-10814,-66.00341796875
37,27,15,8410,32768,-24358,-74.334716796875
37,28,1,0,2,-2,-100.0
37,28,2,3,4,-1,-25.0
37,28,3,4,8,-4,-50.0
37,28,4,4,16,-12,-75.0
37,28,5,16,32,-16,-50.0
37,28,6,6,64,-58,-90.625
37,28,7,64,128,-64,-50.0
37,28,8,44,256,-212,-82.8125
37,28,9,202,512,-310,-60.546875
37,28,10,434,1024,-590,-57.6171875
37,28,11,624,2048,-1424,-69.53125
37,28,12,4258,4096,162,3.955078125
37,28,13,10660,8192,2468,30.126953125
37,28,14,14301,16384,-2083,-12.713623046875
37,28,15,13414,32768,-19354,-59.063720703125
37,29,1,0,2,-2,-100.0
37,29,2,1,4,-3,-75.0
37,29,3,2,8,-6,-75.0
37,29,4,28,16,12,75.0
37,29,5,7,32,-25,-78.125
37,29,6,96,64,32,50.0
37,29,7,21,128,-107,-83.59375
37,29,8,88,256,-168,-65.625
37,29,9,72,512,-440,-85.9375
37,29,10,531,1024,-493,-48.14453125
37,29,11,1977,2048,-71,-3.466796875
37,29,12,614,4096,-3482,-85.009765625
37,29,13,6130,8192,-2062,-25.1708984375
37,29,14,46706,16384,30322,185.07080078125
37,29,15,72888,32768,40120,122.4365234375
37,30,1,0,2,-2,-100.0
37,30,2,3,4,-1,-25.0
37,30,3,6,8,-2,-25.0
37,30,4,27,16,11,68.75
37,30,5,8,32,-24,-75.0
37,30,6,48,64,-16,-25.0
37,30,7,56,128,-72,-56.25
37,30,8,321,256,65,25.390625
37,30,9,220,512,-292,-57.03125
37,30,10,1423,1024,399,38.96484375
37,30,11,520,2048,-1528,-74.609375
37,30,12,1909,4096,-2187,-53.3935546875
37,30,13,2695,8192,-5497,-67.10205078125
37,30,14,23138,16384,6754,41.22314453125
37,30,15,49317,32768,16549,50.5035400390625
37,31,1,0,2,-2,-100.0
37,31,2,2,4,-2,-50.0
37,31,3,8,8,0,0.0
37,31,4,8,16,-8,-50.0
37,31,5,14,32,-18,-56.25
37,31,6,30,64,-34,-53.125
37,31,7,78,128,-50,-39.0625
37,31,8,500,256,244,95.3125
37,31,9,84,512,-428,-83.59375
37,31,10,371,1024,-653,-63.76953125
37,31,11,1083,2048,-965,-47.119140625
37,31,12,697,4096,-3399,-82.9833984375
37,31,13,4102,8192,-4090,-49.9267578125
37,31,14,19842,16384,3458,21.10595703125
37,31,15,6552,32768,-26216,-80.0048828125
37,32,1,0,2,-2,-100.0
37,32,2,1,4,-3,-75.0
37,32,3,7,8,-1,-12.5
37,32,4,17,16,1,6.25
37,32,5,42,32,10,31.25
37,32,6,25,64,-39,-60.9375
37,32,7,93,128,-35,-27.34375
37,32,8,426,256,170,66.40625
37,32,9,1807,512,1295,252.9296875
37,32,10,411,1024,-613,-59.86328125
37,32,11,81,2048,-1967,-96.044921875
37,32,12,2039,4096,-2057,-50.2197265625
37,32,13,14396,8192,6204,75.732421875
37,32,14,34619,16384,18235,111.297607421875
37,32,15,18444,32768,-14324,-43.71337890625
37,33,1,0,2,-2,-100.0
37,33,2,3,4,-1,-25.0
37,33,3,2,8,-6,-75.0
37,33,4,13,16,-3,-18.75
37,33,5,6,32,-26,-81.25
37,33,6,214,64,150,234.375
37,33,7,151,128,23,17.96875
37,33,8,428,256,172,67.1875
37,33,9,286,512,-226,-44.140625
37,33,10,709,1024,-315,-30.76171875
37,33,11,264,2048,-1784,-87.109375
37,33,12,3552,4096,-544,-13.28125
37,33,13,5787,8192,-2405,-29.35791015625
37,33,14,995,16384,-15389,-93.927001953125
37,33,15,41725,32768,8957,27.3345947265625
37,34,1,0,2,-2,-100.0
37,34,2,1,4,-3,-75.0
37,34,3,2,8,-6,-75.0
37,34,4,3,16,-13,-81.25
37,34,5,23,32,-9,-28.125
37,34,6,5,64,-59,-92.1875
37,34,7,211,128,83,64.84375
37,34,8,428,256,172,67.1875
37,34,9,241,512,-271,-52.9296875
37,34,10,1009,1024,-15,-1.46484375
37,34,11,65,2048,-1983,-96.826171875
37,34,12,3831,4096,-265,-6.4697265625
37,34,13,4314,8192,-3878,-47.3388671875
37,34,14,6999,16384,-9385,-57.281494140625
37,34,15,10093,32768,-22675,-69.1986083984375
37,35,1,0,2,-2,-100.0
37,35,2,1,4,-3,-75.0
37,35,3,6,8,-2,-25.0
37,35,4,12,16,-4,-25.0
37,35,5,15,32,-17,-53.125
37,35,6,8,64,-56,-87.5
37,35,7,69,128,-59,-46.09375
37,35,8,8,256,-248,-96.875
37,35,9,405,512,-107,-20.8984375
37,35,10,1861,1024,837,81.73828125
37,35,11,5423,2048,3375,164.794921875
37,35,12,3494,4096,-602,-14.697265625
37,35,13,18183,8192,9991,121.96044921875
37,35,14,8775,16384,-7609,-46.441650390625
37,35,15,86237,32768,53469,163.1744384765625
37,36,1,0,2,-2,-100.0
37,36,2,2,4,-2,-50.0
37,36,3,4,8,-4,-50.0
37,36,4,6,16,-10,-62.5
37,36,5,16,32,-16,-50.0
37,36,6,17,64,-47,-73.4375
37,36,7,19,128,-109,-85.15625
37,36,8,473,256,217,84.765625
37,36,9,553,512,41,8.0078125
37,36,10,2251,1024,1227,119.82421875
37,36,11,162,2048,-1886,-92.08984375
37,36,12,1709,4096,-2387,-58.2763671875
37,36,13,11676,8192,3484,42.529296875
37,36,14,24139,16384,7755,47.332763671875
37,36,15,61665,32768,28897,88.1866455078125
37,37,1,0,2,-2,-100.0
37,37,2,2,4,-2,-50.0
37,37,3,7,8,-1,-12.5
37,37,4,14,16,-2,-12.5
37,37,5,5,32,-27,-84.375
37,37,6,34,64,-30,-46.875
37,37,7,186,128,58,45.3125
37,37,8,683,256,427,166.796875
37,37,9,431,512,-81,-15.8203125
37,37,10,3837,1024,2813,274.70703125
37,37,11,3509,2048,1461,71.337890625
37,37,12,5409,4096,1313,32.0556640625
37,37,13,8000,8192,-192,-2.34375
37,37,14,45349,16384,28965,176.788330078125
37,37,15,1667,32768,-31101,-94.9127197265625
38,1,1,0,2,-2,-100.0
38,1,2,2,4,-2,-50.0
38,1,3,3,8,-5,-62.5
38,1,4,39,16,23,143.75
38,1,5,15,32,-17,-53.125
38,1,6,8,64,-56,-87.5
38,1,7,200,128,72,56.25
38,1,8,53,256,-203,-79.296875
38,1,9,336,512,-176,-34.375
38,1,10,406,1024,-618,-60.3515625
38,1,11,364,2048,-1684,-82.2265625
38,1,12,2386,4096,-1710,-41.748046875
38,1,13,14808,8192,6616,80.76171875
38,1,14,1027,16384,-15357,-93.731689453125
38,1,15,23262,32768,-9506,-29.010009765625
38,2,1,0,2,-2,-100.0
38,2,2,2,4,-2,-50.0
38,2,3,12,8,4,50.0
38,2,4,3,16,-13,-81.25
38,2,5,25,32,-7,-21.875
38,2,6,51,64,-13,-20.3125
38,2,7,12,128,-116,-90.625
38,2,8,298,256,42,16.40625
38,2,9,224,512,-288,-56.25
38,2,10,3030,1024,2006,195.8984375
38,2,11,1303,2048,-745,-36.376953125
38,2,12,2849,4096,-1247,-30.4443359375
38,2,13,7826,8192,-366,-4.4677734375
38,2,14,2226,16384,-14158,-86.41357421875
38,2,15,111299,32768,78531,239.6575927734375
38,3,1,0,2,-2,-100.0
38,3,2,1,4,-3,-75.0
38,3,3,2,8,-6,-75.0
38,3,4,3,16,-13,-81.25
38,3,5,31,32,-1,-3.125
38,3,6,16,64,-48,-75.0
38,3,7,55,128,-73,-57.03125
38,3,8,403,256,147,57.421875
38,3,9,704,512,192,37.5
38,3,10,2329,1024,1305,127.44140625
38,3,11,311,2048,-1737,-84.814453125
38,3,12,1294,4096,-2802,-68.408203125
38,3,13,6100,8192,-2092,-25.537109375
38,3,14,22213,16384,5829,35.577392578125
38,3,15,29461,32768,-3307,-10.0921630859375
38,4,1,0,2,-2,-100.0
38,4,2,2,4,-2,-50.0
38,4,3,6,8,-2,-25.0
38,4,4,17,16,1,6.25
38,4,5,45,32,13,40.625
38,4,6,51,64,-13,-20.3125
38,4,7,11,128,-117,-91.40625
38,4,8,119,256,-137,-53.515625
38,4,9,606,512,94,18.359375
38,4,10,312,1024,-712,-69.53125
38,4,11,1547,2048,-501,-24.462890625
38,4,12,4060,4096,-36,-0.87890625
38,4,13,5474,8192,-2718,-33.1787109375
38,4,14,29801,16384,13417,81.890869140625
38,4,15,73346,32768,40578,123.834228515625
38,5,1,0,2,-2,-100.0
38,5,2,2,4,-2,-50.0
38,5,3,5,8,-3,-37.5
38,5,4,41,16,25,156.25
38,5,5,31,32,-1,-3.125
38,5,6,9,64,-55,-85.9375
38,5,7,163,128,35,27.34375
38,5,8,257,256,1,0.390625
38,5,9,415,512,-97,-18.9453125
38,5,10,1569,1024,545,53.22265625
38,5,11,3480,2048,1432,69.921875
38,5,12,6483,4096,2387,58.2763671875
38,5,13,5683,8192,-2509,-30.62744140625
38,5,14,14574,16384,-1810,-11.04736328125
38,5,15,20004,32768,-12764,-38.95263671875
38,6,1,0,2,-2,-100.0
38,6,2,1,4,-3,-75.0
38,6,3,7,8,-1,-12.5
38,6,4,12,16,-4,-25.0
38,6,5,12,32,-20,-62.5
38,6,6,10,64,-54,-84.375
38,6,7,85,128,-43,-33.59375
38,6,8,109,256,-147,-57.421875
38,6,9,1291,512,779,152.1484375
38,6,10,9,1024,-1015,-99.12109375
38,6,11,1731,2048,-317,-15.478515625
38,6,12,2228,4096,-1868,-45.60546875
38,6,13,2577,8192,-5615,-68.54248046875
38,6,14,48764,16384,32380,197.6318359375
38,6,15,25114,32768,-7654,-23.358154296875
38,7,1,0,2,-2,-100.0
38,7,2,1,4,-3,-75.0
38,7,3,4,8,-4,-50.0
38,7,4,3,16,-13,-81.25
38,7,5,14,32,-18,-56.25
38,7,6,7,64,-57,-89.0625
38,7,7,59,128,-69,-53.90625
38,7,8,583,256,327,127.734375
38,7,9,1777,512,1265,247.0703125
38,7,10,870,1024,-154,-15.0390625
38,7,11,619,2048,-1429,-69.775390625
38,7,12,971,4096,-3125,-76.2939453125
38,7,13,199,8192,-7993,-97.57080078125
38,7,14,1417,16384,-14967,-91.351318359375
38,7,15,9995,32768,-22773,-69.4976806640625
38,8,1,0,2,-2,-100.0
38,8,2,1,4,-3,-75.0
38,8,3,5,8,-3,-37.5
38,8,4,14,16,-2,-12.5
38,8,5,4,32,-28,-87.5
38,8,6,11,64,-53,-82.8125
38,8,7,6,128,-122,-95.3125
38,8,8,243,256,-13,-5.078125
38,8,9,915,512,403,78.7109375
38,8,10,3103,1024,2079,203.02734375
38,8,11,424,2048,-1624,-79.296875
38,8,12,1331,4096,-2765,-67.5048828125
38,8,13,1804,8192,-6388,-77.978515625
38,8,14,3679,16384,-12705,-77.545166015625
38,8,15,25868,32768,-6900,-21.05712890625
38,9,1,0,2,-2,-100.0
38,9,2,3,4,-1,-25.0
38,9,3,6,8,-2,-25.0
38,9,4,9,16,-7,-43.75
38,9,5,19,32,-13,-40.625
38,9,6,50,64,-14,-21.875
38,9,7,145,128,17,13.28125
38,9,8,647,256,391,152.734375
38,9,9,602,512,90,17.578125
38,9,10,1398,1024,374,36.5234375
38,9,11,1442,2048,-606,-29.58984375
38,9,12,10513,4096,6417,156.6650390625
38,9,13,4694,8192,-3498,-42.7001953125
38,9,14,9572,16384,-6812,-41.5771484375
38,9,15,87904,32768,55136,168.26171875
38,10,1,0,2,-2,-100.0
38,10,2,4,4,0,0.0
38,10,3,6,8,-2,-25.0
38,10,4,3,16,-13,-81.25
38,10,5,4,32,-28,-87.5
38,10,6,101,64,37,57.8125
38,10,7,52,128,-76,-59.375
38,10,8,32,256,-224,-87.5
38,10,9,135,512,-377,-73.6328125
38,10,10,2033,1024,1009,98.53515625
38,10,11,1850,2048,-198,-9.66796875
38,10,12,620,4096,-3476,-84.86328125
38,10,13,2705,8192,-5487,-66.97998046875
38,10,14,10020,16384,-6364,-38.8427734375
38,10,15,23388,32768,-9380,-28.62548828125
38,11,1,0,2,-2,-100.0
38,11,2,1,4,-3,-75.0
38,11,3,36,8,28,350.0
38,11,4,20,16,4,25.0
38,11,5,13,32,-19,-59.375
38,11,6,112,64,48,75.0
38,11,7,139,128,11,8.59375
38,11,8,117,256,-139,-54.296875
38,11,9,408,512,-104,-20.3125
38,11,10,527,1024,-497,-48.53515625
38,11,11,1290,2048,-758,-37.01171875
38,11,12,1706,4096,-2390,-58.349609375
38,11,13,3053,8192,-5139,-62.73193359375
38,11,14,16293,16384,-91,-0.555419921875
38,11,15,7154,32768,-25614,-78.167724609375
38,12,1,0,2,-2,-100.0
38,12,2,1,4,-3,-75.0
38,12,3,2,8,-6,-75.0
38,12,4,10,16,-6,-37.5
38,12,5,47,32,15,46.875
38,12,6,26,64,-38,-59.375
38,12,7,22,128,-106,-82.8125
38,12,8,64,256,-192,-75.0
38,12,9,250,512,-262,-51.171875
38,12,10,179,1024,-845,-82.51953125
38,12,11,6388,2048,4340,211.9140625
38,12,12,9165,4096,5069,123.7548828125
38,12,13,3802,8192,-4390,-53.5888671875
38,12,14,10496,16384,-5888,-35.9375
38,12,15,4911,32768,-27857,-85.0128173828125
38,13,1,0,2,-2,-100.0
38,13,2,4,4,0,0.0
38,13,3,5,8,-3,-37.5
38,13,4,8,16,-8,-50.0
38,13,5,49,32,17,53.125
38,13,6,23,64,-41,-64.0625
38,13,7,54,128,-74,-57.8125
38,13,8,122,256,-134,-52.34375
38,13,9,904,512,392,76.5625
38,13,10,1132,1024,108,10.546875
38,13,11,697,2048,-1351,-65.966796875
38,13,12,1602,4096,-2494,-60.888671875
38,13,13,13467,8192,5275,64.39208984375
38,13,14,8123,16384,-8261,-50.421142578125
38,13,15,16003,32768,-16765,-51.1627197265625
38,14,1,0,2,-2,-100.0
38,14,2,2,4,-2,-50.0
38,14,3,2,8,-6,-75.0
38,14,4,17,16,1,6.25
38,14,5,9,32,-23,-71.875
38,14,6,41,64,-23,-35.9375
38,14,7,84,128,-44,-34.375
38,14,8,525,256,269,105.078125
38,14,9,527,512,15,2.9296875
38,14,10,910,1024,-114,-11.1328125
38,14,11,413,2048,-1635,-79.833984375
38,14,12,8985,4096,4889,119.3603515625
38,14,13,9655,8192,1463,17.85888671875
38,14,14,20924,16384,4540,27.7099609375
38,14,15,53799,32768,21031,64.1815185546875
38,15,1,0,2,-2,-100.0
38,15,2,2,4,-2,-50.0
38,15,3,3,8,-5,-62.5
38,15,4,31,16,15,93.75
38,15,5,27,32,-5,-15.625
38,15,6,29,64,-35,-54.6875
38,15,7,34,128,-94,-73.4375
38,15,8,139,256,-117,-45.703125
38,15,9,162,512,-350,-68.359375
38,15,10,27,1024,-997,-97.36328125
38,15,11,1506,2048,-542,-26.46484375
38,15,12,323,4096,-3773,-92.1142578125
38,15,13,14973,8192,6781,82.77587890625
38,15,14,10734,16384,-5650,-34.48486328125
38,15,15,90950,32768,58182,177.557373046875
38,16,1,0,2,-2,-100.0
38,16,2,1,4,-3,-75.0
38,16,3,9,8,1,12.5
38,16,4,12,16,-4,-25.0
38,16,5,21,32,-11,-34.375
38,16,6,14,64,-50,-78.125
38,16,7,34,128,-94,-73.4375
38,16,8,777,256,521,203.515625
38,16,9,391,512,-121,-23.6328125
38,16,10,163,1024,-861,-84.08203125
38,16,11,371,2048,-1677,-81.884765625
38,16,12,218,4096,-3878,-94.677734375
38,16,13,6139,8192,-2053,-25.06103515625
38,16,14,29365,16384,12981,79.229736328125
38,16,15,14817,32768,-17951,-54.7821044921875
38,17,1,0,2,-2,-100.0
38,17,2,2,4,-2,-50.0
38,17,3,2,8,-6,-75.0
38,17,4,3,16,-13,-81.25
38,17,5,13,32,-19,-59.375
38,17,6,103,64,39,60.9375
38,17,7,90,128,-38,-29.6875
38,17,8,98,256,-158,-61.71875
38,17,9,1203,512,691,134.9609375
38,17,10,1194,1024,170,16.6015625
38,17,11,550,2048,-1498,-73.14453125
38,17,12,104,4096,-3992,-97.4609375
38,17,13,2562,8192,-5630,-68.7255859375
38,17,14,10460,16384,-5924,-36.1572265625
38,17,15,36163,32768,3395,10.3607177734375
38,18,1,0,2,-2,-100.0
38,18,2,1,4,-3,-75.0
38,18,3,19,8,11,137.5
38,18,4,6,16,-10,-62.5
38,18,5,4,32,-28,-87.5
38,18,6,9,64,-55,-85.9375
38,18,7,129,128,1,0.78125
38,18,8,275,256,19,7.421875
38,18,9,543,512,31,6.0546875
38,18,10,123,1024,-901,-87.98828125
38,18,11,1300,2048,-748,-36.5234375
38,18,12,80,4096,-4016,-98.046875
38,18,13,594,8192,-7598,-92.7490234375
38,18,14,18131,16384,1747,10.662841796875
38,18,15,29799,32768,-2969,-9.0606689453125
38,19,1,0,2,-2,-100.0
38,19,2,3,4,-1,-25.0
38,19,3,11,8,3,37.5
38,19,4,6,16,-10,-62.5
38,19,5,36,32,4,12.5
38,19,6,94,64,30,46.875
38,19,7,6,128,-122,-95.3125
38,19,8,54,256,-202,-78.90625
38,19,9,311,512,-201,-39.2578125
38,19,10,344,1024,-680,-66.40625
38,19,11,1024,2048,-1024,-50.0
38,19,12,4247,4096,151,3.6865234375
38,19,13,4758,8192,-3434,-41.9189453125
38,19,14,11412,16384,-4972,-30.3466796875
38,19,15,22131,32768,-10637,-32.4615478515625
38,20,1,0,2,-2,-100.0
38,20,2,2,4,-2,-50.0
38,20,3,2,8,-6,-75.0
38,20,4,3,16,-13,-81.25
38,20,5,14,32,-18,-56.25
38,20,6,7,64,-57,-89.0625
38,20,7,143,128,15,11.71875
38,20,8,52,256,-204,-79.6875
38,20,9,44,512,-468,-91.40625
38,20,10,492,1024,-532,-51.953125
38,20,11,7934,2048,5886,287.40234375
38,20,12,13529,4096,9433,230.2978515625
38,20,13,8798,8192,606,7.3974609375
38,20,14,2918,16384,-13466,-82.18994140625
38,20,15,83176,32768,50408,153.8330078125
38,21,1,0,2,-2,-100.0
38,21,2,1,4,-3,-75.0
38,21,3,8,8,0,0.0
38,21,4,4,16,-12,-75.0
38,21,5,71,32,39,121.875
38,21,6,28,64,-36,-56.25
38,21,7,11,128,-117,-91.40625
38,21,8,62,256,-194,-75.78125
38,21,9,275,512,-237,-46.2890625
38,21,10,1935,1024,911,88.96484375
38,21,11,4991,2048,2943,143.701171875
38,21,12,1744,4096,-2352,-57.421875
38,21,13,3329,8192,-4863,-59.36279296875
38,21,14,3614,16384,-12770,-77.94189453125
38,21,15,63016,32768,30248,92.3095703125
38,22,1,0,2,-2,-100.0
38,22,2,2,4,-2,-50.0
38,22,3,6,8,-2,-25.0
38,22,4,7,16,-9,-56.25
38,22,5,24,32,-8,-25.0
38,22,6,146,64,82,128.125
38,22,7,206,128,78,60.9375
38,22,8,178,256,-78,-30.46875
38,22,9,769,512,257,50.1953125
38,22,10,807,1024,-217,-21.19140625
38,22,11,13,2048,-2035,-99.365234375
38,22,12,1171,4096,-2925,-71.4111328125
38,22,13,7327,8192,-865,-10.55908203125
38,22,14,18583,16384,2199,13.421630859375
38,22,15,7570,32768,-25198,-76.898193359375
38,23,1,0,2,-2,-100.0
38,23,2,2,4,-2,-50.0
38,23,3,4,8,-4,-50.0
38,23,4,5,16,-11,-68.75
38,23,5,34,32,2,6.25
38,23,6,18,64,-46,-71.875
38,23,7,229,128,101,78.90625
38,23,8,48,256,-208,-81.25
38,23,9,734,512,222,43.359375
38,23,10,127,1024,-897,-87.59765625
38,23,11,4520,2048,2472,120.703125
38,23,12,5050,4096,954,23.291015625
38,23,13,22805,8192,14613,178.38134765625
38,23,14,4976,16384,-11408,-69.62890625
38,23,15,7633,32768,-25135,-76.7059326171875
38,24,1,0,2,-2,-100.0
38,24,2,3,4,-1,-25.0
38,24,3,5,8,-3,-37.5
38,24,4,11,16,-5,-31.25
38,24,5,26,32,-6,-18.75
38,24,6,10,64,-54,-84.375
38,24,7,36,128,-92,-71.875
38,24,8,8,256,-248,-96.875
38,24,9,412,512,-100,-19.53125
38,24,10,1053,1024,29,2.83203125
38,24,11,1491,2048,-557,-27.197265625
38,24,12,1534,4096,-2562,-62.548828125
38,24,13,10558,8192,2366,28.8818359375
38,24,14,25960,16384,9576,58.447265625
38,24,15,29128,32768,-3640,-11.1083984375
38,25,1,0,2,-2,-100.0
38,25,2,2,4,-2,-50.0
38,25,3,7,8,-1,-12.5
38,25,4,27,16,11,68.75
38,25,5,4,32,-28,-87.5
38,25,6,30,64,-34,-53.125
38,25,7,33,128,-95,-74.21875
38,25,8,900,256,644,251.5625
38,25,9,129,512,-383,-74.8046875
38,25,10,1075,1024,51,4.98046875
38,25,11,440,2048,-1608,-78.515625
38,25,12,2654,4096,-1442,-35.205078125
38,25,13,227,8192,-7965,-97.22900390625
38,25,14,5088,16384,-11296,-68.9453125
38,25,15,12101,32768,-20667,-63.0706787109375
38,26,1,0,2,-2,-100.0
38,26,2,1,4,-3,-75.0
38,26,3,2,8,-6,-75.0
38,26,4,3,16,-13,-81.25
38,26,5,49,32,17,53.125
38,26,6,36,64,-28,-43.75
38,26,7,100,128,-28,-21.875
38,26,8,376,256,120,46.875
38,26,9,52,512,-460,-89.84375
38,26,10,63,1024,-961,-93.84765625
38,26,11,3831,2048,1783,87.060546875
38,26,12,8285,4096,4189,102.2705078125
38,26,13,459,8192,-7733,-94.39697265625
38,26,14,7571,16384,-8813,-53.790283203125
38,26,15,24720,32768,-8048,-24.560546875
38,27,1,0,2,-2,-100.0
38,27,2,2,4,-2,-50.0
38,27,3,3,8,-5,-62.5
38,27,4,17,16,1,6.25
38,27,5,51,32,19,59.375
38,27,6,70,64,6,9.375
38,27,7,140,128,12,9.375
38,27,8,123,256,-133,-51.953125
38,27,9,744,512,232,45.3125
38,27,10,528,1024,-496,-48.4375
38,27,11,2205,2048,157,7.666015625
38,27,12,129,4096,-3967,-96.8505859375
38,27,13,11027,8192,2835,34.60693359375
38,27,14,2147,16384,-14237,-86.895751953125
38,27,15,18200,32768,-14568,-44.4580078125
38,28,1,0,2,-2,-100.0
38,28,2,1,4,-3,-75.0
38,28,3,6,8,-2,-25.0
38,28,4,6,16,-10,-62.5
38,28,5,8,32,-24,-75.0
38,28,6,36,64,-28,-43.75
38,28,7,392,128,264,206.25
38,28,8,107,256,-149,-58.203125
38,28,9,71,512,-441,-86.1328125
38,28,10,854,1024,-170,-16.6015625
38,28,11,511,2048,-1537,-75.048828125
38,28,12,11483,4096,7387,180.3466796875
38,28,13,63217,8192,55025,671.69189453125
38,28,14,5158,16384,-11226,-68.51806640625
38,28,15,20506,32768,-12262,-37.420654296875
38,29,1,0,2,-2,-100.0
38,29,2,1,4,-3,-75.0
38,29,3,4,8,-4,-50.0
38,29,4,9,16,-7,-43.75
38,29,5,29,32,-3,-9.375
38,29,6,20,64,-44,-68.75
38,29,7,472,128,344,268.75
38,29,8,152,256,-104,-40.625
38,29,9,1173,512,661,129.1015625
38,29,10,794,1024,-230,-22.4609375
38,29,11,1210,2048,-838,-40.91796875
38,29,12,913,4096,-3183,-77.7099609375
38,29,13,5875,8192,-2317,-28.28369140625
38,29,14,8762,16384,-7622,-46.52099609375
38,29,15,12001,32768,-20767,-63.3758544921875
38,30,1,0,2,-2,-100.0
38,30,2,2,4,-2,-50.0
38,30,3,3,8,-5,-62.5
38,30,4,11,16,-5,-31.25
38,30,5,5,32,-27,-84.375
38,30,6,6,64,-58,-90.625
38,30,7,37,128,-91,-71.09375
38,30,8,929,256,673,262.890625
38,30,9,1122,512,610,119.140625
38,30,10,58,1024,-966,-94.3359375
38,30,11,1690,2048,-358,-17.48046875
38,30,12,293,4096,-3803,-92.8466796875
38,30,13,3381,8192,-4811,-58.72802734375
38,30,14,5062,16384,-11322,-69.10400390625
38,30,15,19019,32768,-13749,-41.9586181640625
38,31,1,0,2,-2,-100.0
38,31,2,1,4,-3,-75.0
38,31,3,4,8,-4,-50.0
38,31,4,17,16,1,6.25
38,31,5,4,32,-28,-87.5
38,31,6,7,64,-57,-89.0625
38,31,7,12,128,-116,-90.625
38,31,8,78,256,-178,-69.53125
38,31,9,129,512,-383,-74.8046875
38,31,10,128,1024,-896,-87.5
38,31,11,297,2048,-1751,-85.498046875
38,31,12,45,4096,-4051,-98.9013671875
38,31,13,5626,8192,-2566,-31.3232421875
38,31,14,7313,16384,-9071,-55.364990234375
38,31,15,16379,32768,-16389,-50.0152587890625
38,32,1,0,2,-2,-100.0
38,32,2,1,4,-3,-75.0
38,32,3,7,8,-1,-12.5
38,32,4,35,16,19,118.75
38,32,5,6,32,-26,-81.25
38,32,6,152,64,88,137.5
38,32,7,55,128,-73,-57.03125
38,32,8,83,256,-173,-67.578125
38,32,9,83,512,-429,-83.7890625
38,32,10,1545,1024,521,50.87890625
38,32,11,1795,2048,-253,-12.353515625
38,32,12,12849,4096,8753,213.6962890625
38,32,13,3778,8192,-4414,-53.8818359375
38,32,14,46096,16384,29712,181.34765625
38,32,15,9562,32768,-23206,-70.819091796875
38,33,1,0,2,-2,-100.0
38,33,2,3,4,-1,-25.0
38,33,3,8,8,0,0.0
38,33,4,5,16,-11,-68.75
38,33,5,27,32,-5,-15.625
38,33,6,55,64,-9,-14.0625
38,33,7,317,128,189,147.65625
38,33,8,931,256,675,263.671875
38,33,9,170,512,-342,-66.796875
38,33,10,2748,1024,1724,168.359375
38,33,11,1527,2048,-521,-25.439453125
38,33,12,278,4096,-3818,-93.212890625
38,33,13,10973,8192,2781,33.94775390625
38,33,14,37914,16384,21530,131.40869140625
38,33,15,5935,32768,-26833,-81.8878173828125
38,34,1,0,2,-2,-100.0
38,34,2,1,4,-3,-75.0
38,34,3,13,8,5,62.5
38,34,4,8,16,-8,-50.0
38,34,5,29,32,-3,-9.375
38,34,6,7,64,-57,-89.0625
38,34,7,24,128,-104,-81.25
38,34,8,39,256,-217,-84.765625
38,34,9,2005,512,1493,291.6015625
38,34,10,702,1024,-322,-31.4453125
38,34,11,1974,2048,-74,-3.61328125
38,34,12,466,4096,-3630,-88.623046875
38,34,13,8918,8192,726,8.8623046875
38,34,14,5848,16384,-10536,-64.306640625
38,34,15,29587,32768,-3181,-9.7076416015625
38,35,1,0,2,-2,-100.0
38,35,2,1,4,-3,-75.0
38,35,3,2,8,-6,-75.0
38,35,4,4,16,-12,-75.0
38,35,5,4,32,-28,-87.5
38,35,6,27,64,-37,-57.8125
38,35,7,313,128,185,144.53125
38,35,8,352,256,96,37.5
38,35,9,387,512,-125,-24.4140625
38,35,10,3097,1024,2073,202.44140625
38,35,11,1668,2048,-380,-18.5546875
38,35,12,53,4096,-4043,-98.7060546875
38,35,13,12238,8192,4046,49.3896484375
38,35,14,17469,16384,1085,6.622314453125
38,35,15,30518,32768,-2250,-6.866455078125
38,36,1,0,2,-2,-100.0
38,36,2,3,4,-1,-25.0
38,36,3,4,8,-4,-50.0
38,36,4,55,16,39,243.75
38,36,5,75,32,43,134.375
38,36,6,29,64,-35,-54.6875
38,36,7,123,128,-5,-3.90625
38,36,8,43,256,-213,-83.203125
38,36,9,292,512,-220,-42.96875
38,36,10,362,1024,-662,-64.6484375
38,36,11,2114,2048,66,3.22265625
38,36,12,1673,4096,-2423,-59.1552734375
38,36,13,3697,8192,-4495,-54.87060546875
38,36,14,924,16384,-15460,-94.3603515625
38,36,15,7837,32768,-24931,-76.0833740234375
38,37,1,0,2,-2,-100.0
38,37,2,3,4,-1,-25.0
38,37,3,2,8,-6,-75.0
38,37,4,4,16,-12,-75.0
38,37,5,95,32,63,196.875
38,37,6,24,64,-40,-62.5
38,37,7,35,128,-93,-72.65625
38,37,8,339,256,83,32.421875
38,37,9,24,512,-488,-95.3125
38,37,10,1172,1024,148,14.453125
38,37,11,871,2048,-1177,-57.470703125
38,37,12,3839,4096,-257,-6.2744140625
38,37,13,4241,8192,-3951,-48.22998046875
38,37,14,23438,16384,7054,43.05419921875
38,37,15,39802,32768,7034,21.466064453125
38,38,1,0,2,-2,-100.0
38,38,2,5,4,1,25.0
38,38,3,2,8,-6,-75.0
38,38,4,5,16,-11,-68.75
38,38,5,8,32,-24,-75.0
38,38,6,41,64,-23,-35.9375
38,38,7,149,128,21,16.40625
38,38,8,109,256,-147,-57.421875
38,38,9,619,512,107,20.8984375
38,38,10,2289,1024,1265,123.53515625
38,38,11,3482,2048,1434,70.01953125
38,38,12,377,4096,-3719,-90.7958984375
38,38,13,2467,8192,-5725,-69.88525390625
38,38,14,19495,16384,3111,18.988037109375
38,38,15,15389,32768,-17379,-53.0364990234375
39,1,1,0,2,-2,-100.0
39,1,2,4,4,0,0.0
39,1,3,2,8,-6,-75.0
39,1,4,7,16,-9,-56.25
39,1,5,6,32,-26,-81.25
39,1,6,75,64,11,17.1875
39,1,7,70,128,-58,-45.3125
39,1,8,122,256,-134,-52.34375
39,1,9,693,512,181,35.3515625
39,1,10,823,1024,-201,-19.62890625
39,1,11,853,2048,-1195,-58.349609375
39,1,12,51,4096,-4045,-98.7548828125
39,1,13,2835,8192,-5357,-65.39306640625
39,1,14,8495,16384,-7889,-48.150634765625
39,1,15,5931,32768,-26837,-81.9000244140625
39,2,1,0,2,-2,-100.0
39,2,2,1,4,-3,-75.0
39,2,3,4,8,-4,-50.0
39,2,4,6,16,-10,-62.5
39,2,5,8,32,-24,-75.0
39,2,6,64,64,0,0.0
39,2,7,59,128,-69,-53.90625
39,2,8,28,256,-228,-89.0625
39,2,9,152,512,-360,-70.3125
39,2,10,505,1024,-519,-50.68359375
39,2,11,28,2048,-2020,-98.6328125
39,2,12,8276,4096,4180,102.05078125
39,2,13,16987,8192,8795,107.36083984375
39,2,14,2306,16384,-14078,-85.92529296875
39,2,15,16931,32768,-15837,-48.3306884765625
39,3,1,0,2,-2,-100.0
39,3,2,1,4,-3,-75.0
39,3,3,2,8,-6,-75.0
39,3,4,19,16,3,18.75
39,3,5,14,32,-18,-56.25
39,3,6,103,64,39,60.9375
39,3,7,452,128,324,253.125
39,3,8,25,256,-231,-90.234375
39,3,9,84,512,-428,-83.59375
39,3,10,41,1024,-983,-95.99609375
39,3,11,1829,2048,-219,-10.693359375
39,3,12,1502,4096,-2594,-63.330078125
39,3,13,51457,8192,43265,528.13720703125
39,3,14,3238,16384,-13146,-80.23681640625
39,3,15,80062,32768,47294,144.329833984375
39,4,1,0,2,-2,-100.0
39,4,2,1,4,-3,-75.0
39,4,3,14,8,6,75.0
39,4,4,8,16,-8,-50.0
39,4,5,130,32,98,306.25
39,4,6,14,64,-50,-78.125
39,4,7,215,128,87,67.96875
39,4,8,58,256,-198,-77.34375
39,4,9,95,512,-417,-81.4453125
39,4,10,790,1024,-234,-22.8515625
39,4,11,1273,2048,-775,-37.841796875
39,4,12,8955,4096,4859,118.6279296875
39,4,13,9086,8192,894,10.9130859375
39,4,14,9970,16384,-6414,-39.14794921875
39,4,15,2871,32768,-29897,-91.2384033203125
39,5,1,0,2,-2,-100.0
39,5,2,1,4,-3,-75.0
39,5,3,2,8,-6,-75.0
39,5,4,5,16,-11,-68.75
39,5,5,57,32,25,78.125
39,5,6,64,64,0,0.0
39,5,7,77,128,-51,-39.84375
39,5,8,186,256,-70,-27.34375
39,5,9,133,512,-379,-74.0234375
39,5,10,169,1024,-855,-83.49609375
39,5,11,2879,2048,831,40.576171875
39,5,12,9371,4096,5275,128.7841796875
39,5,13,10635,8192,2443,29.82177734375
39,5,14,15679,16384,-705,-4.302978515625
39,5,15,6565,32768,-26203,-79.9652099609375
39,6,1,0,2,-2,-100.0
39,6,2,1,4,-3,-75.0
39,6,3,26,8,18,225.0
39,6,4,3,16,-13,-81.25
39,6,5,41,32,9,28.125
39,6,6,5,64,-59,-92.1875
39,6,7,90,128,-38,-29.6875
39,6,8,255,256,-1,-0.390625
39,6,9,568,512,56,10.9375
39,6,10,528,1024,-496,-48.4375
39,6,11,1730,2048,-318,-15.52734375
39,6,12,58,4096,-4038,-98.583984375
39,6,13,1874,8192,-6318,-77.1240234375
39,6,14,37208,16384,20824,127.099609375
39,6,15,36731,32768,3963,12.0941162109375
39,7,1,0,2,-2,-100.0
39,7,2,1,4,-3,-75.0
39,7,3,27,8,19,237.5
39,7,4,9,16,-7,-43.75
39,7,5,12,32,-20,-62.5
39,7,6,14,64,-50,-78.125
39,7,7,206,128,78,60.9375
39,7,8,98,256,-158,-61.71875
39,7,9,300,512,-212,-41.40625
39,7,10,277,1024,-747,-72.94921875
39,7,11,275,2048,-1773,-86.572265625
39,7,12,977,4096,-3119,-76.1474609375
39,7,13,37,8192,-8155,-99.54833984375
39,7,14,8343,16384,-8041,-49.078369140625
39,7,15,5291,32768,-27477,-83.8531494140625
39,8,1,0,2,-2,-100.0
39,8,2,1,4,-3,-75.0
39,8,3,13,8,5,62.5
39,8,4,6,16,-10,-62.5
39,8,5,42,32,10,31.25
39,8,6,371,64,307,479.6875
39,8,7,25,128,-103,-80.46875
39,8,8,212,256,-44,-17.1875
39,8,9,140,512,-372,-72.65625
39,8,10,590,1024,-434,-42.3828125
39,8,11,6102,2048,4054,197.94921875
39,8,12,7233,4096,3137,76.5869140625
39,8,13,125,8192,-8067,-98.47412109375
39,8,14,27434,16384,11050,67.44384765625
39,8,15,54255,32768,21487,65.5731201171875
39,9,1,0,2,-2,-100.0
39,9,2,5,4,1,25.0
39,9,3,2,8,-6,-75.0
39,9,4,24,16,8,50.0
39,9,5,49,32,17,53.125
39,9,6,25,64,-39,-60.9375
39,9,7,321,128,193,150.78125
39,9,8,461,256,205,80.078125
39,9,9,403,512,-109,-21.2890625
39,9,10,1547,1024,523,51.07421875
39,9,11,1698,2048,-350,-17.08984375
39,9,12,1592,4096,-2504,-61.1328125
39,9,13,6703,8192,-1489,-18.17626953125
39,9,14,29579,16384,13195,80.535888671875
39,9,15,40251,32768,7483,22.8363037109375
39,10,1,0,2,-2,-100.0
39,10,2,2,4,-2,-50.0
39,10,3,15,8,7,87.5
39,10,4,45,16,29,181.25
39,10,5,65,32,33,103.125
39,10,6,23,64,-41,-64.0625
39,10,7,8,128,-120,-93.75
39,10,8,86,256,-170,-66.40625
39,10,9,2057,512,1545,301.7578125
39,10,10,227,1024,-797,-77.83203125
39,10,11,1777,2048,-271,-13.232421875
39,10,12,949,4096,-3147,-76.8310546875
39,10,13,7265,8192,-927,-11.31591796875
39,10,14,283,16384,-16101,-98.272705078125
39,10,15,19682,32768,-13086,-39.935302734375
39,11,1,0,2,-2,-100.0
39,11,2,1,4,-3,-75.0
39,11,3,6,8,-2,-25.0
39,11,4,3,16,-13,-81.25
39,11,5,31,32,-1,-3.125
39,11,6,20,64,-44,-68.75
39,11,7,238,128,110,85.9375
39,11,8,43,256,-213,-83.203125
39,11,9,325,512,-187,-36.5234375
39,11,10,210,1024,-814,-79.4921875
39,11,11,486,2048,-1562,-76.26953125
39,11,12,16472,4096,12376,302.1484375
39,11,13,6213,8192,-1979,-24.15771484375
39,11,14,1571,16384,-14813,-90.411376953125
39,11,15,12392,32768,-20376,-62.1826171875
39,12,1,0,2,-2,-100.0
39,12,2,1,4,-3,-75.0
39,12,3,17,8,9,112.5
39,12,4,14,16,-2,-12.5
39,12,5,15,32,-17,-53.125
39,12,6,368,64,304,475.0
39,12,7,70,128,-58,-45.3125
39,12,8,131,256,-125,-48.828125
39,12,9,243,512,-269,-52.5390625
39,12,10,1792,1024,768,75.0
39,12,11,783,2048,-1265,-61.767578125
39,12,12,1259,4096,-2837,-69.2626953125
39,12,13,9340,8192,1148,14.013671875
39,12,14,5157,16384,-11227,-68.524169921875
39,12,15,84115,32768,51347,156.6986083984375
39,13,1,0,2,-2,-100.0
39,13,2,1,4,-3,-75.0
39,13,3,4,8,-4,-50.0
39,13,4,16,16,0,0.0
39,13,5,22,32,-10,-31.25
39,13,6,60,64,-4,-6.25
39,13,7,112,128,-16,-12.5
39,13,8,69,256,-187,-73.046875
39,13,9,339,512,-173,-33.7890625
39,13,10,450,1024,-574,-56.0546875
39,13,11,3617,2048,1569,76.611328125
39,13,12,2134,4096,-1962,-47.900390625
39,13,13,5965,8192,-2227,-27.18505859375
39,13,14,10323,16384,-6061,-36.993408203125
39,13,15,5603,32768,-27165,-82.9010009765625
39,14,1,0,2,-2,-100.0
39,14,2,2,4,-2,-50.0
39,14,3,9,8,1,12.5
39,14,4,10,16,-6,-37.5
39,14,5,61,32,29,90.625
39,14,6,127,64,63,98.4375
39,14,7,61,128,-67,-52.34375
39,14,8,10,256,-246,-96.09375
39,14,9,179,512,-333,-65.0390625
39,14,10,137,1024,-887,-86.62109375
39,14,11,3283,2048,1235,60.302734375
39,14,12,348,4096,-3748,-91.50390625
39,14,13,3568,8192,-4624,-56.4453125
39,14,14,17618,16384,1234,7.53173828125
39,14,15,1883,32768,-30885,-94.2535400390625
39,15,1,0,2,-2,-100.0
39,15,2,1,4,-3,-75.0
39,15,3,3,8,-5,-62.5
39,15,4,9,16,-7,-43.75
39,15,5,41,32,9,28.125
39,15,6,8,64,-56,-87.5
39,15,7,29,128,-99,-77.34375
39,15,8,371,256,115,44.921875
39,15,9,306,512,-206,-40.234375
39,15,10,1167,1024,143,13.96484375
39,15,11,182,2048,-1866,-91.11328125
39,15,12,1234,4096,-2862,-69.873046875
39,15,13,8104,8192,-88,-1.07421875
39,15,14,8443,16384,-7941,-48.468017578125
39,15,15,59041,32768,26273,80.1788330078125
39,16,1,0,2,-2,-100.0
39,16,2,2,4,-2,-50.0
39,16,3,2,8,-6,-75.0
39,16,4,38,16,22,137.5
39,16,5,125,32,93,290.625
39,16,6,92,64,28,43.75
39,16,7,7,128,-121,-94.53125
39,16,8,310,256,54,21.09375
39,16,9,938,512,426,83.203125
39,16,10,314,1024,-710,-69.3359375
39,16,11,512,2048,-1536,-75.0
39,16,12,4881,4096,785,19.1650390625
39,16,13,1868,8192,-6324,-77.197265625
39,16,14,62485,16384,46101,281.378173828125
39,16,15,24490,32768,-8278,-25.262451171875
39,17,1,0,2,-2,-100.0
39,17,2,2,4,-2,-50.0
39,17,3,6,8,-2,-25.0
39,17,4,13,16,-3,-18.75
39,17,5,9,32,-23,-71.875
39,17,6,26,64,-38,-59.375
39,17,7,78,128,-50,-39.0625
39,17,8,314,256,58,22.65625
39,17,9,384,512,-128,-25.0
39,17,10,1960,1024,936,91.40625
39,17,11,8066,2048,6018,293.84765625
39,17,12,8612,4096,4516,110.25390625
39,17,13,964,8192,-7228,-88.232421875
39,17,14,13322,16384,-3062,-18.68896484375
39,17,15,10118,32768,-22650,-69.122314453125
39,18,1,0,2,-2,-100.0
39,18,2,2,4,-2,-50.0
39,18,3,6,8,-2,-25.0
39,18,4,5,16,-11,-68.75
39,18,5,25,32,-7,-21.875
39,18,6,65,64,1,1.5625
39,18,7,145,128,17,13.28125
39,18,8,535,256,279,108.984375
39,18,9,20,512,-492,-96.09375
39,18,10,1479,1024,455,44.43359375
39,18,11,70,2048,-1978,-96.58203125
39,18,12,2250,4096,-1846,-45.068359375
39,18,13,5557,8192,-2635,-32.16552734375
39,18,14,17366,16384,982,5.99365234375
39,18,15,1813,32768,-30955,-94.4671630859375
39,19,1,0,2,-2,-100.0
39,19,2,1,4,-3,-75.0
39,19,3,4,8,-4,-50.0
39,19,4,8,16,-8,-50.0
39,19,5,18,32,-14,-43.75
39,19,6,187,64,123,192.1875
39,19,7,555,128,427,333.59375
39,19,8,114,256,-142,-55.46875
39,19,9,180,512,-332,-64.84375
39,19,10,687,1024,-337,-32.91015625
39,19,11,2403,2048,355,17.333984375
39,19,12,1274,4096,-2822,-68.896484375
39,19,13,24744,8192,16552,202.05078125
39,19,14,1031,16384,-15353,-93.707275390625
39,19,15,68320,32768,35552,108.49609375
39,20,1,0,2,-2,-100.0
39,20,2,2,4,-2,-50.0
39,20,3,2,8,-6,-75.0
39,20,4,6,16,-10,-62.5
39,20,5,25,32,-7,-21.875
39,20,6,75,64,11,17.1875
39,20,7,41,128,-87,-67.96875
39,20,8,79,256,-177,-69.140625
39,20,9,190,512,-322,-62.890625
39,20,10,224,1024,-800,-78.125
39,20,11,1616,2048,-432,-21.09375
39,20,12,3096,4096,-1000,-24.4140625
39,20,13,180,8192,-8012,-97.802734375
39,20,14,2177,16384,-14207,-86.712646484375
39,20,15,14569,32768,-18199,-55.5389404296875
39,21,1,0,2,-2,-100.0
39,21,2,4,4,0,0.0
39,21,3,5,8,-3,-37.5
39,21,4,14,16,-2,-12.5
39,21,5,6,32,-26,-81.25
39,21,6,65,64,1,1.5625
39,21,7,116,128,-12,-9.375
39,21,8,697,256,441,172.265625
39,21,9,723,512,211,41.2109375
39,21,10,83,1024,-941,-91.89453125
39,21,11,716,2048,-1332,-65.0390625
39,21,12,891,4096,-3205,-78.2470703125
39,21,13,22808,8192,14616,178.41796875
39,21,14,5626,16384,-10758,-65.66162109375
39,21,15,2975,32768,-29793,-90.9210205078125
39,22,1,0,2,-2,-100.0
39,22,2,3,4,-1,-25.0
39,22,3,3,8,-5,-62.5
39,22,4,4,16,-12,-75.0
39,22,5,9,32,-23,-71.875
39,22,6,39,64,-25,-39.0625
39,22,7,120,128,-8,-6.25
39,22,8,87,256,-169,-66.015625
39,22,9,162,512,-350,-68.359375
39,22,10,4840,1024,3816,372.65625
39,22,11,446,2048,-1602,-78.22265625
39,22,12,4277,4096,181,4.4189453125
39,22,13,4293,8192,-3899,-47.59521484375
39,22,14,9983,16384,-6401,-39.068603515625
39,22,15,100682,32768,67914,207.257080078125
39,23,1,0,2,-2,-100.0
39,23,2,1,4,-3,-75.0
39,23,3,3,8,-5,-62.5
39,23,4,32,16,16,100.0
39,23,5,10,32,-22,-68.75
39,23,6,14,64,-50,-78.125
39,23,7,61,128,-67,-52.34375
39,23,8,145,256,-111,-43.359375
39,23,9,536,512,24,4.6875
39,23,10,722,1024,-302,-29.4921875
39,23,11,1897,2048,-151,-7.373046875
39,23,12,1424,4096,-2672,-65.234375
39,23,13,6950,8192,-1242,-15.1611328125
39,23,14,2991,16384,-13393,-81.744384765625
39,23,15,19535,32768,-13233,-40.3839111328125
39,24,1,0,2,-2,-100.0
39,24,2,3,4,-1,-25.0
39,24,3,7,8,-1,-12.5
39,24,4,34,16,18,112.5
39,24,5,36,32,4,12.5
39,24,6,11,64,-53,-82.8125
39,24,7,137,128,9,7.03125
39,24,8,84,256,-172,-67.1875
39,24,9,333,512,-179,-34.9609375
39,24,10,1927,1024,903,88.18359375
39,24,11,1948,2048,-100,-4.8828125
39,24,12,3168,4096,-928,-22.65625
39,24,13,2077,8192,-6115,-74.64599609375
39,24,14,92,16384,-16292,-99.4384765625
39,24,15,52484,32768,19716,60.16845703125
39,25,1,0,2,-2,-100.0
39,25,2,1,4,-3,-75.0
39,25,3,6,8,-2,-25.0
39,25,4,9,16,-7,-43.75
39,25,5,33,32,1,3.125
39,25,6,345,64,281,439.0625
39,25,7,232,128,104,81.25
39,25,8,285,256,29,11.328125
39,25,9,242,512,-270,-52.734375
39,25,10,106,1024,-918,-89.6484375
39,25,11,134,2048,-1914,-93.45703125
39,25,12,2160,4096,-1936,-47.265625
39,25,13,8267,8192,75,0.91552734375
39,25,14,42604,16384,26220,160.0341796875
39,25,15,152816,32768,120048,366.357421875
39,26,1,0,2,-2,-100.0
39,26,2,1,4,-3,-75.0
39,26,3,6,8,-2,-25.0
39,26,4,15,16,-1,-6.25
39,26,5,4,32,-28,-87.5
39,26,6,78,64,14,21.875
39,26,7,49,128,-79,-61.71875
39,26,8,8,256,-248,-96.875
39,26,9,312,512,-200,-39.0625
39,26,10,849,1024,-175,-17.08984375
39,26,11,4775,2048,2727,133.154296875
39,26,12,2533,4096,-1563,-38.1591796875
39,26,13,1459,8192,-6733,-82.18994140625
39,26,14,38707,16384,22323,136.248779296875
39,26,15,55550,32768,22782,69.525146484375
39,27,1,0,2,-2,-100.0
39,27,2,5,4,1,25.0
39,27,3,5,8,-3,-37.5
39,27,4,14,16,-2,-12.5
39,27,5,14,32,-18,-56.25
39,27,6,58,64,-6,-9.375
39,27,7,54,128,-74,-57.8125
39,27,8,544,256,288,112.5
39,27,9,588,512,76,14.84375
39,27,10,1542,1024,518,50.5859375
39,27,11,1580,2048,-468,-22.8515625
39,27,12,14597,4096,10501,256.3720703125
39,27,13,4863,8192,-3329,-40.63720703125
39,27,14,3123,16384,-13261,-80.938720703125
39,27,15,9086,32768,-23682,-72.271728515625
39,28,1,0,2,-2,-100.0
39,28,2,1,4,-3,-75.0
39,28,3,27,8,19,237.5
39,28,4,17,16,1,6.25
39,28,5,10,32,-22,-68.75
39,28,6,42,64,-22,-34.375
39,28,7,103,128,-25,-19.53125
39,28,8,208,256,-48,-18.75
39,28,9,130,512,-382,-74.609375
39,28,10,250,1024,-774,-75.5859375
39,28,11,825,2048,-1223,-59.716796875
39,28,12,890,4096,-3206,-78.271484375
39,28,13,3415,8192,-4777,-58.31298828125
39,28,14,6379,16384,-10005,-61.065673828125
39,28,15,12733,32768,-20035,-61.1419677734375
39,29,1,0,2,-2,-100.0
39,29,2,1,4,-3,-75.0
39,29,3,3,8,-5,-62.5
39,29,4,9,16,-7,-43.75
39,29,5,112,32,80,250.0
39,29,6,17,64,-47,-73.4375
39,29,7,72,128,-56,-43.75
39,29,8,493,256,237,92.578125
39,29,9,326,512,-186,-36.328125
39,29,10,1748,1024,724,70.703125
39,29,11,3195,2048,1147,56.005859375
39,29,12,3394,4096,-702,-17.138671875
39,29,13,13440,8192,5248,64.0625
39,29,14,5046,16384,-11338,-69.20166015625
39,29,15,55307,32768,22539,68.7835693359375
39,30,1,0,2,-2,-100.0
39,30,2,2,4,-2,-50.0
39,30,3,4,8,-4,-50.0
39,30,4,14,16,-2,-12.5
39,30,5,119,32,87,271.875
39,30,6,35,64,-29,-45.3125
39,30,7,56,128,-72,-56.25
39,30,8,75,256,-181,-70.703125
39,30,9,869,512,357,69.7265625
39,30,10,59,1024,-965,-94.23828125
39,30,11,5509,2048,3461,168.994140625
39,30,12,3170,4096,-926,-22.607421875
39,30,13,29580,8192,21388,261.083984375
39,30,14,37968,16384,21584,131.73828125
39,30,15,33040,32768,272,0.830078125
39,31,1,0,2,-2,-100.0
39,31,2,2,4,-2,-50.0
39,31,3,4,8,-4,-50.0
39,31,4,22,16,6,37.5
39,31,5,75,32,43,134.375
39,31,6,45,64,-19,-29.6875
39,31,7,17,128,-111,-86.71875
39,31,8,295,256,39,15.234375
39,31,9,1605,512,1093,213.4765625
39,31,10,3708,1024,2684,262.109375
39,31,11,777,2048,-1271,-62.060546875
39,31,12,3271,4096,-825,-20.1416015625
39,31,13,1364,8192,-6828,-83.349609375
39,31,14,600,16384,-15784,-96.337890625
39,31,15,13544,32768,-19224,-58.6669921875
39,32,1,0,2,-2,-100.0
39,32,2,2,4,-2,-50.0
39,32,3,5,8,-3,-37.5
39,32,4,17,16,1,6.25
39,32,5,4,32,-28,-87.5
39,32,6,48,64,-16,-25.0
39,32,7,76,128,-52,-40.625
39,32,8,206,256,-50,-19.53125
39,32,9,413,512,-99,-19.3359375
39,32,10,767,1024,-257,-25.09765625
39,32,11,3205,2048,1157,56.494140625
39,32,12,7320,4096,3224,78.7109375
39,32,13,4623,8192,-3569,-43.56689453125
39,32,14,21504,16384,5120,31.25
39,32,15,75131,32768,42363,129.2816162109375
39,33,1,0,2,-2,-100.0
39,33,2,7,4,3,75.0
39,33,3,14,8,6,75.0
39,33,4,9,16,-7,-43.75
39,33,5,41,32,9,28.125
39,33,6,17,64,-47,-73.4375
39,33,7,17,128,-111,-86.71875
39,33,8,235,256,-21,-8.203125
39,33,9,650,512,138,26.953125
39,33,10,1665,1024,641,62.59765625
39,33,11,685,2048,-1363,-66.552734375
39,33,12,3936,4096,-160,-3.90625
39,33,13,369,8192,-7823,-95.49560546875
39,33,14,40305,16384,23921,146.002197265625
39,33,15,21657,32768,-11111,-33.9080810546875
39,34,1,0,2,-2,-100.0
39,34,2,4,4,0,0.0
39,34,3,5,8,-3,-37.5
39,34,4,28,16,12,75.0
39,34,5,26,32,-6,-18.75
39,34,6,28,64,-36,-56.25
39,34,7,145,128,17,13.28125
39,34,8,56,256,-200,-78.125
39,34,9,312,512,-200,-39.0625
39,34,10,71,1024,-953,-93.06640625
39,34,11,7318,2048,5270,257.32421875
39,34,12,23121,4096,19025,464.4775390625
39,34,13,18405,8192,10213,124.67041015625
39,34,14,30825,16384,14441,88.140869140625
39,34,15,131,32768,-32637,-99.6002197265625
39,35,1,0,2,-2,-100.0
39,35,2,2,4,-2,-50.0
39,35,3,6,8,-2,-25.0
39,35,4,3,16,-13,-81.25
39,35,5,19,32,-13,-40.625
39,35,6,124,64,60,93.75
39,35,7,95,128,-33,-25.78125
39,35,8,434,256,178,69.53125
39,35,9,322,512,-190,-37.109375
39,35,10,2179,1024,1155,112.79296875
39,35,11,580,2048,-1468,-71.6796875
39,35,12,1419,4096,-2677,-65.3564453125
39,35,13,407,8192,-7785,-95.03173828125
39,35,14,26866,16384,10482,63.97705078125
39,35,15,106042,32768,73274,223.614501953125
39,36,1,0,2,-2,-100.0
39,36,2,1,4,-3,-75.0
39,36,3,9,8,1,12.5
39,36,4,17,16,1,6.25
39,36,5,12,32,-20,-62.5
39,36,6,49,64,-15,-23.4375
39,36,7,262,128,134,104.6875
39,36,8,22,256,-234,-91.40625
39,36,9,194,512,-318,-62.109375
39,36,10,169,1024,-855,-83.49609375
39,36,11,282,2048,-1766,-86.23046875
39,36,12,17134,4096,13038,318.310546875
39,36,13,3820,8192,-4372,-53.369140625
39,36,14,27220,16384,10836,66.1376953125
39,36,15,5207,32768,-27561,-84.1094970703125
39,37,1,0,2,-2,-100.0
39,37,2,1,4,-3,-75.0
39,37,3,3,8,-5,-62.5
39,37,4,3,16,-13,-81.25
39,37,5,7,32,-25,-78.125
39,37,6,142,64,78,121.875
39,37,7,138,128,10,7.8125
39,37,8,13,256,-243,-94.921875
39,37,9,267,512,-245,-47.8515625
39,37,10,469,1024,-555,-54.19921875
39,37,11,549,2048,-1499,-73.193359375
39,37,12,88,4096,-4008,-97.8515625
39,37,13,8068,8192,-124,-1.513671875
39,37,14,12505,16384,-3879,-23.675537109375
39,37,15,35860,32768,3092,9.43603515625
39,38,1,0,2,-2,-100.0
39,38,2,1,4,-3,-75.0
39,38,3,2,8,-6,-75.0
39,38,4,5,16,-11,-68.75
39,38,5,4,32,-28,-87.5
39,38,6,19,64,-45,-70.3125
39,38,7,15,128,-113,-88.28125
39,38,8,442,256,186,72.65625
39,38,9,614,512,102,19.921875
39,38,10,957,1024,-67,-6.54296875
39,38,11,4126,2048,2078,101.46484375
39,38,12,1235,4096,-2861,-69.8486328125
39,38,13,18210,8192,10018,122.2900390625
39,38,14,18132,16384,1748,10.6689453125
39,38,15,3496,32768,-29272,-89.3310546875
39,39,1,0,2,-2,-100.0
39,39,2,1,4,-3,-75.0
39,39,3,3,8,-5,-62.5
39,39,4,7,16,-9,-56.25
39,39,5,40,32,8,25.0
39,39,6,6,64,-58,-90.625
39,39,7,54,128,-74,-57.8125
39,39,8,420,256,164,64.0625
39,39,9,145,512,-367,-71.6796875
39,39,10,2026,1024,1002,97.8515625
39,39,11,407,2048,-1641,-80.126953125
39,39,12,552,4096,-3544,-86.5234375
39,39,13,6949,8192,-1243,-15.17333984375
39,39,14,13765,16384,-2619,-15.985107421875
39,39,15,31047,32768,-1721,-5.2520751953125
40,1,1,0,2,-2,-100.0
40,1,2,1,4,-3,-75.0
40,1,3,6,8,-2,-25.0
40,1,4,9,16,-7,-43.75
40,1,5,16,32,-16,-50.0
40,1,6,43,64,-21,-32.8125
40,1,7,19,128,-109,-85.15625
40,1,8,23,256,-233,-91.015625
40,1,9,588,512,76,14.84375
40,1,10,568,1024,-456,-44.53125
40,1,11,564,2048,-1484,-72.4609375
40,1,12,4121,4096,25,0.6103515625
40,1,13,4124,8192,-4068,-49.658203125
40,1,14,14255,16384,-2129,-12.994384765625
40,1,15,4439,32768,-28329,-86.4532470703125
40,2,1,0,2,-2,-100.0
40,2,2,3,4,-1,-25.0
40,2,3,9,8,1,12.5
40,2,4,4,16,-12,-75.0
40,2,5,25,32,-7,-21.875
40,2,6,25,64,-39,-60.9375
40,2,7,586,128,458,357.8125
40,2,8,359,256,103,40.234375
40,2,9,517,512,5,0.9765625
40,2,10,1619,1024,595,58.10546875
40,2,11,3045,2048,997,48.681640625
40,2,12,17042,4096,12946,316.064453125
40,2,13,959,8192,-7233,-88.29345703125
40,2,14,68045,16384,51661,315.313720703125
40,2,15,1111,32768,-31657,-96.6094970703125
40,3,1,0,2,-2,-100.0
40,3,2,1,4,-3,-75.0
40,3,3,2,8,-6,-75.0
40,3,4,4,16,-12,-75.0
40,3,5,8,32,-24,-75.0
40,3,6,30,64,-34,-53.125
40,3,7,143,128,15,11.71875
40,3,8,111,256,-145,-56.640625
40,3,9,52,512,-460,-89.84375
40,3,10,361,1024,-663,-64.74609375
40,3,11,113,2048,-1935,-94.482421875
40,3,12,3317,4096,-779,-19.0185546875
40,3,13,5529,8192,-2663,-32.50732421875
40,3,14,9446,16384,-6938,-42.34619140625
40,3,15,88079,32768,55311,168.7957763671875
40,4,1,0,2,-2,-100.0
40,4,2,2,4,-2,-50.0
40,4,3,11,8,3,37.5
40,4,4,6,16,-10,-62.5
40,4,5,95,32,63,196.875
40,4,6,29,64,-35,-54.6875
40,4,7,70,128,-58,-45.3125
40,4,8,32,256,-224,-87.5
40,4,9,154,512,-358,-69.921875
40,4,10,790,1024,-234,-22.8515625
40,4,11,486,2048,-1562,-76.26953125
40,4,12,13397,4096,9301,227.0751953125
40,4,13,1494,8192,-6698,-81.7626953125
40,4,14,27993,16384,11609,70.855712890625
40,4,15,198,32768,-32570,-99.395751953125
40,5,1,0,2,-2,-100.0
40,5,2,1,4,-3,-75.0
40,5,3,2,8,-6,-75.0
40,5,4,20,16,4,25.0
40,5,5,163,32,131,409.375
40,5,6,61,64,-3,-4.6875
40,5,7,135,128,7,5.46875
40,5,8,502,256,246,96.09375
40,5,9,700,512,188,36.71875
40,5,10,374,1024,-650,-63.4765625
40,5,11,2533,2048,485,23.681640625
40,5,12,4970,4096,874,21.337890625
40,5,13,6840,8192,-1352,-16.50390625
40,5,14,9206,16384,-7178,-43.81103515625
40,5,15,158425,32768,125657,383.4747314453125
40,6,1,0,2,-2,-100.0
40,6,2,1,4,-3,-75.0
40,6,3,3,8,-5,-62.5
40,6,4,5,16,-11,-68.75
40,6,5,13,32,-19,-59.375
40,6,6,84,64,20,31.25
40,6,7,48,128,-80,-62.5
40,6,8,130,256,-126,-49.21875
40,6,9,96,512,-416,-81.25
40,6,10,859,1024,-165,-16.11328125
40,6,11,119,2048,-1929,-94.189453125
40,6,12,2028,4096,-2068,-50.48828125
40,6,13,2607,8192,-5585,-68.17626953125
40,6,14,10518,16384,-5866,-35.80322265625
40,6,15,974,32768,-31794,-97.027587890625
40,7,1,0,2,-2,-100.0
40,7,2,1,4,-3,-75.0
40,7,3,7,8,-1,-12.5
40,7,4,7,16,-9,-56.25
40,7,5,8,32,-24,-75.0
40,7,6,12,64,-52,-81.25
40,7,7,16,128,-112,-87.5
40,7,8,85,256,-171,-66.796875
40,7,9,120,512,-392,-76.5625
40,7,10,2763,1024,1739,169.82421875
40,7,11,8632,2048,6584,321.484375
40,7,12,6340,4096,2244,54.78515625
40,7,13,17327,8192,9135,111.51123046875
40,7,14,22899,16384,6515,39.764404296875
40,7,15,43450,32768,10682,32.598876953125
40,8,1,0,2,-2,-100.0
40,8,2,1,4,-3,-75.0
40,8,3,7,8,-1,-12.5
40,8,4,6,16,-10,-62.5
40,8,5,30,32,-2,-6.25
40,8,6,35,64,-29,-45.3125
40,8,7,170,128,42,32.8125
40,8,8,14,256,-242,-94.53125
40,8,9,263,512,-249,-48.6328125
40,8,10,3385,1024,2361,230.56640625
40,8,11,2689,2048,641,31.298828125
40,8,12,217,4096,-3879,-94.7021484375
40,8,13,4051,8192,-4141,-50.54931640625
40,8,14,28063,16384,11679,71.282958984375
40,8,15,106211,32768,73443,224.1302490234375
40,9,1,0,2,-2,-100.0
40,9,2,2,4,-2,-50.0
40,9,3,2,8,-6,-75.0
40,9,4,5,16,-11,-68.75
40,9,5,9,32,-23,-71.875
40,9,6,14,64,-50,-78.125
40,9,7,100,128,-28,-21.875
40,9,8,78,256,-178,-69.53125
40,9,9,337,512,-175,-34.1796875
40,9,10,427,1024,-597,-58.30078125
40,9,11,2194,2048,146,7.12890625
40,9,12,681,4096,-3415,-83.3740234375
40,9,13,11127,8192,2935,35.82763671875
40,9,14,9559,16384,-6825,-41.656494140625
40,9,15,64815,32768,32047,97.7996826171875
40,10,1,0,2,-2,-100.0
40,10,2,1,4,-3,-75.0
40,10,3,7,8,-1,-12.5
40,10,4,10,16,-6,-37.5
40,10,5,64,32,32,100.0
40,10,6,45,64,-19,-29.6875
40,10,7,256,128,128,100.0
40,10,8,484,256,228,89.0625
40,10,9,820,512,308,60.15625
40,10,10,3402,1024,2378,232.2265625
40,10,11,457,2048,-1591,-77.685546875
40,10,12,4835,4096,739,18.0419921875
40,10,13,6105,8192,-2087,-25.47607421875
40,10,14,81908,16384,65524,399.9267578125
40,10,15,1623,32768,-31145,-95.0469970703125
40,11,1,0,2,-2,-100.0
40,11,2,1,4,-3,-75.0
40,11,3,17,8,9,112.5
40,11,4,19,16,3,18.75
40,11,5,11,32,-21,-65.625
40,11,6,81,64,17,26.5625
40,11,7,152,128,24,18.75
40,11,8,258,256,2,0.78125
40,11,9,294,512,-218,-42.578125
40,11,10,1010,1024,-14,-1.3671875
40,11,11,11164,2048,9116,445.1171875
40,11,12,2256,4096,-1840,-44.921875
40,11,13,12384,8192,4192,51.171875
40,11,14,13393,16384,-2991,-18.255615234375
40,11,15,17287,32768,-15481,-47.2442626953125
40,12,1,0,2,-2,-100.0
40,12,2,1,4,-3,-75.0
40,12,3,2,8,-6,-75.0
40,12,4,3,16,-13,-81.25
40,12,5,9,32,-23,-71.875
40,12,6,100,64,36,56.25
40,12,7,271,128,143,111.71875
40,12,8,322,256,66,25.78125
40,12,9,348,512,-164,-32.03125
40,12,10,578,1024,-446,-43.5546875
40,12,11,706,2048,-1342,-65.52734375
40,12,12,10438,4096,6342,154.833984375
40,12,13,148,8192,-8044,-98.193359375
40,12,14,38114,16384,21730,132.62939453125
40,12,15,11212,32768,-21556,-65.78369140625
40,13,1,0,2,-2,-100.0
40,13,2,1,4,-3,-75.0
40,13,3,2,8,-6,-75.0
40,13,4,7,16,-9,-56.25
40,13,5,4,32,-28,-87.5
40,13,6,6,64,-58,-90.625
40,13,7,207,128,79,61.71875
40,13,8,1050,256,794,310.15625
40,13,9,968,512,456,89.0625
40,13,10,164,1024,-860,-83.984375
40,13,11,8048,2048,6000,292.96875
40,13,12,218,4096,-3878,-94.677734375
40,13,13,27886,8192,19694,240.4052734375
40,13,14,5468,16384,-10916,-66.6259765625
40,13,15,30000,32768,-2768,-8.447265625
40,14,1,0,2,-2,-100.0
40,14,2,5,4,1,25.0
40,14,3,3,8,-5,-62.5
40,14,4,3,16,-13,-81.25
40,14,5,7,32,-25,-78.125
40,14,6,84,64,20,31.25
40,14,7,99,128,-29,-22.65625
40,14,8,1112,256,856,334.375
40,14,9,963,512,451,88.0859375
40,14,10,940,1024,-84,-8.203125
40,14,11,1622,2048,-426,-20.80078125
40,14,12,3978,4096,-118,-2.880859375
40,14,13,3956,8192,-4236,-51.708984375
40,14,14,8610,16384,-7774,-47.44873046875
40,14,15,4143,32768,-28625,-87.3565673828125
40,15,1,0,2,-2,-100.0
40,15,2,3,4,-1,-25.0
40,15,3,5,8,-3,-37.5
40,15,4,11,16,-5,-31.25
40,15,5,22,32,-10,-31.25
40,15,6,45,64,-19,-29.6875
40,15,7,152,128,24,18.75
40,15,8,25,256,-231,-90.234375
40,15,9,1972,512,1460,285.15625
40,15,10,2658,1024,1634,159.5703125
40,15,11,6938,2048,4890,238.76953125
40,15,12,8472,4096,4376,106.8359375
40,15,13,1420,8192,-6772,-82.666015625
40,15,14,25594,16384,9210,56.21337890625
40,15,15,8060,32768,-24708,-75.40283203125
40,16,1,0,2,-2,-100.0
40,16,2,6,4,2,50.0
40,16,3,2,8,-6,-75.0
40,16,4,23,16,7,43.75
40,16,5,8,32,-24,-75.0
40,16,6,6,64,-58,-90.625
40,16,7,59,128,-69,-53.90625
40,16,8,95,256,-161,-62.890625
40,16,9,867,512,355,69.3359375
40,16,10,401,1024,-623,-60.83984375
40,16,11,1607,2048,-441,-21.533203125
40,16,12,1620,4096,-2476,-60.44921875
40,16,13,2877,8192,-5315,-64.88037109375
40,16,14,42369,16384,25985,158.599853515625
40,16,15,7106,32768,-25662,-78.314208984375
40,17,1,0,2,-2,-100.0
40,17,2,6,4,2,50.0
40,17,3,2,8,-6,-75.0
40,17,4,18,16,2,12.5
40,17,5,17,32,-15,-46.875
40,17,6,34,64,-30,-46.875
40,17,7,340,128,212,165.625
40,17,8,141,256,-115,-44.921875
40,17,9,310,512,-202,-39.453125
40,17,10,788,1024,-236,-23.046875
40,17,11,4136,2048,2088,101.953125
40,17,12,4946,4096,850,20.751953125
40,17,13,70,8192,-8122,-99.1455078125
40,17,14,10829,16384,-5555,-33.905029296875
40,17,15,77783,32768,45015,137.3748779296875
40,18,1,0,2,-2,-100.0
40,18,2,1,4,-3,-75.0
40,18,3,3,8,-5,-62.5
40,18,4,9,16,-7,-43.75
40,18,5,10,32,-22,-68.75
40,18,6,61,64,-3,-4.6875
40,18,7,592,128,464,362.5
40,18,8,94,256,-162,-63.28125
40,18,9,235,512,-277,-54.1015625
40,18,10,85,1024,-939,-91.69921875
40,18,11,6185,2048,4137,202.001953125
40,18,12,1860,4096,-2236,-54.58984375
40,18,13,10353,8192,2161,26.37939453125
40,18,14,9664,16384,-6720,-41.015625
40,18,15,70066,32768,37298,113.824462890625
40,19,1,0,2,-2,-100.0
40,19,2,1,4,-3,-75.0
40,19,3,3,8,-5,-62.5
40,19,4,31,16,15,93.75
40,19,5,30,32,-2,-6.25
40,19,6,67,64,3,4.6875
40,19,7,46,128,-82,-64.0625
40,19,8,29,256,-227,-88.671875
40,19,9,351,512,-161,-31.4453125
40,19,10,2087,1024,1063,103.80859375
40,19,11,6351,2048,4303,210.107421875
40,19,12,7926,4096,3830,93.505859375
40,19,13,12512,8192,4320,52.734375
40,19,14,6043,16384,-10341,-63.116455078125
40,19,15,10277,32768,-22491,-68.6370849609375
40,20,1,0,2,-2,-100.0
40,20,2,5,4,1,25.0
40,20,3,5,8,-3,-37.5
40,20,4,31,16,15,93.75
40,20,5,58,32,26,81.25
40,20,6,10,64,-54,-84.375
40,20,7,61,128,-67,-52.34375
40,20,8,249,256,-7,-2.734375
40,20,9,97,512,-415,-81.0546875
40,20,10,1412,1024,388,37.890625
40,20,11,1065,2048,-983,-47.998046875
40,20,12,2183,4096,-1913,-46.7041015625
40,20,13,10191,8192,1999,24.40185546875
40,20,14,8803,16384,-7581,-46.270751953125
40,20,15,29204,32768,-3564,-10.87646484375
40,21,1,0,2,-2,-100.0
40,21,2,3,4,-1,-25.0
40,21,3,2,8,-6,-75.0
40,21,4,4,16,-12,-75.0
40,21,5,4,32,-28,-87.5
40,21,6,50,64,-14,-21.875
40,21,7,149,128,21,16.40625
40,21,8,246,256,-10,-3.90625
40,21,9,863,512,351,68.5546875
40,21,10,389,1024,-635,-62.01171875
40,21,11,1338,2048,-710,-34.66796875
40,21,12,10873,4096,6777,165.4541015625
40,21,13,154,8192,-8038,-98.1201171875
40,21,14,10212,16384,-6172,-37.6708984375
40,21,15,14900,32768,-17868,-54.52880859375
40,22,1,0,2,-2,-100.0
40,22,2,1,4,-3,-75.0
40,22,3,2,8,-6,-75.0
40,22,4,7,16,-9,-56.25
40,22,5,11,32,-21,-65.625
40,22,6,52,64,-12,-18.75
40,22,7,59,128,-69,-53.90625
40,22,8,790,256,534,208.59375
40,22,9,222,512,-290,-56.640625
40,22,10,386,1024,-638,-62.3046875
40,22,11,826,2048,-1222,-59.66796875
40,22,12,4473,4096,377,9.2041015625
40,22,13,10410,8192,2218,27.0751953125
40,22,14,1631,16384,-14753,-90.045166015625
40,22,15,46062,32768,13294,40.570068359375
40,23,1,0,2,-2,-100.0
40,23,2,1,4,-3,-75.0
40,23,3,2,8,-6,-75.0
40,23,4,3,16,-13,-81.25
40,23,5,32,32,0,0.0
40,23,6,20,64,-44,-68.75
40,23,7,24,128,-104,-81.25
40,23,8,162,256,-94,-36.71875
40,23,9,358,512,-154,-30.078125
40,23,10,236,1024,-788,-76.953125
40,23,11,1082,2048,-966,-47.16796875
40,23,12,2289,4096,-1807,-44.1162109375
40,23,13,3004,8192,-5188,-63.330078125
40,23,14,2511,16384,-13873,-84.674072265625
40,23,15,58217,32768,25449,77.6641845703125
40,24,1,0,2,-2,-100.0
40,24,2,2,4,-2,-50.0
40,24,3,2,8,-6,-75.0
40,24,4,26,16,10,62.5
40,24,5,4,32,-28,-87.5
40,24,6,70,64,6,9.375
40,24,7,38,128,-90,-70.3125
40,24,8,158,256,-98,-38.28125
40,24,9,156,512,-356,-69.53125
40,24,10,350,1024,-674,-65.8203125
40,24,11,620,2048,-1428,-69.7265625
40,24,12,16215,4096,12119,295.8740234375
40,24,13,824,8192,-7368,-89.94140625
40,24,14,15897,16384,-487,-2.972412109375
40,24,15,25073,32768,-7695,-23.4832763671875
40,25,1,0,2,-2,-100.0
40,25,2,1,4,-3,-75.0
40,25,3,3,8,-5,-62.5
40,25,4,19,16,3,18.75
40,25,5,19,32,-13,-40.625
40,25,6,75,64,11,17.1875
40,25,7,6,128,-122,-95.3125
40,25,8,305,256,49,19.140625
40,25,9,135,512,-377,-73.6328125
40,25,10,20,1024,-1004,-98.046875
40,25,11,154,2048,-1894,-92.48046875
40,25,12,15929,4096,11833,288.8916015625
40,25,13,5041,8192,-3151,-38.46435546875
40,25,14,17662,16384,1278,7.80029296875
40,25,15,16345,32768,-16423,-50.1190185546875
40,26,1,0,2,-2,-100.0
40,26,2,1,4,-3,-75.0
40,26,3,3,8,-5,-62.5
40,26,4,14,16,-2,-12.5
40,26,5,18,32,-14,-43.75
40,26,6,27,64,-37,-57.8125
40,26,7,14,128,-114,-89.0625
40,26,8,67,256,-189,-73.828125
40,26,9,43,512,-469,-91.6015625
40,26,10,11,1024,-1013,-98.92578125
40,26,11,2995,2048,947,46.240234375
40,26,12,2212,4096,-1884,-45.99609375
40,26,13,2567,8192,-5625,-68.66455078125
40,26,14,33089,16384,16705,101.959228515625
40,26,15,24332,32768,-8436,-25.74462890625
40,27,1,0,2,-2,-100.0
40,27,2,2,4,-2,-50.0
40,27,3,2,8,-6,-75.0
40,27,4,5,16,-11,-68.75
40,27,5,22,32,-10,-31.25
40,27,6,12,64,-52,-81.25
40,27,7,374,128,246,192.1875
40,27,8,443,256,187,73.046875
40,27,9,2220,512,1708,333.59375
40,27,10,915,1024,-109,-10.64453125
40,27,11,555,2048,-1493,-72.900390625
40,27,12,10684,4096,6588,160.83984375
40,27,13,7772,8192,-420,-5.126953125
40,27,14,5433,16384,-10951,-66.839599609375
40,27,15,4493,32768,-28275,-86.2884521484375
40,28,1,0,2,-2,-100.0
40,28,2,1,4,-3,-75.0
40,28,3,5,8,-3,-37.5
40,28,4,14,16,-2,-12.5
40,28,5,4,32,-28,-87.5
40,28,6,16,64,-48,-75.0
40,28,7,18,128,-110,-85.9375
40,28,8,728,256,472,184.375
40,28,9,106,512,-406,-79.296875
40,28,10,99,1024,-925,-90.33203125
40,28,11,1484,2048,-564,-27.5390625
40,28,12,49,4096,-4047,-98.8037109375
40,28,13,2002,8192,-6190,-75.5615234375
40,28,14,698,16384,-15686,-95.73974609375
40,28,15,42877,32768,10109,30.8502197265625
40,29,1,0,2,-2,-100.0
40,29,2,2,4,-2,-50.0
40,29,3,4,8,-4,-50.0
40,29,4,33,16,17,106.25
40,29,5,4,32,-28,-87.5
40,29,6,67,64,3,4.6875
40,29,7,10,128,-118,-92.1875
40,29,8,425,256,169,66.015625
40,29,9,887,512,375,73.2421875
40,29,10,1887,1024,863,84.27734375
40,29,11,4119,2048,2071,101.123046875
40,29,12,755,4096,-3341,-81.5673828125
40,29,13,16330,8192,8138,99.3408203125
40,29,14,711,16384,-15673,-95.660400390625
40,29,15,9479,32768,-23289,-71.0723876953125
40,30,1,0,2,-2,-100.0
40,30,2,2,4,-2,-50.0
40,30,3,7,8,-1,-12.5
40,30,4,9,16,-7,-43.75
40,30,5,30,32,-2,-6.25
40,30,6,24,64,-40,-62.5
40,30,7,32,128,-96,-75.0
40,30,8,329,256,73,28.515625
40,30,9,905,512,393,76.7578125
40,30,10,253,1024,-771,-75.29296875
40,30,11,585,2048,-1463,-71.435546875
40,30,12,455,4096,-3641,-88.8916015625
40,30,13,1682,8192,-6510,-79.4677734375
40,30,14,28474,16384,12090,73.79150390625
40,30,15,3260,32768,-29508,-90.05126953125
40,31,1,0,2,-2,-100.0
40,31,2,1,4,-3,-75.0
40,31,3,4,8,-4,-50.0
40,31,4,7,16,-9,-56.25
40,31,5,4,32,-28,-87.5
40,31,6,122,64,58,90.625
40,31,7,96,128,-32,-25.0
40,31,8,65,256,-191,-74.609375
40,31,9,367,512,-145,-28.3203125
40,31,10,1277,1024,253,24.70703125
40,31,11,322,2048,-1726,-84.27734375
40,31,12,463,4096,-3633,-88.6962890625
40,31,13,5780,8192,-2412,-29.443359375
40,31,14,1473,16384,-14911,-91.009521484375
40,31,15,31024,32768,-1744,-5.322265625
40,32,1,0,2,-2,-100.0
40,32,2,4,4,0,0.0
40,32,3,2,8,-6,-75.0
40,32,4,12,16,-4,-25.0
40,32,5,17,32,-15,-46.875
40,32,6,73,64,9,14.0625
40,32,7,10,128,-118,-92.1875
40,32,8,76,256,-180,-70.3125
40,32,9,88,512,-424,-82.8125
40,32,10,2270,1024,1246,121.6796875
40,32,11,2930,2048,882,43.06640625
40,32,12,555,4096,-3541,-86.4501953125
40,32,13,5346,8192,-2846,-34.7412109375
40,32,14,5610,16384,-10774,-65.75927734375
40,32,15,7932,32768,-24836,-75.79345703125
40,33,1,0,2,-2,-100.0
40,33,2,3,4,-1,-25.0
40,33,3,10,8,2,25.0
40,33,4,9,16,-7,-43.75
40,33,5,44,32,12,37.5
40,33,6,44,64,-20,-31.25
40,33,7,221,128,93,72.65625
40,33,8,433,256,177,69.140625
40,33,9,156,512,-356,-69.53125
40,33,10,656,1024,-368,-35.9375
40,33,11,483,2048,-1565,-76.416015625
40,33,12,2025,4096,-2071,-50.5615234375
40,33,13,2495,8192,-5697,-69.54345703125
40,33,14,43569,16384,27185,165.924072265625
40,33,15,2409,32768,-30359,-92.6483154296875
40,34,1,0,2,-2,-100.0
40,34,2,1,4,-3,-75.0
40,34,3,7,8,-1,-12.5
40,34,4,16,16,0,0.0
40,34,5,10,32,-22,-68.75
40,34,6,297,64,233,364.0625
40,34,7,24,128,-104,-81.25
40,34,8,82,256,-174,-67.96875
40,34,9,634,512,122,23.828125
40,34,10,1304,1024,280,27.34375
40,34,11,1638,2048,-410,-20.01953125
40,34,12,719,4096,-3377,-82.4462890625
40,34,13,553,8192,-7639,-93.24951171875
40,34,14,21949,16384,5565,33.966064453125
40,34,15,42601,32768,9833,30.0079345703125
40,35,1,0,2,-2,-100.0
40,35,2,2,4,-2,-50.0
40,35,3,4,8,-4,-50.0
40,35,4,7,16,-9,-56.25
40,35,5,29,32,-3,-9.375
40,35,6,57,64,-7,-10.9375
40,35,7,139,128,11,8.59375
40,35,8,579,256,323,126.171875
40,35,9,147,512,-365,-71.2890625
40,35,10,541,1024,-483,-47.16796875
40,35,11,9893,2048,7845,383.056640625
40,35,12,12598,4096,8502,207.568359375
40,35,13,2666,8192,-5526,-67.4560546875
40,35,14,1701,16384,-14683,-89.617919921875
40,35,15,26163,32768,-6605,-20.1568603515625
40,36,1,0,2,-2,-100.0
40,36,2,2,4,-2,-50.0
40,36,3,5,8,-3,-37.5
40,36,4,4,16,-12,-75.0
40,36,5,18,32,-14,-43.75
40,36,6,10,64,-54,-84.375
40,36,7,132,128,4,3.125
40,36,8,303,256,47,18.359375
40,36,9,181,512,-331,-64.6484375
40,36,10,1454,1024,430,41.9921875
40,36,11,1900,2048,-148,-7.2265625
40,36,12,2089,4096,-2007,-48.9990234375
40,36,13,2501,8192,-5691,-69.47021484375
40,36,14,23763,16384,7379,45.037841796875
40,36,15,5879,32768,-26889,-82.0587158203125
40,37,1,0,2,-2,-100.0
40,37,2,1,4,-3,-75.0
40,37,3,10,8,2,25.0
40,37,4,8,16,-8,-50.0
40,37,5,6,32,-26,-81.25
40,37,6,11,64,-53,-82.8125
40,37,7,363,128,235,183.59375
40,37,8,7,256,-249,-97.265625
40,37,9,89,512,-423,-82.6171875
40,37,10,3208,1024,2184,213.28125
40,37,11,1986,2048,-62,-3.02734375
40,37,12,9679,4096,5583,136.3037109375
40,37,13,28032,8192,19840,242.1875
40,37,14,29840,16384,13456,82.12890625
40,37,15,32759,32768,-9,-0.0274658203125
40,38,1,0,2,-2,-100.0
40,38,2,1,4,-3,-75.0
40,38,3,14,8,6,75.0
40,38,4,3,16,-13,-81.25
40,38,5,5,32,-27,-84.375
40,38,6,47,64,-17,-26.5625
40,38,7,453,128,325,253.90625
40,38,8,723,256,467,182.421875
40,38,9,1613,512,1101,215.0390625
40,38,10,3383,1024,2359,230.37109375
40,38,11,2724,2048,676,33.0078125
40,38,12,3289,4096,-807,-19.7021484375
40,38,13,3137,8192,-5055,-61.70654296875
40,38,14,4714,16384,-11670,-71.22802734375
40,38,15,86796,32768,54028,164.88037109375
40,39,1,0,2,-2,-100.0
40,39,2,3,4,-1,-25.0
40,39,3,2,8,-6,-75.0
40,39,4,9,16,-7,-43.75
40,39,5,21,32,-11,-34.375
40,39,6,45,64,-19,-29.6875
40,39,7,213,128,85,66.40625
40,39,8,40,256,-216,-84.375
40,39,9,1110,512,598,116.796875
40,39,10,90,1024,-934,-91.2109375
40,39,11,144,2048,-1904,-92.96875
40,39,12,633,4096,-3463,-84.5458984375
40,39,13,19492,8192,11300,137.939453125
40,39,14,27859,16384,11475,70.037841796875
40,39,15,36691,32768,3923,11.9720458984375
40,40,1,0,2,-2,-100.0
40,40,2,2,4,-2,-50.0
40,40,3,2,8,-6,-75.0
40,40,4,12,16,-4,-25.0
40,40,5,28,32,-4,-12.5
40,40,6,72,64,8,12.5
40,40,7,28,128,-100,-78.125
40,40,8,1230,256,974,380.46875
40,40,9,215,512,-297,-58.0078125
40,40,10,970,1024,-54,-5.2734375
40,40,11,1207,2048,-841,-41.064453125
40,40,12,4172,4096,76,1.85546875
40,40,13,2785,8192,-5407,-66.00341796875
40,40,14,3862,16384,-12522,-76.42822265625
40,40,15,37123,32768,4355,13.2904052734375
41,1,1,0,2,-2,-100.0
41,1,2,1,4,-3,-75.0
41,1,3,11,8,3,37.5
41,1,4,24,16,8,50.0
41,1,5,12,32,-20,-62.5
41,1,6,23,64,-41,-64.0625
41,1,7,57,128,-71,-55.46875
41,1,8,150,256,-106,-41.40625
41,1,9,427,512,-85,-16.6015625
41,1,10,591,1024,-433,-42.28515625
41,1,11,8859,2048,6811,332.568359375
41,1,12,2060,4096,-2036,-49.70703125
41,1,13,11087,8192,2895,35.33935546875
41,1,14,9364,16384,-7020,-42.8466796875
41,1,15,27988,32768,-4780,-14.58740234375
41,2,1,0,2,-2,-100.0
41,2,2,3,4,-1,-25.0
41,2,3,2,8,-6,-75.0
41,2,4,16,16,0,0.0
41,2,5,8,32,-24,-75.0
41,2,6,18,64,-46,-71.875
41,2,7,37,128,-91,-71.09375
41,2,8,387,256,131,51.171875
41,2,9,438,512,-74,-14.453125
41,2,10,489,1024,-535,-52.24609375
41,2,11,1941,2048,-107,-5.224609375
41,2,12,243,4096,-3853,-94.0673828125
41,2,13,3136,8192,-5056,-61.71875
41,2,14,27338,16384,10954,66.85791015625
41,2,15,23170,32768,-9598,-29.290771484375
41,3,1,0,2,-2,-100.0
41,3,2,2,4,-2,-50.0
41,3,3,21,8,13,162.5
41,3,4,14,16,-2,-12.5
41,3,5,5,32,-27,-84.375
41,3,6,99,64,35,54.6875
41,3,7,59,128,-69,-53.90625
41,3,8,222,256,-34,-13.28125
41,3,9,1695,512,1183,231.0546875
41,3,10,987,1024,-37,-3.61328125
41,3,11,2060,2048,12,0.5859375
41,3,12,7396,4096,3300,80.56640625
41,3,13,270,8192,-7922,-96.7041015625
41,3,14,5740,16384,-10644,-64.9658203125
41,3,15,15410,32768,-17358,-52.972412109375
41,4,1,0,2,-2,-100.0
41,4,2,5,4,1,25.0
41,4,3,10,8,2,25.0
41,4,4,10,16,-6,-37.5
41,4,5,30,32,-2,-6.25
41,4,6,61,64,-3,-4.6875
41,4,7,51,128,-77,-60.15625
41,4,8,105,256,-151,-58.984375
41,4,9,15,512,-497,-97.0703125
41,4,10,391,1024,-633,-61.81640625
41,4,11,2555,2048,507,24.755859375
41,4,12,2202,4096,-1894,-46.240234375
41,4,13,3225,8192,-4967,-60.63232421875
41,4,14,20180,16384,3796,23.1689453125
41,4,15,17143,32768,-15625,-47.6837158203125
41,5,1,0,2,-2,-100.0
41,5,2,4,4,0,0.0
41,5,3,2,8,-6,-75.0
41,5,4,22,16,6,37.5
41,5,5,4,32,-28,-87.5
41,5,6,8,64,-56,-87.5
41,5,7,7,128,-121,-94.53125
41,5,8,216,256,-40,-15.625
41,5,9,229,512,-283,-55.2734375
41,5,10,232,1024,-792,-77.34375
41,5,11,119,2048,-1929,-94.189453125
41,5,12,2331,4096,-1765,-43.0908203125
41,5,13,18586,8192,10394,126.8798828125
41,5,14,11047,16384,-5337,-32.574462890625
41,5,15,31064,32768,-1704,-5.2001953125
41,6,1,0,2,-2,-100.0
41,6,2,2,4,-2,-50.0
41,6,3,9,8,1,12.5
41,6,4,18,16,2,12.5
41,6,5,73,32,41,128.125
41,6,6,12,64,-52,-81.25
41,6,7,144,128,16,12.5
41,6,8,589,256,333,130.078125
41,6,9,72,512,-440,-85.9375
41,6,10,5179,1024,4155,405.76171875
41,6,11,969,2048,-1079,-52.685546875
41,6,12,8145,4096,4049,98.8525390625
41,6,13,59,8192,-8133,-99.27978515625
41,6,14,42330,16384,25946,158.36181640625
41,6,15,1272,32768,-31496,-96.1181640625
41,7,1,0,2,-2,-100.0
41,7,2,3,4,-1,-25.0
41,7,3,14,8,6,75.0
41,7,4,6,16,-10,-62.5
41,7,5,4,32,-28,-87.5
41,7,6,49,64,-15,-23.4375
41,7,7,57,128,-71,-55.46875
41,7,8,141,256,-115,-44.921875
41,7,9,738,512,226,44.140625
41,7,10,1503,1024,479,46.77734375
41,7,11,5073,2048,3025,147.705078125
41,7,12,5139,4096,1043,25.4638671875
41,7,13,434,8192,-7758,-94.7021484375
41,7,14,4803,16384,-11581,-70.684814453125
41,7,15,24451,32768,-8317,-25.3814697265625
41,8,1,0,2,-2,-100.0
41,8,2,1,4,-3,-75.0
41,8,3,16,8,8,100.0
41,8,4,5,16,-11,-68.75
41,8,5,19,32,-13,-40.625
41,8,6,66,64,2,3.125
41,8,7,434,128,306,239.0625
41,8,8,189,256,-67,-26.171875
41,8,9,34,512,-478,-93.359375
41,8,10,824,1024,-200,-19.53125
41,8,11,1048,2048,-1000,-48.828125
41,8,12,13670,4096,9574,233.740234375
41,8,13,6569,8192,-1623,-19.81201171875
41,8,14,9172,16384,-7212,-44.0185546875
41,8,15,8505,32768,-24263,-74.0447998046875
41,9,1,0,2,-2,-100.0
41,9,2,1,4,-3,-75.0
41,9,3,2,8,-6,-75.0
41,9,4,17,16,1,6.25
41,9,5,4,32,-28,-87.5
41,9,6,28,64,-36,-56.25
41,9,7,21,128,-107,-83.59375
41,9,8,319,256,63,24.609375
41,9,9,39,512,-473,-92.3828125
41,9,10,3094,1024,2070,202.1484375
41,9,11,2635,2048,587,28.662109375
41,9,12,1346,4096,-2750,-67.138671875
41,9,13,4224,8192,-3968,-48.4375
41,9,14,52217,16384,35833,218.707275390625
41,9,15,78200,32768,45432,138.6474609375
41,10,1,0,2,-2,-100.0
41,10,2,3,4,-1,-25.0
41,10,3,4,8,-4,-50.0
41,10,4,44,16,28,175.0
41,10,5,84,32,52,162.5
41,10,6,31,64,-33,-51.5625
41,10,7,87,128,-41,-32.03125
41,10,8,82,256,-174,-67.96875
41,10,9,2657,512,2145,418.9453125
41,10,10,85,1024,-939,-91.69921875
41,10,11,4601,2048,2553,124.658203125
41,10,12,6654,4096,2558,62.451171875
41,10,13,9311,8192,1119,13.65966796875
41,10,14,7364,16384,-9020,-55.0537109375
41,10,15,6900,32768,-25868,-78.94287109375
41,11,1,0,2,-2,-100.0
41,11,2,2,4,-2,-50.0
41,11,3,7,8,-1,-12.5
41,11,4,5,16,-11,-68.75
41,11,5,74,32,42,131.25
41,11,6,77,64,13,20.3125
41,11,7,245,128,117,91.40625
41,11,8,32,256,-224,-87.5
41,11,9,262,512,-250,-48.828125
41,11,10,2187,1024,1163,113.57421875
41,11,11,2216,2048,168,8.203125
41,11,12,6119,4096,2023,49.3896484375
41,11,13,7675,8192,-517,-6.31103515625
41,11,14,23326,16384,6942,42.37060546875
41,11,15,14404,32768,-18364,-56.04248046875
41,12,1,0,2,-2,-100.0
41,12,2,1,4,-3,-75.0
41,12,3,7,8,-1,-12.5
41,12,4,7,16,-9,-56.25
41,12,5,70,32,38,118.75
41,12,6,96,64,32,50.0
41,12,7,163,128,35,27.34375
41,12,8,260,256,4,1.5625
41,12,9,828,512,316,61.71875
41,12,10,2009,1024,985,96.19140625
41,12,11,276,2048,-1772,-86.5234375
41,12,12,1740,4096,-2356,-57.51953125
41,12,13,21608,8192,13416,163.76953125
41,12,14,35540,16384,19156,116.9189453125
41,12,15,21397,32768,-11371,-34.7015380859375
41,13,1,0,2,-2,-100.0
41,13,2,7,4,3,75.0
41,13,3,6,8,-2,-25.0
41,13,4,21,16,5,31.25
41,13,5,22,32,-10,-31.25
41,13,6,15,64,-49,-76.5625
41,13,7,214,128,86,67.1875
41,13,8,279,256,23,8.984375
41,13,9,41,512,-471,-91.9921875
41,13,10,540,1024,-484,-47.265625
41,13,11,4193,2048,2145,104.736328125
41,13,12,1338,4096,-2758,-67.333984375
41,13,13,3106,8192,-5086,-62.0849609375
41,13,14,18947,16384,2563,15.643310546875
41,13,15,20130,32768,-12638,-38.568115234375
41,14,1,0,2,-2,-100.0
41,14,2,2,4,-2,-50.0
41,14,3,32,8,24,300.0
41,14,4,9,16,-7,-43.75
41,14,5,15,32,-17,-53.125
41,14,6,25,64,-39,-60.9375
41,14,7,28,128,-100,-78.125
41,14,8,57,256,-199,-77.734375
41,14,9,336,512,-176,-34.375
41,14,10,1193,1024,169,16.50390625
41,14,11,1586,2048,-462,-22.55859375
41,14,12,1212,4096,-2884,-70.41015625
41,14,13,503,8192,-7689,-93.85986328125
41,14,14,12027,16384,-4357,-26.593017578125
41,14,15,2578,32768,-30190,-92.132568359375
41,15,1,0,2,-2,-100.0
41,15,2,2,4,-2,-50.0
41,15,3,4,8,-4,-50.0
41,15,4,14,16,-2,-12.5
41,15,5,67,32,35,109.375
41,15,6,7,64,-57,-89.0625
41,15,7,33,128,-95,-74.21875
41,15,8,181,256,-75,-29.296875
41,15,9,1417,512,905,176.7578125
41,15,10,639,1024,-385,-37.59765625
41,15,11,6070,2048,4022,196.38671875
41,15,12,234,4096,-3862,-94.287109375
41,15,13,1777,8192,-6415,-78.30810546875
41,15,14,2853,16384,-13531,-82.586669921875
41,15,15,14224,32768,-18544,-56.591796875
41,16,1,0,2,-2,-100.0
41,16,2,5,4,1,25.0
41,16,3,3,8,-5,-62.5
41,16,4,6,16,-10,-62.5
41,16,5,12,32,-20,-62.5
41,16,6,16,64,-48,-75.0
41,16,7,68,128,-60,-46.875
41,16,8,592,256,336,131.25
41,16,9,29,512,-483,-94.3359375
41,16,10,286,1024,-738,-72.0703125
41,16,11,478,2048,-1570,-76.66015625
41,16,12,4846,4096,750,18.310546875
41,16,13,11443,8192,3251,39.68505859375
41,16,14,17347,16384,963,5.877685546875
41,16,15,34768,32768,2000,6.103515625
41,17,1,0,2,-2,-100.0
41,17,2,3,4,-1,-25.0
41,17,3,7,8,-1,-12.5
41,17,4,5,16,-11,-68.75
41,17,5,5,32,-27,-84.375
41,17,6,7,64,-57,-89.0625
41,17,7,26,128,-102,-79.6875
41,17,8,56,256,-200,-78.125
41,17,9,33,512,-479,-93.5546875
41,17,10,433,1024,-591,-57.71484375
41,17,11,1700,2048,-348,-16.9921875
41,17,12,176,4096,-3920,-95.703125
41,17,13,8756,8192,564,6.884765625
41,17,14,9729,16384,-6655,-40.618896484375
41,17,15,21939,32768,-10829,-33.0474853515625
41,18,1,0,2,-2,-100.0
41,18,2,1,4,-3,-75.0
41,18,3,4,8,-4,-50.0
41,18,4,21,16,5,31.25
41,18,5,59,32,27,84.375
41,18,6,98,64,34,53.125
41,18,7,211,128,83,64.84375
41,18,8,25,256,-231,-90.234375
41,18,9,1412,512,900,175.78125
41,18,10,902,1024,-122,-11.9140625
41,18,11,442,2048,-1606,-78.41796875
41,18,12,8649,4096,4553,111.1572265625
41,18,13,1763,8192,-6429,-78.47900390625
41,18,14,21682,16384,5298,32.33642578125
41,18,15,7839,32768,-24929,-76.0772705078125
41,19,1,0,2,-2,-100.0
41,19,2,1,4,-3,-75.0
41,19,3,2,8,-6,-75.0
41,19,4,19,16,3,18.75
41,19,5,34,32,2,6.25
41,19,6,9,64,-55,-85.9375
41,19,7,182,128,54,42.1875
41,19,8,13,256,-243,-94.921875
41,19,9,1705,512,1193,233.0078125
41,19,10,2432,1024,1408,137.5
41,19,11,2179,2048,131,6.396484375
41,19,12,8044,4096,3948,96.38671875
41,19,13,16831,8192,8639,105.45654296875
41,19,14,1847,16384,-14537,-88.726806640625
41,19,15,36303,32768,3535,10.7879638671875
41,20,1,0,2,-2,-100.0
41,20,2,2,4,-2,-50.0
41,20,3,2,8,-6,-75.0
41,20,4,20,16,4,25.0
41,20,5,9,32,-23,-71.875
41,20,6,336,64,272,425.0
41,20,7,31,128,-97,-75.78125
41,20,8,76,256,-180,-70.3125
41,20,9,56,512,-456,-89.0625
41,20,10,316,1024,-708,-69.140625
41,20,11,4074,2048,2026,98.92578125
41,20,12,3615,4096,-481,-11.7431640625
41,20,13,867,8192,-7325,-89.41650390625
41,20,14,2594,16384,-13790,-84.16748046875
41,20,15,168189,32768,135421,413.2720947265625
41,21,1,0,2,-2,-100.0
41,21,2,4,4,0,0.0
41,21,3,5,8,-3,-37.5
41,21,4,6,16,-10,-62.5
41,21,5,28,32,-4,-12.5
41,21,6,113,64,49,76.5625
41,21,7,35,128,-93,-72.65625
41,21,8,375,256,119,46.484375
41,21,9,566,512,54,10.546875
41,21,10,82,1024,-942,-91.9921875
41,21,11,891,2048,-1157,-56.494140625
41,21,12,2963,4096,-1133,-27.6611328125
41,21,13,13631,8192,5439,66.39404296875
41,21,14,4650,16384,-11734,-71.61865234375
41,21,15,16745,32768,-16023,-48.8983154296875
41,22,1,0,2,-2,-100.0
41,22,2,2,4,-2,-50.0
41,22,3,10,8,2,25.0
41,22,4,19,16,3,18.75
41,22,5,24,32,-8,-25.0
41,22,6,11,64,-53,-82.8125
41,22,7,30,128,-98,-76.5625
41,22,8,219,256,-37,-14.453125
41,22,9,930,512,418,81.640625
41,22,10,726,1024,-298,-29.1015625
41,22,11,4794,2048,2746,134.08203125
41,22,12,3028,4096,-1068,-26.07421875
41,22,13,1594,8192,-6598,-80.5419921875
41,22,14,33698,16384,17314,105.67626953125
41,22,15,1513,32768,-31255,-95.3826904296875
41,23,1,0,2,-2,-100.0
41,23,2,2,4,-2,-50.0
41,23,3,6,8,-2,-25.0
41,23,4,9,16,-7,-43.75
41,23,5,4,32,-28,-87.5
41,23,6,50,64,-14,-21.875
41,23,7,36,128,-92,-71.875
41,23,8,809,256,553,216.015625
41,23,9,867,512,355,69.3359375
41,23,10,18,1024,-1006,-98.2421875
41,23,11,805,2048,-1243,-60.693359375
41,23,12,556,4096,-3540,-86.42578125
41,23,13,14989,8192,6797,82.97119140625
41,23,14,5122,16384,-11262,-68.73779296875
41,23,15,55220,32768,22452,68.51806640625
41,24,1,0,2,-2,-100.0
41,24,2,1,4,-3,-75.0
41,24,3,3,8,-5,-62.5
41,24,4,15,16,-1,-6.25
41,24,5,8,32,-24,-75.0
41,24,6,105,64,41,64.0625
41,24,7,102,128,-26,-20.3125
41,24,8,328,256,72,28.125
41,24,9,553,512,41,8.0078125
41,24,10,157,1024,-867,-84.66796875
41,24,11,2674,2048,626,30.56640625
41,24,12,2306,4096,-1790,-43.701171875
41,24,13,909,8192,-7283,-88.90380859375
41,24,14,7413,16384,-8971,-54.754638671875
41,24,15,16361,32768,-16407,-50.0701904296875
41,25,1,0,2,-2,-100.0
41,25,2,1,4,-3,-75.0
41,25,3,11,8,3,37.5
41,25,4,3,16,-13,-81.25
41,25,5,5,32,-27,-84.375
41,25,6,54,64,-10,-15.625
41,25,7,43,128,-85,-66.40625
41,25,8,327,256,71,27.734375
41,25,9,160,512,-352,-68.75
41,25,10,1222,1024,198,19.3359375
41,25,11,1492,2048,-556,-27.1484375
41,25,12,13282,4096,9186,224.267578125
41,25,13,3636,8192,-4556,-55.615234375
41,25,14,15765,16384,-619,-3.778076171875
41,25,15,10536,32768,-22232,-67.8466796875
41,26,1,0,2,-2,-100.0
41,26,2,1,4,-3,-75.0
41,26,3,5,8,-3,-37.5
41,26,4,41,16,25,156.25
41,26,5,50,32,18,56.25
41,26,6,50,64,-14,-21.875
41,26,7,183,128,55,42.96875
41,26,8,196,256,-60,-23.4375
41,26,9,80,512,-432,-84.375
41,26,10,1431,1024,407,39.74609375
41,26,11,1066,2048,-982,-47.94921875
41,26,12,12915,4096,8819,215.3076171875
41,26,13,5483,8192,-2709,-33.06884765625
41,26,14,3150,16384,-13234,-80.77392578125
41,26,15,20152,32768,-12616,-38.5009765625
41,27,1,0,2,-2,-100.0
41,27,2,6,4,2,50.0
41,27,3,5,8,-3,-37.5
41,27,4,9,16,-7,-43.75
41,27,5,67,32,35,109.375
41,27,6,12,64,-52,-81.25
41,27,7,412,128,284,221.875
41,27,8,205,256,-51,-19.921875
41,27,9,112,512,-400,-78.125
41,27,10,81,1024,-943,-92.08984375
41,27,11,9603,2048,7555,368.896484375
41,27,12,4466,4096,370,9.033203125
41,27,13,7014,8192,-1178,-14.3798828125
41,27,14,16843,16384,459,2.801513671875
41,27,15,10126,32768,-22642,-69.097900390625
41,28,1,0,2,-2,-100.0
41,28,2,1,4,-3,-75.0
41,28,3,7,8,-1,-12.5
41,28,4,4,16,-12,-75.0
41,28,5,4,32,-28,-87.5
41,28,6,130,64,66,103.125
41,28,7,222,128,94,73.4375
41,28,8,422,256,166,64.84375
41,28,9,659,512,147,28.7109375
41,28,10,844,1024,-180,-17.578125
41,28,11,771,2048,-1277,-62.353515625
41,28,12,5575,4096,1479,36.1083984375
41,28,13,13382,8192,5190,63.3544921875
41,28,14,4979,16384,-11405,-69.610595703125
41,28,15,14481,32768,-18287,-55.8074951171875
41,29,1,0,2,-2,-100.0
41,29,2,3,4,-1,-25.0
41,29,3,2,8,-6,-75.0
41,29,4,21,16,5,31.25
41,29,5,40,32,8,25.0
41,29,6,12,64,-52,-81.25
41,29,7,243,128,115,89.84375
41,29,8,305,256,49,19.140625
41,29,9,1868,512,1356,264.84375
41,29,10,536,1024,-488,-47.65625
41,29,11,11044,2048,8996,439.2578125
41,29,12,1468,4096,-2628,-64.16015625
41,29,13,342,8192,-7850,-95.8251953125
41,29,14,22551,16384,6167,37.640380859375
41,29,15,445,32768,-32323,-98.6419677734375
41,30,1,0,2,-2,-100.0
41,30,2,1,4,-3,-75.0
41,30,3,2,8,-6,-75.0
41,30,4,27,16,11,68.75
41,30,5,48,32,16,50.0
41,30,6,18,64,-46,-71.875
41,30,7,74,128,-54,-42.1875
41,30,8,71,256,-185,-72.265625
41,30,9,170,512,-342,-66.796875
41,30,10,3073,1024,2049,200.09765625
41,30,11,3107,2048,1059,51.708984375
41,30,12,5946,4096,1850,45.166015625
41,30,13,1045,8192,-7147,-87.24365234375
41,30,14,18542,16384,2158,13.17138671875
41,30,15,24386,32768,-8382,-25.579833984375
41,31,1,0,2,-2,-100.0
41,31,2,6,4,2,50.0
41,31,3,2,8,-6,-75.0
41,31,4,42,16,26,162.5
41,31,5,35,32,3,9.375
41,31,6,6,64,-58,-90.625
41,31,7,77,128,-51,-39.84375
41,31,8,290,256,34,13.28125
41,31,9,993,512,481,93.9453125
41,31,10,186,1024,-838,-81.8359375
41,31,11,498,2048,-1550,-75.68359375
41,31,12,5586,4096,1490,36.376953125
41,31,13,1488,8192,-6704,-81.8359375
41,31,14,36748,16384,20364,124.2919921875
41,31,15,22834,32768,-9934,-30.316162109375
41,32,1,0,2,-2,-100.0
41,32,2,1,4,-3,-75.0
41,32,3,3,8,-5,-62.5
41,32,4,13,16,-3,-18.75
41,32,5,36,32,4,12.5
41,32,6,122,64,58,90.625
41,32,7,119,128,-9,-7.03125
41,32,8,109,256,-147,-57.421875
41,32,9,1050,512,538,105.078125
41,32,10,42,1024,-982,-95.8984375
41,32,11,801,2048,-1247,-60.888671875
41,32,12,4651,4096,555,13.5498046875
41,32,13,1819,8192,-6373,-77.79541015625
41,32,14,14191,16384,-2193,-13.385009765625
41,32,15,13504,32768,-19264,-58.7890625
41,33,1,0,2,-2,-100.0
41,33,2,1,4,-3,-75.0
41,33,3,5,8,-3,-37.5
41,33,4,14,16,-2,-12.5
41,33,5,17,32,-15,-46.875
41,33,6,49,64,-15,-23.4375
41,33,7,275,128,147,114.84375
41,33,8,175,256,-81,-31.640625
41,33,9,43,512,-469,-91.6015625
41,33,10,832,1024,-192,-18.75
41,33,11,1836,2048,-212,-10.3515625
41,33,12,3581,4096,-515,-12.5732421875
41,33,13,1306,8192,-6886,-84.0576171875
41,33,14,6134,16384,-10250,-62.56103515625
41,33,15,58260,32768,25492,77.79541015625
41,34,1,0,2,-2,-100.0
41,34,2,1,4,-3,-75.0
41,34,3,13,8,5,62.5
41,34,4,16,16,0,0.0
41,34,5,88,32,56,175.0
41,34,6,49,64,-15,-23.4375
41,34,7,81,128,-47,-36.71875
41,34,8,262,256,6,2.34375
41,34,9,542,512,30,5.859375
41,34,10,112,1024,-912,-89.0625
41,34,11,609,2048,-1439,-70.263671875
41,34,12,2635,4096,-1461,-35.6689453125
41,34,13,10621,8192,2429,29.65087890625
41,34,14,10957,16384,-5427,-33.123779296875
41,34,15,32718,32768,-50,-0.152587890625
41,35,1,0,2,-2,-100.0
41,35,2,3,4,-1,-25.0
41,35,3,4,8,-4,-50.0
41,35,4,3,16,-13,-81.25
41,35,5,18,32,-14,-43.75
41,35,6,17,64,-47,-73.4375
41,35,7,428,128,300,234.375
41,35,8,284,256,28,10.9375
41,35,9,292,512,-220,-42.96875
41,35,10,373,1024,-651,-63.57421875
41,35,11,126,2048,-1922,-93.84765625
41,35,12,3922,4096,-174,-4.248046875
41,35,13,713,8192,-7479,-91.29638671875
41,35,14,4470,16384,-11914,-72.71728515625
41,35,15,13209,32768,-19559,-59.6893310546875
41,36,1,0,2,-2,-100.0
41,36,2,1,4,-3,-75.0
41,36,3,14,8,6,75.0
41,36,4,22,16,6,37.5
41,36,5,17,32,-15,-46.875
41,36,6,69,64,5,7.8125
41,36,7,85,128,-43,-33.59375
41,36,8,199,256,-57,-22.265625
41,36,9,319,512,-193,-37.6953125
41,36,10,214,1024,-810,-79.1015625
41,36,11,268,2048,-1780,-86.9140625
41,36,12,1818,4096,-2278,-55.615234375
41,36,13,6207,8192,-1985,-24.23095703125
41,36,14,3978,16384,-12406,-75.72021484375
41,36,15,29573,32768,-3195,-9.7503662109375
41,37,1,0,2,-2,-100.0
41,37,2,1,4,-3,-75.0
41,37,3,9,8,1,12.5
41,37,4,8,16,-8,-50.0
41,37,5,38,32,6,18.75
41,37,6,66,64,2,3.125
41,37,7,58,128,-70,-54.6875
41,37,8,218,256,-38,-14.84375
41,37,9,359,512,-153,-29.8828125
41,37,10,2644,1024,1620,158.203125
41,37,11,64,2048,-1984,-96.875
41,37,12,2903,4096,-1193,-29.1259765625
41,37,13,27439,8192,19247,234.94873046875
41,37,14,12328,16384,-4056,-24.755859375
41,37,15,1689,32768,-31079,-94.8455810546875
41,38,1,0,2,-2,-100.0
41,38,2,1,4,-3,-75.0
41,38,3,7,8,-1,-12.5
41,38,4,26,16,10,62.5
41,38,5,28,32,-4,-12.5
41,38,6,24,64,-40,-62.5
41,38,7,23,128,-105,-82.03125
41,38,8,48,256,-208,-81.25
41,38,9,432,512,-80,-15.625
41,38,10,1372,1024,348,33.984375
41,38,11,2782,2048,734,35.83984375
41,38,12,3879,4096,-217,-5.2978515625
41,38,13,2018,8192,-6174,-75.3662109375
41,38,14,23750,16384,7366,44.95849609375
41,38,15,32878,32768,110,0.335693359375
41,39,1,0,2,-2,-100.0
41,39,2,1,4,-3,-75.0
41,39,3,8,8,0,0.0
41,39,4,7,16,-9,-56.25
41,39,5,5,32,-27,-84.375
41,39,6,43,64,-21,-32.8125
41,39,7,58,128,-70,-54.6875
41,39,8,346,256,90,35.15625
41,39,9,791,512,279,54.4921875
41,39,10,154,1024,-870,-84.9609375
41,39,11,2482,2048,434,21.19140625
41,39,12,6620,4096,2524,61.62109375
41,39,13,4432,8192,-3760,-45.8984375
41,39,14,29086,16384,12702,77.52685546875
41,39,15,28115,32768,-4653,-14.1998291015625
41,40,1,0,2,-2,-100.0
41,40,2,1,4,-3,-75.0
41,40,3,3,8,-5,-62.5
41,40,4,14,16,-2,-12.5
41,40,5,8,32,-24,-75.0
41,40,6,38,64,-26,-40.625
41,40,7,60,128,-68,-53.125
41,40,8,221,256,-35,-13.671875
41,40,9,122,512,-390,-76.171875
41,40,10,882,1024,-142,-13.8671875
41,40,11,4326,2048,2278,111.23046875
41,40,12,296,4096,-3800,-92.7734375
41,40,13,28598,8192,20406,249.0966796875
41,40,14,15927,16384,-457,-2.789306640625
41,40,15,6918,32768,-25850,-78.887939453125
41,41,1,0,2,-2,-100.0
41,41,2,3,4,-1,-25.0
41,41,3,8,8,0,0.0
41,41,4,3,16,-13,-81.25
41,41,5,58,32,26,81.25
41,41,6,57,64,-7,-10.9375
41,41,7,122,128,-6,-4.6875
41,41,8,520,256,264,103.125
41,41,9,1918,512,1406,274.609375
41,41,10,400,1024,-624,-60.9375
41,41,11,545,2048,-1503,-73.388671875
41,41,12,1484,4096,-2612,-63.76953125
41,41,13,1724,8192,-6468,-78.955078125
41,41,14,4516,16384,-11868,-72.4365234375
41,41,15,6953,32768,-25815,-78.7811279296875
42,1,1,0,2,-2,-100.0
42,1,2,11,4,7,175.0
42,1,3,2,8,-6,-75.0
42,1,4,8,16,-8,-50.0
42,1,5,38,32,6,18.75
42,1,6,111,64,47,73.4375
42,1,7,150,128,22,17.1875
42,1,8,324,256,68,26.5625
42,1,9,161,512,-351,-68.5546875
42,1,10,1491,1024,467,45.60546875
42,1,11,96,2048,-1952,-95.3125
42,1,12,2026,4096,-2070,-50.537109375
42,1,13,4322,8192,-3870,-47.2412109375
42,1,14,1604,16384,-14780,-90.2099609375
42,1,15,3165,32768,-29603,-90.3411865234375
42,2,1,0,2,-2,-100.0
42,2,2,2,4,-2,-50.0
42,2,3,9,8,1,12.5
42,2,4,4,16,-12,-75.0
42,2,5,20,32,-12,-37.5
42,2,6,32,64,-32,-50.0
42,2,7,85,128,-43,-33.59375
42,2,8,28,256,-228,-89.0625
42,2,9,1672,512,1160,226.5625
42,2,10,2145,1024,1121,109.47265625
42,2,11,6390,2048,4342,212.01171875
42,2,12,1757,4096,-2339,-57.1044921875
42,2,13,19236,8192,11044,134.814453125
42,2,14,1103,16384,-15281,-93.267822265625
42,2,15,63218,32768,30450,92.926025390625
42,3,1,0,2,-2,-100.0
42,3,2,1,4,-3,-75.0
42,3,3,9,8,1,12.5
42,3,4,26,16,10,62.5
42,3,5,14,32,-18,-56.25
42,3,6,72,64,8,12.5
42,3,7,74,128,-54,-42.1875
42,3,8,329,256,73,28.515625
42,3,9,303,512,-209,-40.8203125
42,3,10,801,1024,-223,-21.77734375
42,3,11,514,2048,-1534,-74.90234375
42,3,12,2649,4096,-1447,-35.3271484375
42,3,13,5776,8192,-2416,-29.4921875
42,3,14,4928,16384,-11456,-69.921875
42,3,15,30520,32768,-2248,-6.8603515625
42,4,1,0,2,-2,-100.0
42,4,2,4,4,0,0.0
42,4,3,5,8,-3,-37.5
42,4,4,3,16,-13,-81.25
42,4,5,9,32,-23,-71.875
42,4,6,12,64,-52,-81.25
42,4,7,185,128,57,44.53125
42,4,8,321,256,65,25.390625
42,4,9,239,512,-273,-53.3203125
42,4,10,1053,1024,29,2.83203125
42,4,11,2394,2048,346,16.89453125
42,4,12,203,4096,-3893,-95.0439453125
42,4,13,18430,8192,10238,124.9755859375
42,4,14,4028,16384,-12356,-75.4150390625
42,4,15,113159,32768,80391,245.3338623046875
42,5,1,0,2,-2,-100.0
42,5,2,1,4,-3,-75.0
42,5,3,4,8,-4,-50.0
42,5,4,7,16,-9,-56.25
42,5,5,32,32,0,0.0
42,5,6,47,64,-17,-26.5625
42,5,7,301,128,173,135.15625
42,5,8,126,256,-130,-50.78125
42,5,9,919,512,407,79.4921875
42,5,10,217,1024,-807,-78.80859375
42,5,11,2686,2048,638,31.15234375
42,5,12,1646,4096,-2450,-59.814453125
42,5,13,6321,8192,-1871,-22.83935546875
42,5,14,2566,16384,-13818,-84.33837890625
42,5,15,16748,32768,-16020,-48.88916015625
42,6,1,0,2,-2,-100.0
42,6,2,3,4,-1,-25.0
42,6,3,5,8,-3,-37.5
42,6,4,3,16,-13,-81.25
42,6,5,43,32,11,34.375
42,6,6,43,64,-21,-32.8125
42,6,7,298,128,170,132.8125
42,6,8,128,256,-128,-50.0
42,6,9,426,512,-86,-16.796875
42,6,10,1915,1024,891,87.01171875
42,6,11,3522,2048,1474,71.97265625
42,6,12,1298,4096,-2798,-68.310546875
42,6,13,1060,8192,-7132,-87.060546875
42,6,14,20128,16384,3744,22.8515625
42,6,15,2020,32768,-30748,-93.83544921875
42,7,1,0,2,-2,-100.0
42,7,2,2,4,-2,-50.0
42,7,3,4,8,-4,-50.0
42,7,4,3,16,-13,-81.25
42,7,5,15,32,-17,-53.125
42,7,6,10,64,-54,-84.375
42,7,7,34,128,-94,-73.4375
42,7,8,63,256,-193,-75.390625
42,7,9,243,512,-269,-52.5390625
42,7,10,548,1024,-476,-46.484375
42,7,11,29,2048,-2019,-98.583984375
42,7,12,2903,4096,-1193,-29.1259765625
42,7,13,19,8192,-8173,-99.76806640625
42,7,14,13197,16384,-3187,-19.451904296875
42,7,15,5866,32768,-26902,-82.098388671875
42,8,1,0,2,-2,-100.0
42,8,2,3,4,-1,-25.0
42,8,3,2,8,-6,-75.0
42,8,4,31,16,15,93.75
42,8,5,98,32,66,206.25
42,8,6,42,64,-22,-34.375
42,8,7,77,128,-51,-39.84375
42,8,8,527,256,271,105.859375
42,8,9,1085,512,573,111.9140625
42,8,10,423,1024,-601,-58.69140625
42,8,11,344,2048,-1704,-83.203125
42,8,12,2935,4096,-1161,-28.3447265625
42,8,13,6754,8192,-1438,-17.5537109375
42,8,14,10153,16384,-6231,-38.031005859375
42,8,15,26783,32768,-5985,-18.2647705078125
42,9,1,0,2,-2,-100.0
42,9,2,1,4,-3,-75.0
42,9,3,9,8,1,12.5
42,9,4,8,16,-8,-50.0
42,9,5,56,32,24,75.0
42,9,6,121,64,57,89.0625
42,9,7,145,128,17,13.28125
42,9,8,191,256,-65,-25.390625
42,9,9,255,512,-257,-50.1953125
42,9,10,3569,1024,2545,248.53515625
42,9,11,2699,2048,651,31.787109375
42,9,12,3671,4096,-425,-10.3759765625
42,9,13,10599,8192,2407,29.38232421875
42,9,14,37408,16384,21024,128.3203125
42,9,15,19359,32768,-13409,-40.9210205078125
42,10,1,0,2,-2,-100.0
42,10,2,3,4,-1,-25.0
42,10,3,2,8,-6,-75.0
42,10,4,4,16,-12,-75.0
42,10,5,24,32,-8,-25.0
42,10,6,105,64,41,64.0625
42,10,7,119,128,-9,-7.03125
42,10,8,415,256,159,62.109375
42,10,9,179,512,-333,-65.0390625
42,10,10,506,1024,-518,-50.5859375
42,10,11,345,2048,-1703,-83.154296875
42,10,12,3351,4096,-745,-18.1884765625
42,10,13,1068,8192,-7124,-86.962890625
42,10,14,17317,16384,933,5.694580078125
42,10,15,16464,32768,-16304,-49.755859375
42,11,1,0,2,-2,-100.0
42,11,2,4,4,0,0.0
42,11,3,6,8,-2,-25.0
42,11,4,13,16,-3,-18.75
42,11,5,33,32,1,3.125
42,11,6,33,64,-31,-48.4375
42,11,7,127,128,-1,-0.78125
42,11,8,57,256,-199,-77.734375
42,11,9,134,512,-378,-73.828125
42,11,10,421,1024,-603,-58.88671875
42,11,11,1144,2048,-904,-44.140625
42,11,12,3601,4096,-495,-12.0849609375
42,11,13,125,8192,-8067,-98.47412109375
42,11,14,21650,16384,5266,32.14111328125
42,11,15,21624,32768,-11144,-34.0087890625
42,12,1,0,2,-2,-100.0
42,12,2,2,4,-2,-50.0
42,12,3,2,8,-6,-75.0
42,12,4,8,16,-8,-50.0
42,12,5,113,32,81,253.125
42,12,6,110,64,46,71.875
42,12,7,18,128,-110,-85.9375
42,12,8,52,256,-204,-79.6875
42,12,9,34,512,-478,-93.359375
42,12,10,1568,1024,544,53.125
42,12,11,1027,2048,-1021,-49.853515625
42,12,12,4227,4096,131,3.1982421875
42,12,13,3454,8192,-4738,-57.8369140625
42,12,14,5402,16384,-10982,-67.02880859375
42,12,15,32226,32768,-542,-1.654052734375
42,13,1,0,2,-2,-100.0
42,13,2,1,4,-3,-75.0
42,13,3,5,8,-3,-37.5
42,13,4,12,16,-4,-25.0
42,13,5,28,32,-4,-12.5
42,13,6,6,64,-58,-90.625
42,13,7,87,128,-41,-32.03125
42,13,8,172,256,-84,-32.8125
42,13,9,1024,512,512,100.0
42,13,10,4455,1024,3431,335.05859375
42,13,11,2568,2048,520,25.390625
42,13,12,9161,4096,5065,123.6572265625
42,13,13,6694,8192,-1498,-18.2861328125
42,13,14,8849,16384,-7535,-45.989990234375
42,13,15,23597,32768,-9171,-27.9876708984375
42,14,1,0,2,-2,-100.0
42,14,2,1,4,-3,-75.0
42,14,3,3,8,-5,-62.5
42,14,4,16,16,0,0.0
42,14,5,20,32,-12,-37.5
42,14,6,5,64,-59,-92.1875
42,14,7,102,128,-26,-20.3125
42,14,8,137,256,-119,-46.484375
42,14,9,227,512,-285,-55.6640625
42,14,10,2207,1024,1183,115.52734375
42,14,11,63,2048,-1985,-96.923828125
42,14,12,1228,4096,-2868,-70.01953125
42,14,13,13566,8192,5374,65.6005859375
42,14,14,9571,16384,-6813,-41.583251953125
42,14,15,9786,32768,-22982,-70.135498046875
42,15,1,0,2,-2,-100.0
42,15,2,4,4,0,0.0
42,15,3,2,8,-6,-75.0
42,15,4,9,16,-7,-43.75
42,15,5,25,32,-7,-21.875
42,15,6,16,64,-48,-75.0
42,15,7,17,128,-111,-86.71875
42,15,8,532,256,276,107.8125
42,15,9,375,512,-137,-26.7578125
42,15,10,853,1024,-171,-16.69921875
42,15,11,1123,2048,-925,-45.166015625
42,15,12,1645,4096,-2451,-59.8388671875
42,15,13,2038,8192,-6154,-75.1220703125
42,15,14,9186,16384,-7198,-43.93310546875
42,15,15,8504,32768,-24264,-74.0478515625
42,16,1,0,2,-2,-100.0
42,16,2,2,4,-2,-50.0
42,16,3,2,8,-6,-75.0
42,16,4,8,16,-8,-50.0
42,16,5,41,32,9,28.125
42,16,6,29,64,-35,-54.6875
42,16,7,12,128,-116,-90.625
42,16,8,130,256,-126,-49.21875
42,16,9,1120,512,608,118.75
42,16,10,2654,1024,1630,159.1796875
42,16,11,1785,2048,-263,-12.841796875
42,16,12,879,4096,-3217,-78.5400390625
42,16,13,4997,8192,-3195,-39.00146484375
42,16,14,13246,16384,-3138,-19.15283203125
42,16,15,16914,32768,-15854,-48.382568359375
42,17,1,0,2,-2,-100.0
42,17,2,2,4,-2,-50.0
42,17,3,21,8,13,162.5
42,17,4,6,16,-10,-62.5
42,17,5,4,32,-28,-87.5
42,17,6,105,64,41,64.0625
42,17,7,79,128,-49,-38.28125
42,17,8,105,256,-151,-58.984375
42,17,9,156,512,-356,-69.53125
42,17,10,1156,1024,132,12.890625
42,17,11,3170,2048,1122,54.78515625
42,17,12,2093,4096,-2003,-48.9013671875
42,17,13,8104,8192,-88,-1.07421875
42,17,14,19909,16384,3525,21.514892578125
42,17,15,3054,32768,-29714,-90.679931640625
42,18,1,0,2,-2,-100.0
42,18,2,3,4,-1,-25.0
42,18,3,2,8,-6,-75.0
42,18,4,25,16,9,56.25
42,18,5,7,32,-25,-78.125
42,18,6,47,64,-17,-26.5625
42,18,7,19,128,-109,-85.15625
42,18,8,315,256,59,23.046875
42,18,9,468,512,-44,-8.59375
42,18,10,546,1024,-478,-46.6796875
42,18,11,4144,2048,2096,102.34375
42,18,12,10894,4096,6798,165.966796875
42,18,13,792,8192,-7400,-90.33203125
42,18,14,6846,16384,-9538,-58.21533203125
42,18,15,740,32768,-32028,-97.74169921875
42,19,1,0,2,-2,-100.0
42,19,2,2,4,-2,-50.0
42,19,3,5,8,-3,-37.5
42,19,4,9,16,-7,-43.75
42,19,5,143,32,111,346.875
42,19,6,6,64,-58,-90.625
42,19,7,407,128,279,217.96875
42,19,8,120,256,-136,-53.125
42,19,9,771,512,259,50.5859375
42,19,10,2639,1024,1615,157.71484375
42,19,11,1563,2048,-485,-23.681640625
42,19,12,3541,4096,-555,-13.5498046875
42,19,13,17183,8192,8991,109.75341796875
42,19,14,19348,16384,2964,18.0908203125
42,19,15,62829,32768,30061,91.7388916015625
42,20,1,0,2,-2,-100.0
42,20,2,1,4,-3,-75.0
42,20,3,4,8,-4,-50.0
42,20,4,29,16,13,81.25
42,20,5,24,32,-8,-25.0
42,20,6,36,64,-28,-43.75
42,20,7,211,128,83,64.84375
42,20,8,195,256,-61,-23.828125
42,20,9,788,512,276,53.90625
42,20,10,1029,1024,5,0.48828125
42,20,11,1657,2048,-391,-19.091796875
42,20,12,133,4096,-3963,-96.7529296875
42,20,13,3039,8192,-5153,-62.90283203125
42,20,14,9726,16384,-6658,-40.63720703125
42,20,15,7516,32768,-25252,-77.06298828125
42,21,1,0,2,-2,-100.0
42,21,2,3,4,-1,-25.0
42,21,3,2,8,-6,-75.0
42,21,4,3,16,-13,-81.25
42,21,5,18,32,-14,-43.75
42,21,6,7,64,-57,-89.0625
42,21,7,35,128,-93,-72.65625
42,21,8,586,256,330,128.90625
42,21,9,430,512,-82,-16.015625
42,21,10,1136,1024,112,10.9375
42,21,11,2730,2048,682,33.30078125
42,21,12,2067,4096,-2029,-49.5361328125
42,21,13,4313,8192,-3879,-47.35107421875
42,21,14,11088,16384,-5296,-32.32421875
42,21,15,37888,32768,5120,15.625
42,22,1,0,2,-2,-100.0
42,22,2,5,4,1,25.0
42,22,3,2,8,-6,-75.0
42,22,4,3,16,-13,-81.25
42,22,5,41,32,9,28.125
42,22,6,29,64,-35,-54.6875
42,22,7,67,128,-61,-47.65625
42,22,8,324,256,68,26.5625
42,22,9,317,512,-195,-38.0859375
42,22,10,124,1024,-900,-87.890625
42,22,11,1398,2048,-650,-31.73828125
42,22,12,945,4096,-3151,-76.9287109375
42,22,13,11630,8192,3438,41.9677734375
42,22,14,37842,16384,21458,130.96923828125
42,22,15,8389,32768,-24379,-74.3988037109375
42,23,1,0,2,-2,-100.0
42,23,2,1,4,-3,-75.0
42,23,3,4,8,-4,-50.0
42,23,4,4,16,-12,-75.0
42,23,5,47,32,15,46.875
42,23,6,56,64,-8,-12.5
42,23,7,127,128,-1,-0.78125
42,23,8,146,256,-110,-42.96875
42,23,9,391,512,-121,-23.6328125
42,23,10,175,1024,-849,-82.91015625
42,23,11,1752,2048,-296,-14.453125
42,23,12,1662,4096,-2434,-59.423828125
42,23,13,3853,8192,-4339,-52.96630859375
42,23,14,31803,16384,15419,94.110107421875
42,23,15,23427,32768,-9341,-28.5064697265625
42,24,1,0,2,-2,-100.0
42,24,2,1,4,-3,-75.0
42,24,3,4,8,-4,-50.0
42,24,4,18,16,2,12.5
42,24,5,37,32,5,15.625
42,24,6,68,64,4,6.25
42,24,7,103,128,-25,-19.53125
42,24,8,177,256,-79,-30.859375
42,24,9,122,512,-390,-76.171875
42,24,10,1900,1024,876,85.546875
42,24,11,67,2048,-1981,-96.728515625
42,24,12,12096,4096,8000,195.3125
42,24,13,1666,8192,-6526,-79.6630859375
42,24,14,6649,16384,-9735,-59.417724609375
42,24,15,50487,32768,17719,54.0740966796875
42,25,1,0,2,-2,-100.0
42,25,2,2,4,-2,-50.0
42,25,3,2,8,-6,-75.0
42,25,4,13,16,-3,-18.75
42,25,5,6,32,-26,-81.25
42,25,6,76,64,12,18.75
42,25,7,50,128,-78,-60.9375
42,25,8,73,256,-183,-71.484375
42,25,9,56,512,-456,-89.0625
42,25,10,1068,1024,44,4.296875
42,25,11,57,2048,-1991,-97.216796875
42,25,12,1452,4096,-2644,-64.55078125
42,25,13,6229,8192,-1963,-23.96240234375
42,25,14,1968,16384,-14416,-87.98828125
42,25,15,9150,32768,-23618,-72.076416015625
42,26,1,0,2,-2,-100.0
42,26,2,1,4,-3,-75.0
42,26,3,9,8,1,12.5
42,26,4,3,16,-13,-81.25
42,26,5,52,32,20,62.5
42,26,6,53,64,-11,-17.1875
42,26,7,14,128,-114,-89.0625
42,26,8,32,256,-224,-87.5
42,26,9,1002,512,490,95.703125
42,26,10,3244,1024,2220,216.796875
42,26,11,1180,2048,-868,-42.3828125
42,26,12,2642,4096,-1454,-35.498046875
42,26,13,776,8192,-7416,-90.52734375
42,26,14,5327,16384,-11057,-67.486572265625
42,26,15,7767,32768,-25001,-76.2969970703125
42,27,1,0,2,-2,-100.0
42,27,2,1,4,-3,-75.0
42,27,3,4,8,-4,-50.0
42,27,4,33,16,17,106.25
42,27,5,34,32,2,6.25
42,27,6,137,64,73,114.0625
42,27,7,118,128,-10,-7.8125
42,27,8,513,256,257,100.390625
42,27,9,15,512,-497,-97.0703125
42,27,10,1447,1024,423,41.30859375
42,27,11,908,2048,-1140,-55.6640625
42,27,12,3090,4096,-1006,-24.560546875
42,27,13,1073,8192,-7119,-86.90185546875
42,27,14,4784,16384,-11600,-70.80078125
42,27,15,10368,32768,-22400,-68.359375
42,28,1,0,2,-2,-100.0
42,28,2,2,4,-2,-50.0
42,28,3,18,8,10,125.0
42,28,4,24,16,8,50.0
42,28,5,42,32,10,31.25
42,28,6,14,64,-50,-78.125
42,28,7,62,128,-66,-51.5625
42,28,8,85,256,-171,-66.796875
42,28,9,752,512,240,46.875
42,28,10,232,1024,-792,-77.34375
42,28,11,1523,2048,-525,-25.634765625
42,28,12,3072,4096,-1024,-25.0
42,28,13,2407,8192,-5785,-70.61767578125
42,28,14,34479,16384,18095,110.443115234375
42,28,15,11336,32768,-21432,-65.4052734375
42,29,1,0,2,-2,-100.0
42,29,2,1,4,-3,-75.0
42,29,3,5,8,-3,-37.5
42,29,4,7,16,-9,-56.25
42,29,5,66,32,34,106.25
42,29,6,74,64,10,15.625
42,29,7,51,128,-77,-60.15625
42,29,8,530,256,274,107.03125
42,29,9,652,512,140,27.34375
42,29,10,1534,1024,510,49.8046875
42,29,11,6470,2048,4422,215.91796875
42,29,12,5670,4096,1574,38.427734375
42,29,13,1510,8192,-6682,-81.5673828125
42,29,14,6365,16384,-10019,-61.151123046875
42,29,15,95670,32768,62902,191.961669921875
42,30,1,0,2,-2,-100.0
42,30,2,4,4,0,0.0
42,30,3,8,8,0,0.0
42,30,4,7,16,-9,-56.25
42,30,5,11,32,-21,-65.625
42,30,6,72,64,8,12.5
42,30,7,336,128,208,162.5
42,30,8,20,256,-236,-92.1875
42,30,9,887,512,375,73.2421875
42,30,10,913,1024,-111,-10.83984375
42,30,11,1875,2048,-173,-8.447265625
42,30,12,15051,4096,10955,267.4560546875
42,30,13,5454,8192,-2738,-33.4228515625
42,30,14,4479,16384,-11905,-72.662353515625
42,30,15,4326,32768,-28442,-86.798095703125
42,31,1,0,2,-2,-100.0
42,31,2,4,4,0,0.0
42,31,3,2,8,-6,-75.0
42,31,4,3,16,-13,-81.25
42,31,5,25,32,-7,-21.875
42,31,6,6,64,-58,-90.625
42,31,7,289,128,161,125.78125
42,31,8,312,256,56,21.875
42,31,9,248,512,-264,-51.5625
42,31,10,1376,1024,352,34.375
42,31,11,1178,2048,-870,-42.48046875
42,31,12,3128,4096,-968,-23.6328125
42,31,13,4069,8192,-4123,-50.32958984375
42,31,14,6271,16384,-10113,-61.724853515625
42,31,15,38051,32768,5283,16.1224365234375
42,32,1,0,2,-2,-100.0
42,32,2,1,4,-3,-75.0
42,32,3,11,8,3,37.5
42,32,4,11,16,-5,-31.25
42,32,5,15,32,-17,-53.125
42,32,6,7,64,-57,-89.0625
42,32,7,76,128,-52,-40.625
42,32,8,103,256,-153,-59.765625
42,32,9,626,512,114,22.265625
42,32,10,480,1024,-544,-53.125
42,32,11,544,2048,-1504,-73.4375
42,32,12,5426,4096,1330,32.470703125
42,32,13,197,8192,-7995,-97.59521484375
42,32,14,51459,16384,35075,214.080810546875
42,32,15,5043,32768,-27725,-84.6099853515625
42,33,1,0,2,-2,-100.0
42,33,2,1,4,-3,-75.0
42,33,3,2,8,-6,-75.0
42,33,4,8,16,-8,-50.0
42,33,5,31,32,-1,-3.125
42,33,6,12,64,-52,-81.25
42,33,7,159,128,31,24.21875
42,33,8,445,256,189,73.828125
42,33,9,482,512,-30,-5.859375
42,33,10,41,1024,-983,-95.99609375
42,33,11,6879,2048,4831,235.888671875
42,33,12,6269,4096,2173,53.0517578125
42,33,13,16210,8192,8018,97.8759765625
42,33,14,4387,16384,-11997,-73.223876953125
42,33,15,29406,32768,-3362,-10.260009765625
42,34,1,0,2,-2,-100.0
42,34,2,1,4,-3,-75.0
42,34,3,2,8,-6,-75.0
42,34,4,7,16,-9,-56.25
42,34,5,55,32,23,71.875
42,34,6,81,64,17,26.5625
42,34,7,83,128,-45,-35.15625
42,34,8,142,256,-114,-44.53125
42,34,9,23,512,-489,-95.5078125
42,34,10,132,1024,-892,-87.109375
42,34,11,770,2048,-1278,-62.40234375
42,34,12,2469,4096,-1627,-39.7216796875
42,34,13,14151,8192,5959,72.74169921875
42,34,14,51174,16384,34790,212.34130859375
42,34,15,7024,32768,-25744,-78.564453125
42,35,1,0,2,-2,-100.0
42,35,2,3,4,-1,-25.0
42,35,3,7,8,-1,-12.5
42,35,4,15,16,-1,-6.25
42,35,5,16,32,-16,-50.0
42,35,6,26,64,-38,-59.375
42,35,7,388,128,260,203.125
42,35,8,441,256,185,72.265625
42,35,9,295,512,-217,-42.3828125
42,35,10,230,1024,-794,-77.5390625
42,35,11,2790,2048,742,36.23046875
42,35,12,7734,4096,3638,88.818359375
42,35,13,9980,8192,1788,21.826171875
42,35,14,13788,16384,-2596,-15.8447265625
42,35,15,53206,32768,20438,62.371826171875
42,36,1,0,2,-2,-100.0
42,36,2,1,4,-3,-75.0
42,36,3,2,8,-6,-75.0
42,36,4,9,16,-7,-43.75
42,36,5,5,32,-27,-84.375
42,36,6,178,64,114,178.125
42,36,7,188,128,60,46.875
42,36,8,136,256,-120,-46.875
42,36,9,1762,512,1250,244.140625
42,36,10,241,1024,-783,-76.46484375
42,36,11,660,2048,-1388,-67.7734375
42,36,12,7704,4096,3608,88.0859375
42,36,13,9869,8192,1677,20.47119140625
42,36,14,25525,16384,9141,55.792236328125
42,36,15,117604,32768,84836,258.89892578125
42,37,1,0,2,-2,-100.0
42,37,2,5,4,1,25.0
42,37,3,6,8,-2,-25.0
42,37,4,15,16,-1,-6.25
42,37,5,13,32,-19,-59.375
42,37,6,13,64,-51,-79.6875
42,37,7,179,128,51,39.84375
42,37,8,200,256,-56,-21.875
42,37,9,574,512,62,12.109375
42,37,10,986,1024,-38,-3.7109375
42,37,11,1933,2048,-115,-5.615234375
42,37,12,6776,4096,2680,65.4296875
42,37,13,6773,8192,-1419,-17.32177734375
42,37,14,13273,16384,-3111,-18.988037109375
42,37,15,77002,32768,44234,134.991455078125
42,38,1,0,2,-2,-100.0
42,38,2,1,4,-3,-75.0
42,38,3,2,8,-6,-75.0
42,38,4,6,16,-10,-62.5
42,38,5,4,32,-28,-87.5
42,38,6,16,64,-48,-75.0
42,38,7,48,128,-80,-62.5
42,38,8,396,256,140,54.6875
42,38,9,856,512,344,67.1875
42,38,10,90,1024,-934,-91.2109375
42,38,11,5166,2048,3118,152.24609375
42,38,12,4121,4096,25,0.6103515625
42,38,13,11839,8192,3647,44.51904296875
42,38,14,56454,16384,40070,244.56787109375
42,38,15,5218,32768,-27550,-84.075927734375
42,39,1,0,2,-2,-100.0
42,39,2,1,4,-3,-75.0
42,39,3,2,8,-6,-75.0
42,39,4,11,16,-5,-31.25
42,39,5,10,32,-22,-68.75
42,39,6,26,64,-38,-59.375
42,39,7,180,128,52,40.625
42,39,8,266,256,10,3.90625
42,39,9,43,512,-469,-91.6015625
42,39,10,643,1024,-381,-37.20703125
42,39,11,64,2048,-1984,-96.875
42,39,12,1243,4096,-2853,-69.6533203125
42,39,13,1705,8192,-6487,-79.18701171875
42,39,14,44,16384,-16340,-99.7314453125
42,39,15,33894,32768,1126,3.436279296875
42,40,1,0,2,-2,-100.0
42,40,2,1,4,-3,-75.0
42,40,3,2,8,-6,-75.0
42,40,4,4,16,-12,-75.0
42,40,5,65,32,33,103.125
42,40,6,90,64,26,40.625
42,40,7,31,128,-97,-75.78125
42,40,8,162,256,-94,-36.71875
42,40,9,73,512,-439,-85.7421875
42,40,10,481,1024,-543,-53.02734375
42,40,11,1293,2048,-755,-36.865234375
42,40,12,6495,4096,2399,58.5693359375
42,40,13,10266,8192,2074,25.3173828125
42,40,14,23177,16384,6793,41.461181640625
42,40,15,78563,32768,45795,139.7552490234375
42,41,1,0,2,-2,-100.0
42,41,2,1,4,-3,-75.0
42,41,3,2,8,-6,-75.0
42,41,4,7,16,-9,-56.25
42,41,5,20,32,-12,-37.5
42,41,6,19,64,-45,-70.3125
42,41,7,19,128,-109,-85.15625
42,41,8,499,256,243,94.921875
42,41,9,165,512,-347,-67.7734375
42,41,10,1187,1024,163,15.91796875
42,41,11,1683,2048,-365,-17.822265625
42,41,12,10324,4096,6228,152.05078125
42,41,13,3034,8192,-5158,-62.9638671875
42,41,14,12110,16384,-4274,-26.08642578125
42,41,15,9448,32768,-23320,-71.1669921875
42,42,1,0,2,-2,-100.0
42,42,2,1,4,-3,-75.0
42,42,3,3,8,-5,-62.5
42,42,4,3,16,-13,-81.25
42,42,5,49,32,17,53.125
42,42,6,86,64,22,34.375
42,42,7,86,128,-42,-32.8125
42,42,8,843,256,587,229.296875
42,42,9,881,512,369,72.0703125
42,42,10,756,1024,-268,-26.171875
42,42,11,4439,2048,2391,116.748046875
42,42,12,2841,4096,-1255,-30.6396484375
42,42,13,1811,8192,-6381,-77.89306640625
42,42,14,16703,16384,319,1.947021484375
42,42,15,120030,32768,87262,266.302490234375
43,1,1,0,2,-2,-100.0
43,1,2,1,4,-3,-75.0
43,1,3,4,8,-4,-50.0
43,1,4,10,16,-6,-37.5
43,1,5,13,32,-19,-59.375
43,1,6,58,64,-6,-9.375
43,1,7,77,128,-51,-39.84375
43,1,8,262,256,6,2.34375
43,1,9,1200,512,688,134.375
43,1,10,110,1024,-914,-89.2578125
43,1,11,1246,2048,-802,-39.16015625
43,1,12,13191,4096,9095,222.0458984375
43,1,13,17310,8192,9118,111.3037109375
43,1,14,4787,16384,-11597,-70.782470703125
43,1,15,31868,32768,-900,-2.74658203125
43,2,1,0,2,-2,-100.0
43,2,2,1,4,-3,-75.0
43,2,3,5,8,-3,-37.5
43,2,4,4,16,-12,-75.0
43,2,5,32,32,0,0.0
43,2,6,50,64,-14,-21.875
43,2,7,50,128,-78,-60.9375
43,2,8,292,256,36,14.0625
43,2,9,43,512,-469,-91.6015625
43,2,10,1607,1024,583,56.93359375
43,2,11,1024,2048,-1024,-50.0
43,2,12,5009,4096,913,22.2900390625
43,2,13,4860,8192,-3332,-40.673828125
43,2,14,56946,16384,40562,247.57080078125
43,2,15,22,32768,-32746,-99.932861328125
43,3,1,0,2,-2,-100.0
43,3,2,2,4,-2,-50.0
43,3,3,4,8,-4,-50.0
43,3,4,6,16,-10,-62.5
43,3,5,4,32,-28,-87.5
43,3,6,108,64,44,68.75
43,3,7,20,128,-108,-84.375
43,3,8,226,256,-30,-11.71875
43,3,9,206,512,-306,-59.765625
43,3,10,524,1024,-500,-48.828125
43,3,11,2687,2048,639,31.201171875
43,3,12,5376,4096,1280,31.25
43,3,13,4125,8192,-4067,-49.64599609375
43,3,14,22903,16384,6519,39.788818359375
43,3,15,15722,32768,-17046,-52.020263671875
43,4,1,0,2,-2,-100.0
43,4,2,1,4,-3,-75.0
43,4,3,3,8,-5,-62.5
43,4,4,9,16,-7,-43.75
43,4,5,66,32,34,106.25
43,4,6,38,64,-26,-40.625
43,4,7,49,128,-79,-61.71875
43,4,8,207,256,-49,-19.140625
43,4,9,353,512,-159,-31.0546875
43,4,10,279,1024,-745,-72.75390625
43,4,11,11584,2048,9536,465.625
43,4,12,3971,4096,-125,-3.0517578125
43,4,13,21014,8192,12822,156.5185546875
43,4,14,430,16384,-15954,-97.37548828125
43,4,15,33723,32768,955,2.9144287109375
43,5,1,0,2,-2,-100.0
43,5,2,1,4,-3,-75.0
43,5,3,2,8,-6,-75.0
43,5,4,10,16,-6,-37.5
43,5,5,6,32,-26,-81.25
43,5,6,195,64,131,204.6875
43,5,7,34,128,-94,-73.4375
43,5,8,271,256,15,5.859375
43,5,9,1082,512,570,111.328125
43,5,10,1006,1024,-18,-1.7578125
43,5,11,3111,2048,1063,51.904296875
43,5,12,1413,4096,-2683,-65.5029296875
43,5,13,3360,8192,-4832,-58.984375
43,5,14,2917,16384,-13467,-82.196044921875
43,5,15,46007,32768,13239,40.4022216796875
43,6,1,0,2,-2,-100.0
43,6,2,1,4,-3,-75.0
43,6,3,5,8,-3,-37.5
43,6,4,24,16,8,50.0
43,6,5,39,32,7,21.875
43,6,6,115,64,51,79.6875
43,6,7,445,128,317,247.65625
43,6,8,291,256,35,13.671875
43,6,9,593,512,81,15.8203125
43,6,10,399,1024,-625,-61.03515625
43,6,11,1780,2048,-268,-13.0859375
43,6,12,918,4096,-3178,-77.587890625
43,6,13,10744,8192,2552,31.15234375
43,6,14,12308,16384,-4076,-24.8779296875
43,6,15,47282,32768,14514,44.293212890625
43,7,1,0,2,-2,-100.0
43,7,2,1,4,-3,-75.0
43,7,3,7,8,-1,-12.5
43,7,4,23,16,7,43.75
43,7,5,28,32,-4,-12.5
43,7,6,39,64,-25,-39.0625
43,7,7,17,128,-111,-86.71875
43,7,8,45,256,-211,-82.421875
43,7,9,139,512,-373,-72.8515625
43,7,10,19,1024,-1005,-98.14453125
43,7,11,5164,2048,3116,152.1484375
43,7,12,3050,4096,-1046,-25.537109375
43,7,13,428,8192,-7764,-94.775390625
43,7,14,835,16384,-15549,-94.903564453125
43,7,15,49495,32768,16727,51.0467529296875
43,8,1,0,2,-2,-100.0
43,8,2,1,4,-3,-75.0
43,8,3,2,8,-6,-75.0
43,8,4,6,16,-10,-62.5
43,8,5,82,32,50,156.25
43,8,6,28,64,-36,-56.25
43,8,7,160,128,32,25.0
43,8,8,628,256,372,145.3125
43,8,9,833,512,321,62.6953125
43,8,10,550,1024,-474,-46.2890625
43,8,11,1259,2048,-789,-38.525390625
43,8,12,7682,4096,3586,87.548828125
43,8,13,17280,8192,9088,110.9375
43,8,14,6973,16384,-9411,-57.440185546875
43,8,15,100514,32768,67746,206.744384765625
43,9,1,0,2,-2,-100.0
43,9,2,1,4,-3,-75.0
43,9,3,3,8,-5,-62.5
43,9,4,23,16,7,43.75
43,9,5,15,32,-17,-53.125
43,9,6,15,64,-49,-76.5625
43,9,7,57,128,-71,-55.46875
43,9,8,464,256,208,81.25
43,9,9,641,512,129,25.1953125
43,9,10,248,1024,-776,-75.78125
43,9,11,1801,2048,-247,-12.060546875
43,9,12,1859,4096,-2237,-54.6142578125
43,9,13,8650,8192,458,5.5908203125
43,9,14,28058,16384,11674,71.25244140625
43,9,15,35811,32768,3043,9.2864990234375
43,10,1,0,2,-2,-100.0
43,10,2,1,4,-3,-75.0
43,10,3,15,8,7,87.5
43,10,4,34,16,18,112.5
43,10,5,39,32,7,21.875
43,10,6,67,64,3,4.6875
43,10,7,155,128,27,21.09375
43,10,8,399,256,143,55.859375
43,10,9,215,512,-297,-58.0078125
43,10,10,125,1024,-899,-87.79296875
43,10,11,185,2048,-1863,-90.966796875
43,10,12,3416,4096,-680,-16.6015625
43,10,13,13476,8192,5284,64.501953125
43,10,14,10668,16384,-5716,-34.8876953125
43,10,15,2189,32768,-30579,-93.3197021484375
43,11,1,0,2,-2,-100.0
43,11,2,2,4,-2,-50.0
43,11,3,5,8,-3,-37.5
43,11,4,10,16,-6,-37.5
43,11,5,7,32,-25,-78.125
43,11,6,70,64,6,9.375
43,11,7,12,128,-116,-90.625
43,11,8,426,256,170,66.40625
43,11,9,485,512,-27,-5.2734375
43,11,10,847,1024,-177,-17.28515625
43,11,11,2066,2048,18,0.87890625
43,11,12,1092,4096,-3004,-73.33984375
43,11,13,2115,8192,-6077,-74.18212890625
43,11,14,6680,16384,-9704,-59.228515625
43,11,15,4460,32768,-28308,-86.38916015625
43,12,1,0,2,-2,-100.0
43,12,2,6,4,2,50.0
43,12,3,5,8,-3,-37.5
43,12,4,7,16,-9,-56.25
43,12,5,15,32,-17,-53.125
43,12,6,128,64,64,100.0
43,12,7,85,128,-43,-33.59375
43,12,8,46,256,-210,-82.03125
43,12,9,105,512,-407,-79.4921875
43,12,10,348,1024,-676,-66.015625
43,12,11,627,2048,-1421,-69.384765625
43,12,12,3025,4096,-1071,-26.1474609375
43,12,13,9663,8192,1471,17.95654296875
43,12,14,7217,16384,-9167,-55.950927734375
43,12,15,16774,32768,-15994,-48.809814453125
43,13,1,0,2,-2,-100.0
43,13,2,7,4,3,75.0
43,13,3,4,8,-4,-50.0
43,13,4,9,16,-7,-43.75
43,13,5,27,32,-5,-15.625
43,13,6,44,64,-20,-31.25
43,13,7,179,128,51,39.84375
43,13,8,166,256,-90,-35.15625
43,13,9,381,512,-131,-25.5859375
43,13,10,2412,1024,1388,135.546875
43,13,11,1112,2048,-936,-45.703125
43,13,12,1937,4096,-2159,-52.7099609375
43,13,13,588,8192,-7604,-92.822265625
43,13,14,841,16384,-15543,-94.866943359375
43,13,15,5118,32768,-27650,-84.381103515625
43,14,1,0,2,-2,-100.0
43,14,2,1,4,-3,-75.0
43,14,3,2,8,-6,-75.0
43,14,4,10,16,-6,-37.5
43,14,5,15,32,-17,-53.125
43,14,6,10,64,-54,-84.375
43,14,7,416,128,288,225.0
43,14,8,94,256,-162,-63.28125
43,14,9,533,512,21,4.1015625
43,14,10,1947,1024,923,90.13671875
43,14,11,2523,2048,475,23.193359375
43,14,12,12119,4096,8023,195.8740234375
43,14,13,1211,8192,-6981,-85.21728515625
43,14,14,46670,16384,30286,184.85107421875
43,14,15,48264,32768,15496,47.2900390625
43,15,1,0,2,-2,-100.0
43,15,2,3,4,-1,-25.0
43,15,3,3,8,-5,-62.5
43,15,4,21,16,5,31.25
43,15,5,23,32,-9,-28.125
43,15,6,19,64,-45,-70.3125
43,15,7,236,128,108,84.375
43,15,8,182,256,-74,-28.90625
43,15,9,901,512,389,75.9765625
43,15,10,1027,1024,3,0.29296875
43,15,11,1275,2048,-773,-37.744140625
43,15,12,2520,4096,-1576,-38.4765625
43,15,13,5114,8192,-3078,-37.5732421875
43,15,14,23371,16384,6987,42.645263671875
43,15,15,5853,32768,-26915,-82.1380615234375
43,16,1,0,2,-2,-100.0
43,16,2,1,4,-3,-75.0
43,16,3,8,8,0,0.0
43,16,4,3,16,-13,-81.25
43,16,5,42,32,10,31.25
43,16,6,10,64,-54,-84.375
43,16,7,44,128,-84,-65.625
43,16,8,403,256,147,57.421875
43,16,9,716,512,204,39.84375
43,16,10,1225,1024,201,19.62890625
43,16,11,1132,2048,-916,-44.7265625
43,16,12,576,4096,-3520,-85.9375
43,16,13,14024,8192,5832,71.19140625
43,16,14,13231,16384,-3153,-19.244384765625
43,16,15,31827,32768,-941,-2.8717041015625
43,17,1,0,2,-2,-100.0
43,17,2,1,4,-3,-75.0
43,17,3,2,8,-6,-75.0
43,17,4,23,16,7,43.75
43,17,5,7,32,-25,-78.125
43,17,6,15,64,-49,-76.5625
43,17,7,10,128,-118,-92.1875
43,17,8,408,256,152,59.375
43,17,9,360,512,-152,-29.6875
43,17,10,3191,1024,2167,211.62109375
43,17,11,1131,2048,-917,-44.775390625
43,17,12,8309,4096,4213,102.8564453125
43,17,13,653,8192,-7539,-92.02880859375
43,17,14,12906,16384,-3478,-21.22802734375
43,17,15,23617,32768,-9151,-27.9266357421875
43,18,1,0,2,-2,-100.0
43,18,2,1,4,-3,-75.0
43,18,3,5,8,-3,-37.5
43,18,4,4,16,-12,-75.0
43,18,5,40,32,8,25.0
43,18,6,7,64,-57,-89.0625
43,18,7,378,128,250,195.3125
43,18,8,347,256,91,35.546875
43,18,9,109,512,-403,-78.7109375
43,18,10,1074,1024,50,4.8828125
43,18,11,62,2048,-1986,-96.97265625
43,18,12,3812,4096,-284,-6.93359375
43,18,13,8571,8192,379,4.62646484375
43,18,14,15917,16384,-467,-2.850341796875
43,18,15,7121,32768,-25647,-78.2684326171875
43,19,1,0,2,-2,-100.0
43,19,2,2,4,-2,-50.0
43,19,3,2,8,-6,-75.0
43,19,4,10,16,-6,-37.5
43,19,5,10,32,-22,-68.75
43,19,6,12,64,-52,-81.25
43,19,7,278,128,150,117.1875
43,19,8,177,256,-79,-30.859375
43,19,9,817,512,305,59.5703125
43,19,10,168,1024,-856,-83.59375
43,19,11,393,2048,-1655,-80.810546875
43,19,12,2170,4096,-1926,-47.021484375
43,19,13,12369,8192,4177,50.98876953125
43,19,14,13938,16384,-2446,-14.92919921875
43,19,15,20560,32768,-12208,-37.255859375
43,20,1,0,2,-2,-100.0
43,20,2,1,4,-3,-75.0
43,20,3,3,8,-5,-62.5
43,20,4,6,16,-10,-62.5
43,20,5,18,32,-14,-43.75
43,20,6,66,64,2,3.125
43,20,7,8,128,-120,-93.75
43,20,8,450,256,194,75.78125
43,20,9,836,512,324,63.28125
43,20,10,38,1024,-986,-96.2890625
43,20,11,1595,2048,-453,-22.119140625
43,20,12,716,4096,-3380,-82.51953125
43,20,13,8692,8192,500,6.103515625
43,20,14,2170,16384,-14214,-86.75537109375
43,20,15,7394,32768,-25374,-77.435302734375
43,21,1,0,2,-2,-100.0
43,21,2,4,4,0,0.0
43,21,3,5,8,-3,-37.5
43,21,4,24,16,8,50.0
43,21,5,10,32,-22,-68.75
43,21,6,11,64,-53,-82.8125
43,21,7,184,128,56,43.75
43,21,8,653,256,397,155.078125
43,21,9,273,512,-239,-46.6796875
43,21,10,319,1024,-705,-68.84765625
43,21,11,7268,2048,5220,254.8828125
43,21,12,4960,4096,864,21.09375
43,21,13,1861,8192,-6331,-77.28271484375
43,21,14,1025,16384,-15359,-93.743896484375
43,21,15,47599,32768,14831,45.2606201171875
43,22,1,0,2,-2,-100.0
43,22,2,2,4,-2,-50.0
43,22,3,2,8,-6,-75.0
43,22,4,3,16,-13,-81.25
43,22,5,13,32,-19,-59.375
43,22,6,24,64,-40,-62.5
43,22,7,57,128,-71,-55.46875
43,22,8,159,256,-97,-37.890625
43,22,9,41,512,-471,-91.9921875
43,22,10,341,1024,-683,-66.69921875
43,22,11,464,2048,-1584,-77.34375
43,22,12,374,4096,-3722,-90.869140625
43,22,13,2637,8192,-5555,-67.81005859375
43,22,14,18721,16384,2337,14.263916015625
43,22,15,5283,32768,-27485,-83.8775634765625
43,23,1,0,2,-2,-100.0
43,23,2,2,4,-2,-50.0
43,23,3,3,8,-5,-62.5
43,23,4,4,16,-12,-75.0
43,23,5,19,32,-13,-40.625
43,23,6,9,64,-55,-85.9375
43,23,7,164,128,36,28.125
43,23,8,168,256,-88,-34.375
43,23,9,299,512,-213,-41.6015625
43,23,10,546,1024,-478,-46.6796875
43,23,11,1390,2048,-658,-32.12890625
43,23,12,26,4096,-4070,-99.365234375
43,23,13,6856,8192,-1336,-16.30859375
43,23,14,12995,16384,-3389,-20.684814453125
43,23,15,10378,32768,-22390,-68.328857421875
43,24,1,0,2,-2,-100.0
43,24,2,2,4,-2,-50.0
43,24,3,2,8,-6,-75.0
43,24,4,9,16,-7,-43.75
43,24,5,40,32,8,25.0
43,24,6,7,64,-57,-89.0625
43,24,7,361,128,233,182.03125
43,24,8,1210,256,954,372.65625
43,24,9,306,512,-206,-40.234375
43,24,10,543,1024,-481,-46.97265625
43,24,11,1156,2048,-892,-43.5546875
43,24,12,1220,4096,-2876,-70.21484375
43,24,13,11913,8192,3721,45.42236328125
43,24,14,43710,16384,27326,166.78466796875
43,24,15,1979,32768,-30789,-93.9605712890625
43,25,1,0,2,-2,-100.0
43,25,2,6,4,2,50.0
43,25,3,5,8,-3,-37.5
43,25,4,18,16,2,12.5
43,25,5,42,32,10,31.25
43,25,6,25,64,-39,-60.9375
43,25,7,45,128,-83,-64.84375
43,25,8,38,256,-218,-85.15625
43,25,9,1397,512,885,172.8515625
43,25,10,1608,1024,584,57.03125
43,25,11,420,2048,-1628,-79.4921875
43,25,12,1781,4096,-2315,-56.5185546875
43,25,13,161,8192,-8031,-98.03466796875
43,25,14,2313,16384,-14071,-85.882568359375
43,25,15,32614,32768,-154,-0.469970703125
43,26,1,0,2,-2,-100.0
43,26,2,4,4,0,0.0
43,26,3,7,8,-1,-12.5
43,26,4,13,16,-3,-18.75
43,26,5,40,32,8,25.0
43,26,6,148,64,84,131.25
43,26,7,131,128,3,2.34375
43,26,8,48,256,-208,-81.25
43,26,9,1266,512,754,147.265625
43,26,10,171,1024,-853,-83.30078125
43,26,11,3190,2048,1142,55.76171875
43,26,12,507,4096,-3589,-87.6220703125
43,26,13,846,8192,-7346,-89.6728515625
43,26,14,10204,16384,-6180,-37.7197265625
43,26,15,55371,32768,22603,68.9788818359375
43,27,1,0,2,-2,-100.0
43,27,2,5,4,1,25.0
43,27,3,4,8,-4,-50.0
43,27,4,12,16,-4,-25.0
43,27,5,11,32,-21,-65.625
43,27,6,21,64,-43,-67.1875
43,27,7,10,128,-118,-92.1875
43,27,8,139,256,-117,-45.703125
43,27,9,420,512,-92,-17.96875
43,27,10,41,1024,-983,-95.99609375
43,27,11,931,2048,-1117,-54.541015625
43,27,12,2493,4096,-1603,-39.1357421875
43,27,13,9124,8192,932,11.376953125
43,27,14,3638,16384,-12746,-77.79541015625
43,27,15,35067,32768,2299,7.0159912109375
43,28,1,0,2,-2,-100.0
43,28,2,3,4,-1,-25.0
43,28,3,7,8,-1,-12.5
43,28,4,45,16,29,181.25
43,28,5,13,32,-19,-59.375
43,28,6,132,64,68,106.25
43,28,7,369,128,241,188.28125
43,28,8,101,256,-155,-60.546875
43,28,9,200,512,-312,-60.9375
43,28,10,219,1024,-805,-78.61328125
43,28,11,692,2048,-1356,-66.2109375
43,28,12,775,4096,-3321,-81.0791015625
43,28,13,7046,8192,-1146,-13.9892578125
43,28,14,9549,16384,-6835,-41.717529296875
43,28,15,14930,32768,-17838,-54.437255859375
43,29,1,0,2,-2,-100.0
43,29,2,1,4,-3,-75.0
43,29,3,14,8,6,75.0
43,29,4,13,16,-3,-18.75
43,29,5,28,32,-4,-12.5
43,29,6,98,64,34,53.125
43,29,7,81,128,-47,-36.71875
43,29,8,307,256,51,19.921875
43,29,9,1262,512,750,146.484375
43,29,10,29,1024,-995,-97.16796875
43,29,11,1443,2048,-605,-29.541015625
43,29,12,2683,4096,-1413,-34.4970703125
43,29,13,22684,8192,14492,176.904296875
43,29,14,13658,16384,-2726,-16.63818359375
43,29,15,35684,32768,2916,8.89892578125
43,30,1,0,2,-2,-100.0
43,30,2,2,4,-2,-50.0
43,30,3,17,8,9,112.5
43,30,4,30,16,14,87.5
43,30,5,118,32,86,268.75
43,30,6,40,64,-24,-37.5
43,30,7,733,128,605,472.65625
43,30,8,590,256,334,130.46875
43,30,9,350,512,-162,-31.640625
43,30,10,2014,1024,990,96.6796875
43,30,11,517,2048,-1531,-74.755859375
43,30,12,3539,4096,-557,-13.5986328125
43,30,13,6840,8192,-1352,-16.50390625
43,30,14,2321,16384,-14063,-85.833740234375
43,30,15,54572,32768,21804,66.54052734375
43,31,1,0,2,-2,-100.0
43,31,2,1,4,-3,-75.0
43,31,3,6,8,-2,-25.0
43,31,4,5,16,-11,-68.75
43,31,5,15,32,-17,-53.125
43,31,6,108,64,44,68.75
43,31,7,206,128,78,60.9375
43,31,8,360,256,104,40.625
43,31,9,656,512,144,28.125
43,31,10,1727,1024,703,68.65234375
43,31,11,383,2048,-1665,-81.298828125
43,31,12,2715,4096,-1381,-33.7158203125
43,31,13,25140,8192,16948,206.884765625
43,31,14,10607,16384,-5777,-35.260009765625
43,31,15,2071,32768,-30697,-93.6798095703125
43,32,1,0,2,-2,-100.0
43,32,2,4,4,0,0.0
43,32,3,2,8,-6,-75.0
43,32,4,37,16,21,131.25
43,32,5,21,32,-11,-34.375
43,32,6,74,64,10,15.625
43,32,7,42,128,-86,-67.1875
43,32,8,284,256,28,10.9375
43,32,9,647,512,135,26.3671875
43,32,10,2350,1024,1326,129.4921875
43,32,11,3985,2048,1937,94.580078125
43,32,12,3877,4096,-219,-5.3466796875
43,32,13,7255,8192,-937,-11.43798828125
43,32,14,7143,16384,-9241,-56.402587890625
43,32,15,435,32768,-32333,-98.6724853515625
43,33,1,0,2,-2,-100.0
43,33,2,2,4,-2,-50.0
43,33,3,2,8,-6,-75.0
43,33,4,12,16,-4,-25.0
43,33,5,21,32,-11,-34.375
43,33,6,78,64,14,21.875
43,33,7,45,128,-83,-64.84375
43,33,8,225,256,-31,-12.109375
43,33,9,226,512,-286,-55.859375
43,33,10,956,1024,-68,-6.640625
43,33,11,1886,2048,-162,-7.91015625
43,33,12,3181,4096,-915,-22.3388671875
43,33,13,8200,8192,8,0.09765625
43,33,14,10119,16384,-6265,-38.238525390625
43,33,15,11808,32768,-20960,-63.96484375
43,34,1,0,2,-2,-100.0
43,34,2,2,4,-2,-50.0
43,34,3,7,8,-1,-12.5
43,34,4,20,16,4,25.0
43,34,5,140,32,108,337.5
43,34,6,53,64,-11,-17.1875
43,34,7,91,128,-37,-28.90625
43,34,8,21,256,-235,-91.796875
43,34,9,185,512,-327,-63.8671875
43,34,10,3034,1024,2010,196.2890625
43,34,11,1331,2048,-717,-35.009765625
43,34,12,1684,4096,-2412,-58.88671875
43,34,13,8619,8192,427,5.21240234375
43,34,14,4941,16384,-11443,-69.842529296875
43,34,15,45621,32768,12853,39.2242431640625
43,35,1,0,2,-2,-100.0
43,35,2,3,4,-1,-25.0
43,35,3,19,8,11,137.5
43,35,4,6,16,-10,-62.5
43,35,5,79,32,47,146.875
43,35,6,24,64,-40,-62.5
43,35,7,8,128,-120,-93.75
43,35,8,11,256,-245,-95.703125
43,35,9,98,512,-414,-80.859375
43,35,10,107,1024,-917,-89.55078125
43,35,11,2681,2048,633,30.908203125
43,35,12,760,4096,-3336,-81.4453125
43,35,13,5402,8192,-2790,-34.0576171875
43,35,14,22066,16384,5682,34.68017578125
43,35,15,35357,32768,2589,7.9010009765625
43,36,1,0,2,-2,-100.0
43,36,2,3,4,-1,-25.0
43,36,3,5,8,-3,-37.5
43,36,4,14,16,-2,-12.5
43,36,5,50,32,18,56.25
43,36,6,28,64,-36,-56.25
43,36,7,510,128,382,298.4375
43,36,8,121,256,-135,-52.734375
43,36,9,386,512,-126,-24.609375
43,36,10,1166,1024,142,13.8671875
43,36,11,272,2048,-1776,-86.71875
43,36,12,3744,4096,-352,-8.59375
43,36,13,9613,8192,1421,17.34619140625
43,36,14,13631,16384,-2753,-16.802978515625
43,36,15,57130,32768,24362,74.346923828125
43,37,1,0,2,-2,-100.0
43,37,2,1,4,-3,-75.0
43,37,3,10,8,2,25.0
43,37,4,7,16,-9,-56.25
43,37,5,67,32,35,109.375
43,37,6,201,64,137,214.0625
43,37,7,253,128,125,97.65625
43,37,8,316,256,60,23.4375
43,37,9,262,512,-250,-48.828125
43,37,10,170,1024,-854,-83.3984375
43,37,11,5051,2048,3003,146.630859375
43,37,12,2357,4096,-1739,-42.4560546875
43,37,13,18953,8192,10761,131.35986328125
43,37,14,4490,16384,-11894,-72.59521484375
43,37,15,137225,32768,104457,318.7774658203125
43,38,1,0,2,-2,-100.0
43,38,2,6,4,2,50.0
43,38,3,4,8,-4,-50.0
43,38,4,23,16,7,43.75
43,38,5,4,32,-28,-87.5
43,38,6,11,64,-53,-82.8125
43,38,7,73,128,-55,-42.96875
43,38,8,114,256,-142,-55.46875
43,38,9,203,512,-309,-60.3515625
43,38,10,405,1024,-619,-60.44921875
43,38,11,761,2048,-1287,-62.841796875
43,38,12,11096,4096,7000,170.8984375
43,38,13,10341,8192,2149,26.23291015625
43,38,14,31832,16384,15448,94.287109375
43,38,15,13373,32768,-19395,-59.1888427734375
43,39,1,0,2,-2,-100.0
43,39,2,4,4,0,0.0
43,39,3,11,8,3,37.5
43,39,4,25,16,9,56.25
43,39,5,18,32,-14,-43.75
43,39,6,76,64,12,18.75
43,39,7,223,128,95,74.21875
43,39,8,54,256,-202,-78.90625
43,39,9,219,512,-293,-57.2265625
43,39,10,1521,1024,497,48.53515625
43,39,11,1627,2048,-421,-20.556640625
43,39,12,45,4096,-4051,-98.9013671875
43,39,13,13540,8192,5348,65.283203125
43,39,14,6058,16384,-10326,-63.02490234375
43,39,15,43299,32768,10531,32.1380615234375
43,40,1,0,2,-2,-100.0
43,40,2,4,4,0,0.0
43,40,3,3,8,-5,-62.5
43,40,4,20,16,4,25.0
43,40,5,22,32,-10,-31.25
43,40,6,25,64,-39,-60.9375
43,40,7,290,128,162,126.5625
43,40,8,62,256,-194,-75.78125
43,40,9,818,512,306,59.765625
43,40,10,495,1024,-529,-51.66015625
43,40,11,26,2048,-2022,-98.73046875
43,40,12,1988,4096,-2108,-51.46484375
43,40,13,6112,8192,-2080,-25.390625
43,40,14,24439,16384,8055,49.163818359375
43,40,15,39101,32768,6333,19.3267822265625
43,41,1,0,2,-2,-100.0
43,41,2,3,4,-1,-25.0
43,41,3,2,8,-6,-75.0
43,41,4,5,16,-11,-68.75
43,41,5,15,32,-17,-53.125
43,41,6,60,64,-4,-6.25
43,41,7,118,128,-10,-7.8125
43,41,8,81,256,-175,-68.359375
43,41,9,2332,512,1820,355.46875
43,41,10,717,1024,-307,-29.98046875
43,41,11,6370,2048,4322,211.03515625
43,41,12,1955,4096,-2141,-52.2705078125
43,41,13,3349,8192,-4843,-59.11865234375
43,41,14,26025,16384,9641,58.843994140625
43,41,15,72229,32768,39461,120.4254150390625
43,42,1,0,2,-2,-100.0
43,42,2,1,4,-3,-75.0
43,42,3,4,8,-4,-50.0
43,42,4,12,16,-4,-25.0
43,42,5,40,32,8,25.0
43,42,6,130,64,66,103.125
43,42,7,310,128,182,142.1875
43,42,8,74,256,-182,-71.09375
43,42,9,116,512,-396,-77.34375
43,42,10,406,1024,-618,-60.3515625
43,42,11,2034,2048,-14,-0.68359375
43,42,12,166,4096,-3930,-95.947265625
43,42,13,3231,8192,-4961,-60.55908203125
43,42,14,368,16384,-16016,-97.75390625
43,42,15,16917,32768,-15851,-48.3734130859375
43,43,1,0,2,-2,-100.0
43,43,2,1,4,-3,-75.0
43,43,3,8,8,0,0.0
43,43,4,33,16,17,106.25
43,43,5,51,32,19,59.375
43,43,6,100,64,36,56.25
43,43,7,16,128,-112,-87.5
43,43,8,10,256,-246,-96.09375
43,43,9,282,512,-230,-44.921875
43,43,10,501,1024,-523,-51.07421875
43,43,11,1882,2048,-166,-8.10546875
43,43,12,4141,4096,45,1.0986328125
43,43,13,8094,8192,-98,-1.1962890625
43,43,14,6590,16384,-9794,-59.77783203125
43,43,15,49808,32768,17040,52.001953125
44,1,1,0,2,-2,-100.0
44,1,2,1,4,-3,-75.0
44,1,3,2,8,-6,-75.0
44,1,4,7,16,-9,-56.25
44,1,5,21,32,-11,-34.375
44,1,6,13,64,-51,-79.6875
44,1,7,220,128,92,71.875
44,1,8,90,256,-166,-64.84375
44,1,9,1658,512,1146,223.828125
44,1,10,139,1024,-885,-86.42578125
44,1,11,4315,2048,2267,110.693359375
44,1,12,2229,4096,-1867,-45.5810546875
44,1,13,903,8192,-7289,-88.97705078125
44,1,14,2616,16384,-13768,-84.033203125
44,1,15,110991,32768,78223,238.7176513671875
44,2,1,0,2,-2,-100.0
44,2,2,1,4,-3,-75.0
44,2,3,4,8,-4,-50.0
44,2,4,8,16,-8,-50.0
44,2,5,9,32,-23,-71.875
44,2,6,63,64,-1,-1.5625
44,2,7,214,128,86,67.1875
44,2,8,708,256,452,176.5625
44,2,9,66,512,-446,-87.109375
44,2,10,415,1024,-609,-59.47265625
44,2,11,4317,2048,2269,110.791015625
44,2,12,199,4096,-3897,-95.1416015625
44,2,13,796,8192,-7396,-90.283203125
44,2,14,4212,16384,-12172,-74.2919921875
44,2,15,9541,32768,-23227,-70.8831787109375
44,3,1,0,2,-2,-100.0
44,3,2,2,4,-2,-50.0
44,3,3,2,8,-6,-75.0
44,3,4,26,16,10,62.5
44,3,5,25,32,-7,-21.875
44,3,6,50,64,-14,-21.875
44,3,7,125,128,-3,-2.34375
44,3,8,22,256,-234,-91.40625
44,3,9,1631,512,1119,218.5546875
44,3,10,924,1024,-100,-9.765625
44,3,11,430,2048,-1618,-79.00390625
44,3,12,1596,4096,-2500,-61.03515625
44,3,13,8799,8192,607,7.40966796875
44,3,14,14686,16384,-1698,-10.36376953125
44,3,15,8160,32768,-24608,-75.09765625
44,4,1,0,2,-2,-100.0
44,4,2,1,4,-3,-75.0
44,4,3,2,8,-6,-75.0
44,4,4,11,16,-5,-31.25
44,4,5,21,32,-11,-34.375
44,4,6,100,64,36,56.25
44,4,7,74,128,-54,-42.1875
44,4,8,164,256,-92,-35.9375
44,4,9,489,512,-23,-4.4921875
44,4,10,612,1024,-412,-40.234375
44,4,11,492,2048,-1556,-75.9765625
44,4,12,3239,4096,-857,-20.9228515625
44,4,13,2367,8192,-5825,-71.10595703125
44,4,14,9198,16384,-7186,-43.85986328125
44,4,15,31534,32768,-1234,-3.765869140625
44,5,1,0,2,-2,-100.0
44,5,2,2,4,-2,-50.0
44,5,3,6,8,-2,-25.0
44,5,4,13,16,-3,-18.75
44,5,5,6,32,-26,-81.25
44,5,6,20,64,-44,-68.75
44,5,7,130,128,2,1.5625
44,5,8,465,256,209,81.640625
44,5,9,798,512,286,55.859375
44,5,10,2687,1024,1663,162.40234375
44,5,11,1015,2048,-1033,-50.439453125
44,5,12,1588,4096,-2508,-61.23046875
44,5,13,2347,8192,-5845,-71.35009765625
44,5,14,7822,16384,-8562,-52.25830078125
44,5,15,26441,32768,-6327,-19.3084716796875
44,6,1,0,2,-2,-100.0
44,6,2,4,4,0,0.0
44,6,3,5,8,-3,-37.5
44,6,4,3,16,-13,-81.25
44,6,5,22,32,-10,-31.25
44,6,6,84,64,20,31.25
44,6,7,46,128,-82,-64.0625
44,6,8,773,256,517,201.953125
44,6,9,137,512,-375,-73.2421875
44,6,10,222,1024,-802,-78.3203125
44,6,11,757,2048,-1291,-63.037109375
44,6,12,4054,4096,-42,-1.025390625
44,6,13,1384,8192,-6808,-83.10546875
44,6,14,1181,16384,-15203,-92.791748046875
44,6,15,43912,32768,11144,34.0087890625
44,7,1,0,2,-2,-100.0
44,7,2,1,4,-3,-75.0
44,7,3,4,8,-4,-50.0
44,7,4,14,16,-2,-12.5
44,7,5,41,32,9,28.125
44,7,6,6,64,-58,-90.625
44,7,7,292,128,164,128.125
44,7,8,18,256,-238,-92.96875
44,7,9,316,512,-196,-38.28125
44,7,10,265,1024,-759,-74.12109375
44,7,11,558,2048,-1490,-72.75390625
44,7,12,3481,4096,-615,-15.0146484375
44,7,13,6154,8192,-2038,-24.8779296875
44,7,14,26077,16384,9693,59.161376953125
44,7,15,22292,32768,-10476,-31.97021484375
44,8,1,0,2,-2,-100.0
44,8,2,2,4,-2,-50.0
44,8,3,2,8,-6,-75.0
44,8,4,10,16,-6,-37.5
44,8,5,8,32,-24,-75.0
44,8,6,32,64,-32,-50.0
44,8,7,56,128,-72,-56.25
44,8,8,60,256,-196,-76.5625
44,8,9,252,512,-260,-50.78125
44,8,10,1395,1024,371,36.23046875
44,8,11,760,2048,-1288,-62.890625
44,8,12,474,4096,-3622,-88.427734375
44,8,13,1440,8192,-6752,-82.421875
44,8,14,17909,16384,1525,9.307861328125
44,8,15,28874,32768,-3894,-11.883544921875
44,9,1,0,2,-2,-100.0
44,9,2,1,4,-3,-75.0
44,9,3,3,8,-5,-62.5
44,9,4,32,16,16,100.0
44,9,5,41,32,9,28.125
44,9,6,90,64,26,40.625
44,9,7,81,128,-47,-36.71875
44,9,8,28,256,-228,-89.0625
44,9,9,2109,512,1597,311.9140625
44,9,10,1344,1024,320,31.25
44,9,11,3720,2048,1672,81.640625
44,9,12,280,4096,-3816,-93.1640625
44,9,13,27862,8192,19670,240.1123046875
44,9,14,1529,16384,-14855,-90.667724609375
44,9,15,3213,32768,-29555,-90.1947021484375
44,10,1,0,2,-2,-100.0
44,10,2,1,4,-3,-75.0
44,10,3,10,8,2,25.0
44,10,4,16,16,0,0.0
44,10,5,18,32,-14,-43.75
44,10,6,158,64,94,146.875
44,10,7,18,128,-110,-85.9375
44,10,8,377,256,121,47.265625
44,10,9,2531,512,2019,394.3359375
44,10,10,506,1024,-518,-50.5859375
44,10,11,1607,2048,-441,-21.533203125
44,10,12,2428,4096,-1668,-40.72265625
44,10,13,2733,8192,-5459,-66.63818359375
44,10,14,15784,16384,-600,-3.662109375
44,10,15,140338,32768,107570,328.277587890625
44,11,1,0,2,-2,-100.0
44,11,2,1,4,-3,-75.0
44,11,3,6,8,-2,-25.0
44,11,4,4,16,-12,-75.0
44,11,5,7,32,-25,-78.125
44,11,6,84,64,20,31.25
44,11,7,64,128,-64,-50.0
44,11,8,76,256,-180,-70.3125
44,11,9,74,512,-438,-85.546875
44,11,10,1921,1024,897,87.59765625
44,11,11,816,2048,-1232,-60.15625
44,11,12,7268,4096,3172,77.44140625
44,11,13,26729,8192,18537,226.28173828125
44,11,14,23809,16384,7425,45.318603515625
44,11,15,48887,32768,16119,49.1912841796875
44,12,1,0,2,-2,-100.0
44,12,2,1,4,-3,-75.0
44,12,3,6,8,-2,-25.0
44,12,4,3,16,-13,-81.25
44,12,5,55,32,23,71.875
44,12,6,235,64,171,267.1875
44,12,7,71,128,-57,-44.53125
44,12,8,242,256,-14,-5.46875
44,12,9,46,512,-466,-91.015625
44,12,10,258,1024,-766,-74.8046875
44,12,11,999,2048,-1049,-51.220703125
44,12,12,310,4096,-3786,-92.431640625
44,12,13,156,8192,-8036,-98.095703125
44,12,14,46795,16384,30411,185.614013671875
44,12,15,54057,32768,21289,64.9688720703125
44,13,1,0,2,-2,-100.0
44,13,2,2,4,-2,-50.0
44,13,3,14,8,6,75.0
44,13,4,23,16,7,43.75
44,13,5,17,32,-15,-46.875
44,13,6,67,64,3,4.6875
44,13,7,63,128,-65,-50.78125
44,13,8,39,256,-217,-84.765625
44,13,9,221,512,-291,-56.8359375
44,13,10,1528,1024,504,49.21875
44,13,11,2715,2048,667,32.568359375
44,13,12,1696,4096,-2400,-58.59375
44,13,13,17419,8192,9227,112.63427734375
44,13,14,3253,16384,-13131,-80.145263671875
44,13,15,13107,32768,-19661,-60.0006103515625
44,14,1,0,2,-2,-100.0
44,14,2,1,4,-3,-75.0
44,14,3,3,8,-5,-62.5
44,14,4,12,16,-4,-25.0
44,14,5,11,32,-21,-65.625
44,14,6,67,64,3,4.6875
44,14,7,396,128,268,209.375
44,14,8,321,256,65,25.390625
44,14,9,388,512,-124,-24.21875
44,14,10,962,1024,-62,-6.0546875
44,14,11,1292,2048,-756,-36.9140625
44,14,12,3560,4096,-536,-13.0859375
44,14,13,10634,8192,2442,29.8095703125
44,14,14,6927,16384,-9457,-57.720947265625
44,14,15,18217,32768,-14551,-44.4061279296875
44,15,1,0,2,-2,-100.0
44,15,2,1,4,-3,-75.0
44,15,3,5,8,-3,-37.5
44,15,4,3,16,-13,-81.25
44,15,5,81,32,49,153.125
44,15,6,55,64,-9,-14.0625
44,15,7,192,128,64,50.0
44,15,8,36,256,-220,-85.9375
44,15,9,287,512,-225,-43.9453125
44,15,10,81,1024,-943,-92.08984375
44,15,11,1722,2048,-326,-15.91796875
44,15,12,1275,4096,-2821,-68.8720703125
44,15,13,12207,8192,4015,49.01123046875
44,15,14,34085,16384,17701,108.038330078125
44,15,15,88647,32768,55879,170.5291748046875
44,16,1,0,2,-2,-100.0
44,16,2,2,4,-2,-50.0
44,16,3,8,8,0,0.0
44,16,4,3,16,-13,-81.25
44,16,5,85,32,53,165.625
44,16,6,162,64,98,153.125
44,16,7,102,128,-26,-20.3125
44,16,8,174,256,-82,-32.03125
44,16,9,92,512,-420,-82.03125
44,16,10,527,1024,-497,-48.53515625
44,16,11,868,2048,-1180,-57.6171875
44,16,12,5426,4096,1330,32.470703125
44,16,13,3707,8192,-4485,-54.74853515625
44,16,14,26513,16384,10129,61.822509765625
44,16,15,4427,32768,-28341,-86.4898681640625
44,17,1,0,2,-2,-100.0
44,17,2,1,4,-3,-75.0
44,17,3,19,8,11,137.5
44,17,4,30,16,14,87.5
44,17,5,80,32,48,150.0
44,17,6,62,64,-2,-3.125
44,17,7,23,128,-105,-82.03125
44,17,8,263,256,7,2.734375
44,17,9,358,512,-154,-30.078125
44,17,10,1223,1024,199,19.43359375
44,17,11,1065,2048,-983,-47.998046875
44,17,12,9478,4096,5382,131.396484375
44,17,13,5675,8192,-2517,-30.72509765625
44,17,14,14593,16384,-1791,-10.931396484375
44,17,15,44052,32768,11284,34.43603515625
44,18,1,0,2,-2,-100.0
44,18,2,3,4,-1,-25.0
44,18,3,4,8,-4,-50.0
44,18,4,14,16,-2,-12.5
44,18,5,10,32,-22,-68.75
44,18,6,48,64,-16,-25.0
44,18,7,131,128,3,2.34375
44,18,8,351,256,95,37.109375
44,18,9,76,512,-436,-85.15625
44,18,10,1048,1024,24,2.34375
44,18,11,355,2048,-1693,-82.666015625
44,18,12,3248,4096,-848,-20.703125
44,18,13,566,8192,-7626,-93.0908203125
44,18,14,29960,16384,13576,82.861328125
44,18,15,4272,32768,-28496,-86.962890625
44,19,1,0,2,-2,-100.0
44,19,2,1,4,-3,-75.0
44,19,3,2,8,-6,-75.0
44,19,4,29,16,13,81.25
44,19,5,8,32,-24,-75.0
44,19,6,280,64,216,337.5
44,19,7,25,128,-103,-80.46875
44,19,8,215,256,-41,-16.015625
44,19,9,1450,512,938,183.203125
44,19,10,136,1024,-888,-86.71875
44,19,11,3118,2048,1070,52.24609375
44,19,12,1651,4096,-2445,-59.6923828125
44,19,13,32984,8192,24792,302.63671875
44,19,14,16792,16384,408,2.490234375
44,19,15,17526,32768,-15242,-46.514892578125
44,20,1,0,2,-2,-100.0
44,20,2,2,4,-2,-50.0
44,20,3,2,8,-6,-75.0
44,20,4,9,16,-7,-43.75
44,20,5,48,32,16,50.0
44,20,6,97,64,33,51.5625
44,20,7,450,128,322,251.5625
44,20,8,107,256,-149,-58.203125
44,20,9,435,512,-77,-15.0390625
44,20,10,484,1024,-540,-52.734375
44,20,11,753,2048,-1295,-63.232421875
44,20,12,4061,4096,-35,-0.8544921875
44,20,13,2673,8192,-5519,-67.37060546875
44,20,14,10680,16384,-5704,-34.814453125
44,20,15,41935,32768,9167,27.9754638671875
44,21,1,0,2,-2,-100.0
44,21,2,1,4,-3,-75.0
44,21,3,8,8,0,0.0
44,21,4,14,16,-2,-12.5
44,21,5,4,32,-28,-87.5
44,21,6,12,64,-52,-81.25
44,21,7,121,128,-7,-5.46875
44,21,8,102,256,-154,-60.15625
44,21,9,533,512,21,4.1015625
44,21,10,160,1024,-864,-84.375
44,21,11,1785,2048,-263,-12.841796875
44,21,12,3393,4096,-703,-17.1630859375
44,21,13,19475,8192,11283,137.73193359375
44,21,14,4576,16384,-11808,-72.0703125
44,21,15,41609,32768,8841,26.9805908203125
44,22,1,0,2,-2,-100.0
44,22,2,1,4,-3,-75.0
44,22,3,3,8,-5,-62.5
44,22,4,20,16,4,25.0
44,22,5,22,32,-10,-31.25
44,22,6,56,64,-8,-12.5
44,22,7,55,128,-73,-57.03125
44,22,8,504,256,248,96.875
44,22,9,244,512,-268,-52.34375
44,22,10,2009,1024,985,96.19140625
44,22,11,2545,2048,497,24.267578125
44,22,12,1275,4096,-2821,-68.8720703125
44,22,13,4084,8192,-4108,-50.146484375
44,22,14,20829,16384,4445,27.130126953125
44,22,15,54651,32768,21883,66.7816162109375
44,23,1,0,2,-2,-100.0
44,23,2,6,4,2,50.0
44,23,3,13,8,5,62.5
44,23,4,7,16,-9,-56.25
44,23,5,18,32,-14,-43.75
44,23,6,24,64,-40,-62.5
44,23,7,180,128,52,40.625
44,23,8,103,256,-153,-59.765625
44,23,9,49,512,-463,-90.4296875
44,23,10,1284,1024,260,25.390625
44,23,11,3341,2048,1293,63.134765625
44,23,12,275,4096,-3821,-93.2861328125
44,23,13,17987,8192,9795,119.56787109375
44,23,14,5350,16384,-11034,-67.34619140625
44,23,15,4334,32768,-28434,-86.773681640625
44,24,1,0,2,-2,-100.0
44,24,2,3,4,-1,-25.0
44,24,3,2,8,-6,-75.0
44,24,4,14,16,-2,-12.5
44,24,5,21,32,-11,-34.375
44,24,6,150,64,86,134.375
44,24,7,70,128,-58,-45.3125
44,24,8,755,256,499,194.921875
44,24,9,238,512,-274,-53.515625
44,24,10,360,1024,-664,-64.84375
44,24,11,1602,2048,-446,-21.77734375
44,24,12,7122,4096,3026,73.876953125
44,24,13,25819,8192,17627,215.17333984375
44,24,14,218,16384,-16166,-98.66943359375
44,24,15,1856,32768,-30912,-94.3359375
44,25,1,0,2,-2,-100.0
44,25,2,1,4,-3,-75.0
44,25,3,2,8,-6,-75.0
44,25,4,4,16,-12,-75.0
44,25,5,35,32,3,9.375
44,25,6,33,64,-31,-48.4375
44,25,7,157,128,29,22.65625
44,25,8,8,256,-248,-96.875
44,25,9,42,512,-470,-91.796875
44,25,10,13,1024,-1011,-98.73046875
44,25,11,2300,2048,252,12.3046875
44,25,12,1669,4096,-2427,-59.2529296875
44,25,13,1185,8192,-7007,-85.53466796875
44,25,14,10424,16384,-5960,-36.376953125
44,25,15,12277,32768,-20491,-62.5335693359375
44,26,1,0,2,-2,-100.0
44,26,2,1,4,-3,-75.0
44,26,3,12,8,4,50.0
44,26,4,10,16,-6,-37.5
44,26,5,15,32,-17,-53.125
44,26,6,43,64,-21,-32.8125
44,26,7,97,128,-31,-24.21875
44,26,8,426,256,170,66.40625
44,26,9,157,512,-355,-69.3359375
44,26,10,67,1024,-957,-93.45703125
44,26,11,3222,2048,1174,57.32421875
44,26,12,2514,4096,-1582,-38.623046875
44,26,13,7817,8192,-375,-4.57763671875
44,26,14,3176,16384,-13208,-80.615234375
44,26,15,18474,32768,-14294,-43.621826171875
44,27,1,0,2,-2,-100.0
44,27,2,2,4,-2,-50.0
44,27,3,2,8,-6,-75.0
44,27,4,13,16,-3,-18.75
44,27,5,9,32,-23,-71.875
44,27,6,197,64,133,207.8125
44,27,7,38,128,-90,-70.3125
44,27,8,460,256,204,79.6875
44,27,9,338,512,-174,-33.984375
44,27,10,2391,1024,1367,133.49609375
44,27,11,2042,2048,-6,-0.29296875
44,27,12,2143,4096,-1953,-47.6806640625
44,27,13,257,8192,-7935,-96.86279296875
44,27,14,56949,16384,40565,247.589111328125
44,27,15,26714,32768,-6054,-18.475341796875
44,28,1,0,2,-2,-100.0
44,28,2,1,4,-3,-75.0
44,28,3,4,8,-4,-50.0
44,28,4,19,16,3,18.75
44,28,5,20,32,-12,-37.5
44,28,6,93,64,29,45.3125
44,28,7,188,128,60,46.875
44,28,8,200,256,-56,-21.875
44,28,9,636,512,124,24.21875
44,28,10,990,1024,-34,-3.3203125
44,28,11,1363,2048,-685,-33.447265625
44,28,12,972,4096,-3124,-76.26953125
44,28,13,1987,8192,-6205,-75.74462890625
44,28,14,32911,16384,16527,100.872802734375
44,28,15,26601,32768,-6167,-18.8201904296875
44,29,1,0,2,-2,-100.0
44,29,2,1,4,-3,-75.0
44,29,3,2,8,-6,-75.0
44,29,4,19,16,3,18.75
44,29,5,12,32,-20,-62.5
44,29,6,11,64,-53,-82.8125
44,29,7,158,128,30,23.4375
44,29,8,261,256,5,1.953125
44,29,9,40,512,-472,-92.1875
44,29,10,90,1024,-934,-91.2109375
44,29,11,2122,2048,74,3.61328125
44,29,12,8269,4096,4173,101.8798828125
44,29,13,53798,8192,45606,556.7138671875
44,29,14,9951,16384,-6433,-39.263916015625
44,29,15,43830,32768,11062,33.758544921875
44,30,1,0,2,-2,-100.0
44,30,2,2,4,-2,-50.0
44,30,3,12,8,4,50.0
44,30,4,3,16,-13,-81.25
44,30,5,25,32,-7,-21.875
44,30,6,24,64,-40,-62.5
44,30,7,10,128,-118,-92.1875
44,30,8,342,256,86,33.59375
44,30,9,1645,512,1133,221.2890625
44,30,10,190,1024,-834,-81.4453125
44,30,11,645,2048,-1403,-68.505859375
44,30,12,301,4096,-3795,-92.6513671875
44,30,13,4376,8192,-3816,-46.58203125
44,30,14,6084,16384,-10300,-62.8662109375
44,30,15,12895,32768,-19873,-60.6475830078125
44,31,1,0,2,-2,-100.0
44,31,2,1,4,-3,-75.0
44,31,3,2,8,-6,-75.0
44,31,4,20,16,4,25.0
44,31,5,19,32,-13,-40.625
44,31,6,9,64,-55,-85.9375
44,31,7,61,128,-67,-52.34375
44,31,8,221,256,-35,-13.671875
44,31,9,293,512,-219,-42.7734375
44,31,10,1738,1024,714,69.7265625
44,31,11,1122,2048,-926,-45.21484375
44,31,12,581,4096,-3515,-85.8154296875
44,31,13,4880,8192,-3312,-40.4296875
44,31,14,9507,16384,-6877,-41.973876953125
44,31,15,31334,32768,-1434,-4.376220703125
44,32,1,0,2,-2,-100.0
44,32,2,1,4,-3,-75.0
44,32,3,2,8,-6,-75.0
44,32,4,28,16,12,75.0
44,32,5,28,32,-4,-12.5
44,32,6,19,64,-45,-70.3125
44,32,7,56,128,-72,-56.25
44,32,8,65,256,-191,-74.609375
44,32,9,2016,512,1504,293.75
44,32,10,716,1024,-308,-30.078125
44,32,11,149,2048,-1899,-92.724609375
44,32,12,17623,4096,13527,330.2490234375
44,32,13,3889,8192,-4303,-52.52685546875
44,32,14,30980,16384,14596,89.0869140625
44,32,15,15706,32768,-17062,-52.069091796875
44,33,1,0,2,-2,-100.0
44,33,2,2,4,-2,-50.0
44,33,3,9,8,1,12.5
44,33,4,22,16,6,37.5
44,33,5,51,32,19,59.375
44,33,6,187,64,123,192.1875
44,33,7,123,128,-5,-3.90625
44,33,8,222,256,-34,-13.28125
44,33,9,20,512,-492,-96.09375
44,33,10,978,1024,-46,-4.4921875
44,33,11,2750,2048,702,34.27734375
44,33,12,6785,4096,2689,65.6494140625
44,33,13,1571,8192,-6621,-80.82275390625
44,33,14,29533,16384,13149,80.255126953125
44,33,15,11106,32768,-21662,-66.107177734375
44,34,1,0,2,-2,-100.0
44,34,2,1,4,-3,-75.0
44,34,3,2,8,-6,-75.0
44,34,4,17,16,1,6.25
44,34,5,36,32,4,12.5
44,34,6,23,64,-41,-64.0625
44,34,7,18,128,-110,-85.9375
44,34,8,209,256,-47,-18.359375
44,34,9,122,512,-390,-76.171875
44,34,10,284,1024,-740,-72.265625
44,34,11,2118,2048,70,3.41796875
44,34,12,551,4096,-3545,-86.5478515625
44,34,13,779,8192,-7413,-90.49072265625
44,34,14,25632,16384,9248,56.4453125
44,34,15,12348,32768,-20420,-62.31689453125
44,35,1,0,2,-2,-100.0
44,35,2,1,4,-3,-75.0
44,35,3,2,8,-6,-75.0
44,35,4,5,16,-11,-68.75
44,35,5,33,32,1,3.125
44,35,6,16,64,-48,-75.0
44,35,7,164,128,36,28.125
44,35,8,70,256,-186,-72.65625
44,35,9,386,512,-126,-24.609375
44,35,10,810,1024,-214,-20.8984375
44,35,11,1009,2048,-1039,-50.732421875
44,35,12,444,4096,-3652,-89.16015625
44,35,13,9044,8192,852,10.400390625
44,35,14,22919,16384,6535,39.886474609375
44,35,15,46469,32768,13701,41.8121337890625
44,36,1,0,2,-2,-100.0
44,36,2,1,4,-3,-75.0
44,36,3,3,8,-5,-62.5
44,36,4,16,16,0,0.0
44,36,5,16,32,-16,-50.0
44,36,6,271,64,207,323.4375
44,36,7,8,128,-120,-93.75
44,36,8,40,256,-216,-84.375
44,36,9,1976,512,1464,285.9375
44,36,10,1342,1024,318,31.0546875
44,36,11,1311,2048,-737,-35.986328125
44,36,12,1166,4096,-2930,-71.533203125
44,36,13,2934,8192,-5258,-64.1845703125
44,36,14,23517,16384,7133,43.536376953125
44,36,15,39660,32768,6892,21.03271484375
44,37,1,0,2,-2,-100.0
44,37,2,3,4,-1,-25.0
44,37,3,3,8,-5,-62.5
44,37,4,8,16,-8,-50.0
44,37,5,22,32,-10,-31.25
44,37,6,16,64,-48,-75.0
44,37,7,129,128,1,0.78125
44,37,8,66,256,-190,-74.21875
44,37,9,143,512,-369,-72.0703125
44,37,10,124,1024,-900,-87.890625
44,37,11,2850,2048,802,39.16015625
44,37,12,13055,4096,8959,218.7255859375
44,37,13,3515,8192,-4677,-57.09228515625
44,37,14,22108,16384,5724,34.9365234375
44,37,15,655,32768,-32113,-98.0010986328125
44,38,1,0,2,-2,-100.0
44,38,2,1,4,-3,-75.0
44,38,3,2,8,-6,-75.0
44,38,4,7,16,-9,-56.25
44,38,5,6,32,-26,-81.25
44,38,6,211,64,147,229.6875
44,38,7,546,128,418,326.5625
44,38,8,25,256,-231,-90.234375
44,38,9,553,512,41,8.0078125
44,38,10,174,1024,-850,-83.0078125
44,38,11,415,2048,-1633,-79.736328125
44,38,12,365,4096,-3731,-91.0888671875
44,38,13,4192,8192,-4000,-48.828125
44,38,14,27084,16384,10700,65.3076171875
44,38,15,12033,32768,-20735,-63.2781982421875
44,39,1,0,2,-2,-100.0
44,39,2,5,4,1,25.0
44,39,3,3,8,-5,-62.5
44,39,4,9,16,-7,-43.75
44,39,5,109,32,77,240.625
44,39,6,48,64,-16,-25.0
44,39,7,460,128,332,259.375
44,39,8,33,256,-223,-87.109375
44,39,9,232,512,-280,-54.6875
44,39,10,156,1024,-868,-84.765625
44,39,11,5096,2048,3048,148.828125
44,39,12,1397,4096,-2699,-65.8935546875
44,39,13,508,8192,-7684,-93.798828125
44,39,14,9246,16384,-7138,-43.56689453125
44,39,15,6195,32768,-26573,-81.0943603515625
44,40,1,0,2,-2,-100.0
44,40,2,3,4,-1,-25.0
44,40,3,3,8,-5,-62.5
44,40,4,4,16,-12,-75.0
44,40,5,16,32,-16,-50.0
44,40,6,76,64,12,18.75
44,40,7,15,128,-113,-88.28125
44,40,8,129,256,-127,-49.609375
44,40,9,168,512,-344,-67.1875
44,40,10,65,1024,-959,-93.65234375
44,40,11,1111,2048,-937,-45.751953125
44,40,12,1477,4096,-2619,-63.9404296875
44,40,13,12100,8192,3908,47.705078125
44,40,14,13765,16384,-2619,-15.985107421875
44,40,15,53268,32768,20500,62.56103515625
44,41,1,0,2,-2,-100.0
44,41,2,1,4,-3,-75.0
44,41,3,6,8,-2,-25.0
44,41,4,5,16,-11,-68.75
44,41,5,5,32,-27,-84.375
44,41,6,14,64,-50,-78.125
44,41,7,24,128,-104,-81.25
44,41,8,9,256,-247,-96.484375
44,41,9,26,512,-486,-94.921875
44,41,10,74,1024,-950,-92.7734375
44,41,11,146,2048,-1902,-92.87109375
44,41,12,3116,4096,-980,-23.92578125
44,41,13,22325,8192,14133,172.52197265625
44,41,14,3113,16384,-13271,-80.999755859375
44,41,15,51402,32768,18634,56.866455078125
44,42,1,0,2,-2,-100.0
44,42,2,1,4,-3,-75.0
44,42,3,3,8,-5,-62.5
44,42,4,14,16,-2,-12.5
44,42,5,36,32,4,12.5
44,42,6,21,64,-43,-67.1875
44,42,7,122,128,-6,-4.6875
44,42,8,180,256,-76,-29.6875
44,42,9,538,512,26,5.078125
44,42,10,469,1024,-555,-54.19921875
44,42,11,5856,2048,3808,185.9375
44,42,12,25603,4096,21507,525.0732421875
44,42,13,7248,8192,-944,-11.5234375
44,42,14,2018,16384,-14366,-87.68310546875
44,42,15,61777,32768,29009,88.5284423828125
44,43,1,0,2,-2,-100.0
44,43,2,4,4,0,0.0
44,43,3,16,8,8,100.0
44,43,4,20,16,4,25.0
44,43,5,24,32,-8,-25.0
44,43,6,36,64,-28,-43.75
44,43,7,154,128,26,20.3125
44,43,8,18,256,-238,-92.96875
44,43,9,1040,512,528,103.125
44,43,10,356,1024,-668,-65.234375
44,43,11,2753,2048,705,34.423828125
44,43,12,735,4096,-3361,-82.0556640625
44,43,13,15155,8192,6963,84.99755859375
44,43,14,87042,16384,70658,431.26220703125
44,43,15,7088,32768,-25680,-78.369140625
44,44,1,0,2,-2,-100.0
44,44,2,1,4,-3,-75.0
44,44,3,2,8,-6,-75.0
44,44,4,45,16,29,181.25
44,44,5,9,32,-23,-71.875
44,44,6,10,64,-54,-84.375
44,44,7,108,128,-20,-15.625
44,44,8,88,256,-168,-65.625
44,44,9,201,512,-311,-60.7421875
44,44,10,1166,1024,142,13.8671875
44,44,11,2075,2048,27,1.318359375
44,44,12,4933,4096,837,20.4345703125
44,44,13,2220,8192,-5972,-72.900390625
44,44,14,7295,16384,-9089,-55.474853515625
44,44,15,17515,32768,-15253,-46.5484619140625
45,1,1,0,2,-2,-100.0
45,1,2,3,4,-1,-25.0
45,1,3,20,8,12,150.0
45,1,4,17,16,1,6.25
45,1,5,11,32,-21,-65.625
45,1,6,65,64,1,1.5625
45,1,7,62,128,-66,-51.5625
45,1,8,253,256,-3,-1.171875
45,1,9,650,512,138,26.953125
45,1,10,2090,1024,1066,104.1015625
45,1,11,2932,2048,884,43.1640625
45,1,12,5756,4096,1660,40.52734375
45,1,13,6853,8192,-1339,-16.34521484375
45,1,14,44267,16384,27883,170.184326171875
45,1,15,8203,32768,-24565,-74.9664306640625
45,2,1,0,2,-2,-100.0
45,2,2,1,4,-3,-75.0
45,2,3,2,8,-6,-75.0
45,2,4,26,16,10,62.5
45,2,5,32,32,0,0.0
45,2,6,105,64,41,64.0625
45,2,7,69,128,-59,-46.09375
45,2,8,91,256,-165,-64.453125
45,2,9,541,512,29,5.6640625
45,2,10,467,1024,-557,-54.39453125
45,2,11,3503,2048,1455,71.044921875
45,2,12,2815,4096,-1281,-31.2744140625
45,2,13,8469,8192,277,3.38134765625
45,2,14,13132,16384,-3252,-19.8486328125
45,2,15,47499,32768,14731,44.9554443359375
45,3,1,0,2,-2,-100.0
45,3,2,3,4,-1,-25.0
45,3,3,2,8,-6,-75.0
45,3,4,14,16,-2,-12.5
45,3,5,25,32,-7,-21.875
45,3,6,119,64,55,85.9375
45,3,7,25,128,-103,-80.46875
45,3,8,64,256,-192,-75.0
45,3,9,595,512,83,16.2109375
45,3,10,1071,1024,47,4.58984375
45,3,11,1635,2048,-413,-20.166015625
45,3,12,121,4096,-3975,-97.0458984375
45,3,13,1387,8192,-6805,-83.06884765625
45,3,14,16800,16384,416,2.5390625
45,3,15,4100,32768,-28668,-87.48779296875
45,4,1,0,2,-2,-100.0
45,4,2,1,4,-3,-75.0
45,4,3,12,8,4,50.0
45,4,4,9,16,-7,-43.75
45,4,5,80,32,48,150.0
45,4,6,42,64,-22,-34.375
45,4,7,72,128,-56,-43.75
45,4,8,247,256,-9,-3.515625
45,4,9,380,512,-132,-25.78125
45,4,10,2690,1024,1666,162.6953125
45,4,11,3167,2048,1119,54.638671875
45,4,12,3108,4096,-988,-24.12109375
45,4,13,7470,8192,-722,-8.8134765625
45,4,14,13093,16384,-3291,-20.086669921875
45,4,15,26783,32768,-5985,-18.2647705078125
45,5,1,0,2,-2,-100.0
45,5,2,4,4,0,0.0
45,5,3,4,8,-4,-50.0
45,5,4,7,16,-9,-56.25
45,5,5,8,32,-24,-75.0
45,5,6,35,64,-29,-45.3125
45,5,7,226,128,98,76.5625
45,5,8,173,256,-83,-32.421875
45,5,9,226,512,-286,-55.859375
45,5,10,317,1024,-707,-69.04296875
45,5,11,3035,2048,987,48.193359375
45,5,12,4097,4096,1,0.0244140625
45,5,13,4894,8192,-3298,-40.2587890625
45,5,14,4468,16384,-11916,-72.7294921875
45,5,15,3601,32768,-29167,-89.0106201171875
45,6,1,0,2,-2,-100.0
45,6,2,1,4,-3,-75.0
45,6,3,3,8,-5,-62.5
45,6,4,15,16,-1,-6.25
45,6,5,115,32,83,259.375
45,6,6,5,64,-59,-92.1875
45,6,7,39,128,-89,-69.53125
45,6,8,683,256,427,166.796875
45,6,9,38,512,-474,-92.578125
45,6,10,84,1024,-940,-91.796875
45,6,11,6175,2048,4127,201.513671875
45,6,12,1200,4096,-2896,-70.703125
45,6,13,9103,8192,911,11.12060546875
45,6,14,4179,16384,-12205,-74.493408203125
45,6,15,26150,32768,-6618,-20.196533203125
45,7,1,0,2,-2,-100.0
45,7,2,1,4,-3,-75.0
45,7,3,11,8,3,37.5
45,7,4,19,16,3,18.75
45,7,5,15,32,-17,-53.125
45,7,6,12,64,-52,-81.25
45,7,7,71,128,-57,-44.53125
45,7,8,72,256,-184,-71.875
45,7,9,34,512,-478,-93.359375
45,7,10,582,1024,-442,-43.1640625
45,7,11,2050,2048,2,0.09765625
45,7,12,2000,4096,-2096,-51.171875
45,7,13,2267,8192,-5925,-72.32666015625
45,7,14,11239,16384,-5145,-31.402587890625
45,7,15,1590,32768,-31178,-95.147705078125
45,8,1,0,2,-2,-100.0
45,8,2,1,4,-3,-75.0
45,8,3,7,8,-1,-12.5
45,8,4,13,16,-3,-18.75
45,8,5,8,32,-24,-75.0
45,8,6,54,64,-10,-15.625
45,8,7,122,128,-6,-4.6875
45,8,8,38,256,-218,-85.15625
45,8,9,227,512,-285,-55.6640625
45,8,10,23,1024,-1001,-97.75390625
45,8,11,6475,2048,4427,216.162109375
45,8,12,2927,4096,-1169,-28.5400390625
45,8,13,8565,8192,373,4.55322265625
45,8,14,10529,16384,-5855,-35.736083984375
45,8,15,45201,32768,12433,37.9425048828125
45,9,1,0,2,-2,-100.0
45,9,2,5,4,1,25.0
45,9,3,3,8,-5,-62.5
45,9,4,3,16,-13,-81.25
45,9,5,16,32,-16,-50.0
45,9,6,10,64,-54,-84.375
45,9,7,302,128,174,135.9375
45,9,8,182,256,-74,-28.90625
45,9,9,125,512,-387,-75.5859375
45,9,10,893,1024,-131,-12.79296875
45,9,11,6380,2048,4332,211.5234375
45,9,12,4283,4096,187,4.5654296875
45,9,13,17416,8192,9224,112.59765625
45,9,14,15061,16384,-1323,-8.074951171875
45,9,15,40938,32768,8170,24.932861328125
45,10,1,0,2,-2,-100.0
45,10,2,1,4,-3,-75.0
45,10,3,5,8,-3,-37.5
45,10,4,7,16,-9,-56.25
45,10,5,6,32,-26,-81.25
45,10,6,41,64,-23,-35.9375
45,10,7,136,128,8,6.25
45,10,8,543,256,287,112.109375
45,10,9,115,512,-397,-77.5390625
45,10,10,4615,1024,3591,350.68359375
45,10,11,1486,2048,-562,-27.44140625
45,10,12,797,4096,-3299,-80.5419921875
45,10,13,424,8192,-7768,-94.82421875
45,10,14,257,16384,-16127,-98.431396484375
45,10,15,75354,32768,42586,129.962158203125
45,11,1,0,2,-2,-100.0
45,11,2,9,4,5,125.0
45,11,3,13,8,5,62.5
45,11,4,6,16,-10,-62.5
45,11,5,28,32,-4,-12.5
45,11,6,39,64,-25,-39.0625
45,11,7,133,128,5,3.90625
45,11,8,273,256,17,6.640625
45,11,9,507,512,-5,-0.9765625
45,11,10,1354,1024,330,32.2265625
45,11,11,1947,2048,-101,-4.931640625
45,11,12,770,4096,-3326,-81.201171875
45,11,13,2270,8192,-5922,-72.2900390625
45,11,14,12558,16384,-3826,-23.35205078125
45,11,15,27002,32768,-5766,-17.596435546875
45,12,1,0,2,-2,-100.0
45,12,2,4,4,0,0.0
45,12,3,6,8,-2,-25.0
45,12,4,7,16,-9,-56.25
45,12,5,25,32,-7,-21.875
45,12,6,71,64,7,10.9375
45,12,7,103,128,-25,-19.53125
45,12,8,8,256,-248,-96.875
45,12,9,48,512,-464,-90.625
45,12,10,1981,1024,957,93.45703125
45,12,11,784,2048,-1264,-61.71875
45,12,12,7005,4096,2909,71.0205078125
45,12,13,1658,8192,-6534,-79.7607421875
45,12,14,15888,16384,-496,-3.02734375
45,12,15,9306,32768,-23462,-71.600341796875
45,13,1,0,2,-2,-100.0
45,13,2,1,4,-3,-75.0
45,13,3,8,8,0,0.0
45,13,4,7,16,-9,-56.25
45,13,5,15,32,-17,-53.125
45,13,6,7,64,-57,-89.0625
45,13,7,217,128,89,69.53125
45,13,8,72,256,-184,-71.875
45,13,9,122,512,-390,-76.171875
45,13,10,415,1024,-609,-59.47265625
45,13,11,4050,2048,2002,97.75390625
45,13,12,10612,4096,6516,159.08203125
45,13,13,2048,8192,-6144,-75.0
45,13,14,1199,16384,-15185,-92.681884765625
45,13,15,77301,32768,44533,135.9039306640625
45,14,1,0,2,-2,-100.0
45,14,2,3,4,-1,-25.0
45,14,3,5,8,-3,-37.5
45,14,4,54,16,38,237.5
45,14,5,38,32,6,18.75
45,14,6,15,64,-49,-76.5625
45,14,7,91,128,-37,-28.90625
45,14,8,84,256,-172,-67.1875
45,14,9,408,512,-104,-20.3125
45,14,10,2139,1024,1115,108.88671875
45,14,11,511,2048,-1537,-75.048828125
45,14,12,2594,4096,-1502,-36.669921875
45,14,13,616,8192,-7576,-92.48046875
45,14,14,34194,16384,17810,108.70361328125
45,14,15,23917,32768,-8851,-27.0111083984375
45,15,1,0,2,-2,-100.0
45,15,2,3,4,-1,-25.0
45,15,3,2,8,-6,-75.0
45,15,4,3,16,-13,-81.25
45,15,5,7,32,-25,-78.125
45,15,6,54,64,-10,-15.625
45,15,7,150,128,22,17.1875
45,15,8,39,256,-217,-84.765625
45,15,9,45,512,-467,-91.2109375
45,15,10,976,1024,-48,-4.6875
45,15,11,3012,2048,964,47.0703125
45,15,12,159,4096,-3937,-96.1181640625
45,15,13,15011,8192,6819,83.23974609375
45,15,14,1645,16384,-14739,-89.959716796875
45,15,15,33213,32768,445,1.3580322265625
45,16,1,0,2,-2,-100.0
45,16,2,3,4,-1,-25.0
45,16,3,7,8,-1,-12.5
45,16,4,37,16,21,131.25
45,16,5,25,32,-7,-21.875
45,16,6,46,64,-18,-28.125
45,16,7,357,128,229,178.90625
45,16,8,152,256,-104,-40.625
45,16,9,346,512,-166,-32.421875
45,16,10,88,1024,-936,-91.40625
45,16,11,473,2048,-1575,-76.904296875
45,16,12,5393,4096,1297,31.6650390625
45,16,13,1443,8192,-6749,-82.38525390625
45,16,14,10665,16384,-5719,-34.906005859375
45,16,15,41842,32768,9074,27.691650390625
45,17,1,0,2,-2,-100.0
45,17,2,5,4,1,25.0
45,17,3,4,8,-4,-50.0
45,17,4,35,16,19,118.75
45,17,5,36,32,4,12.5
45,17,6,5,64,-59,-92.1875
45,17,7,88,128,-40,-31.25
45,17,8,28,256,-228,-89.0625
45,17,9,68,512,-444,-86.71875
45,17,10,138,1024,-886,-86.5234375
45,17,11,3393,2048,1345,65.673828125
45,17,12,3551,4096,-545,-13.3056640625
45,17,13,10474,8192,2282,27.8564453125
45,17,14,937,16384,-15447,-94.281005859375
45,17,15,6818,32768,-25950,-79.193115234375
45,18,1,0,2,-2,-100.0
45,18,2,1,4,-3,-75.0
45,18,3,6,8,-2,-25.0
45,18,4,5,16,-11,-68.75
45,18,5,9,32,-23,-71.875
45,18,6,19,64,-45,-70.3125
45,18,7,53,128,-75,-58.59375
45,18,8,64,256,-192,-75.0
45,18,9,408,512,-104,-20.3125
45,18,10,204,1024,-820,-80.078125
45,18,11,2943,2048,895,43.701171875
45,18,12,2002,4096,-2094,-51.123046875
45,18,13,22701,8192,14509,177.11181640625
45,18,14,2763,16384,-13621,-83.135986328125
45,18,15,14583,32768,-18185,-55.4962158203125
45,19,1,0,2,-2,-100.0
45,19,2,3,4,-1,-25.0
45,19,3,3,8,-5,-62.5
45,19,4,7,16,-9,-56.25
45,19,5,9,32,-23,-71.875
45,19,6,33,64,-31,-48.4375
45,19,7,169,128,41,32.03125
45,19,8,414,256,158,61.71875
45,19,9,431,512,-81,-15.8203125
45,19,10,1088,1024,64,6.25
45,19,11,867,2048,-1181,-57.666015625
45,19,12,112,4096,-3984,-97.265625
45,19,13,27558,8192,19366,236.4013671875
45,19,14,12383,16384,-4001,-24.420166015625
45,19,15,68401,32768,35633,108.7432861328125
45,20,1,0,2,-2,-100.0
45,20,2,1,4,-3,-75.0
45,20,3,4,8,-4,-50.0
45,20,4,10,16,-6,-37.5
45,20,5,4,32,-28,-87.5
45,20,6,55,64,-9,-14.0625
45,20,7,55,128,-73,-57.03125
45,20,8,488,256,232,90.625
45,20,9,53,512,-459,-89.6484375
45,20,10,495,1024,-529,-51.66015625
45,20,11,1068,2048,-980,-47.8515625
45,20,12,10669,4096,6573,160.4736328125
45,20,13,3796,8192,-4396,-53.662109375
45,20,14,5639,16384,-10745,-65.582275390625
45,20,15,14786,32768,-17982,-54.876708984375
45,21,1,0,2,-2,-100.0
45,21,2,1,4,-3,-75.0
45,21,3,12,8,4,50.0
45,21,4,11,16,-5,-31.25
45,21,5,34,32,2,6.25
45,21,6,31,64,-33,-51.5625
45,21,7,25,128,-103,-80.46875
45,21,8,79,256,-177,-69.140625
45,21,9,73,512,-439,-85.7421875
45,21,10,1247,1024,223,21.77734375
45,21,11,1130,2048,-918,-44.82421875
45,21,12,1864,4096,-2232,-54.4921875
45,21,13,3421,8192,-4771,-58.23974609375
45,21,14,14146,16384,-2238,-13.65966796875
45,21,15,28475,32768,-4293,-13.1011962890625
45,22,1,0,2,-2,-100.0
45,22,2,3,4,-1,-25.0
45,22,3,6,8,-2,-25.0
45,22,4,13,16,-3,-18.75
45,22,5,13,32,-19,-59.375
45,22,6,50,64,-14,-21.875
45,22,7,316,128,188,146.875
45,22,8,15,256,-241,-94.140625
45,22,9,598,512,86,16.796875
45,22,10,152,1024,-872,-85.15625
45,22,11,595,2048,-1453,-70.947265625
45,22,12,6596,4096,2500,61.03515625
45,22,13,9185,8192,993,12.12158203125
45,22,14,37625,16384,21241,129.644775390625
45,22,15,25219,32768,-7549,-23.0377197265625
45,23,1,0,2,-2,-100.0
45,23,2,1,4,-3,-75.0
45,23,3,4,8,-4,-50.0
45,23,4,29,16,13,81.25
45,23,5,30,32,-2,-6.25
45,23,6,41,64,-23,-35.9375
45,23,7,26,128,-102,-79.6875
45,23,8,277,256,21,8.203125
45,23,9,102,512,-410,-80.078125
45,23,10,1733,1024,709,69.23828125
45,23,11,1957,2048,-91,-4.443359375
45,23,12,5982,4096,1886,46.044921875
45,23,13,4109,8192,-4083,-49.84130859375
45,23,14,43995,16384,27611,168.524169921875
45,23,15,27341,32768,-5427,-16.5618896484375
45,24,1,0,2,-2,-100.0
45,24,2,2,4,-2,-50.0
45,24,3,8,8,0,0.0
45,24,4,3,16,-13,-81.25
45,24,5,18,32,-14,-43.75
45,24,6,25,64,-39,-60.9375
45,24,7,296,128,168,131.25
45,24,8,353,256,97,37.890625
45,24,9,235,512,-277,-54.1015625
45,24,10,2937,1024,1913,186.81640625
45,24,11,1197,2048,-851,-41.552734375
45,24,12,1441,4096,-2655,-64.8193359375
45,24,13,1960,8192,-6232,-76.07421875
45,24,14,5861,16384,-10523,-64.227294921875
45,24,15,42628,32768,9860,30.09033203125
45,25,1,0,2,-2,-100.0
45,25,2,2,4,-2,-50.0
45,25,3,6,8,-2,-25.0
45,25,4,25,16,9,56.25
45,25,5,48,32,16,50.0
45,25,6,9,64,-55,-85.9375
45,25,7,108,128,-20,-15.625
45,25,8,32,256,-224,-87.5
45,25,9,301,512,-211,-41.2109375
45,25,10,4272,1024,3248,317.1875
45,25,11,1602,2048,-446,-21.77734375
45,25,12,4966,4096,870,21.240234375
45,25,13,6551,8192,-1641,-20.03173828125
45,25,14,32838,16384,16454,100.42724609375
45,25,15,175,32768,-32593,-99.4659423828125
45,26,1,0,2,-2,-100.0
45,26,2,3,4,-1,-25.0
45,26,3,2,8,-6,-75.0
45,26,4,5,16,-11,-68.75
45,26,5,61,32,29,90.625
45,26,6,87,64,23,35.9375
45,26,7,24,128,-104,-81.25
45,26,8,167,256,-89,-34.765625
45,26,9,112,512,-400,-78.125
45,26,10,54,1024,-970,-94.7265625
45,26,11,908,2048,-1140,-55.6640625
45,26,12,929,4096,-3167,-77.3193359375
45,26,13,10949,8192,2757,33.65478515625
45,26,14,1639,16384,-14745,-89.996337890625
45,26,15,12923,32768,-19845,-60.5621337890625
45,27,1,0,2,-2,-100.0
45,27,2,3,4,-1,-25.0
45,27,3,13,8,5,62.5
45,27,4,33,16,17,106.25
45,27,5,80,32,48,150.0
45,27,6,33,64,-31,-48.4375
45,27,7,90,128,-38,-29.6875
45,27,8,530,256,274,107.03125
45,27,9,676,512,164,32.03125
45,27,10,162,1024,-862,-84.1796875
45,27,11,510,2048,-1538,-75.09765625
45,27,12,13761,4096,9665,235.9619140625
45,27,13,7159,8192,-1033,-12.60986328125
45,27,14,23398,16384,7014,42.81005859375
45,27,15,17771,32768,-14997,-45.7672119140625
45,28,1,0,2,-2,-100.0
45,28,2,1,4,-3,-75.0
45,28,3,9,8,1,12.5
45,28,4,7,16,-9,-56.25
45,28,5,5,32,-27,-84.375
45,28,6,5,64,-59,-92.1875
45,28,7,19,128,-109,-85.15625
45,28,8,513,256,257,100.390625
45,28,9,337,512,-175,-34.1796875
45,28,10,2990,1024,1966,191.9921875
45,28,11,848,2048,-1200,-58.59375
45,28,12,18,4096,-4078,-99.560546875
45,28,13,1135,8192,-7057,-86.14501953125
45,28,14,4115,16384,-12269,-74.884033203125
45,28,15,55373,32768,22605,68.9849853515625
45,29,1,0,2,-2,-100.0
45,29,2,1,4,-3,-75.0
45,29,3,18,8,10,125.0
45,29,4,5,16,-11,-68.75
45,29,5,33,32,1,3.125
45,29,6,5,64,-59,-92.1875
45,29,7,19,128,-109,-85.15625
45,29,8,568,256,312,121.875
45,29,9,526,512,14,2.734375
45,29,10,272,1024,-752,-73.4375
45,29,11,4321,2048,2273,110.986328125
45,29,12,95,4096,-4001,-97.6806640625
45,29,13,32893,8192,24701,301.52587890625
45,29,14,23747,16384,7363,44.940185546875
45,29,15,45612,32768,12844,39.19677734375
45,30,1,0,2,-2,-100.0
45,30,2,2,4,-2,-50.0
45,30,3,3,8,-5,-62.5
45,30,4,13,16,-3,-18.75
45,30,5,7,32,-25,-78.125
45,30,6,12,64,-52,-81.25
45,30,7,440,128,312,243.75
45,30,8,47,256,-209,-81.640625
45,30,9,294,512,-218,-42.578125
45,30,10,243,1024,-781,-76.26953125
45,30,11,1491,2048,-557,-27.197265625
45,30,12,2137,4096,-1959,-47.8271484375
45,30,13,2547,8192,-5645,-68.90869140625
45,30,14,13692,16384,-2692,-16.4306640625
45,30,15,18085,32768,-14683,-44.8089599609375
45,31,1,0,2,-2,-100.0
45,31,2,6,4,2,50.0
45,31,3,13,8,5,62.5
45,31,4,12,16,-4,-25.0
45,31,5,32,32,0,0.0
45,31,6,13,64,-51,-79.6875
45,31,7,72,128,-56,-43.75
45,31,8,244,256,-12,-4.6875
45,31,9,1069,512,557,108.7890625
45,31,10,1643,1024,619,60.44921875
45,31,11,245,2048,-1803,-88.037109375
45,31,12,5384,4096,1288,31.4453125
45,31,13,24824,8192,16632,203.02734375
45,31,14,23180,16384,6796,41.4794921875
45,31,15,101063,32768,68295,208.4197998046875
45,32,1,0,2,-2,-100.0
45,32,2,3,4,-1,-25.0
45,32,3,4,8,-4,-50.0
45,32,4,16,16,0,0.0
45,32,5,8,32,-24,-75.0
45,32,6,153,64,89,139.0625
45,32,7,7,128,-121,-94.53125
45,32,8,27,256,-229,-89.453125
45,32,9,35,512,-477,-93.1640625
45,32,10,160,1024,-864,-84.375
45,32,11,839,2048,-1209,-59.033203125
45,32,12,180,4096,-3916,-95.60546875
45,32,13,13769,8192,5577,68.07861328125
45,32,14,28906,16384,12522,76.42822265625
45,32,15,41431,32768,8663,26.4373779296875
45,33,1,0,2,-2,-100.0
45,33,2,1,4,-3,-75.0
45,33,3,6,8,-2,-25.0
45,33,4,5,16,-11,-68.75
45,33,5,18,32,-14,-43.75
45,33,6,154,64,90,140.625
45,33,7,148,128,20,15.625
45,33,8,533,256,277,108.203125
45,33,9,297,512,-215,-41.9921875
45,33,10,1423,1024,399,38.96484375
45,33,11,690,2048,-1358,-66.30859375
45,33,12,7156,4096,3060,74.70703125
45,33,13,4198,8192,-3994,-48.7548828125
45,33,14,7494,16384,-8890,-54.26025390625
45,33,15,46145,32768,13377,40.8233642578125
45,34,1,0,2,-2,-100.0
45,34,2,2,4,-2,-50.0
45,34,3,2,8,-6,-75.0
45,34,4,25,16,9,56.25
45,34,5,38,32,6,18.75
45,34,6,62,64,-2,-3.125
45,34,7,12,128,-116,-90.625
45,34,8,472,256,216,84.375
45,34,9,186,512,-326,-63.671875
45,34,10,2110,1024,1086,106.0546875
45,34,11,364,2048,-1684,-82.2265625
45,34,12,1332,4096,-2764,-67.48046875
45,34,13,1951,8192,-6241,-76.18408203125
45,34,14,1940,16384,-14444,-88.1591796875
45,34,15,4327,32768,-28441,-86.7950439453125
45,35,1,0,2,-2,-100.0
45,35,2,1,4,-3,-75.0
45,35,3,4,8,-4,-50.0
45,35,4,9,16,-7,-43.75
45,35,5,4,32,-28,-87.5
45,35,6,262,64,198,309.375
45,35,7,75,128,-53,-41.40625
45,35,8,34,256,-222,-86.71875
45,35,9,9,512,-503,-98.2421875
45,35,10,1005,1024,-19,-1.85546875
45,35,11,848,2048,-1200,-58.59375
45,35,12,562,4096,-3534,-86.279296875
45,35,13,4039,8192,-4153,-50.69580078125
45,35,14,2367,16384,-14017,-85.552978515625
45,35,15,15453,32768,-17315,-52.8411865234375
45,36,1,0,2,-2,-100.0
45,36,2,4,4,0,0.0
45,36,3,2,8,-6,-75.0
45,36,4,17,16,1,6.25
45,36,5,31,32,-1,-3.125
45,36,6,63,64,-1,-1.5625
45,36,7,166,128,38,29.6875
45,36,8,112,256,-144,-56.25
45,36,9,66,512,-446,-87.109375
45,36,10,85,1024,-939,-91.69921875
45,36,11,3868,2048,1820,88.8671875
45,36,12,5676,4096,1580,38.57421875
45,36,13,4820,8192,-3372,-41.162109375
45,36,14,12851,16384,-3533,-21.563720703125
45,36,15,5555,32768,-27213,-83.0474853515625
45,37,1,0,2,-2,-100.0
45,37,2,1,4,-3,-75.0
45,37,3,2,8,-6,-75.0
45,37,4,10,16,-6,-37.5
45,37,5,6,32,-26,-81.25
45,37,6,19,64,-45,-70.3125
45,37,7,126,128,-2,-1.5625
45,37,8,28,256,-228,-89.0625
45,37,9,74,512,-438,-85.546875
45,37,10,249,1024,-775,-75.68359375
45,37,11,356,2048,-1692,-82.6171875
45,37,12,3037,4096,-1059,-25.8544921875
45,37,13,5714,8192,-2478,-30.2490234375
45,37,14,1540,16384,-14844,-90.6005859375
45,37,15,28834,32768,-3934,-12.005615234375
45,38,1,0,2,-2,-100.0
45,38,2,2,4,-2,-50.0
45,38,3,5,8,-3,-37.5
45,38,4,6,16,-10,-62.5
45,38,5,23,32,-9,-28.125
45,38,6,78,64,14,21.875
45,38,7,67,128,-61,-47.65625
45,38,8,118,256,-138,-53.90625
45,38,9,97,512,-415,-81.0546875
45,38,10,676,1024,-348,-33.984375
45,38,11,148,2048,-1900,-92.7734375
45,38,12,11665,4096,7569,184.7900390625
45,38,13,1995,8192,-6197,-75.64697265625
45,38,14,7446,16384,-8938,-54.55322265625
45,38,15,36305,32768,3537,10.7940673828125
45,39,1,0,2,-2,-100.0
45,39,2,4,4,0,0.0
45,39,3,5,8,-3,-37.5
45,39,4,10,16,-6,-37.5
45,39,5,24,32,-8,-25.0
45,39,6,17,64,-47,-73.4375
45,39,7,25,128,-103,-80.46875
45,39,8,11,256,-245,-95.703125
45,39,9,822,512,310,60.546875
45,39,10,1311,1024,287,28.02734375
45,39,11,3830,2048,1782,87.01171875
45,39,12,84,4096,-4012,-97.94921875
45,39,13,8766,8192,574,7.0068359375
45,39,14,4306,16384,-12078,-73.71826171875
45,39,15,11670,32768,-21098,-64.385986328125
45,40,1,0,2,-2,-100.0
45,40,2,7,4,3,75.0
45,40,3,2,8,-6,-75.0
45,40,4,12,16,-4,-25.0
45,40,5,13,32,-19,-59.375
45,40,6,59,64,-5,-7.8125
45,40,7,380,128,252,196.875
45,40,8,97,256,-159,-62.109375
45,40,9,288,512,-224,-43.75
45,40,10,1137,1024,113,11.03515625
45,40,11,2198,2048,150,7.32421875
45,40,12,758,4096,-3338,-81.494140625
45,40,13,13420,8192,5228,63.818359375
45,40,14,23077,16384,6693,40.850830078125
45,40,15,2718,32768,-30050,-91.705322265625
45,41,1,0,2,-2,-100.0
45,41,2,1,4,-3,-75.0
45,41,3,2,8,-6,-75.0
45,41,4,14,16,-2,-12.5
45,41,5,7,32,-25,-78.125
45,41,6,73,64,9,14.0625
45,41,7,72,128,-56,-43.75
45,41,8,143,256,-113,-44.140625
45,41,9,251,512,-261,-50.9765625
45,41,10,220,1024,-804,-78.515625
45,41,11,852,2048,-1196,-58.3984375
45,41,12,2005,4096,-2091,-51.0498046875
45,41,13,7062,8192,-1130,-13.7939453125
45,41,14,47448,16384,31064,189.599609375
45,41,15,15730,32768,-17038,-51.995849609375
45,42,1,0,2,-2,-100.0
45,42,2,4,4,0,0.0
45,42,3,4,8,-4,-50.0
45,42,4,6,16,-10,-62.5
45,42,5,46,32,14,43.75
45,42,6,14,64,-50,-78.125
45,42,7,58,128,-70,-54.6875
45,42,8,364,256,108,42.1875
45,42,9,59,512,-453,-88.4765625
45,42,10,686,1024,-338,-33.0078125
45,42,11,479,2048,-1569,-76.611328125
45,42,12,162,4096,-3934,-96.044921875
45,42,13,613,8192,-7579,-92.51708984375
45,42,14,13961,16384,-2423,-14.788818359375
45,42,15,33623,32768,855,2.6092529296875
45,43,1,0,2,-2,-100.0
45,43,2,1,4,-3,-75.0
45,43,3,12,8,4,50.0
45,43,4,3,16,-13,-81.25
45,43,5,9,32,-23,-71.875
45,43,6,164,64,100,156.25
45,43,7,234,128,106,82.8125
45,43,8,93,256,-163,-63.671875
45,43,9,949,512,437,85.3515625
45,43,10,304,1024,-720,-70.3125
45,43,11,235,2048,-1813,-88.525390625
45,43,12,114,4096,-3982,-97.216796875
45,43,13,591,8192,-7601,-92.78564453125
45,43,14,28810,16384,12426,75.84228515625
45,43,15,20327,32768,-12441,-37.9669189453125
45,44,1,0,2,-2,-100.0
45,44,2,1,4,-3,-75.0
45,44,3,6,8,-2,-25.0
45,44,4,24,16,8,50.0
45,44,5,55,32,23,71.875
45,44,6,89,64,25,39.0625
45,44,7,86,128,-42,-32.8125
45,44,8,835,256,579,226.171875
45,44,9,546,512,34,6.640625
45,44,10,1685,1024,661,64.55078125
45,44,11,1080,2048,-968,-47.265625
45,44,12,451,4096,-3645,-88.9892578125
45,44,13,2607,8192,-5585,-68.17626953125
45,44,14,4860,16384,-11524,-70.3369140625
45,44,15,7445,32768,-25323,-77.2796630859375
45,45,1,0,2,-2,-100.0
45,45,2,3,4,-1,-25.0
45,45,3,6,8,-2,-25.0
45,45,4,20,16,4,25.0
45,45,5,6,32,-26,-81.25
45,45,6,65,64,1,1.5625
45,45,7,130,128,2,1.5625
45,45,8,108,256,-148,-57.8125
45,45,9,468,512,-44,-8.59375
45,45,10,1071,1024,47,4.58984375
45,45,11,1671,2048,-377,-18.408203125
45,45,12,2966,4096,-1130,-27.587890625
45,45,13,191,8192,-8001,-97.66845703125
45,45,14,544,16384,-15840,-96.6796875
45,45,15,46208,32768,13440,41.015625
46,1,1,0,2,-2,-100.0
46,1,2,2,4,-2,-50.0
46,1,3,2,8,-6,-75.0
46,1,4,52,16,36,225.0
46,1,5,5,32,-27,-84.375
46,1,6,157,64,93,145.3125
46,1,7,143,128,15,11.71875
46,1,8,23,256,-233,-91.015625
46,1,9,373,512,-139,-27.1484375
46,1,10,1934,1024,910,88.8671875
46,1,11,882,2048,-1166,-56.93359375
46,1,12,7608,4096,3512,85.7421875
46,1,13,1422,8192,-6770,-82.6416015625
46,1,14,16531,16384,147,0.897216796875
46,1,15,9329,32768,-23439,-71.5301513671875
46,2,1,0,2,-2,-100.0
46,2,2,2,4,-2,-50.0
46,2,3,7,8,-1,-12.5
46,2,4,14,16,-2,-12.5
46,2,5,14,32,-18,-56.25
46,2,6,35,64,-29,-45.3125
46,2,7,375,128,247,192.96875
46,2,8,97,256,-159,-62.109375
46,2,9,61,512,-451,-88.0859375
46,2,10,1678,1024,654,63.8671875
46,2,11,2435,2048,387,18.896484375
46,2,12,3833,4096,-263,-6.4208984375
46,2,13,1352,8192,-6840,-83.49609375
46,2,14,44740,16384,28356,173.0712890625
46,2,15,44324,32768,11556,35.26611328125
46,3,1,0,2,-2,-100.0
46,3,2,4,4,0,0.0
46,3,3,4,8,-4,-50.0
46,3,4,8,16,-8,-50.0
46,3,5,54,32,22,68.75
46,3,6,46,64,-18,-28.125
46,3,7,52,128,-76,-59.375
46,3,8,41,256,-215,-83.984375
46,3,9,527,512,15,2.9296875
46,3,10,667,1024,-357,-34.86328125
46,3,11,1875,2048,-173,-8.447265625
46,3,12,3778,4096,-318,-7.763671875
46,3,13,9774,8192,1582,19.3115234375
46,3,14,63227,16384,46843,285.906982421875
46,3,15,21301,32768,-11467,-34.9945068359375
46,4,1,0,2,-2,-100.0
46,4,2,7,4,3,75.0
46,4,3,9,8,1,12.5
46,4,4,12,16,-4,-25.0
46,4,5,15,32,-17,-53.125
46,4,6,50,64,-14,-21.875
46,4,7,41,128,-87,-67.96875
46,4,8,58,256,-198,-77.34375
46,4,9,642,512,130,25.390625
46,4,10,1354,1024,330,32.2265625
46,4,11,5112,2048,3064,149.609375
46,4,12,1001,4096,-3095,-75.5615234375
46,4,13,2068,8192,-6124,-74.755859375
46,4,14,279,16384,-16105,-98.297119140625
46,4,15,36702,32768,3934,12.005615234375
46,5,1,0,2,-2,-100.0
46,5,2,2,4,-2,-50.0
46,5,3,2,8,-6,-75.0
46,5,4,4,16,-12,-75.0
46,5,5,28,32,-4,-12.5
46,5,6,52,64,-12,-18.75
46,5,7,29,128,-99,-77.34375
46,5,8,793,256,537,209.765625
46,5,9,618,512,106,20.703125
46,5,10,433,1024,-591,-57.71484375
46,5,11,4523,2048,2475,120.849609375
46,5,12,9867,4096,5771,140.8935546875
46,5,13,1279,8192,-6913,-84.38720703125
46,5,14,4770,16384,-11614,-70.88623046875
46,5,15,8484,32768,-24284,-74.10888671875
46,6,1,0,2,-2,-100.0
46,6,2,1,4,-3,-75.0
46,6,3,3,8,-5,-62.5
46,6,4,16,16,0,0.0
46,6,5,24,32,-8,-25.0
46,6,6,61,64,-3,-4.6875
46,6,7,6,128,-122,-95.3125
46,6,8,716,256,460,179.6875
46,6,9,429,512,-83,-16.2109375
46,6,10,1320,1024,296,28.90625
46,6,11,1176,2048,-872,-42.578125
46,6,12,1564,4096,-2532,-61.81640625
46,6,13,4852,8192,-3340,-40.771484375
46,6,14,6196,16384,-10188,-62.1826171875
46,6,15,10372,32768,-22396,-68.34716796875
46,7,1,0,2,-2,-100.0
46,7,2,2,4,-2,-50.0
46,7,3,4,8,-4,-50.0
46,7,4,6,16,-10,-62.5
46,7,5,21,32,-11,-34.375
46,7,6,129,64,65,101.5625
46,7,7,7,128,-121,-94.53125
46,7,8,155,256,-101,-39.453125
46,7,9,282,512,-230,-44.921875
46,7,10,533,1024,-491,-47.94921875
46,7,11,43,2048,-2005,-97.900390625
46,7,12,5471,4096,1375,33.5693359375
46,7,13,8245,8192,53,0.64697265625
46,7,14,2944,16384,-13440,-82.03125
46,7,15,25520,32768,-7248,-22.119140625
46,8,1,0,2,-2,-100.0
46,8,2,1,4,-3,-75.0
46,8,3,7,8,-1,-12.5
46,8,4,21,16,5,31.25
46,8,5,14,32,-18,-56.25
46,8,6,17,64,-47,-73.4375
46,8,7,90,128,-38,-29.6875
46,8,8,71,256,-185,-72.265625
46,8,9,181,512,-331,-64.6484375
46,8,10,2262,1024,1238,120.8984375
46,8,11,2452,2048,404,19.7265625
46,8,12,11554,4096,7458,182.080078125
46,8,13,8366,8192,174,2.1240234375
46,8,14,18286,16384,1902,11.60888671875
46,8,15,24071,32768,-8697,-26.5411376953125
46,9,1,0,2,-2,-100.0
46,9,2,2,4,-2,-50.0
46,9,3,10,8,2,25.0
46,9,4,22,16,6,37.5
46,9,5,13,32,-19,-59.375
46,9,6,49,64,-15,-23.4375
46,9,7,40,128,-88,-68.75
46,9,8,7,256,-249,-97.265625
46,9,9,86,512,-426,-83.203125
46,9,10,969,1024,-55,-5.37109375
46,9,11,539,2048,-1509,-73.681640625
46,9,12,984,4096,-3112,-75.9765625
46,9,13,2871,8192,-5321,-64.95361328125
46,9,14,25411,16384,9027,55.096435546875
46,9,15,21078,32768,-11690,-35.675048828125
46,10,1,0,2,-2,-100.0
46,10,2,3,4,-1,-25.0
46,10,3,5,8,-3,-37.5
46,10,4,15,16,-1,-6.25
46,10,5,48,32,16,50.0
46,10,6,31,64,-33,-51.5625
46,10,7,10,128,-118,-92.1875
46,10,8,1225,256,969,378.515625
46,10,9,590,512,78,15.234375
46,10,10,3279,1024,2255,220.21484375
46,10,11,1474,2048,-574,-28.02734375
46,10,12,3177,4096,-919,-22.4365234375
46,10,13,17830,8192,9638,117.6513671875
46,10,14,20206,16384,3822,23.32763671875
46,10,15,22207,32768,-10561,-32.2296142578125
46,11,1,0,2,-2,-100.0
46,11,2,1,4,-3,-75.0
46,11,3,3,8,-5,-62.5
46,11,4,16,16,0,0.0
46,11,5,4,32,-28,-87.5
46,11,6,43,64,-21,-32.8125
46,11,7,67,128,-61,-47.65625
46,11,8,76,256,-180,-70.3125
46,11,9,1033,512,521,101.7578125
46,11,10,1352,1024,328,32.03125
46,11,11,646,2048,-1402,-68.45703125
46,11,12,2486,4096,-1610,-39.306640625
46,11,13,990,8192,-7202,-87.9150390625
46,11,14,8175,16384,-8209,-50.103759765625
46,11,15,30353,32768,-2415,-7.3699951171875
46,12,1,0,2,-2,-100.0
46,12,2,3,4,-1,-25.0
46,12,3,2,8,-6,-75.0
46,12,4,13,16,-3,-18.75
46,12,5,23,32,-9,-28.125
46,12,6,5,64,-59,-92.1875
46,12,7,330,128,202,157.8125
46,12,8,160,256,-96,-37.5
46,12,9,61,512,-451,-88.0859375
46,12,10,264,1024,-760,-74.21875
46,12,11,2310,2048,262,12.79296875
46,12,12,4381,4096,285,6.9580078125
46,12,13,13041,8192,4849,59.19189453125
46,12,14,1374,16384,-15010,-91.61376953125
46,12,15,34137,32768,1369,4.1778564453125
46,13,1,0,2,-2,-100.0
46,13,2,1,4,-3,-75.0
46,13,3,4,8,-4,-50.0
46,13,4,3,16,-13,-81.25
46,13,5,4,32,-28,-87.5
46,13,6,18,64,-46,-71.875
46,13,7,116,128,-12,-9.375
46,13,8,92,256,-164,-64.0625
46,13,9,485,512,-27,-5.2734375
46,13,10,2735,1024,1711,167.08984375
46,13,11,1789,2048,-259,-12.646484375
46,13,12,9652,4096,5556,135.64453125
46,13,13,1579,8192,-6613,-80.72509765625
46,13,14,3287,16384,-13097,-79.937744140625
46,13,15,3819,32768,-28949,-88.3453369140625
46,14,1,0,2,-2,-100.0
46,14,2,3,4,-1,-25.0
46,14,3,7,8,-1,-12.5
46,14,4,3,16,-13,-81.25
46,14,5,99,32,67,209.375
46,14,6,16,64,-48,-75.0
46,14,7,16,128,-112,-87.5
46,14,8,75,256,-181,-70.703125
46,14,9,432,512,-80,-15.625
46,14,10,648,1024,-376,-36.71875
46,14,11,217,2048,-1831,-89.404296875
46,14,12,275,4096,-3821,-93.2861328125
46,14,13,134,8192,-8058,-98.3642578125
46,14,14,8119,16384,-8265,-50.445556640625
46,14,15,13529,32768,-19239,-58.7127685546875
46,15,1,0,2,-2,-100.0
46,15,2,1,4,-3,-75.0
46,15,3,2,8,-6,-75.0
46,15,4,24,16,8,50.0
46,15,5,13,32,-19,-59.375
46,15,6,92,64,28,43.75
46,15,7,33,128,-95,-74.21875
46,15,8,18,256,-238,-92.96875
46,15,9,647,512,135,26.3671875
46,15,10,1775,1024,751,73.33984375
46,15,11,5586,2048,3538,172.75390625
46,15,12,782,4096,-3314,-80.908203125
46,15,13,540,8192,-7652,-93.408203125
46,15,14,1031,16384,-15353,-93.707275390625
46,15,15,87579,32768,54811,167.2698974609375
46,16,1,0,2,-2,-100.0
46,16,2,2,4,-2,-50.0
46,16,3,10,8,2,25.0
46,16,4,8,16,-8,-50.0
46,16,5,12,32,-20,-62.5
46,16,6,9,64,-55,-85.9375
46,16,7,128,128,0,0.0
46,16,8,434,256,178,69.53125
46,16,9,749,512,237,46.2890625
46,16,10,1261,1024,237,23.14453125
46,16,11,7257,2048,5209,254.345703125
46,16,12,1345,4096,-2751,-67.1630859375
46,16,13,3670,8192,-4522,-55.2001953125
46,16,14,6067,16384,-10317,-62.969970703125
46,16,15,50012,32768,17244,52.62451171875
46,17,1,0,2,-2,-100.0
46,17,2,2,4,-2,-50.0
46,17,3,4,8,-4,-50.0
46,17,4,16,16,0,0.0
46,17,5,20,32,-12,-37.5
46,17,6,91,64,27,42.1875
46,17,7,83,128,-45,-35.15625
46,17,8,1131,256,875,341.796875
46,17,9,419,512,-93,-18.1640625
46,17,10,159,1024,-865,-84.47265625
46,17,11,2925,2048,877,42.822265625
46,17,12,3750,4096,-346,-8.447265625
46,17,13,7073,8192,-1119,-13.65966796875
46,17,14,1320,16384,-15064,-91.943359375
46,17,15,99525,32768,66757,203.7261962890625
46,18,1,0,2,-2,-100.0
46,18,2,1,4,-3,-75.0
46,18,3,2,8,-6,-75.0
46,18,4,6,16,-10,-62.5
46,18,5,66,32,34,106.25
46,18,6,70,64,6,9.375
46,18,7,24,128,-104,-81.25
46,18,8,33,256,-223,-87.109375
46,18,9,161,512,-351,-68.5546875
46,18,10,1468,1024,444,43.359375
46,18,11,1383,2048,-665,-32.470703125
46,18,12,3221,4096,-875,-21.3623046875
46,18,13,23177,8192,14985,182.92236328125
46,18,14,18370,16384,1986,12.12158203125
46,18,15,103734,32768,70966,216.571044921875
46,19,1,0,2,-2,-100.0
46,19,2,1,4,-3,-75.0
46,19,3,8,8,0,0.0
46,19,4,6,16,-10,-62.5
46,19,5,8,32,-24,-75.0
46,19,6,21,64,-43,-67.1875
46,19,7,296,128,168,131.25
46,19,8,428,256,172,67.1875
46,19,9,924,512,412,80.46875
46,19,10,2273,1024,1249,121.97265625
46,19,11,6570,2048,4522,220.80078125
46,19,12,7771,4096,3675,89.7216796875
46,19,13,14273,8192,6081,74.23095703125
46,19,14,10756,16384,-5628,-34.3505859375
46,19,15,17013,32768,-15755,-48.0804443359375
46,20,1,0,2,-2,-100.0
46,20,2,1,4,-3,-75.0
46,20,3,2,8,-6,-75.0
46,20,4,12,16,-4,-25.0
46,20,5,66,32,34,106.25
46,20,6,84,64,20,31.25
46,20,7,197,128,69,53.90625
46,20,8,329,256,73,28.515625
46,20,9,47,512,-465,-90.8203125
46,20,10,1661,1024,637,62.20703125
46,20,11,1612,2048,-436,-21.2890625
46,20,12,1450,4096,-2646,-64.599609375
46,20,13,9304,8192,1112,13.57421875
46,20,14,42954,16384,26570,162.17041015625
46,20,15,48996,32768,16228,49.52392578125
46,21,1,0,2,-2,-100.0
46,21,2,1,4,-3,-75.0
46,21,3,5,8,-3,-37.5
46,21,4,10,16,-6,-37.5
46,21,5,28,32,-4,-12.5
46,21,6,26,64,-38,-59.375
46,21,7,26,128,-102,-79.6875
46,21,8,644,256,388,151.5625
46,21,9,67,512,-445,-86.9140625
46,21,10,44,1024,-980,-95.703125
46,21,11,601,2048,-1447,-70.654296875
46,21,12,928,4096,-3168,-77.34375
46,21,13,10964,8192,2772,33.837890625
46,21,14,25093,16384,8709,53.155517578125
46,21,15,13621,32768,-19147,-58.4320068359375
46,22,1,0,2,-2,-100.0
46,22,2,2,4,-2,-50.0
46,22,3,2,8,-6,-75.0
46,22,4,7,16,-9,-56.25
46,22,5,13,32,-19,-59.375
46,22,6,127,64,63,98.4375
46,22,7,104,128,-24,-18.75
46,22,8,84,256,-172,-67.1875
46,22,9,43,512,-469,-91.6015625
46,22,10,53,1024,-971,-94.82421875
46,22,11,234,2048,-1814,-88.57421875
46,22,12,590,4096,-3506,-85.595703125
46,22,13,1530,8192,-6662,-81.3232421875
46,22,14,61510,16384,45126,275.42724609375
46,22,15,67852,32768,35084,107.06787109375
46,23,1,0,2,-2,-100.0
46,23,2,2,4,-2,-50.0
46,23,3,2,8,-6,-75.0
46,23,4,8,16,-8,-50.0
46,23,5,24,32,-8,-25.0
46,23,6,80,64,16,25.0
46,23,7,117,128,-11,-8.59375
46,23,8,111,256,-145,-56.640625
46,23,9,1306,512,794,155.078125
46,23,10,355,1024,-669,-65.33203125
46,23,11,3475,2048,1427,69.677734375
46,23,12,240,4096,-3856,-94.140625
46,23,13,208,8192,-7984,-97.4609375
46,23,14,15315,16384,-1069,-6.524658203125
46,23,15,21936,32768,-10832,-33.056640625
46,24,1,0,2,-2,-100.0
46,24,2,4,4,0,0.0
46,24,3,2,8,-6,-75.0
46,24,4,20,16,4,25.0
46,24,5,25,32,-7,-21.875
46,24,6,45,64,-19,-29.6875
46,24,7,154,128,26,20.3125
46,24,8,220,256,-36,-14.0625
46,24,9,279,512,-233,-45.5078125
46,24,10,345,1024,-679,-66.30859375
46,24,11,1418,2048,-630,-30.76171875
46,24,12,281,4096,-3815,-93.1396484375
46,24,13,8658,8192,466,5.6884765625
46,24,14,24555,16384,8171,49.871826171875
46,24,15,40190,32768,7422,22.650146484375
46,25,1,0,2,-2,-100.0
46,25,2,3,4,-1,-25.0
46,25,3,4,8,-4,-50.0
46,25,4,22,16,6,37.5
46,25,5,39,32,7,21.875
46,25,6,117,64,53,82.8125
46,25,7,115,128,-13,-10.15625
46,25,8,358,256,102,39.84375
46,25,9,97,512,-415,-81.0546875
46,25,10,155,1024,-869,-84.86328125
46,25,11,2138,2048,90,4.39453125
46,25,12,1449,4096,-2647,-64.6240234375
46,25,13,9603,8192,1411,17.22412109375
46,25,14,43301,16384,26917,164.288330078125
46,25,15,25347,32768,-7421,-22.6470947265625
46,26,1,0,2,-2,-100.0
46,26,2,2,4,-2,-50.0
46,26,3,11,8,3,37.5
46,26,4,10,16,-6,-37.5
46,26,5,56,32,24,75.0
46,26,6,122,64,58,90.625
46,26,7,22,128,-106,-82.8125
46,26,8,160,256,-96,-37.5
46,26,9,755,512,243,47.4609375
46,26,10,672,1024,-352,-34.375
46,26,11,75,2048,-1973,-96.337890625
46,26,12,12925,4096,8829,215.5517578125
46,26,13,3231,8192,-4961,-60.55908203125
46,26,14,7711,16384,-8673,-52.935791015625
46,26,15,25124,32768,-7644,-23.32763671875
46,27,1,0,2,-2,-100.0
46,27,2,1,4,-3,-75.0
46,27,3,4,8,-4,-50.0
46,27,4,36,16,20,125.0
46,27,5,8,32,-24,-75.0
46,27,6,38,64,-26,-40.625
46,27,7,189,128,61,47.65625
46,27,8,464,256,208,81.25
46,27,9,1355,512,843,164.6484375
46,27,10,957,1024,-67,-6.54296875
46,27,11,3529,2048,1481,72.314453125
46,27,12,4001,4096,-95,-2.3193359375
46,27,13,9983,8192,1791,21.86279296875
46,27,14,13487,16384,-2897,-17.681884765625
46,27,15,78799,32768,46031,140.4754638671875
46,28,1,0,2,-2,-100.0
46,28,2,2,4,-2,-50.0
46,28,3,6,8,-2,-25.0
46,28,4,17,16,1,6.25
46,28,5,30,32,-2,-6.25
46,28,6,21,64,-43,-67.1875
46,28,7,222,128,94,73.4375
46,28,8,175,256,-81,-31.640625
46,28,9,259,512,-253,-49.4140625
46,28,10,4645,1024,3621,353.61328125
46,28,11,478,2048,-1570,-76.66015625
46,28,12,1039,4096,-3057,-74.6337890625
46,28,13,10430,8192,2238,27.3193359375
46,28,14,37931,16384,21547,131.512451171875
46,28,15,46117,32768,13349,40.7379150390625
46,29,1,0,2,-2,-100.0
46,29,2,4,4,0,0.0
46,29,3,2,8,-6,-75.0
46,29,4,20,16,4,25.0
46,29,5,21,32,-11,-34.375
46,29,6,54,64,-10,-15.625
46,29,7,37,128,-91,-71.09375
46,29,8,87,256,-169,-66.015625
46,29,9,566,512,54,10.546875
46,29,10,2778,1024,1754,171.2890625
46,29,11,402,2048,-1646,-80.37109375
46,29,12,3676,4096,-420,-10.25390625
46,29,13,465,8192,-7727,-94.32373046875
46,29,14,20656,16384,4272,26.07421875
46,29,15,27724,32768,-5044,-15.39306640625
46,30,1,0,2,-2,-100.0
46,30,2,1,4,-3,-75.0
46,30,3,6,8,-2,-25.0
46,30,4,5,16,-11,-68.75
46,30,5,42,32,10,31.25
46,30,6,38,64,-26,-40.625
46,30,7,62,128,-66,-51.5625
46,30,8,28,256,-228,-89.0625
46,30,9,495,512,-17,-3.3203125
46,30,10,258,1024,-766,-74.8046875
46,30,11,4557,2048,2509,122.509765625
46,30,12,20661,4096,16565,404.4189453125
46,30,13,8132,8192,-60,-0.732421875
46,30,14,1900,16384,-14484,-88.4033203125
46,30,15,29046,32768,-3722,-11.358642578125
46,31,1,0,2,-2,-100.0
46,31,2,2,4,-2,-50.0
46,31,3,5,8,-3,-37.5
46,31,4,7,16,-9,-56.25
46,31,5,17,32,-15,-46.875
46,31,6,23,64,-41,-64.0625
46,31,7,95,128,-33,-25.78125
46,31,8,368,256,112,43.75
46,31,9,86,512,-426,-83.203125
46,31,10,1596,1024,572,55.859375
46,31,11,2337,2048,289,14.111328125
46,31,12,1417,4096,-2679,-65.4052734375
46,31,13,4254,8192,-3938,-48.0712890625
46,31,14,21914,16384,5530,33.75244140625
46,31,15,68594,32768,35826,109.332275390625
46,32,1,0,2,-2,-100.0
46,32,2,3,4,-1,-25.0
46,32,3,5,8,-3,-37.5
46,32,4,37,16,21,131.25
46,32,5,55,32,23,71.875
46,32,6,6,64,-58,-90.625
46,32,7,93,128,-35,-27.34375
46,32,8,219,256,-37,-14.453125
46,32,9,330,512,-182,-35.546875
46,32,10,493,1024,-531,-51.85546875
46,32,11,390,2048,-1658,-80.95703125
46,32,12,12418,4096,8322,203.173828125
46,32,13,11050,8192,2858,34.8876953125
46,32,14,22007,16384,5623,34.320068359375
46,32,15,69607,32768,36839,112.4237060546875
46,33,1,0,2,-2,-100.0
46,33,2,2,4,-2,-50.0
46,33,3,2,8,-6,-75.0
46,33,4,6,16,-10,-62.5
46,33,5,14,32,-18,-56.25
46,33,6,5,64,-59,-92.1875
46,33,7,213,128,85,66.40625
46,33,8,79,256,-177,-69.140625
46,33,9,798,512,286,55.859375
46,33,10,468,1024,-556,-54.296875
46,33,11,3350,2048,1302,63.57421875
46,33,12,1590,4096,-2506,-61.181640625
46,33,13,2115,8192,-6077,-74.18212890625
46,33,14,18760,16384,2376,14.501953125
46,33,15,53370,32768,20602,62.872314453125
46,34,1,0,2,-2,-100.0
46,34,2,1,4,-3,-75.0
46,34,3,2,8,-6,-75.0
46,34,4,7,16,-9,-56.25
46,34,5,28,32,-4,-12.5
46,34,6,64,64,0,0.0
46,34,7,337,128,209,163.28125
46,34,8,285,256,29,11.328125
46,34,9,607,512,95,18.5546875
46,34,10,1046,1024,22,2.1484375
46,34,11,397,2048,-1651,-80.615234375
46,34,12,1014,4096,-3082,-75.244140625
46,34,13,3735,8192,-4457,-54.40673828125
46,34,14,10129,16384,-6255,-38.177490234375
46,34,15,18945,32768,-13823,-42.1844482421875
46,35,1,0,2,-2,-100.0
46,35,2,1,4,-3,-75.0
46,35,3,3,8,-5,-62.5
46,35,4,5,16,-11,-68.75
46,35,5,11,32,-21,-65.625
46,35,6,85,64,21,32.8125
46,35,7,106,128,-22,-17.1875
46,35,8,88,256,-168,-65.625
46,35,9,1253,512,741,144.7265625
46,35,10,1015,1024,-9,-0.87890625
46,35,11,6447,2048,4399,214.794921875
46,35,12,2508,4096,-1588,-38.76953125
46,35,13,2789,8192,-5403,-65.95458984375
46,35,14,28981,16384,12597,76.885986328125
46,35,15,603,32768,-32165,-98.1597900390625
46,36,1,0,2,-2,-100.0
46,36,2,1,4,-3,-75.0
46,36,3,4,8,-4,-50.0
46,36,4,3,16,-13,-81.25
46,36,5,4,32,-28,-87.5
46,36,6,6,64,-58,-90.625
46,36,7,46,128,-82,-64.0625
46,36,8,11,256,-245,-95.703125
46,36,9,448,512,-64,-12.5
46,36,10,120,1024,-904,-88.28125
46,36,11,2229,2048,181,8.837890625
46,36,12,970,4096,-3126,-76.318359375
46,36,13,16583,8192,8391,102.42919921875
46,36,14,62809,16384,46425,283.355712890625
46,36,15,15775,32768,-16993,-51.8585205078125
46,37,1,0,2,-2,-100.0
46,37,2,3,4,-1,-25.0
46,37,3,5,8,-3,-37.5
46,37,4,24,16,8,50.0
46,37,5,54,32,22,68.75
46,37,6,243,64,179,279.6875
46,37,7,358,128,230,179.6875
46,37,8,242,256,-14,-5.46875
46,37,9,942,512,430,83.984375
46,37,10,1299,1024,275,26.85546875
46,37,11,944,2048,-1104,-53.90625
46,37,12,1038,4096,-3058,-74.658203125
46,37,13,3225,8192,-4967,-60.63232421875
46,37,14,17749,16384,1365,8.331298828125
46,37,15,11568,32768,-21200,-64.697265625
46,38,1,0,2,-2,-100.0
46,38,2,3,4,-1,-25.0
46,38,3,8,8,0,0.0
46,38,4,4,16,-12,-75.0
46,38,5,29,32,-3,-9.375
46,38,6,138,64,74,115.625
46,38,7,37,128,-91,-71.09375
46,38,8,366,256,110,42.96875
46,38,9,1282,512,770,150.390625
46,38,10,1509,1024,485,47.36328125
46,38,11,1114,2048,-934,-45.60546875
46,38,12,3982,4096,-114,-2.783203125
46,38,13,3647,8192,-4545,-55.48095703125
46,38,14,34164,16384,17780,108.5205078125
46,38,15,56490,32768,23722,72.393798828125
46,39,1,0,2,-2,-100.0
46,39,2,2,4,-2,-50.0
46,39,3,13,8,5,62.5
46,39,4,15,16,-1,-6.25
46,39,5,31,32,-1,-3.125
46,39,6,50,64,-14,-21.875
46,39,7,93,128,-35,-27.34375
46,39,8,102,256,-154,-60.15625
46,39,9,531,512,19,3.7109375
46,39,10,268,1024,-756,-73.828125
46,39,11,159,2048,-1889,-92.236328125
46,39,12,5118,4096,1022,24.951171875
46,39,13,59862,8192,51670,630.7373046875
46,39,14,121,16384,-16263,-99.261474609375
46,39,15,48554,32768,15786,48.175048828125
46,40,1,0,2,-2,-100.0
46,40,2,2,4,-2,-50.0
46,40,3,2,8,-6,-75.0
46,40,4,20,16,4,25.0
46,40,5,69,32,37,115.625
46,40,6,21,64,-43,-67.1875
46,40,7,82,128,-46,-35.9375
46,40,8,135,256,-121,-47.265625
46,40,9,173,512,-339,-66.2109375
46,40,10,1306,1024,282,27.5390625
46,40,11,1945,2048,-103,-5.029296875
46,40,12,332,4096,-3764,-91.89453125
46,40,13,10109,8192,1917,23.40087890625
46,40,14,26312,16384,9928,60.595703125
46,40,15,40593,32768,7825,23.8800048828125
46,41,1,0,2,-2,-100.0
46,41,2,2,4,-2,-50.0
46,41,3,8,8,0,0.0
46,41,4,8,16,-8,-50.0
46,41,5,5,32,-27,-84.375
46,41,6,27,64,-37,-57.8125
46,41,7,167,128,39,30.46875
46,41,8,319,256,63,24.609375
46,41,9,913,512,401,78.3203125
46,41,10,774,1024,-250,-24.4140625
46,41,11,29,2048,-2019,-98.583984375
46,41,12,2296,4096,-1800,-43.9453125
46,41,13,19539,8192,11347,138.51318359375
46,41,14,66670,16384,50286,306.92138671875
46,41,15,9277,32768,-23491,-71.6888427734375
46,42,1,0,2,-2,-100.0
46,42,2,3,4,-1,-25.0
46,42,3,3,8,-5,-62.5
46,42,4,10,16,-6,-37.5
46,42,5,12,32,-20,-62.5
46,42,6,55,64,-9,-14.0625
46,42,7,343,128,215,167.96875
46,42,8,136,256,-120,-46.875
46,42,9,45,512,-467,-91.2109375
46,42,10,771,1024,-253,-24.70703125
46,42,11,1887,2048,-161,-7.861328125
46,42,12,14390,4096,10294,251.318359375
46,42,13,1890,8192,-6302,-76.9287109375
46,42,14,4680,16384,-11704,-71.435546875
46,42,15,55605,32768,22837,69.6929931640625
46,43,1,0,2,-2,-100.0
46,43,2,1,4,-3,-75.0
46,43,3,3,8,-5,-62.5
46,43,4,6,16,-10,-62.5
46,43,5,44,32,12,37.5
46,43,6,32,64,-32,-50.0
46,43,7,6,128,-122,-95.3125
46,43,8,72,256,-184,-71.875
46,43,9,33,512,-479,-93.5546875
46,43,10,3557,1024,2533,247.36328125
46,43,11,639,2048,-1409,-68.798828125
46,43,12,11183,4096,7087,173.0224609375
46,43,13,4640,8192,-3552,-43.359375
46,43,14,10902,16384,-5482,-33.45947265625
46,43,15,8578,32768,-24190,-73.822021484375
46,44,1,0,2,-2,-100.0
46,44,2,1,4,-3,-75.0
46,44,3,2,8,-6,-75.0
46,44,4,19,16,3,18.75
46,44,5,21,32,-11,-34.375
46,44,6,51,64,-13,-20.3125
46,44,7,165,128,37,28.90625
46,44,8,120,256,-136,-53.125
46,44,9,1078,512,566,110.546875
46,44,10,1437,1024,413,40.33203125
46,44,11,871,2048,-1177,-57.470703125
46,44,12,8438,4096,4342,106.005859375
46,44,13,2699,8192,-5493,-67.05322265625
46,44,14,43642,16384,27258,166.36962890625
46,44,15,43697,32768,10929,33.3526611328125
46,45,1,0,2,-2,-100.0
46,45,2,2,4,-2,-50.0
46,45,3,2,8,-6,-75.0
46,45,4,32,16,16,100.0
46,45,5,8,32,-24,-75.0
46,45,6,21,64,-43,-67.1875
46,45,7,16,128,-112,-87.5
46,45,8,654,256,398,155.46875
46,45,9,177,512,-335,-65.4296875
46,45,10,734,1024,-290,-28.3203125
46,45,11,1116,2048,-932,-45.5078125
46,45,12,5330,4096,1234,30.126953125
46,45,13,204,8192,-7988,-97.509765625
46,45,14,14239,16384,-2145,-13.092041015625
46,45,15,14535,32768,-18233,-55.6427001953125
46,46,1,0,2,-2,-100.0
46,46,2,5,4,1,25.0
46,46,3,2,8,-6,-75.0
46,46,4,11,16,-5,-31.25
46,46,5,17,32,-15,-46.875
46,46,6,36,64,-28,-43.75
46,46,7,470,128,342,267.1875
46,46,8,161,256,-95,-37.109375
46,46,9,170,512,-342,-66.796875
46,46,10,2621,1024,1597,155.95703125
46,46,11,244,2048,-1804,-88.0859375
46,46,12,3463,4096,-633,-15.4541015625
46,46,13,39775,8192,31583,385.53466796875
46,46,14,1512,16384,-14872,-90.771484375
46,46,15,23374,32768,-9394,-28.668212890625
47,1,1,0,2,-2,-100.0
47,1,2,1,4,-3,-75.0
47,1,3,2,8,-6,-75.0
47,1,4,11,16,-5,-31.25
47,1,5,5,32,-27,-84.375
47,1,6,97,64,33,51.5625
47,1,7,156,128,28,21.875
47,1,8,57,256,-199,-77.734375
47,1,9,62,512,-450,-87.890625
47,1,10,1646,1024,622,60.7421875
47,1,11,454,2048,-1594,-77.83203125
47,1,12,63,4096,-4033,-98.4619140625
47,1,13,2457,8192,-5735,-70.00732421875
47,1,14,10716,16384,-5668,-34.5947265625
47,1,15,59643,32768,26875,82.0159912109375
47,2,1,0,2,-2,-100.0
47,2,2,2,4,-2,-50.0
47,2,3,20,8,12,150.0
47,2,4,6,16,-10,-62.5
47,2,5,20,32,-12,-37.5
47,2,6,14,64,-50,-78.125
47,2,7,344,128,216,168.75
47,2,8,14,256,-242,-94.53125
47,2,9,1250,512,738,144.140625
47,2,10,787,1024,-237,-23.14453125
47,2,11,525,2048,-1523,-74.365234375
47,2,12,940,4096,-3156,-77.05078125
47,2,13,4919,8192,-3273,-39.95361328125
47,2,14,47739,16384,31355,191.375732421875
47,2,15,31112,32768,-1656,-5.0537109375
47,3,1,0,2,-2,-100.0
47,3,2,1,4,-3,-75.0
47,3,3,5,8,-3,-37.5
47,3,4,3,16,-13,-81.25
47,3,5,55,32,23,71.875
47,3,6,109,64,45,70.3125
47,3,7,34,128,-94,-73.4375
47,3,8,220,256,-36,-14.0625
47,3,9,632,512,120,23.4375
47,3,10,1733,1024,709,69.23828125
47,3,11,402,2048,-1646,-80.37109375
47,3,12,3673,4096,-423,-10.3271484375
47,3,13,7965,8192,-227,-2.77099609375
47,3,14,7771,16384,-8613,-52.569580078125
47,3,15,81245,32768,48477,147.9400634765625
47,4,1,0,2,-2,-100.0
47,4,2,4,4,0,0.0
47,4,3,6,8,-2,-25.0
47,4,4,5,16,-11,-68.75
47,4,5,7,32,-25,-78.125
47,4,6,76,64,12,18.75
47,4,7,15,128,-113,-88.28125
47,4,8,217,256,-39,-15.234375
47,4,9,3223,512,2711,529.4921875
47,4,10,34,1024,-990,-96.6796875
47,4,11,2958,2048,910,44.43359375
47,4,12,4208,4096,112,2.734375
47,4,13,7120,8192,-1072,-13.0859375
47,4,14,2643,16384,-13741,-83.868408203125
47,4,15,3605,32768,-29163,-88.9984130859375
47,5,1,0,2,-2,-100.0
47,5,2,3,4,-1,-25.0
47,5,3,2,8,-6,-75.0
47,5,4,14,16,-2,-12.5
47,5,5,43,32,11,34.375
47,5,6,18,64,-46,-71.875
47,5,7,16,128,-112,-87.5
47,5,8,99,256,-157,-61.328125
47,5,9,1090,512,578,112.890625
47,5,10,1258,1024,234,22.8515625
47,5,11,975,2048,-1073,-52.392578125
47,5,12,5937,4096,1841,44.9462890625
47,5,13,9316,8192,1124,13.720703125
47,5,14,9475,16384,-6909,-42.169189453125
47,5,15,5034,32768,-27734,-84.637451171875
47,6,1,0,2,-2,-100.0
47,6,2,2,4,-2,-50.0
47,6,3,5,8,-3,-37.5
47,6,4,7,16,-9,-56.25
47,6,5,31,32,-1,-3.125
47,6,6,7,64,-57,-89.0625
47,6,7,89,128,-39,-30.46875
47,6,8,990,256,734,286.71875
47,6,9,153,512,-359,-70.1171875
47,6,10,310,1024,-714,-69.7265625
47,6,11,1890,2048,-158,-7.71484375
47,6,12,4502,4096,406,9.912109375
47,6,13,4696,8192,-3496,-42.67578125
47,6,14,21356,16384,4972,30.3466796875
47,6,15,33808,32768,1040,3.173828125
47,7,1,0,2,-2,-100.0
47,7,2,5,4,1,25.0
47,7,3,2,8,-6,-75.0
47,7,4,12,16,-4,-25.0
47,7,5,15,32,-17,-53.125
47,7,6,37,64,-27,-42.1875
47,7,7,27,128,-101,-78.90625
47,7,8,476,256,220,85.9375
47,7,9,33,512,-479,-93.5546875
47,7,10,1059,1024,35,3.41796875
47,7,11,2354,2048,306,14.94140625
47,7,12,711,4096,-3385,-82.6416015625
47,7,13,12501,8192,4309,52.60009765625
47,7,14,13350,16384,-3034,-18.51806640625
47,7,15,5883,32768,-26885,-82.0465087890625
47,8,1,0,2,-2,-100.0
47,8,2,1,4,-3,-75.0
47,8,3,14,8,6,75.0
47,8,4,3,16,-13,-81.25
47,8,5,39,32,7,21.875
47,8,6,78,64,14,21.875
47,8,7,25,128,-103,-80.46875
47,8,8,139,256,-117,-45.703125
47,8,9,507,512,-5,-0.9765625
47,8,10,298,1024,-726,-70.8984375
47,8,11,337,2048,-1711,-83.544921875
47,8,12,685,4096,-3411,-83.2763671875
47,8,13,29106,8192,20914,255.2978515625
47,8,14,5285,16384,-11099,-67.742919921875
47,8,15,2651,32768,-30117,-91.9097900390625
47,9,1,0,2,-2,-100.0
47,9,2,4,4,0,0.0
47,9,3,2,8,-6,-75.0
47,9,4,7,16,-9,-56.25
47,9,5,26,32,-6,-18.75
47,9,6,82,64,18,28.125
47,9,7,550,128,422,329.6875
47,9,8,63,256,-193,-75.390625
47,9,9,195,512,-317,-61.9140625
47,9,10,468,1024,-556,-54.296875
47,9,11,1278,2048,-770,-37.59765625
47,9,12,1544,4096,-2552,-62.3046875
47,9,13,14863,8192,6671,81.43310546875
47,9,14,5774,16384,-10610,-64.75830078125
47,9,15,41081,32768,8313,25.3692626953125
47,10,1,0,2,-2,-100.0
47,10,2,3,4,-1,-25.0
47,10,3,3,8,-5,-62.5
47,10,4,4,16,-12,-75.0
47,10,5,22,32,-10,-31.25
47,10,6,265,64,201,314.0625
47,10,7,350,128,222,173.4375
47,10,8,200,256,-56,-21.875
47,10,9,249,512,-263,-51.3671875
47,10,10,222,1024,-802,-78.3203125
47,10,11,2844,2048,796,38.8671875
47,10,12,3385,4096,-711,-17.3583984375
47,10,13,655,8192,-7537,-92.00439453125
47,10,14,9859,16384,-6525,-39.825439453125
47,10,15,42655,32768,9887,30.1727294921875
47,11,1,0,2,-2,-100.0
47,11,2,1,4,-3,-75.0
47,11,3,4,8,-4,-50.0
47,11,4,25,16,9,56.25
47,11,5,50,32,18,56.25
47,11,6,23,64,-41,-64.0625
47,11,7,16,128,-112,-87.5
47,11,8,162,256,-94,-36.71875
47,11,9,112,512,-400,-78.125
47,11,10,72,1024,-952,-92.96875
47,11,11,395,2048,-1653,-80.712890625
47,11,12,5436,4096,1340,32.71484375
47,11,13,4490,8192,-3702,-45.1904296875
47,11,14,35198,16384,18814,114.83154296875
47,11,15,56208,32768,23440,71.533203125
47,12,1,0,2,-2,-100.0
47,12,2,2,4,-2,-50.0
47,12,3,2,8,-6,-75.0
47,12,4,10,16,-6,-37.5
47,12,5,5,32,-27,-84.375
47,12,6,67,64,3,4.6875
47,12,7,17,128,-111,-86.71875
47,12,8,411,256,155,60.546875
47,12,9,1405,512,893,174.4140625
47,12,10,519,1024,-505,-49.31640625
47,12,11,2946,2048,898,43.84765625
47,12,12,804,4096,-3292,-80.37109375
47,12,13,13432,8192,5240,63.96484375
47,12,14,8732,16384,-7652,-46.7041015625
47,12,15,92362,32768,59594,181.866455078125
47,13,1,0,2,-2,-100.0
47,13,2,1,4,-3,-75.0
47,13,3,10,8,2,25.0
47,13,4,15,16,-1,-6.25
47,13,5,6,32,-26,-81.25
47,13,6,60,64,-4,-6.25
47,13,7,29,128,-99,-77.34375
47,13,8,202,256,-54,-21.09375
47,13,9,427,512,-85,-16.6015625
47,13,10,2708,1024,1684,164.453125
47,13,11,538,2048,-1510,-73.73046875
47,13,12,7643,4096,3547,86.5966796875
47,13,13,2998,8192,-5194,-63.4033203125
47,13,14,3726,16384,-12658,-77.25830078125
47,13,15,19556,32768,-13212,-40.31982421875
47,14,1,0,2,-2,-100.0
47,14,2,3,4,-1,-25.0
47,14,3,2,8,-6,-75.0
47,14,4,16,16,0,0.0
47,14,5,4,32,-28,-87.5
47,14,6,43,64,-21,-32.8125
47,14,7,8,128,-120,-93.75
47,14,8,908,256,652,254.6875
47,14,9,79,512,-433,-84.5703125
47,14,10,140,1024,-884,-86.328125
47,14,11,7184,2048,5136,250.78125
47,14,12,7308,4096,3212,78.41796875
47,14,13,14756,8192,6564,80.126953125
47,14,14,30805,16384,14421,88.018798828125
47,14,15,33930,32768,1162,3.546142578125
47,15,1,0,2,-2,-100.0
47,15,2,3,4,-1,-25.0
47,15,3,3,8,-5,-62.5
47,15,4,7,16,-9,-56.25
47,15,5,10,32,-22,-68.75
47,15,6,182,64,118,184.375
47,15,7,6,128,-122,-95.3125
47,15,8,233,256,-23,-8.984375
47,15,9,365,512,-147,-28.7109375
47,15,10,93,1024,-931,-90.91796875
47,15,11,210,2048,-1838,-89.74609375
47,15,12,2944,4096,-1152,-28.125
47,15,13,5331,8192,-2861,-34.92431640625
47,15,14,10110,16384,-6274,-38.29345703125
47,15,15,10555,32768,-22213,-67.7886962890625
47,16,1,0,2,-2,-100.0
47,16,2,1,4,-3,-75.0
47,16,3,2,8,-6,-75.0
47,16,4,9,16,-7,-43.75
47,16,5,96,32,64,200.0
47,16,6,5,64,-59,-92.1875
47,16,7,56,128,-72,-56.25
47,16,8,79,256,-177,-69.140625
47,16,9,467,512,-45,-8.7890625
47,16,10,434,1024,-590,-57.6171875
47,16,11,781,2048,-1267,-61.865234375
47,16,12,2695,4096,-1401,-34.2041015625
47,16,13,11145,8192,2953,36.04736328125
47,16,14,38135,16384,21751,132.757568359375
47,16,15,11553,32768,-21215,-64.7430419921875
47,17,1,0,2,-2,-100.0
47,17,2,1,4,-3,-75.0
47,17,3,3,8,-5,-62.5
47,17,4,10,16,-6,-37.5
47,17,5,17,32,-15,-46.875
47,17,6,17,64,-47,-73.4375
47,17,7,40,128,-88,-68.75
47,17,8,618,256,362,141.40625
47,17,9,371,512,-141,-27.5390625
47,17,10,205,1024,-819,-79.98046875
47,17,11,2578,2048,530,25.87890625
47,17,12,7321,4096,3225,78.7353515625
47,17,13,4916,8192,-3276,-39.990234375
47,17,14,8516,16384,-7868,-48.0224609375
47,17,15,18469,32768,-14299,-43.6370849609375
47,18,1,0,2,-2,-100.0
47,18,2,1,4,-3,-75.0
47,18,3,4,8,-4,-50.0
47,18,4,3,16,-13,-81.25
47,18,5,11,32,-21,-65.625
47,18,6,145,64,81,126.5625
47,18,7,289,128,161,125.78125
47,18,8,80,256,-176,-68.75
47,18,9,773,512,261,50.9765625
47,18,10,458,1024,-566,-55.2734375
47,18,11,902,2048,-1146,-55.95703125
47,18,12,3507,4096,-589,-14.3798828125
47,18,13,10513,8192,2321,28.33251953125
47,18,14,1970,16384,-14414,-87.97607421875
47,18,15,58298,32768,25530,77.911376953125
47,19,1,0,2,-2,-100.0
47,19,2,1,4,-3,-75.0
47,19,3,2,8,-6,-75.0
47,19,4,6,16,-10,-62.5
47,19,5,8,32,-24,-75.0
47,19,6,117,64,53,82.8125
47,19,7,91,128,-37,-28.90625
47,19,8,386,256,130,50.78125
47,19,9,167,512,-345,-67.3828125
47,19,10,793,1024,-231,-22.55859375
47,19,11,222,2048,-1826,-89.16015625
47,19,12,2336,4096,-1760,-42.96875
47,19,13,2829,8192,-5363,-65.46630859375
47,19,14,16371,16384,-13,-0.079345703125
47,19,15,63842,32768,31074,94.830322265625
47,20,1,0,2,-2,-100.0
47,20,2,2,4,-2,-50.0
47,20,3,4,8,-4,-50.0
47,20,4,7,16,-9,-56.25
47,20,5,85,32,53,165.625
47,20,6,53,64,-11,-17.1875
47,20,7,39,128,-89,-69.53125
47,20,8,51,256,-205,-80.078125
47,20,9,171,512,-341,-66.6015625
47,20,10,647,1024,-377,-36.81640625
47,20,11,5365,2048,3317,161.962890625
47,20,12,6542,4096,2446,59.716796875
47,20,13,14331,8192,6139,74.93896484375
47,20,14,47007,16384,30623,186.907958984375
47,20,15,7925,32768,-24843,-75.8148193359375
47,21,1,0,2,-2,-100.0
47,21,2,3,4,-1,-25.0
47,21,3,5,8,-3,-37.5
47,21,4,5,16,-11,-68.75
47,21,5,8,32,-24,-75.0
47,21,6,27,64,-37,-57.8125
47,21,7,22,128,-106,-82.8125
47,21,8,10,256,-246,-96.09375
47,21,9,289,512,-223,-43.5546875
47,21,10,5018,1024,3994,390.0390625
47,21,11,214,2048,-1834,-89.55078125
47,21,12,6586,4096,2490,60.791015625
47,21,13,4872,8192,-3320,-40.52734375
47,21,14,6267,16384,-10117,-61.749267578125
47,21,15,37601,32768,4833,14.7491455078125
47,22,1,0,2,-2,-100.0
47,22,2,1,4,-3,-75.0
47,22,3,6,8,-2,-25.0
47,22,4,3,16,-13,-81.25
47,22,5,67,32,35,109.375
47,22,6,80,64,16,25.0
47,22,7,23,128,-105,-82.03125
47,22,8,290,256,34,13.28125
47,22,9,283,512,-229,-44.7265625
47,22,10,252,1024,-772,-75.390625
47,22,11,502,2048,-1546,-75.48828125
47,22,12,7237,4096,3141,76.6845703125
47,22,13,9493,8192,1301,15.88134765625
47,22,14,46041,16384,29657,181.011962890625
47,22,15,367,32768,-32401,-98.8800048828125
47,23,1,0,2,-2,-100.0
47,23,2,1,4,-3,-75.0
47,23,3,2,8,-6,-75.0
47,23,4,5,16,-11,-68.75
47,23,5,29,32,-3,-9.375
47,23,6,8,64,-56,-87.5
47,23,7,35,128,-93,-72.65625
47,23,8,226,256,-30,-11.71875
47,23,9,180,512,-332,-64.84375
47,23,10,9,1024,-1015,-99.12109375
47,23,11,899,2048,-1149,-56.103515625
47,23,12,1873,4096,-2223,-54.2724609375
47,23,13,4489,8192,-3703,-45.20263671875
47,23,14,4933,16384,-11451,-69.891357421875
47,23,15,12689,32768,-20079,-61.2762451171875
47,24,1,0,2,-2,-100.0
47,24,2,3,4,-1,-25.0
47,24,3,6,8,-2,-25.0
47,24,4,12,16,-4,-25.0
47,24,5,30,32,-2,-6.25
47,24,6,183,64,119,185.9375
47,24,7,41,128,-87,-67.96875
47,24,8,268,256,12,4.6875
47,24,9,140,512,-372,-72.65625
47,24,10,1472,1024,448,43.75
47,24,11,1783,2048,-265,-12.939453125
47,24,12,2879,4096,-1217,-29.7119140625
47,24,13,6916,8192,-1276,-15.576171875
47,24,14,15696,16384,-688,-4.19921875
47,24,15,20608,32768,-12160,-37.109375
47,25,1,0,2,-2,-100.0
47,25,2,1,4,-3,-75.0
47,25,3,3,8,-5,-62.5
47,25,4,26,16,10,62.5
47,25,5,36,32,4,12.5
47,25,6,132,64,68,106.25
47,25,7,25,128,-103,-80.46875
47,25,8,202,256,-54,-21.09375
47,25,9,370,512,-142,-27.734375
47,25,10,409,1024,-615,-60.05859375
47,25,11,4501,2048,2453,119.775390625
47,25,12,4771,4096,675,16.4794921875
47,25,13,4801,8192,-3391,-41.39404296875
47,25,14,10116,16384,-6268,-38.2568359375
47,25,15,12692,32768,-20076,-61.26708984375
47,26,1,0,2,-2,-100.0
47,26,2,4,4,0,0.0
47,26,3,3,8,-5,-62.5
47,26,4,31,16,15,93.75
47,26,5,7,32,-25,-78.125
47,26,6,29,64,-35,-54.6875
47,26,7,82,128,-46,-35.9375
47,26,8,426,256,170,66.40625
47,26,9,234,512,-278,-54.296875
47,26,10,2599,1024,1575,153.80859375
47,26,11,54,2048,-1994,-97.36328125
47,26,12,3327,4096,-769,-18.7744140625
47,26,13,931,8192,-7261,-88.63525390625
47,26,14,17024,16384,640,3.90625
47,26,15,33731,32768,963,2.9388427734375
47,27,1,0,2,-2,-100.0
47,27,2,1,4,-3,-75.0
47,27,3,11,8,3,37.5
47,27,4,13,16,-3,-18.75
47,27,5,31,32,-1,-3.125
47,27,6,192,64,128,200.0
47,27,7,39,128,-89,-69.53125
47,27,8,23,256,-233,-91.015625
47,27,9,818,512,306,59.765625
47,27,10,51,1024,-973,-95.01953125
47,27,11,4372,2048,2324,113.4765625
47,27,12,4399,4096,303,7.3974609375
47,27,13,7893,8192,-299,-3.64990234375
47,27,14,1620,16384,-14764,-90.1123046875
47,27,15,24752,32768,-8016,-24.462890625
47,28,1,0,2,-2,-100.0
47,28,2,3,4,-1,-25.0
47,28,3,13,8,5,62.5
47,28,4,11,16,-5,-31.25
47,28,5,143,32,111,346.875
47,28,6,185,64,121,189.0625
47,28,7,40,128,-88,-68.75
47,28,8,1040,256,784,306.25
47,28,9,1080,512,568,110.9375
47,28,10,1338,1024,314,30.6640625
47,28,11,1170,2048,-878,-42.87109375
47,28,12,3326,4096,-770,-18.798828125
47,28,13,11661,8192,3469,42.34619140625
47,28,14,111,16384,-16273,-99.322509765625
47,28,15,11662,32768,-21106,-64.410400390625
47,29,1,0,2,-2,-100.0
47,29,2,1,4,-3,-75.0
47,29,3,7,8,-1,-12.5
47,29,4,36,16,20,125.0
47,29,5,68,32,36,112.5
47,29,6,75,64,11,17.1875
47,29,7,173,128,45,35.15625
47,29,8,165,256,-91,-35.546875
47,29,9,1152,512,640,125.0
47,29,10,667,1024,-357,-34.86328125
47,29,11,2589,2048,541,26.416015625
47,29,12,1936,4096,-2160,-52.734375
47,29,13,5788,8192,-2404,-29.345703125
47,29,14,5474,16384,-10910,-66.58935546875
47,29,15,25049,32768,-7719,-23.5565185546875
47,30,1,0,2,-2,-100.0
47,30,2,1,4,-3,-75.0
47,30,3,4,8,-4,-50.0
47,30,4,35,16,19,118.75
47,30,5,21,32,-11,-34.375
47,30,6,16,64,-48,-75.0
47,30,7,10,128,-118,-92.1875
47,30,8,789,256,533,208.203125
47,30,9,153,512,-359,-70.1171875
47,30,10,237,1024,-787,-76.85546875
47,30,11,473,2048,-1575,-76.904296875
47,30,12,23991,4096,19895,485.7177734375
47,30,13,13064,8192,4872,59.47265625
47,30,14,49365,16384,32981,201.300048828125
47,30,15,9044,32768,-23724,-72.39990234375
47,31,1,0,2,-2,-100.0
47,31,2,2,4,-2,-50.0
47,31,3,7,8,-1,-12.5
47,31,4,7,16,-9,-56.25
47,31,5,35,32,3,9.375
47,31,6,30,64,-34,-53.125
47,31,7,114,128,-14,-10.9375
47,31,8,265,256,9,3.515625
47,31,9,8,512,-504,-98.4375
47,31,10,451,1024,-573,-55.95703125
47,31,11,2385,2048,337,16.455078125
47,31,12,3847,4096,-249,-6.0791015625
47,31,13,11939,8192,3747,45.73974609375
47,31,14,1927,16384,-14457,-88.238525390625
47,31,15,70313,32768,37545,114.5782470703125
47,32,1,0,2,-2,-100.0
47,32,2,2,4,-2,-50.0
47,32,3,2,8,-6,-75.0
47,32,4,3,16,-13,-81.25
47,32,5,4,32,-28,-87.5
47,32,6,41,64,-23,-35.9375
47,32,7,148,128,20,15.625
47,32,8,39,256,-217,-84.765625
47,32,9,328,512,-184,-35.9375
47,32,10,433,1024,-591,-57.71484375
47,32,11,2898,2048,850,41.50390625
47,32,12,4540,4096,444,10.83984375
47,32,13,4104,8192,-4088,-49.90234375
47,32,14,1950,16384,-14434,-88.09814453125
47,32,15,17956,32768,-14812,-45.20263671875
47,33,1,0,2,-2,-100.0
47,33,2,3,4,-1,-25.0
47,33,3,2,8,-6,-75.0
47,33,4,26,16,10,62.5
47,33,5,32,32,0,0.0
47,33,6,113,64,49,76.5625
47,33,7,307,128,179,139.84375
47,33,8,392,256,136,53.125
47,33,9,764,512,252,49.21875
47,33,10,319,1024,-705,-68.84765625
47,33,11,366,2048,-1682,-82.12890625
47,33,12,7291,4096,3195,78.0029296875
47,33,13,619,8192,-7573,-92.44384765625
47,33,14,3260,16384,-13124,-80.1025390625
47,33,15,25608,32768,-7160,-21.8505859375
47,34,1,0,2,-2,-100.0
47,34,2,1,4,-3,-75.0
47,34,3,5,8,-3,-37.5
47,34,4,3,16,-13,-81.25
47,34,5,23,32,-9,-28.125
47,34,6,127,64,63,98.4375
47,34,7,297,128,169,132.03125
47,34,8,176,256,-80,-31.25
47,34,9,1453,512,941,183.7890625
47,34,10,2013,1024,989,96.58203125
47,34,11,2708,2048,660,32.2265625
47,34,12,53,4096,-4043,-98.7060546875
47,34,13,6941,8192,-1251,-15.27099609375
47,34,14,11626,16384,-4758,-29.04052734375
47,34,15,43510,32768,10742,32.781982421875
47,35,1,0,2,-2,-100.0
47,35,2,2,4,-2,-50.0
47,35,3,3,8,-5,-62.5
47,35,4,6,16,-10,-62.5
47,35,5,10,32,-22,-68.75
47,35,6,16,64,-48,-75.0
47,35,7,321,128,193,150.78125
47,35,8,582,256,326,127.34375
47,35,9,280,512,-232,-45.3125
47,35,10,3463,1024,2439,238.18359375
47,35,11,2936,2048,888,43.359375
47,35,12,2082,4096,-2014,-49.169921875
47,35,13,1163,8192,-7029,-85.80322265625
47,35,14,20195,16384,3811,23.260498046875
47,35,15,23123,32768,-9645,-29.4342041015625
47,36,1,0,2,-2,-100.0
47,36,2,1,4,-3,-75.0
47,36,3,6,8,-2,-25.0
47,36,4,29,16,13,81.25
47,36,5,83,32,51,159.375
47,36,6,62,64,-2,-3.125
47,36,7,232,128,104,81.25
47,36,8,89,256,-167,-65.234375
47,36,9,1036,512,524,102.34375
47,36,10,66,1024,-958,-93.5546875
47,36,11,1986,2048,-62,-3.02734375
47,36,12,11900,4096,7804,190.52734375
47,36,13,1771,8192,-6421,-78.38134765625
47,36,14,4445,16384,-11939,-72.869873046875
47,36,15,25343,32768,-7425,-22.6593017578125
47,37,1,0,2,-2,-100.0
47,37,2,1,4,-3,-75.0
47,37,3,3,8,-5,-62.5
47,37,4,6,16,-10,-62.5
47,37,5,49,32,17,53.125
47,37,6,54,64,-10,-15.625
47,37,7,33,128,-95,-74.21875
47,37,8,261,256,5,1.953125
47,37,9,153,512,-359,-70.1171875
47,37,10,1249,1024,225,21.97265625
47,37,11,1196,2048,-852,-41.6015625
47,37,12,1076,4096,-3020,-73.73046875
47,37,13,5505,8192,-2687,-32.80029296875
47,37,14,28009,16384,11625,70.953369140625
47,37,15,79297,32768,46529,141.9952392578125
47,38,1,0,2,-2,-100.0
47,38,2,1,4,-3,-75.0
47,38,3,8,8,0,0.0
47,38,4,5,16,-11,-68.75
47,38,5,14,32,-18,-56.25
47,38,6,43,64,-21,-32.8125
47,38,7,76,128,-52,-40.625
47,38,8,239,256,-17,-6.640625
47,38,9,508,512,-4,-0.78125
47,38,10,1574,1024,550,53.7109375
47,38,11,1076,2048,-972,-47.4609375
47,38,12,2373,4096,-1723,-42.0654296875
47,38,13,11784,8192,3592,43.84765625
47,38,14,36919,16384,20535,125.335693359375
47,38,15,74020,32768,41252,125.89111328125
47,39,1,0,2,-2,-100.0
47,39,2,1,4,-3,-75.0
47,39,3,4,8,-4,-50.0
47,39,4,9,16,-7,-43.75
47,39,5,23,32,-9,-28.125
47,39,6,77,64,13,20.3125
47,39,7,146,128,18,14.0625
47,39,8,305,256,49,19.140625
47,39,9,325,512,-187,-36.5234375
47,39,10,912,1024,-112,-10.9375
47,39,11,550,2048,-1498,-73.14453125
47,39,12,1654,4096,-2442,-59.619140625
47,39,13,6960,8192,-1232,-15.0390625
47,39,14,2388,16384,-13996,-85.4248046875
47,39,15,12890,32768,-19878,-60.662841796875
47,40,1,0,2,-2,-100.0
47,40,2,1,4,-3,-75.0
47,40,3,4,8,-4,-50.0
47,40,4,5,16,-11,-68.75
47,40,5,68,32,36,112.5
47,40,6,121,64,57,89.0625
47,40,7,101,128,-27,-21.09375
47,40,8,759,256,503,196.484375
47,40,9,495,512,-17,-3.3203125
47,40,10,442,1024,-582,-56.8359375
47,40,11,593,2048,-1455,-71.044921875
47,40,12,3100,4096,-996,-24.31640625
47,40,13,731,8192,-7461,-91.07666015625
47,40,14,14797,16384,-1587,-9.686279296875
47,40,15,22002,32768,-10766,-32.855224609375
47,41,1,0,2,-2,-100.0
47,41,2,5,4,1,25.0
47,41,3,14,8,6,75.0
47,41,4,3,16,-13,-81.25
47,41,5,5,32,-27,-84.375
47,41,6,23,64,-41,-64.0625
47,41,7,59,128,-69,-53.90625
47,41,8,434,256,178,69.53125
47,41,9,224,512,-288,-56.25
47,41,10,825,1024,-199,-19.43359375
47,41,11,430,2048,-1618,-79.00390625
47,41,12,16931,4096,12835,313.3544921875
47,41,13,11385,8192,3193,38.97705078125
47,41,14,16309,16384,-75,-0.457763671875
47,41,15,12285,32768,-20483,-62.5091552734375
47,42,1,0,2,-2,-100.0
47,42,2,1,4,-3,-75.0
47,42,3,2,8,-6,-75.0
47,42,4,33,16,17,106.25
47,42,5,88,32,56,175.0
47,42,6,182,64,118,184.375
47,42,7,105,128,-23,-17.96875
47,42,8,263,256,7,2.734375
47,42,9,96,512,-416,-81.25
47,42,10,97,1024,-927,-90.52734375
47,42,11,3364,2048,1316,64.2578125
47,42,12,7076,4096,2980,72.75390625
47,42,13,636,8192,-7556,-92.236328125
47,42,14,1086,16384,-15298,-93.37158203125
47,42,15,155412,32768,122644,374.27978515625
47,43,1,0,2,-2,-100.0
47,43,2,1,4,-3,-75.0
47,43,3,5,8,-3,-37.5
47,43,4,6,16,-10,-62.5
47,43,5,11,32,-21,-65.625
47,43,6,54,64,-10,-15.625
47,43,7,73,128,-55,-42.96875
47,43,8,645,256,389,151.953125
47,43,9,131,512,-381,-74.4140625
47,43,10,99,1024,-925,-90.33203125
47,43,11,3247,2048,1199,58.544921875
47,43,12,3338,4096,-758,-18.505859375
47,43,13,2404,8192,-5788,-70.654296875
47,43,14,10692,16384,-5692,-34.7412109375
47,43,15,3735,32768,-29033,-88.6016845703125
47,44,1,0,2,-2,-100.0
47,44,2,3,4,-1,-25.0
47,44,3,4,8,-4,-50.0
47,44,4,10,16,-6,-37.5
47,44,5,61,32,29,90.625
47,44,6,7,64,-57,-89.0625
47,44,7,107,128,-21,-16.40625
47,44,8,138,256,-118,-46.09375
47,44,9,932,512,420,82.03125
47,44,10,1287,1024,263,25.68359375
47,44,11,3309,2048,1261,61.572265625
47,44,12,3175,4096,-921,-22.4853515625
47,44,13,12259,8192,4067,49.64599609375
47,44,14,45459,16384,29075,177.459716796875
47,44,15,13375,32768,-19393,-59.1827392578125
47,45,1,0,2,-2,-100.0
47,45,2,1,4,-3,-75.0
47,45,3,3,8,-5,-62.5
47,45,4,21,16,5,31.25
47,45,5,16,32,-16,-50.0
47,45,6,22,64,-42,-65.625
47,45,7,70,128,-58,-45.3125
47,45,8,101,256,-155,-60.546875
47,45,9,28,512,-484,-94.53125
47,45,10,745,1024,-279,-27.24609375
47,45,11,639,2048,-1409,-68.798828125
47,45,12,9057,4096,4961,121.1181640625
47,45,13,7085,8192,-1107,-13.51318359375
47,45,14,15960,16384,-424,-2.587890625
47,45,15,8525,32768,-24243,-73.9837646484375
47,46,1,0,2,-2,-100.0
47,46,2,3,4,-1,-25.0
47,46,3,6,8,-2,-25.0
47,46,4,37,16,21,131.25
47,46,5,34,32,2,6.25
47,46,6,7,64,-57,-89.0625
47,46,7,173,128,45,35.15625
47,46,8,53,256,-203,-79.296875
47,46,9,869,512,357,69.7265625
47,46,10,437,1024,-587,-57.32421875
47,46,11,337,2048,-1711,-83.544921875
47,46,12,14183,4096,10087,246.2646484375
47,46,13,23818,8192,15626,190.7470703125
47,46,14,36958,16384,20574,125.57373046875
47,46,15,26002,32768,-6766,-20.648193359375
47,47,1,0,2,-2,-100.0
47,47,2,3,4,-1,-25.0
47,47,3,5,8,-3,-37.5
47,47,4,5,16,-11,-68.75
47,47,5,14,32,-18,-56.25
47,47,6,26,64,-38,-59.375
47,47,7,52,128,-76,-59.375
47,47,8,11,256,-245,-95.703125
47,47,9,591,512,79,15.4296875
47,47,10,863,1024,-161,-15.72265625
47,47,11,1925,2048,-123,-6.005859375
47,47,12,352,4096,-3744,-91.40625
47,47,13,1265,8192,-6927,-84.55810546875
47,47,14,4677,16384,-11707,-71.453857421875
47,47,15,112664,32768,79896,243.8232421875
48,1,1,0,2,-2,-100.0
48,1,2,1,4,-3,-75.0
48,1,3,9,8,1,12.5
48,1,4,9,16,-7,-43.75
48,1,5,4,32,-28,-87.5
48,1,6,195,64,131,204.6875
48,1,7,223,128,95,74.21875
48,1,8,132,256,-124,-48.4375
48,1,9,96,512,-416,-81.25
48,1,10,401,1024,-623,-60.83984375
48,1,11,3266,2048,1218,59.47265625
48,1,12,3091,4096,-1005,-24.5361328125
48,1,13,1593,8192,-6599,-80.55419921875
48,1,14,39772,16384,23388,142.7490234375
48,1,15,568,32768,-32200,-98.2666015625
48,2,1,0,2,-2,-100.0
48,2,2,2,4,-2,-50.0
48,2,3,5,8,-3,-37.5
48,2,4,3,16,-13,-81.25
48,2,5,29,32,-3,-9.375
48,2,6,71,64,7,10.9375
48,2,7,43,128,-85,-66.40625
48,2,8,102,256,-154,-60.15625
48,2,9,522,512,10,1.953125
48,2,10,1166,1024,142,13.8671875
48,2,11,1895,2048,-153,-7.470703125
48,2,12,3264,4096,-832,-20.3125
48,2,13,1856,8192,-6336,-77.34375
48,2,14,18785,16384,2401,14.654541015625
48,2,15,26941,32768,-5827,-17.7825927734375
48,3,1,0,2,-2,-100.0
48,3,2,1,4,-3,-75.0
48,3,3,4,8,-4,-50.0
48,3,4,42,16,26,162.5
48,3,5,8,32,-24,-75.0
48,3,6,12,64,-52,-81.25
48,3,7,36,128,-92,-71.875
48,3,8,698,256,442,172.65625
48,3,9,119,512,-393,-76.7578125
48,3,10,197,1024,-827,-80.76171875
48,3,11,534,2048,-1514,-73.92578125
48,3,12,1921,4096,-2175,-53.1005859375
48,3,13,11511,8192,3319,40.51513671875
48,3,14,15433,16384,-951,-5.804443359375
48,3,15,9028,32768,-23740,-72.44873046875
48,4,1,0,2,-2,-100.0
48,4,2,4,4,0,0.0
48,4,3,2,8,-6,-75.0
48,4,4,4,16,-12,-75.0
48,4,5,103,32,71,221.875
48,4,6,5,64,-59,-92.1875
48,4,7,184,128,56,43.75
48,4,8,288,256,32,12.5
48,4,9,52,512,-460,-89.84375
48,4,10,421,1024,-603,-58.88671875
48,4,11,7642,2048,5594,273.14453125
48,4,12,2439,4096,-1657,-40.4541015625
48,4,13,3933,8192,-4259,-51.98974609375
48,4,14,20902,16384,4518,27.57568359375
48,4,15,27140,32768,-5628,-17.17529296875
48,5,1,0,2,-2,-100.0
48,5,2,3,4,-1,-25.0
48,5,3,10,8,2,25.0
48,5,4,3,16,-13,-81.25
48,5,5,25,32,-7,-21.875
48,5,6,61,64,-3,-4.6875
48,5,7,103,128,-25,-19.53125
48,5,8,626,256,370,144.53125
48,5,9,362,512,-150,-29.296875
48,5,10,495,1024,-529,-51.66015625
48,5,11,354,2048,-1694,-82.71484375
48,5,12,710,4096,-3386,-82.666015625
48,5,13,7000,8192,-1192,-14.55078125
48,5,14,7496,16384,-8888,-54.248046875
48,5,15,526,32768,-32242,-98.394775390625
48,6,1,0,2,-2,-100.0
48,6,2,1,4,-3,-75.0
48,6,3,3,8,-5,-62.5
48,6,4,21,16,5,31.25
48,6,5,5,32,-27,-84.375
48,6,6,49,64,-15,-23.4375
48,6,7,37,128,-91,-71.09375
48,6,8,857,256,601,234.765625
48,6,9,742,512,230,44.921875
48,6,10,1510,1024,486,47.4609375
48,6,11,2625,2048,577,28.173828125
48,6,12,50,4096,-4046,-98.779296875
48,6,13,3934,8192,-4258,-51.9775390625
48,6,14,23344,16384,6960,42.48046875
48,6,15,23653,32768,-9115,-27.8167724609375
48,7,1,0,2,-2,-100.0
48,7,2,1,4,-3,-75.0
48,7,3,4,8,-4,-50.0
48,7,4,46,16,30,187.5
48,7,5,21,32,-11,-34.375
48,7,6,31,64,-33,-51.5625
48,7,7,148,128,20,15.625
48,7,8,314,256,58,22.65625
48,7,9,484,512,-28,-5.46875
48,7,10,310,1024,-714,-69.7265625
48,7,11,58,2048,-1990,-97.16796875
48,7,12,1170,4096,-2926,-71.435546875
48,7,13,3671,8192,-4521,-55.18798828125
48,7,14,3177,16384,-13207,-80.609130859375
48,7,15,6440,32768,-26328,-80.3466796875
48,8,1,0,2,-2,-100.0
48,8,2,2,4,-2,-50.0
48,8,3,2,8,-6,-75.0
48,8,4,13,16,-3,-18.75
48,8,5,39,32,7,21.875
48,8,6,65,64,1,1.5625
48,8,7,492,128,364,284.375
48,8,8,644,256,388,151.5625
48,8,9,571,512,59,11.5234375
48,8,10,96,1024,-928,-90.625
48,8,11,351,2048,-1697,-82.861328125
48,8,12,2505,4096,-1591,-38.8427734375
48,8,13,28799,8192,20607,251.55029296875
48,8,14,596,16384,-15788,-96.3623046875
48,8,15,1418,32768,-31350,-95.672607421875
48,9,1,0,2,-2,-100.0
48,9,2,2,4,-2,-50.0
48,9,3,7,8,-1,-12.5
48,9,4,5,16,-11,-68.75
48,9,5,10,32,-22,-68.75
48,9,6,42,64,-22,-34.375
48,9,7,165,128,37,28.90625
48,9,8,111,256,-145,-56.640625
48,9,9,421,512,-91,-17.7734375
48,9,10,433,1024,-591,-57.71484375
48,9,11,1552,2048,-496,-24.21875
48,9,12,36117,4096,32021,781.7626953125
48,9,13,2987,8192,-5205,-63.53759765625
48,9,14,1585,16384,-14799,-90.325927734375
48,9,15,93458,32768,60690,185.211181640625
48,10,1,0,2,-2,-100.0
48,10,2,3,4,-1,-25.0
48,10,3,11,8,3,37.5
48,10,4,8,16,-8,-50.0
48,10,5,19,32,-13,-40.625
48,10,6,47,64,-17,-26.5625
48,10,7,23,128,-105,-82.03125
48,10,8,218,256,-38,-14.84375
48,10,9,1118,512,606,118.359375
48,10,10,294,1024,-730,-71.2890625
48,10,11,362,2048,-1686,-82.32421875
48,10,12,1945,4096,-2151,-52.5146484375
48,10,13,7284,8192,-908,-11.083984375
48,10,14,2326,16384,-14058,-85.80322265625
48,10,15,40313,32768,7545,23.0255126953125
48,11,1,0,2,-2,-100.0
48,11,2,2,4,-2,-50.0
48,11,3,4,8,-4,-50.0
48,11,4,6,16,-10,-62.5
48,11,5,34,32,2,6.25
48,11,6,77,64,13,20.3125
48,11,7,122,128,-6,-4.6875
48,11,8,257,256,1,0.390625
48,11,9,1044,512,532,103.90625
48,11,10,4427,1024,3403,332.32421875
48,11,11,995,2048,-1053,-51.416015625
48,11,12,304,4096,-3792,-92.578125
48,11,13,1085,8192,-7107,-86.75537109375
48,11,14,13541,16384,-2843,-17.352294921875
48,11,15,9246,32768,-23522,-71.783447265625
48,12,1,0,2,-2,-100.0
48,12,2,1,4,-3,-75.0
48,12,3,4,8,-4,-50.0
48,12,4,50,16,34,212.5
48,12,5,26,32,-6,-18.75
48,12,6,60,64,-4,-6.25
48,12,7,9,128,-119,-92.96875
48,12,8,688,256,432,168.75
48,12,9,80,512,-432,-84.375
48,12,10,252,1024,-772,-75.390625
48,12,11,1341,2048,-707,-34.521484375
48,12,12,68,4096,-4028,-98.33984375
48,12,13,5065,8192,-3127,-38.17138671875
48,12,14,24449,16384,8065,49.224853515625
48,12,15,15593,32768,-17175,-52.4139404296875
48,13,1,0,2,-2,-100.0
48,13,2,1,4,-3,-75.0
48,13,3,5,8,-3,-37.5
48,13,4,4,16,-12,-75.0
48,13,5,5,32,-27,-84.375
48,13,6,38,64,-26,-40.625
48,13,7,41,128,-87,-67.96875
48,13,8,254,256,-2,-0.78125
48,13,9,670,512,158,30.859375
48,13,10,986,1024,-38,-3.7109375
48,13,11,1971,2048,-77,-3.759765625
48,13,12,1632,4096,-2464,-60.15625
48,13,13,3458,8192,-4734,-57.7880859375
48,13,14,6848,16384,-9536,-58.203125
48,13,15,30905,32768,-1863,-5.6854248046875
48,14,1,0,2,-2,-100.0
48,14,2,1,4,-3,-75.0
48,14,3,2,8,-6,-75.0
48,14,4,7,16,-9,-56.25
48,14,5,73,32,41,128.125
48,14,6,21,64,-43,-67.1875
48,14,7,40,128,-88,-68.75
48,14,8,300,256,44,17.1875
48,14,9,93,512,-419,-81.8359375
48,14,10,220,1024,-804,-78.515625
48,14,11,1285,2048,-763,-37.255859375
48,14,12,5137,4096,1041,25.4150390625
48,14,13,12506,8192,4314,52.6611328125
48,14,14,1355,16384,-15029,-91.729736328125
48,14,15,51066,32768,18298,55.841064453125
48,15,1,0,2,-2,-100.0
48,15,2,1,4,-3,-75.0
48,15,3,2,8,-6,-75.0
48,15,4,3,16,-13,-81.25
48,15,5,16,32,-16,-50.0
48,15,6,51,64,-13,-20.3125
48,15,7,80,128,-48,-37.5
48,15,8,77,256,-179,-69.921875
48,15,9,803,512,291,56.8359375
48,15,10,250,1024,-774,-75.5859375
48,15,11,632,2048,-1416,-69.140625
48,15,12,5287,4096,1191,29.0771484375
48,15,13,4161,8192,-4031,-49.20654296875
48,15,14,18425,16384,2041,12.457275390625
48,15,15,54859,32768,22091,67.4163818359375
48,16,1,0,2,-2,-100.0
48,16,2,2,4,-2,-50.0
48,16,3,11,8,3,37.5
48,16,4,18,16,2,12.5
48,16,5,4,32,-28,-87.5
48,16,6,56,64,-8,-12.5
48,16,7,49,128,-79,-61.71875
48,16,8,65,256,-191,-74.609375
48,16,9,148,512,-364,-71.09375
48,16,10,2724,1024,1700,166.015625
48,16,11,2209,2048,161,7.861328125
48,16,12,7906,4096,3810,93.017578125
48,16,13,2617,8192,-5575,-68.05419921875
48,16,14,28515,16384,12131,74.041748046875
48,16,15,112209,32768,79441,242.4346923828125
48,17,1,0,2,-2,-100.0
48,17,2,2,4,-2,-50.0
48,17,3,2,8,-6,-75.0
48,17,4,24,16,8,50.0
48,17,5,48,32,16,50.0
48,17,6,83,64,19,29.6875
48,17,7,187,128,59,46.09375
48,17,8,186,256,-70,-27.34375
48,17,9,528,512,16,3.125
48,17,10,2736,1024,1712,167.1875
48,17,11,4119,2048,2071,101.123046875
48,17,12,3703,4096,-393,-9.5947265625
48,17,13,1971,8192,-6221,-75.93994140625
48,17,14,5818,16384,-10566,-64.48974609375
48,17,15,811,32768,-31957,-97.5250244140625
48,18,1,0,2,-2,-100.0
48,18,2,4,4,0,0.0
48,18,3,8,8,0,0.0
48,18,4,6,16,-10,-62.5
48,18,5,5,32,-27,-84.375
48,18,6,241,64,177,276.5625
48,18,7,6,128,-122,-95.3125
48,18,8,256,256,0,0.0
48,18,9,38,512,-474,-92.578125
48,18,10,647,1024,-377,-36.81640625
48,18,11,5779,2048,3731,182.177734375
48,18,12,157,4096,-3939,-96.1669921875
48,18,13,31174,8192,22982,280.5419921875
48,18,14,3190,16384,-13194,-80.52978515625
48,18,15,390556,32768,357788,1091.88232421875
48,19,1,0,2,-2,-100.0
48,19,2,2,4,-2,-50.0
48,19,3,6,8,-2,-25.0
48,19,4,25,16,9,56.25
48,19,5,5,32,-27,-84.375
48,19,6,89,64,25,39.0625
48,19,7,172,128,44,34.375
48,19,8,255,256,-1,-0.390625
48,19,9,508,512,-4,-0.78125
48,19,10,30,1024,-994,-97.0703125
48,19,11,255,2048,-1793,-87.548828125
48,19,12,1938,4096,-2158,-52.685546875
48,19,13,293,8192,-7899,-96.42333984375
48,19,14,18713,16384,2329,14.215087890625
48,19,15,17225,32768,-15543,-47.4334716796875
48,20,1,0,2,-2,-100.0
48,20,2,3,4,-1,-25.0
48,20,3,3,8,-5,-62.5
48,20,4,7,16,-9,-56.25
48,20,5,35,32,3,9.375
48,20,6,131,64,67,104.6875
48,20,7,94,128,-34,-26.5625
48,20,8,441,256,185,72.265625
48,20,9,14,512,-498,-97.265625
48,20,10,11,1024,-1013,-98.92578125
48,20,11,2762,2048,714,34.86328125
48,20,12,2805,4096,-1291,-31.5185546875
48,20,13,6050,8192,-2142,-26.1474609375
48,20,14,17504,16384,1120,6.8359375
48,20,15,29515,32768,-3253,-9.9273681640625
48,21,1,0,2,-2,-100.0
48,21,2,1,4,-3,-75.0
48,21,3,2,8,-6,-75.0
48,21,4,27,16,11,68.75
48,21,5,27,32,-5,-15.625
48,21,6,119,64,55,85.9375
48,21,7,54,128,-74,-57.8125
48,21,8,314,256,58,22.65625
48,21,9,101,512,-411,-80.2734375
48,21,10,616,1024,-408,-39.84375
48,21,11,731,2048,-1317,-64.306640625
48,21,12,3494,4096,-602,-14.697265625
48,21,13,2038,8192,-6154,-75.1220703125
48,21,14,12335,16384,-4049,-24.713134765625
48,21,15,100599,32768,67831,207.0037841796875
48,22,1,0,2,-2,-100.0
48,22,2,3,4,-1,-25.0
48,22,3,14,8,6,75.0
48,22,4,4,16,-12,-75.0
48,22,5,4,32,-28,-87.5
48,22,6,5,64,-59,-92.1875
48,22,7,108,128,-20,-15.625
48,22,8,409,256,153,59.765625
48,22,9,2171,512,1659,324.0234375
48,22,10,624,1024,-400,-39.0625
48,22,11,1360,2048,-688,-33.59375
48,22,12,3367,4096,-729,-17.7978515625
48,22,13,4801,8192,-3391,-41.39404296875
48,22,14,28286,16384,11902,72.64404296875
48,22,15,2595,32768,-30173,-92.0806884765625
48,23,1,0,2,-2,-100.0
48,23,2,2,4,-2,-50.0
48,23,3,5,8,-3,-37.5
48,23,4,11,16,-5,-31.25
48,23,5,21,32,-11,-34.375
48,23,6,5,64,-59,-92.1875
48,23,7,11,128,-117,-91.40625
48,23,8,130,256,-126,-49.21875
48,23,9,42,512,-470,-91.796875
48,23,10,656,1024,-368,-35.9375
48,23,11,2560,2048,512,25.0
48,23,12,908,4096,-3188,-77.83203125
48,23,13,2910,8192,-5282,-64.4775390625
48,23,14,799,16384,-15585,-95.123291015625
48,23,15,58909,32768,26141,79.7760009765625
48,24,1,0,2,-2,-100.0
48,24,2,3,4,-1,-25.0
48,24,3,11,8,3,37.5
48,24,4,9,16,-7,-43.75
48,24,5,25,32,-7,-21.875
48,24,6,57,64,-7,-10.9375
48,24,7,9,128,-119,-92.96875
48,24,8,235,256,-21,-8.203125
48,24,9,354,512,-158,-30.859375
48,24,10,158,1024,-866,-84.5703125
48,24,11,265,2048,-1783,-87.060546875
48,24,12,354,4096,-3742,-91.357421875
48,24,13,8357,8192,165,2.01416015625
48,24,14,3320,16384,-13064,-79.736328125
48,24,15,28817,32768,-3951,-12.0574951171875
48,25,1,0,2,-2,-100.0
48,25,2,1,4,-3,-75.0
48,25,3,8,8,0,0.0
48,25,4,9,16,-7,-43.75
48,25,5,129,32,97,303.125
48,25,6,47,64,-17,-26.5625
48,25,7,312,128,184,143.75
48,25,8,332,256,76,29.6875
48,25,9,283,512,-229,-44.7265625
48,25,10,88,1024,-936,-91.40625
48,25,11,3996,2048,1948,95.1171875
48,25,12,7984,4096,3888,94.921875
48,25,13,18165,8192,9973,121.74072265625
48,25,14,48622,16384,32238,196.76513671875
48,25,15,50849,32768,18081,55.1788330078125
48,26,1,0,2,-2,-100.0
48,26,2,2,4,-2,-50.0
48,26,3,4,8,-4,-50.0
48,26,4,3,16,-13,-81.25
48,26,5,25,32,-7,-21.875
48,26,6,40,64,-24,-37.5
48,26,7,54,128,-74,-57.8125
48,26,8,52,256,-204,-79.6875
48,26,9,409,512,-103,-20.1171875
48,26,10,1861,1024,837,81.73828125
48,26,11,2284,2048,236,11.5234375
48,26,12,6571,4096,2475,60.4248046875
48,26,13,840,8192,-7352,-89.74609375
48,26,14,6861,16384,-9523,-58.123779296875
48,26,15,3019,32768,-29749,-90.7867431640625
48,27,1,0,2,-2,-100.0
48,27,2,1,4,-3,-75.0
48,27,3,5,8,-3,-37.5
48,27,4,17,16,1,6.25
48,27,5,29,32,-3,-9.375
48,27,6,22,64,-42,-65.625
48,27,7,65,128,-63,-49.21875
48,27,8,149,256,-107,-41.796875
48,27,9,116,512,-396,-77.34375
48,27,10,175,1024,-849,-82.91015625
48,27,11,1799,2048,-249,-12.158203125
48,27,12,6072,4096,1976,48.2421875
48,27,13,2057,8192,-6135,-74.89013671875
48,27,14,16157,16384,-227,-1.385498046875
48,27,15,10543,32768,-22225,-67.8253173828125
48,28,1,0,2,-2,-100.0
48,28,2,1,4,-3,-75.0
48,28,3,11,8,3,37.5
48,28,4,4,16,-12,-75.0
48,28,5,6,32,-26,-81.25
48,28,6,45,64,-19,-29.6875
48,28,7,254,128,126,98.4375
48,28,8,108,256,-148,-57.8125
48,28,9,356,512,-156,-30.46875
48,28,10,1485,1024,461,45.01953125
48,28,11,613,2048,-1435,-70.068359375
48,28,12,3468,4096,-628,-15.33203125
48,28,13,346,8192,-7846,-95.7763671875
48,28,14,12027,16384,-4357,-26.593017578125
48,28,15,43023,32768,10255,31.2957763671875
48,29,1,0,2,-2,-100.0
48,29,2,1,4,-3,-75.0
48,29,3,4,8,-4,-50.0
48,29,4,15,16,-1,-6.25
48,29,5,9,32,-23,-71.875
48,29,6,14,64,-50,-78.125
48,29,7,31,128,-97,-75.78125
48,29,8,267,256,11,4.296875
48,29,9,586,512,74,14.453125
48,29,10,2079,1024,1055,103.02734375
48,29,11,1731,2048,-317,-15.478515625
48,29,12,2318,4096,-1778,-43.408203125
48,29,13,4254,8192,-3938,-48.0712890625
48,29,14,8628,16384,-7756,-47.3388671875
48,29,15,27123,32768,-5645,-17.2271728515625
48,30,1,0,2,-2,-100.0
48,30,2,5,4,1,25.0
48,30,3,4,8,-4,-50.0
48,30,4,7,16,-9,-56.25
48,30,5,6,32,-26,-81.25
48,30,6,168,64,104,162.5
48,30,7,24,128,-104,-81.25
48,30,8,97,256,-159,-62.109375
48,30,9,1540,512,1028,200.78125
48,30,10,292,1024,-732,-71.484375
48,30,11,2773,2048,725,35.400390625
48,30,12,894,4096,-3202,-78.173828125
48,30,13,2827,8192,-5365,-65.49072265625
48,30,14,249,16384,-16135,-98.480224609375
48,30,15,681,32768,-32087,-97.9217529296875
48,31,1,0,2,-2,-100.0
48,31,2,2,4,-2,-50.0
48,31,3,8,8,0,0.0
48,31,4,22,16,6,37.5
48,31,5,58,32,26,81.25
48,31,6,37,64,-27,-42.1875
48,31,7,108,128,-20,-15.625
48,31,8,361,256,105,41.015625
48,31,9,148,512,-364,-71.09375
48,31,10,205,1024,-819,-79.98046875
48,31,11,659,2048,-1389,-67.822265625
48,31,12,2595,4096,-1501,-36.6455078125
48,31,13,4383,8192,-3809,-46.49658203125
48,31,14,4535,16384,-11849,-72.320556640625
48,31,15,81806,32768,49038,149.652099609375
48,32,1,0,2,-2,-100.0
48,32,2,2,4,-2,-50.0
48,32,3,5,8,-3,-37.5
48,32,4,5,16,-11,-68.75
48,32,5,49,32,17,53.125
48,32,6,15,64,-49,-76.5625
48,32,7,289,128,161,125.78125
48,32,8,92,256,-164,-64.0625
48,32,9,133,512,-379,-74.0234375
48,32,10,864,1024,-160,-15.625
48,32,11,2071,2048,23,1.123046875
48,32,12,388,4096,-3708,-90.52734375
48,32,13,2831,8192,-5361,-65.44189453125
48,32,14,1930,16384,-14454,-88.22021484375
48,32,15,12752,32768,-20016,-61.083984375
48,33,1,0,2,-2,-100.0
48,33,2,1,4,-3,-75.0
48,33,3,2,8,-6,-75.0
48,33,4,8,16,-8,-50.0
48,33,5,20,32,-12,-37.5
48,33,6,16,64,-48,-75.0
48,33,7,157,128,29,22.65625
48,33,8,256,256,0,0.0
48,33,9,205,512,-307,-59.9609375
48,33,10,1135,1024,111,10.83984375
48,33,11,3328,2048,1280,62.5
48,33,12,11480,4096,7384,180.2734375
48,33,13,1521,8192,-6671,-81.43310546875
48,33,14,3271,16384,-13113,-80.035400390625
48,33,15,14391,32768,-18377,-56.0821533203125
48,34,1,0,2,-2,-100.0
48,34,2,1,4,-3,-75.0
48,34,3,3,8,-5,-62.5
48,34,4,8,16,-8,-50.0
48,34,5,4,32,-28,-87.5
48,34,6,45,64,-19,-29.6875
48,34,7,164,128,36,28.125
48,34,8,143,256,-113,-44.140625
48,34,9,576,512,64,12.5
48,34,10,2648,1024,1624,158.59375
48,34,11,250,2048,-1798,-87.79296875
48,34,12,1609,4096,-2487,-60.7177734375
48,34,13,3208,8192,-4984,-60.83984375
48,34,14,44572,16384,28188,172.0458984375
48,34,15,5282,32768,-27486,-83.880615234375
48,35,1,0,2,-2,-100.0
48,35,2,3,4,-1,-25.0
48,35,3,3,8,-5,-62.5
48,35,4,35,16,19,118.75
48,35,5,10,32,-22,-68.75
48,35,6,17,64,-47,-73.4375
48,35,7,83,128,-45,-35.15625
48,35,8,182,256,-74,-28.90625
48,35,9,1995,512,1483,289.6484375
48,35,10,356,1024,-668,-65.234375
48,35,11,20,2048,-2028,-99.0234375
48,35,12,1204,4096,-2892,-70.60546875
48,35,13,10885,8192,2693,32.87353515625
48,35,14,15375,16384,-1009,-6.158447265625
48,35,15,100033,32768,67265,205.2764892578125
48,36,1,0,2,-2,-100.0
48,36,2,3,4,-1,-25.0
48,36,3,3,8,-5,-62.5
48,36,4,4,16,-12,-75.0
48,36,5,8,32,-24,-75.0
48,36,6,160,64,96,150.0
48,36,7,173,128,45,35.15625
48,36,8,35,256,-221,-86.328125
48,36,9,582,512,70,13.671875
48,36,10,316,1024,-708,-69.140625
48,36,11,946,2048,-1102,-53.80859375
48,36,12,256,4096,-3840,-93.75
48,36,13,7292,8192,-900,-10.986328125
48,36,14,6793,16384,-9591,-58.538818359375
48,36,15,23979,32768,-8789,-26.8218994140625
48,37,1,0,2,-2,-100.0
48,37,2,2,4,-2,-50.0
48,37,3,6,8,-2,-25.0
48,37,4,17,16,1,6.25
48,37,5,15,32,-17,-53.125
48,37,6,100,64,36,56.25
48,37,7,22,128,-106,-82.8125
48,37,8,51,256,-205,-80.078125
48,37,9,233,512,-279,-54.4921875
48,37,10,339,1024,-685,-66.89453125
48,37,11,11056,2048,9008,439.84375
48,37,12,310,4096,-3786,-92.431640625
48,37,13,3302,8192,-4890,-59.6923828125
48,37,14,42700,16384,26316,160.6201171875
48,37,15,100517,32768,67749,206.7535400390625
48,38,1,0,2,-2,-100.0
48,38,2,4,4,0,0.0
48,38,3,6,8,-2,-25.0
48,38,4,4,16,-12,-75.0
48,38,5,43,32,11,34.375
48,38,6,113,64,49,76.5625
48,38,7,7,128,-121,-94.53125
48,38,8,817,256,561,219.140625
48,38,9,247,512,-265,-51.7578125
48,38,10,319,1024,-705,-68.84765625
48,38,11,322,2048,-1726,-84.27734375
48,38,12,228,4096,-3868,-94.43359375
48,38,13,7793,8192,-399,-4.87060546875
48,38,14,16288,16384,-96,-0.5859375
48,38,15,113091,32768,80323,245.1263427734375
48,39,1,0,2,-2,-100.0
48,39,2,1,4,-3,-75.0
48,39,3,2,8,-6,-75.0
48,39,4,5,16,-11,-68.75
48,39,5,66,32,34,106.25
48,39,6,171,64,107,167.1875
48,39,7,41,128,-87,-67.96875
48,39,8,176,256,-80,-31.25
48,39,9,61,512,-451,-88.0859375
48,39,10,1322,1024,298,29.1015625
48,39,11,153,2048,-1895,-92.529296875
48,39,12,3631,4096,-465,-11.3525390625
48,39,13,6070,8192,-2122,-25.9033203125
48,39,14,29641,16384,13257,80.914306640625
48,39,15,44176,32768,11408,34.814453125
48,40,1,0,2,-2,-100.0
48,40,2,8,4,4,100.0
48,40,3,6,8,-2,-25.0
48,40,4,8,16,-8,-50.0
48,40,5,4,32,-28,-87.5
48,40,6,50,64,-14,-21.875
48,40,7,92,128,-36,-28.125
48,40,8,452,256,196,76.5625
48,40,9,631,512,119,23.2421875
48,40,10,71,1024,-953,-93.06640625
48,40,11,1164,2048,-884,-43.1640625
48,40,12,3128,4096,-968,-23.6328125
48,40,13,1229,8192,-6963,-84.99755859375
48,40,14,18577,16384,2193,13.385009765625
48,40,15,4949,32768,-27819,-84.8968505859375
48,41,1,0,2,-2,-100.0
48,41,2,1,4,-3,-75.0
48,41,3,5,8,-3,-37.5
48,41,4,16,16,0,0.0
48,41,5,11,32,-21,-65.625
48,41,6,78,64,14,21.875
48,41,7,8,128,-120,-93.75
48,41,8,543,256,287,112.109375
48,41,9,137,512,-375,-73.2421875
48,41,10,246,1024,-778,-75.9765625
48,41,11,9798,2048,7750,378.41796875
48,41,12,4726,4096,630,15.380859375
48,41,13,24344,8192,16152,197.16796875
48,41,14,8067,16384,-8317,-50.762939453125
48,41,15,15061,32768,-17707,-54.0374755859375
48,42,1,0,2,-2,-100.0
48,42,2,5,4,1,25.0
48,42,3,8,8,0,0.0
48,42,4,12,16,-4,-25.0
48,42,5,188,32,156,487.5
48,42,6,10,64,-54,-84.375
48,42,7,50,128,-78,-60.9375
48,42,8,210,256,-46,-17.96875
48,42,9,253,512,-259,-50.5859375
48,42,10,861,1024,-163,-15.91796875
48,42,11,478,2048,-1570,-76.66015625
48,42,12,1393,4096,-2703,-65.9912109375
48,42,13,693,8192,-7499,-91.54052734375
48,42,14,15236,16384,-1148,-7.0068359375
48,42,15,17143,32768,-15625,-47.6837158203125
48,43,1,0,2,-2,-100.0
48,43,2,1,4,-3,-75.0
48,43,3,17,8,9,112.5
48,43,4,7,16,-9,-56.25
48,43,5,7,32,-25,-78.125
48,43,6,12,64,-52,-81.25
48,43,7,187,128,59,46.09375
48,43,8,121,256,-135,-52.734375
48,43,9,203,512,-309,-60.3515625
48,43,10,69,1024,-955,-93.26171875
48,43,11,151,2048,-1897,-92.626953125
48,43,12,2496,4096,-1600,-39.0625
48,43,13,27597,8192,19405,236.87744140625
48,43,14,8158,16384,-8226,-50.20751953125
48,43,15,3945,32768,-28823,-87.9608154296875
48,44,1,0,2,-2,-100.0
48,44,2,3,4,-1,-25.0
48,44,3,13,8,5,62.5
48,44,4,5,16,-11,-68.75
48,44,5,42,32,10,31.25
48,44,6,45,64,-19,-29.6875
48,44,7,72,128,-56,-43.75
48,44,8,876,256,620,242.1875
48,44,9,659,512,147,28.7109375
48,44,10,1172,1024,148,14.453125
48,44,11,2461,2048,413,20.166015625
48,44,12,7182,4096,3086,75.341796875
48,44,13,15465,8192,7273,88.78173828125
48,44,14,12520,16384,-3864,-23.583984375
48,44,15,47402,32768,14634,44.659423828125
48,45,1,0,2,-2,-100.0
48,45,2,1,4,-3,-75.0
48,45,3,5,8,-3,-37.5
48,45,4,18,16,2,12.5
48,45,5,23,32,-9,-28.125
48,45,6,171,64,107,167.1875
48,45,7,48,128,-80,-62.5
48,45,8,516,256,260,101.5625
48,45,9,44,512,-468,-91.40625
48,45,10,533,1024,-491,-47.94921875
48,45,11,1152,2048,-896,-43.75
48,45,12,1035,4096,-3061,-74.7314453125
48,45,13,1072,8192,-7120,-86.9140625
48,45,14,14529,16384,-1855,-11.322021484375
48,45,15,130856,32768,98088,299.3408203125
48,46,1,0,2,-2,-100.0
48,46,2,2,4,-2,-50.0
48,46,3,4,8,-4,-50.0
48,46,4,7,16,-9,-56.25
48,46,5,4,32,-28,-87.5
48,46,6,125,64,61,95.3125
48,46,7,86,128,-42,-32.8125
48,46,8,175,256,-81,-31.640625
48,46,9,204,512,-308,-60.15625
48,46,10,695,1024,-329,-32.12890625
48,46,11,662,2048,-1386,-67.67578125
48,46,12,963,4096,-3133,-76.4892578125
48,46,13,18409,8192,10217,124.71923828125
48,46,14,9957,16384,-6427,-39.227294921875
48,46,15,57663,32768,24895,75.9735107421875
48,47,1,0,2,-2,-100.0
48,47,2,1,4,-3,-75.0
48,47,3,13,8,5,62.5
48,47,4,3,16,-13,-81.25
48,47,5,46,32,14,43.75
48,47,6,82,64,18,28.125
48,47,7,6,128,-122,-95.3125
48,47,8,122,256,-134,-52.34375
48,47,9,207,512,-305,-59.5703125
48,47,10,1434,1024,410,40.0390625
48,47,11,3117,2048,1069,52.197265625
48,47,12,2754,4096,-1342,-32.763671875
48,47,13,4421,8192,-3771,-46.03271484375
48,47,14,545,16384,-15839,-96.673583984375
48,47,15,10997,32768,-21771,-66.4398193359375
48,48,1,0,2,-2,-100.0
48,48,2,4,4,0,0.0
48,48,3,2,8,-6,-75.0
48,48,4,15,16,-1,-6.25
48,48,5,4,32,-28,-87.5
48,48,6,14,64,-50,-78.125
48,48,7,64,128,-64,-50.0
48,48,8,688,256,432,168.75
48,48,9,681,512,169,33.0078125
48,48,10,3096,1024,2072,202.34375
48,48,11,2292,2048,244,11.9140625
48,48,12,4566,4096,470,11.474609375
48,48,13,3958,8192,-4234,-51.6845703125
48,48,14,12749,16384,-3635,-22.186279296875
48,48,15,56833,32768,24065,73.4405517578125
49,1,1,0,2,-2,-100.0
49,1,2,2,4,-2,-50.0
49,1,3,6,8,-2,-25.0
49,1,4,28,16,12,75.0
49,1,5,4,32,-28,-87.5
49,1,6,59,64,-5,-7.8125
49,1,7,92,128,-36,-28.125
49,1,8,303,256,47,18.359375
49,1,9,37,512,-475,-92.7734375
49,1,10,760,1024,-264,-25.78125
49,1,11,3333,2048,1285,62.744140625
49,1,12,3255,4096,-841,-20.5322265625
49,1,13,24035,8192,15843,193.39599609375
49,1,14,1027,16384,-15357,-93.731689453125
49,1,15,26490,32768,-6278,-19.158935546875
49,2,1,0,2,-2,-100.0
49,2,2,1,4,-3,-75.0
49,2,3,2,8,-6,-75.0
49,2,4,25,16,9,56.25
49,2,5,14,32,-18,-56.25
49,2,6,13,64,-51,-79.6875
49,2,7,112,128,-16,-12.5
49,2,8,261,256,5,1.953125
49,2,9,8,512,-504,-98.4375
49,2,10,4923,1024,3899,380.76171875
49,2,11,6905,2048,4857,237.158203125
49,2,12,4303,4096,207,5.0537109375
49,2,13,1495,8192,-6697,-81.75048828125
49,2,14,7275,16384,-9109,-55.596923828125
49,2,15,4853,32768,-27915,-85.1898193359375
49,3,1,0,2,-2,-100.0
49,3,2,3,4,-1,-25.0
49,3,3,4,8,-4,-50.0
49,3,4,21,16,5,31.25
49,3,5,55,32,23,71.875
49,3,6,5,64,-59,-92.1875
49,3,7,579,128,451,352.34375
49,3,8,33,256,-223,-87.109375
49,3,9,2160,512,1648,321.875
49,3,10,234,1024,-790,-77.1484375
49,3,11,2371,2048,323,15.771484375
49,3,12,4655,4096,559,13.6474609375
49,3,13,7184,8192,-1008,-12.3046875
49,3,14,37352,16384,20968,127.978515625
49,3,15,26037,32768,-6731,-20.5413818359375
49,4,1,0,2,-2,-100.0
49,4,2,1,4,-3,-75.0
49,4,3,18,8,10,125.0
49,4,4,19,16,3,18.75
49,4,5,39,32,7,21.875
49,4,6,51,64,-13,-20.3125
49,4,7,80,128,-48,-37.5
49,4,8,201,256,-55,-21.484375
49,4,9,939,512,427,83.3984375
49,4,10,748,1024,-276,-26.953125
49,4,11,998,2048,-1050,-51.26953125
49,4,12,1948,4096,-2148,-52.44140625
49,4,13,4426,8192,-3766,-45.9716796875
49,4,14,4138,16384,-12246,-74.74365234375
49,4,15,48317,32768,15549,47.4517822265625
49,5,1,0,2,-2,-100.0
49,5,2,1,4,-3,-75.0
49,5,3,2,8,-6,-75.0
49,5,4,3,16,-13,-81.25
49,5,5,71,32,39,121.875
49,5,6,38,64,-26,-40.625
49,5,7,86,128,-42,-32.8125
49,5,8,31,256,-225,-87.890625
49,5,9,342,512,-170,-33.203125
49,5,10,81,1024,-943,-92.08984375
49,5,11,8006,2048,5958,290.91796875
49,5,12,6869,4096,2773,67.7001953125
49,5,13,4941,8192,-3251,-39.68505859375
49,5,14,2460,16384,-13924,-84.9853515625
49,5,15,1751,32768,-31017,-94.6563720703125
49,6,1,0,2,-2,-100.0
49,6,2,3,4,-1,-25.0
49,6,3,3,8,-5,-62.5
49,6,4,7,16,-9,-56.25
49,6,5,20,32,-12,-37.5
49,6,6,9,64,-55,-85.9375
49,6,7,232,128,104,81.25
49,6,8,727,256,471,183.984375
49,6,9,1002,512,490,95.703125
49,6,10,1937,1024,913,89.16015625
49,6,11,2085,2048,37,1.806640625
49,6,12,7711,4096,3615,88.2568359375
49,6,13,25080,8192,16888,206.15234375
49,6,14,563,16384,-15821,-96.563720703125
49,6,15,12926,32768,-19842,-60.552978515625
49,7,1,0,2,-2,-100.0
49,7,2,4,4,0,0.0
49,7,3,3,8,-5,-62.5
49,7,4,8,16,-8,-50.0
49,7,5,136,32,104,325.0
49,7,6,120,64,56,87.5
49,7,7,74,128,-54,-42.1875
49,7,8,46,256,-210,-82.03125
49,7,9,194,512,-318,-62.109375
49,7,10,644,1024,-380,-37.109375
49,7,11,115,2048,-1933,-94.384765625
49,7,12,1349,4096,-2747,-67.0654296875
49,7,13,13101,8192,4909,59.92431640625
49,7,14,29381,16384,12997,79.327392578125
49,7,15,54063,32768,21295,64.9871826171875
49,8,1,0,2,-2,-100.0
49,8,2,1,4,-3,-75.0
49,8,3,2,8,-6,-75.0
49,8,4,3,16,-13,-81.25
49,8,5,13,32,-19,-59.375
49,8,6,44,64,-20,-31.25
49,8,7,177,128,49,38.28125
49,8,8,47,256,-209,-81.640625
49,8,9,492,512,-20,-3.90625
49,8,10,689,1024,-335,-32.71484375
49,8,11,3381,2048,1333,65.087890625
49,8,12,1119,4096,-2977,-72.6806640625
49,8,13,12517,8192,4325,52.79541015625
49,8,14,59089,16384,42705,260.650634765625
49,8,15,31707,32768,-1061,-3.2379150390625
49,9,1,0,2,-2,-100.0
49,9,2,1,4,-3,-75.0
49,9,3,7,8,-1,-12.5
49,9,4,6,16,-10,-62.5
49,9,5,37,32,5,15.625
49,9,6,147,64,83,129.6875
49,9,7,70,128,-58,-45.3125
49,9,8,96,256,-160,-62.5
49,9,9,128,512,-384,-75.0
49,9,10,588,1024,-436,-42.578125
49,9,11,11321,2048,9273,452.783203125
49,9,12,3373,4096,-723,-17.6513671875
49,9,13,4072,8192,-4120,-50.29296875
49,9,14,1856,16384,-14528,-88.671875
49,9,15,6987,32768,-25781,-78.6773681640625
49,10,1,0,2,-2,-100.0
49,10,2,2,4,-2,-50.0
49,10,3,13,8,5,62.5
49,10,4,45,16,29,181.25
49,10,5,22,32,-10,-31.25
49,10,6,37,64,-27,-42.1875
49,10,7,316,128,188,146.875
49,10,8,200,256,-56,-21.875
49,10,9,273,512,-239,-46.6796875
49,10,10,143,1024,-881,-86.03515625
49,10,11,593,2048,-1455,-71.044921875
49,10,12,579,4096,-3517,-85.8642578125
49,10,13,9372,8192,1180,14.404296875
49,10,14,20980,16384,4596,28.0517578125
49,10,15,4642,32768,-28126,-85.833740234375
49,11,1,0,2,-2,-100.0
49,11,2,1,4,-3,-75.0
49,11,3,4,8,-4,-50.0
49,11,4,20,16,4,25.0
49,11,5,28,32,-4,-12.5
49,11,6,99,64,35,54.6875
49,11,7,23,128,-105,-82.03125
49,11,8,238,256,-18,-7.03125
49,11,9,947,512,435,84.9609375
49,11,10,1560,1024,536,52.34375
49,11,11,1697,2048,-351,-17.138671875
49,11,12,12927,4096,8831,215.6005859375
49,11,13,3007,8192,-5185,-63.29345703125
49,11,14,10699,16384,-5685,-34.698486328125
49,11,15,40341,32768,7573,23.1109619140625
49,12,1,0,2,-2,-100.0
49,12,2,2,4,-2,-50.0
49,12,3,2,8,-6,-75.0
49,12,4,6,16,-10,-62.5
49,12,5,29,32,-3,-9.375
49,12,6,31,64,-33,-51.5625
49,12,7,314,128,186,145.3125
49,12,8,276,256,20,7.8125
49,12,9,73,512,-439,-85.7421875
49,12,10,46,1024,-978,-95.5078125
49,12,11,1105,2048,-943,-46.044921875
49,12,12,124,4096,-3972,-96.97265625
49,12,13,6696,8192,-1496,-18.26171875
49,12,14,29970,16384,13586,82.92236328125
49,12,15,3570,32768,-29198,-89.105224609375
49,13,1,0,2,-2,-100.0
49,13,2,2,4,-2,-50.0
49,13,3,6,8,-2,-25.0
49,13,4,9,16,-7,-43.75
49,13,5,9,32,-23,-71.875
49,13,6,30,64,-34,-53.125
49,13,7,16,128,-112,-87.5
49,13,8,1304,256,1048,409.375
49,13,9,198,512,-314,-61.328125
49,13,10,361,1024,-663,-64.74609375
49,13,11,91,2048,-1957,-95.556640625
49,13,12,3478,4096,-618,-15.087890625
49,13,13,498,8192,-7694,-93.9208984375
49,13,14,2134,16384,-14250,-86.97509765625
49,13,15,41554,32768,8786,26.812744140625
49,14,1,0,2,-2,-100.0
49,14,2,5,4,1,25.0
49,14,3,2,8,-6,-75.0
49,14,4,3,16,-13,-81.25
49,14,5,32,32,0,0.0
49,14,6,19,64,-45,-70.3125
49,14,7,178,128,50,39.0625
49,14,8,24,256,-232,-90.625
49,14,9,151,512,-361,-70.5078125
49,14,10,121,1024,-903,-88.18359375
49,14,11,962,2048,-1086,-53.02734375
49,14,12,8907,4096,4811,117.4560546875
49,14,13,10900,8192,2708,33.056640625
49,14,14,26626,16384,10242,62.51220703125
49,14,15,20545,32768,-12223,-37.3016357421875
49,15,1,0,2,-2,-100.0
49,15,2,2,4,-2,-50.0
49,15,3,15,8,7,87.5
49,15,4,6,16,-10,-62.5
49,15,5,52,32,20,62.5
49,15,6,231,64,167,260.9375
49,15,7,27,128,-101,-78.90625
49,15,8,103,256,-153,-59.765625
49,15,9,245,512,-267,-52.1484375
49,15,10,1058,1024,34,3.3203125
49,15,11,4382,2048,2334,113.96484375
49,15,12,4268,4096,172,4.19921875
49,15,13,13395,8192,5203,63.51318359375
49,15,14,126,16384,-16258,-99.23095703125
49,15,15,42505,32768,9737,29.7149658203125
49,16,1,0,2,-2,-100.0
49,16,2,3,4,-1,-25.0
49,16,3,8,8,0,0.0
49,16,4,3,16,-13,-81.25
49,16,5,122,32,90,281.25
49,16,6,33,64,-31,-48.4375
49,16,7,15,128,-113,-88.28125
49,16,8,150,256,-106,-41.40625
49,16,9,620,512,108,21.09375
49,16,10,274,1024,-750,-73.2421875
49,16,11,447,2048,-1601,-78.173828125
49,16,12,415,4096,-3681,-89.8681640625
49,16,13,3884,8192,-4308,-52.587890625
49,16,14,180,16384,-16204,-98.9013671875
49,16,15,98951,32768,66183,201.9744873046875
49,17,1,0,2,-2,-100.0
49,17,2,1,4,-3,-75.0
49,17,3,12,8,4,50.0
49,17,4,13,16,-3,-18.75
49,17,5,19,32,-13,-40.625
49,17,6,27,64,-37,-57.8125
49,17,7,10,128,-118,-92.1875
49,17,8,9,256,-247,-96.484375
49,17,9,9,512,-503,-98.2421875
49,17,10,256,1024,-768,-75.0
49,17,11,421,2048,-1627,-79.443359375
49,17,12,13674,4096,9578,233.837890625
49,17,13,12596,8192,4404,53.759765625
49,17,14,29732,16384,13348,81.4697265625
49,17,15,9147,32768,-23621,-72.0855712890625
49,18,1,0,2,-2,-100.0
49,18,2,1,4,-3,-75.0
49,18,3,22,8,14,175.0
49,18,4,32,16,16,100.0
49,18,5,9,32,-23,-71.875
49,18,6,8,64,-56,-87.5
49,18,7,152,128,24,18.75
49,18,8,240,256,-16,-6.25
49,18,9,1544,512,1032,201.5625
49,18,10,1295,1024,271,26.46484375
49,18,11,3511,2048,1463,71.435546875
49,18,12,2697,4096,-1399,-34.1552734375
49,18,13,1536,8192,-6656,-81.25
49,18,14,16259,16384,-125,-0.762939453125
49,18,15,37580,32768,4812,14.68505859375
49,19,1,0,2,-2,-100.0
49,19,2,3,4,-1,-25.0
49,19,3,6,8,-2,-25.0
49,19,4,3,16,-13,-81.25
49,19,5,5,32,-27,-84.375
49,19,6,5,64,-59,-92.1875
49,19,7,65,128,-63,-49.21875
49,19,8,477,256,221,86.328125
49,19,9,669,512,157,30.6640625
49,19,10,378,1024,-646,-63.0859375
49,19,11,1560,2048,-488,-23.828125
49,19,12,4598,4096,502,12.255859375
49,19,13,8748,8192,556,6.787109375
49,19,14,20642,16384,4258,25.98876953125
49,19,15,33149,32768,381,1.1627197265625
49,20,1,0,2,-2,-100.0
49,20,2,4,4,0,0.0
49,20,3,12,8,4,50.0
49,20,4,20,16,4,25.0
49,20,5,44,32,12,37.5
49,20,6,127,64,63,98.4375
49,20,7,26,128,-102,-79.6875
49,20,8,289,256,33,12.890625
49,20,9,477,512,-35,-6.8359375
49,20,10,2559,1024,1535,149.90234375
49,20,11,304,2048,-1744,-85.15625
49,20,12,1201,4096,-2895,-70.6787109375
49,20,13,1008,8192,-7184,-87.6953125
49,20,14,13099,16384,-3285,-20.050048828125
49,20,15,31653,32768,-1115,-3.4027099609375
49,21,1,0,2,-2,-100.0
49,21,2,2,4,-2,-50.0
49,21,3,2,8,-6,-75.0
49,21,4,10,16,-6,-37.5
49,21,5,11,32,-21,-65.625
49,21,6,197,64,133,207.8125
49,21,7,321,128,193,150.78125
49,21,8,30,256,-226,-88.28125
49,21,9,108,512,-404,-78.90625
49,21,10,765,1024,-259,-25.29296875
49,21,11,1712,2048,-336,-16.40625
49,21,12,1464,4096,-2632,-64.2578125
49,21,13,11478,8192,3286,40.1123046875
49,21,14,9316,16384,-7068,-43.1396484375
49,21,15,36670,32768,3902,11.907958984375
49,22,1,0,2,-2,-100.0
49,22,2,1,4,-3,-75.0
49,22,3,3,8,-5,-62.5
49,22,4,5,16,-11,-68.75
49,22,5,4,32,-28,-87.5
49,22,6,51,64,-13,-20.3125
49,22,7,104,128,-24,-18.75
49,22,8,256,256,0,0.0
49,22,9,890,512,378,73.828125
49,22,10,412,1024,-612,-59.765625
49,22,11,492,2048,-1556,-75.9765625
49,22,12,6320,4096,2224,54.296875
49,22,13,4571,8192,-3621,-44.20166015625
49,22,14,8572,16384,-7812,-47.6806640625
49,22,15,22009,32768,-10759,-32.8338623046875
49,23,1,0,2,-2,-100.0
49,23,2,3,4,-1,-25.0
49,23,3,5,8,-3,-37.5
49,23,4,3,16,-13,-81.25
49,23,5,7,32,-25,-78.125
49,23,6,12,64,-52,-81.25
49,23,7,156,128,28,21.875
49,23,8,79,256,-177,-69.140625
49,23,9,267,512,-245,-47.8515625
49,23,10,2174,1024,1150,112.3046875
49,23,11,4353,2048,2305,112.548828125
49,23,12,2062,4096,-2034,-49.658203125
49,23,13,16417,8192,8225,100.40283203125
49,23,14,1626,16384,-14758,-90.07568359375
49,23,15,43353,32768,10585,32.3028564453125
49,24,1,0,2,-2,-100.0
49,24,2,1,4,-3,-75.0
49,24,3,2,8,-6,-75.0
49,24,4,9,16,-7,-43.75
49,24,5,4,32,-28,-87.5
49,24,6,72,64,8,12.5
49,24,7,42,128,-86,-67.1875
49,24,8,60,256,-196,-76.5625
49,24,9,406,512,-106,-20.703125
49,24,10,52,1024,-972,-94.921875
49,24,11,1297,2048,-751,-36.669921875
49,24,12,2823,4096,-1273,-31.0791015625
49,24,13,6450,8192,-1742,-21.2646484375
49,24,14,8112,16384,-8272,-50.48828125
49,24,15,1552,32768,-31216,-95.263671875
49,25,1,0,2,-2,-100.0
49,25,2,2,4,-2,-50.0
49,25,3,3,8,-5,-62.5
49,25,4,11,16,-5,-31.25
49,25,5,10,32,-22,-68.75
49,25,6,76,64,12,18.75
49,25,7,37,128,-91,-71.09375
49,25,8,449,256,193,75.390625
49,25,9,1322,512,810,158.203125
49,25,10,770,1024,-254,-24.8046875
49,25,11,1880,2048,-168,-8.203125
49,25,12,841,4096,-3255,-79.4677734375
49,25,13,6166,8192,-2026,-24.7314453125
49,25,14,5403,16384,-10981,-67.022705078125
49,25,15,53210,32768,20442,62.384033203125
49,26,1,0,2,-2,-100.0
49,26,2,2,4,-2,-50.0
49,26,3,2,8,-6,-75.0
49,26,4,30,16,14,87.5
49,26,5,20,32,-12,-37.5
49,26,6,24,64,-40,-62.5
49,26,7,87,128,-41,-32.03125
49,26,8,97,256,-159,-62.109375
49,26,9,831,512,319,62.3046875
49,26,10,885,1024,-139,-13.57421875
49,26,11,895,2048,-1153,-56.298828125
49,26,12,4054,4096,-42,-1.025390625
49,26,13,10891,8192,2699,32.94677734375
49,26,14,60833,16384,44449,271.295166015625
49,26,15,5361,32768,-27407,-83.6395263671875
49,27,1,0,2,-2,-100.0
49,27,2,2,4,-2,-50.0
49,27,3,6,8,-2,-25.0
49,27,4,12,16,-4,-25.0
49,27,5,12,32,-20,-62.5
49,27,6,153,64,89,139.0625
49,27,7,119,128,-9,-7.03125
49,27,8,402,256,146,57.03125
49,27,9,1297,512,785,153.3203125
49,27,10,41,1024,-983,-95.99609375
49,27,11,1321,2048,-727,-35.498046875
49,27,12,2588,4096,-1508,-36.81640625
49,27,13,10007,8192,1815,22.15576171875
49,27,14,9860,16384,-6524,-39.8193359375
49,27,15,29610,32768,-3158,-9.637451171875
49,28,1,0,2,-2,-100.0
49,28,2,1,4,-3,-75.0
49,28,3,2,8,-6,-75.0
49,28,4,9,16,-7,-43.75
49,28,5,6,32,-26,-81.25
49,28,6,12,64,-52,-81.25
49,28,7,11,128,-117,-91.40625
49,28,8,850,256,594,232.03125
49,28,9,198,512,-314,-61.328125
49,28,10,1124,1024,100,9.765625
49,28,11,6654,2048,4606,224.90234375
49,28,12,475,4096,-3621,-88.4033203125
49,28,13,8493,8192,301,3.67431640625
49,28,14,18980,16384,2596,15.8447265625
49,28,15,66598,32768,33830,103.240966796875
49,29,1,0,2,-2,-100.0
49,29,2,1,4,-3,-75.0
49,29,3,3,8,-5,-62.5
49,29,4,4,16,-12,-75.0
49,29,5,43,32,11,34.375
49,29,6,39,64,-25,-39.0625
49,29,7,145,128,17,13.28125
49,29,8,415,256,159,62.109375
49,29,9,368,512,-144,-28.125
49,29,10,21,1024,-1003,-97.94921875
49,29,11,1214,2048,-834,-40.72265625
49,29,12,4405,4096,309,7.5439453125
49,29,13,14318,8192,6126,74.7802734375
49,29,14,11413,16384,-4971,-30.340576171875
49,29,15,8806,32768,-23962,-73.126220703125
49,30,1,0,2,-2,-100.0
49,30,2,1,4,-3,-75.0
49,30,3,3,8,-5,-62.5
49,30,4,3,16,-13,-81.25
49,30,5,24,32,-8,-25.0
49,30,6,5,64,-59,-92.1875
49,30,7,33,128,-95,-74.21875
49,30,8,485,256,229,89.453125
49,30,9,712,512,200,39.0625
49,30,10,192,1024,-832,-81.25
49,30,11,2528,2048,480,23.4375
49,30,12,405,4096,-3691,-90.1123046875
49,30,13,3237,8192,-4955,-60.48583984375
49,30,14,400,16384,-15984,-97.55859375
49,30,15,17547,32768,-15221,-46.4508056640625
49,31,1,0,2,-2,-100.0
49,31,2,2,4,-2,-50.0
49,31,3,6,8,-2,-25.0
49,31,4,15,16,-1,-6.25
49,31,5,20,32,-12,-37.5
49,31,6,90,64,26,40.625
49,31,7,108,128,-20,-15.625
49,31,8,17,256,-239,-93.359375
49,31,9,464,512,-48,-9.375
49,31,10,2518,1024,1494,145.8984375
49,31,11,1767,2048,-281,-13.720703125
49,31,12,432,4096,-3664,-89.453125
49,31,13,2643,8192,-5549,-67.73681640625
49,31,14,98683,16384,82299,502.313232421875
49,31,15,3213,32768,-29555,-90.1947021484375
49,32,1,0,2,-2,-100.0
49,32,2,3,4,-1,-25.0
49,32,3,4,8,-4,-50.0
49,32,4,33,16,17,106.25
49,32,5,31,32,-1,-3.125
49,32,6,76,64,12,18.75
49,32,7,66,128,-62,-48.4375
49,32,8,179,256,-77,-30.078125
49,32,9,214,512,-298,-58.203125
49,32,10,3797,1024,2773,270.80078125
49,32,11,117,2048,-1931,-94.287109375
49,32,12,6667,4096,2571,62.7685546875
49,32,13,436,8192,-7756,-94.677734375
49,32,14,2493,16384,-13891,-84.783935546875
49,32,15,64073,32768,31305,95.5352783203125
49,33,1,0,2,-2,-100.0
49,33,2,4,4,0,0.0
49,33,3,18,8,10,125.0
49,33,4,22,16,6,37.5
49,33,5,32,32,0,0.0
49,33,6,48,64,-16,-25.0
49,33,7,497,128,369,288.28125
49,33,8,995,256,739,288.671875
49,33,9,1878,512,1366,266.796875
49,33,10,3434,1024,2410,235.3515625
49,33,11,5074,2048,3026,147.75390625
49,33,12,38,4096,-4058,-99.072265625
49,33,13,3208,8192,-4984,-60.83984375
49,33,14,29745,16384,13361,81.549072265625
49,33,15,4400,32768,-28368,-86.572265625
49,34,1,0,2,-2,-100.0
49,34,2,1,4,-3,-75.0
49,34,3,2,8,-6,-75.0
49,34,4,30,16,14,87.5
49,34,5,24,32,-8,-25.0
49,34,6,25,64,-39,-60.9375
49,34,7,37,128,-91,-71.09375
49,34,8,384,256,128,50.0
49,34,9,603,512,91,17.7734375
49,34,10,93,1024,-931,-90.91796875
49,34,11,6443,2048,4395,214.599609375
49,34,12,4015,4096,-81,-1.9775390625
49,34,13,785,8192,-7407,-90.41748046875
49,34,14,5219,16384,-11165,-68.145751953125
49,34,15,3978,32768,-28790,-87.860107421875
49,35,1,0,2,-2,-100.0
49,35,2,1,4,-3,-75.0
49,35,3,10,8,2,25.0
49,35,4,20,16,4,25.0
49,35,5,4,32,-28,-87.5
49,35,6,70,64,6,9.375
49,35,7,83,128,-45,-35.15625
49,35,8,110,256,-146,-57.03125
49,35,9,105,512,-407,-79.4921875
49,35,10,469,1024,-555,-54.19921875
49,35,11,316,2048,-1732,-84.5703125
49,35,12,4566,4096,470,11.474609375
49,35,13,1995,8192,-6197,-75.64697265625
49,35,14,14007,16384,-2377,-14.508056640625
49,35,15,32515,32768,-253,-0.7720947265625
49,36,1,0,2,-2,-100.0
49,36,2,4,4,0,0.0
49,36,3,2,8,-6,-75.0
49,36,4,11,16,-5,-31.25
49,36,5,5,32,-27,-84.375
49,36,6,23,64,-41,-64.0625
49,36,7,56,128,-72,-56.25
49,36,8,498,256,242,94.53125
49,36,9,168,512,-344,-67.1875
49,36,10,926,1024,-98,-9.5703125
49,36,11,3154,2048,1106,54.00390625
49,36,12,199,4096,-3897,-95.1416015625
49,36,13,15568,8192,7376,90.0390625
49,36,14,1341,16384,-15043,-91.815185546875
49,36,15,61432,32768,28664,87.4755859375
49,37,1,0,2,-2,-100.0
49,37,2,1,4,-3,-75.0
49,37,3,3,8,-5,-62.5
49,37,4,11,16,-5,-31.25
49,37,5,14,32,-18,-56.25
49,37,6,8,64,-56,-87.5
49,37,7,35,128,-93,-72.65625
49,37,8,81,256,-175,-68.359375
49,37,9,71,512,-441,-86.1328125
49,37,10,1852,1024,828,80.859375
49,37,11,10195,2048,8147,397.802734375
49,37,12,964,4096,-3132,-76.46484375
49,37,13,151,8192,-8041,-98.15673828125
49,37,14,20042,16384,3658,22.32666015625
49,37,15,3044,32768,-29724,-90.71044921875
49,38,1,0,2,-2,-100.0
49,38,2,1,4,-3,-75.0
49,38,3,17,8,9,112.5
49,38,4,10,16,-6,-37.5
49,38,5,4,32,-28,-87.5
49,38,6,278,64,214,334.375
49,38,7,6,128,-122,-95.3125
49,38,8,207,256,-49,-19.140625
49,38,9,588,512,76,14.84375
49,38,10,377,1024,-647,-63.18359375
49,38,11,1478,2048,-570,-27.83203125
49,38,12,770,4096,-3326,-81.201171875
49,38,13,19925,8192,11733,143.22509765625
49,38,14,26865,16384,10481,63.970947265625
49,38,15,4094,32768,-28674,-87.506103515625
49,39,1,0,2,-2,-100.0
49,39,2,2,4,-2,-50.0
49,39,3,2,8,-6,-75.0
49,39,4,3,16,-13,-81.25
49,39,5,58,32,26,81.25
49,39,6,307,64,243,379.6875
49,39,7,538,128,410,320.3125
49,39,8,305,256,49,19.140625
49,39,9,667,512,155,30.2734375
49,39,10,359,1024,-665,-64.94140625
49,39,11,1988,2048,-60,-2.9296875
49,39,12,18,4096,-4078,-99.560546875
49,39,13,5129,8192,-3063,-37.39013671875
49,39,14,6425,16384,-9959,-60.784912109375
49,39,15,26692,32768,-6076,-18.54248046875
49,40,1,0,2,-2,-100.0
49,40,2,2,4,-2,-50.0
49,40,3,2,8,-6,-75.0
49,40,4,44,16,28,175.0
49,40,5,7,32,-25,-78.125
49,40,6,149,64,85,132.8125
49,40,7,89,128,-39,-30.46875
49,40,8,245,256,-11,-4.296875
49,40,9,1011,512,499,97.4609375
49,40,10,3219,1024,2195,214.35546875
49,40,11,339,2048,-1709,-83.447265625
49,40,12,3160,4096,-936,-22.8515625
49,40,13,4173,8192,-4019,-49.06005859375
49,40,14,14439,16384,-1945,-11.871337890625
49,40,15,54165,32768,21397,65.2984619140625
49,41,1,0,2,-2,-100.0
49,41,2,5,4,1,25.0
49,41,3,4,8,-4,-50.0
49,41,4,14,16,-2,-12.5
49,41,5,5,32,-27,-84.375
49,41,6,106,64,42,65.625
49,41,7,210,128,82,64.0625
49,41,8,54,256,-202,-78.90625
49,41,9,167,512,-345,-67.3828125
49,41,10,882,1024,-142,-13.8671875
49,41,11,310,2048,-1738,-84.86328125
49,41,12,19929,4096,15833,386.5478515625
49,41,13,843,8192,-7349,-89.70947265625
49,41,14,69362,16384,52978,323.35205078125
49,41,15,27256,32768,-5512,-16.8212890625
49,42,1,0,2,-2,-100.0
49,42,2,1,4,-3,-75.0
49,42,3,2,8,-6,-75.0
49,42,4,9,16,-7,-43.75
49,42,5,23,32,-9,-28.125
49,42,6,41,64,-23,-35.9375
49,42,7,18,128,-110,-85.9375
49,42,8,25,256,-231,-90.234375
49,42,9,444,512,-68,-13.28125
49,42,10,487,1024,-537,-52.44140625
49,42,11,4366,2048,2318,113.18359375
49,42,12,5272,4096,1176,28.7109375
49,42,13,12525,8192,4333,52.89306640625
49,42,14,9999,16384,-6385,-38.970947265625
49,42,15,1294,32768,-31474,-96.051025390625
49,43,1,0,2,-2,-100.0
49,43,2,2,4,-2,-50.0
49,43,3,9,8,1,12.5
49,43,4,24,16,8,50.0
49,43,5,5,32,-27,-84.375
49,43,6,51,64,-13,-20.3125
49,43,7,172,128,44,34.375
49,43,8,433,256,177,69.140625
49,43,9,1107,512,595,116.2109375
49,43,10,499,1024,-525,-51.26953125
49,43,11,135,2048,-1913,-93.408203125
49,43,12,2946,4096,-1150,-28.076171875
49,43,13,23225,8192,15033,183.50830078125
49,43,14,65661,16384,49277,300.762939453125
49,43,15,56003,32768,23235,70.9075927734375
49,44,1,0,2,-2,-100.0
49,44,2,4,4,0,0.0
49,44,3,2,8,-6,-75.0
49,44,4,17,16,1,6.25
49,44,5,6,32,-26,-81.25
49,44,6,222,64,158,246.875
49,44,7,192,128,64,50.0
49,44,8,240,256,-16,-6.25
49,44,9,428,512,-84,-16.40625
49,44,10,450,1024,-574,-56.0546875
49,44,11,1562,2048,-486,-23.73046875
49,44,12,1773,4096,-2323,-56.7138671875
49,44,13,4996,8192,-3196,-39.013671875
49,44,14,35186,16384,18802,114.75830078125
49,44,15,11832,32768,-20936,-63.8916015625
49,45,1,0,2,-2,-100.0
49,45,2,3,4,-1,-25.0
49,45,3,5,8,-3,-37.5
49,45,4,19,16,3,18.75
49,45,5,4,32,-28,-87.5
49,45,6,11,64,-53,-82.8125
49,45,7,233,128,105,82.03125
49,45,8,52,256,-204,-79.6875
49,45,9,176,512,-336,-65.625
49,45,10,149,1024,-875,-85.44921875
49,45,11,77,2048,-1971,-96.240234375
49,45,12,756,4096,-3340,-81.54296875
49,45,13,3332,8192,-4860,-59.326171875
49,45,14,9445,16384,-6939,-42.352294921875
49,45,15,15012,32768,-17756,-54.18701171875
49,46,1,0,2,-2,-100.0
49,46,2,3,4,-1,-25.0
49,46,3,4,8,-4,-50.0
49,46,4,4,16,-12,-75.0
49,46,5,6,32,-26,-81.25
49,46,6,87,64,23,35.9375
49,46,7,23,128,-105,-82.03125
49,46,8,45,256,-211,-82.421875
49,46,9,8,512,-504,-98.4375
49,46,10,2995,1024,1971,192.48046875
49,46,11,4403,2048,2355,114.990234375
49,46,12,2146,4096,-1950,-47.607421875
49,46,13,5801,8192,-2391,-29.18701171875
49,46,14,397,16384,-15987,-97.576904296875
49,46,15,158816,32768,126048,384.66796875
49,47,1,0,2,-2,-100.0
49,47,2,6,4,2,50.0
49,47,3,3,8,-5,-62.5
49,47,4,15,16,-1,-6.25
49,47,5,8,32,-24,-75.0
49,47,6,82,64,18,28.125
49,47,7,49,128,-79,-61.71875
49,47,8,164,256,-92,-35.9375
49,47,9,481,512,-31,-6.0546875
49,47,10,139,1024,-885,-86.42578125
49,47,11,2863,2048,815,39.794921875
49,47,12,3138,4096,-958,-23.388671875
49,47,13,2062,8192,-6130,-74.8291015625
49,47,14,16982,16384,598,3.64990234375
49,47,15,5845,32768,-26923,-82.1624755859375
49,48,1,0,2,-2,-100.0
49,48,2,2,4,-2,-50.0
49,48,3,7,8,-1,-12.5
49,48,4,6,16,-10,-62.5
49,48,5,4,32,-28,-87.5
49,48,6,62,64,-2,-3.125
49,48,7,171,128,43,33.59375
49,48,8,100,256,-156,-60.9375
49,48,9,386,512,-126,-24.609375
49,48,10,329,1024,-695,-67.87109375
49,48,11,1242,2048,-806,-39.35546875
49,48,12,1246,4096,-2850,-69.580078125
49,48,13,5421,8192,-2771,-33.82568359375
49,48,14,11159,16384,-5225,-31.890869140625
49,48,15,3926,32768,-28842,-88.018798828125
49,49,1,0,2,-2,-100.0
49,49,2,1,4,-3,-75.0
49,49,3,3,8,-5,-62.5
49,49,4,49,16,33,206.25
49,49,5,74,32,42,131.25
49,49,6,66,64,2,3.125
49,49,7,38,128,-90,-70.3125
49,49,8,95,256,-161,-62.890625
49,49,9,925,512,413,80.6640625
49,49,10,1109,1024,85,8.30078125
49,49,11,1274,2048,-774,-37.79296875
49,49,12,1022,4096,-3074,-75.048828125
49,49,13,6394,8192,-1798,-21.9482421875
49,49,14,25740,16384,9356,57.1044921875
49,49,15,1774,32768,-30994,-94.586181640625
50,1,1,0,2,-2,-100.0
50,1,2,1,4,-3,-75.0
50,1,3,4,8,-4,-50.0
50,1,4,9,16,-7,-43.75
50,1,5,28,32,-4,-12.5
50,1,6,84,64,20,31.25
50,1,7,61,128,-67,-52.34375
50,1,8,85,256,-171,-66.796875
50,1,9,196,512,-316,-61.71875
50,1,10,528,1024,-496,-48.4375
50,1,11,4904,2048,2856,139.453125
50,1,12,557,4096,-3539,-86.4013671875
50,1,13,190,8192,-8002,-97.6806640625
50,1,14,13179,16384,-3205,-19.561767578125
50,1,15,65970,32768,33202,101.324462890625
50,2,1,0,2,-2,-100.0
50,2,2,1,4,-3,-75.0
50,2,3,2,8,-6,-75.0
50,2,4,9,16,-7,-43.75
50,2,5,85,32,53,165.625
50,2,6,41,64,-23,-35.9375
50,2,7,92,128,-36,-28.125
50,2,8,279,256,23,8.984375
50,2,9,165,512,-347,-67.7734375
50,2,10,1851,1024,827,80.76171875
50,2,11,6727,2048,4679,228.466796875
50,2,12,10289,4096,6193,151.1962890625
50,2,13,17122,8192,8930,109.0087890625
50,2,14,17178,16384,794,4.84619140625
50,2,15,52773,32768,20005,61.0504150390625
50,3,1,0,2,-2,-100.0
50,3,2,3,4,-1,-25.0
50,3,3,2,8,-6,-75.0
50,3,4,28,16,12,75.0
50,3,5,12,32,-20,-62.5
50,3,6,42,64,-22,-34.375
50,3,7,90,128,-38,-29.6875
50,3,8,112,256,-144,-56.25
50,3,9,814,512,302,58.984375
50,3,10,349,1024,-675,-65.91796875
50,3,11,3234,2048,1186,57.91015625
50,3,12,777,4096,-3319,-81.0302734375
50,3,13,3642,8192,-4550,-55.5419921875
50,3,14,16756,16384,372,2.2705078125
50,3,15,4345,32768,-28423,-86.7401123046875
50,4,1,0,2,-2,-100.0
50,4,2,2,4,-2,-50.0
50,4,3,6,8,-2,-25.0
50,4,4,9,16,-7,-43.75
50,4,5,9,32,-23,-71.875
50,4,6,40,64,-24,-37.5
50,4,7,79,128,-49,-38.28125
50,4,8,92,256,-164,-64.0625
50,4,9,9,512,-503,-98.2421875
50,4,10,868,1024,-156,-15.234375
50,4,11,412,2048,-1636,-79.8828125
50,4,12,4058,4096,-38,-0.927734375
50,4,13,17474,8192,9282,113.3056640625
50,4,14,24088,16384,7704,47.021484375
50,4,15,78161,32768,45393,138.5284423828125
50,5,1,0,2,-2,-100.0
50,5,2,2,4,-2,-50.0
50,5,3,2,8,-6,-75.0
50,5,4,10,16,-6,-37.5
50,5,5,15,32,-17,-53.125
50,5,6,7,64,-57,-89.0625
50,5,7,126,128,-2,-1.5625
50,5,8,392,256,136,53.125
50,5,9,1107,512,595,116.2109375
50,5,10,1594,1024,570,55.6640625
50,5,11,1257,2048,-791,-38.623046875
50,5,12,768,4096,-3328,-81.25
50,5,13,8886,8192,694,8.4716796875
50,5,14,49531,16384,33147,202.313232421875
50,5,15,30193,32768,-2575,-7.8582763671875
50,6,1,0,2,-2,-100.0
50,6,2,2,4,-2,-50.0
50,6,3,5,8,-3,-37.5
50,6,4,13,16,-3,-18.75
50,6,5,78,32,46,143.75
50,6,6,42,64,-22,-34.375
50,6,7,100,128,-28,-21.875
50,6,8,388,256,132,51.5625
50,6,9,499,512,-13,-2.5390625
50,6,10,5067,1024,4043,394.82421875
50,6,11,449,2048,-1599,-78.076171875
50,6,12,739,4096,-3357,-81.9580078125
50,6,13,1303,8192,-6889,-84.09423828125
50,6,14,980,16384,-15404,-94.0185546875
50,6,15,14755,32768,-18013,-54.9713134765625
50,7,1,0,2,-2,-100.0
50,7,2,1,4,-3,-75.0
50,7,3,2,8,-6,-75.0
50,7,4,5,16,-11,-68.75
50,7,5,6,32,-26,-81.25
50,7,6,30,64,-34,-53.125
50,7,7,298,128,170,132.8125
50,7,8,575,256,319,124.609375
50,7,9,131,512,-381,-74.4140625
50,7,10,3342,1024,2318,226.3671875
50,7,11,529,2048,-1519,-74.169921875
50,7,12,16969,4096,12873,314.2822265625
50,7,13,18742,8192,10550,128.7841796875
50,7,14,5051,16384,-11333,-69.171142578125
50,7,15,69670,32768,36902,112.615966796875
50,8,1,0,2,-2,-100.0
50,8,2,2,4,-2,-50.0
50,8,3,5,8,-3,-37.5
50,8,4,10,16,-6,-37.5
50,8,5,37,32,5,15.625
50,8,6,140,64,76,118.75
50,8,7,6,128,-122,-95.3125
50,8,8,95,256,-161,-62.890625
50,8,9,51,512,-461,-90.0390625
50,8,10,1071,1024,47,4.58984375
50,8,11,3248,2048,1200,58.59375
50,8,12,442,4096,-3654,-89.208984375
50,8,13,4534,8192,-3658,-44.6533203125
50,8,14,5696,16384,-10688,-65.234375
50,8,15,2912,32768,-29856,-91.11328125
50,9,1,0,2,-2,-100.0
50,9,2,1,4,-3,-75.0
50,9,3,2,8,-6,-75.0
50,9,4,3,16,-13,-81.25
50,9,5,9,32,-23,-71.875
50,9,6,54,64,-10,-15.625
50,9,7,187,128,59,46.09375
50,9,8,277,256,21,8.203125
50,9,9,1138,512,626,122.265625
50,9,10,4175,1024,3151,307.71484375
50,9,11,2583,2048,535,26.123046875
50,9,12,1970,4096,-2126,-51.904296875
50,9,13,127,8192,-8065,-98.44970703125
50,9,14,33261,16384,16877,103.009033203125
50,9,15,25649,32768,-7119,-21.7254638671875
50,10,1,0,2,-2,-100.0
50,10,2,1,4,-3,-75.0
50,10,3,3,8,-5,-62.5
50,10,4,6,16,-10,-62.5
50,10,5,17,32,-15,-46.875
50,10,6,175,64,111,173.4375
50,10,7,176,128,48,37.5
50,10,8,267,256,11,4.296875
50,10,9,724,512,212,41.40625
50,10,10,1113,1024,89,8.69140625
50,10,11,1877,2048,-171,-8.349609375
50,10,12,2356,4096,-1740,-42.48046875
50,10,13,7265,8192,-927,-11.31591796875
50,10,14,1713,16384,-14671,-89.544677734375
50,10,15,1959,32768,-30809,-94.0216064453125
50,11,1,0,2,-2,-100.0
50,11,2,4,4,0,0.0
50,11,3,7,8,-1,-12.5
50,11,4,9,16,-7,-43.75
50,11,5,9,32,-23,-71.875
50,11,6,77,64,13,20.3125
50,11,7,92,128,-36,-28.125
50,11,8,298,256,42,16.40625
50,11,9,737,512,225,43.9453125
50,11,10,894,1024,-130,-12.6953125
50,11,11,1187,2048,-861,-42.041015625
50,11,12,15257,4096,11161,272.4853515625
50,11,13,4302,8192,-3890,-47.4853515625
50,11,14,925,16384,-15459,-94.354248046875
50,11,15,7117,32768,-25651,-78.2806396484375
50,12,1,0,2,-2,-100.0
50,12,2,1,4,-3,-75.0
50,12,3,8,8,0,0.0
50,12,4,26,16,10,62.5
50,12,5,25,32,-7,-21.875
50,12,6,171,64,107,167.1875
50,12,7,95,128,-33,-25.78125
50,12,8,74,256,-182,-71.09375
50,12,9,145,512,-367,-71.6796875
50,12,10,474,1024,-550,-53.7109375
50,12,11,2125,2048,77,3.759765625
50,12,12,2362,4096,-1734,-42.333984375
50,12,13,2798,8192,-5394,-65.8447265625
50,12,14,21766,16384,5382,32.84912109375
50,12,15,26818,32768,-5950,-18.157958984375
50,13,1,0,2,-2,-100.0
50,13,2,3,4,-1,-25.0
50,13,3,5,8,-3,-37.5
50,13,4,6,16,-10,-62.5
50,13,5,17,32,-15,-46.875
50,13,6,51,64,-13,-20.3125
50,13,7,8,128,-120,-93.75
50,13,8,68,256,-188,-73.4375
50,13,9,450,512,-62,-12.109375
50,13,10,590,1024,-434,-42.3828125
50,13,11,3070,2048,1022,49.90234375
50,13,12,5714,4096,1618,39.501953125
50,13,13,12873,8192,4681,57.14111328125
50,13,14,4074,16384,-12310,-75.13427734375
50,13,15,11130,32768,-21638,-66.033935546875
50,14,1,0,2,-2,-100.0
50,14,2,1,4,-3,-75.0
50,14,3,6,8,-2,-25.0
50,14,4,25,16,9,56.25
50,14,5,21,32,-11,-34.375
50,14,6,6,64,-58,-90.625
50,14,7,16,128,-112,-87.5
50,14,8,367,256,111,43.359375
50,14,9,132,512,-380,-74.21875
50,14,10,62,1024,-962,-93.9453125
50,14,11,1849,2048,-199,-9.716796875
50,14,12,1705,4096,-2391,-58.3740234375
50,14,13,3045,8192,-5147,-62.82958984375
50,14,14,26045,16384,9661,58.966064453125
50,14,15,9081,32768,-23687,-72.2869873046875
50,15,1,0,2,-2,-100.0
50,15,2,1,4,-3,-75.0
50,15,3,3,8,-5,-62.5
50,15,4,6,16,-10,-62.5
50,15,5,19,32,-13,-40.625
50,15,6,130,64,66,103.125
50,15,7,97,128,-31,-24.21875
50,15,8,179,256,-77,-30.078125
50,15,9,310,512,-202,-39.453125
50,15,10,115,1024,-909,-88.76953125
50,15,11,594,2048,-1454,-70.99609375
50,15,12,2115,4096,-1981,-48.3642578125
50,15,13,20273,8192,12081,147.47314453125
50,15,14,14834,16384,-1550,-9.46044921875
50,15,15,997,32768,-31771,-96.9573974609375
50,16,1,0,2,-2,-100.0
50,16,2,4,4,0,0.0
50,16,3,2,8,-6,-75.0
50,16,4,5,16,-11,-68.75
50,16,5,133,32,101,315.625
50,16,6,129,64,65,101.5625
50,16,7,9,128,-119,-92.96875
50,16,8,442,256,186,72.65625
50,16,9,768,512,256,50.0
50,16,10,564,1024,-460,-44.921875
50,16,11,3568,2048,1520,74.21875
50,16,12,278,4096,-3818,-93.212890625
50,16,13,863,8192,-7329,-89.46533203125
50,16,14,3880,16384,-12504,-76.318359375
50,16,15,25317,32768,-7451,-22.7386474609375
50,17,1,0,2,-2,-100.0
50,17,2,6,4,2,50.0
50,17,3,4,8,-4,-50.0
50,17,4,16,16,0,0.0
50,17,5,95,32,63,196.875
50,17,6,19,64,-45,-70.3125
50,17,7,44,128,-84,-65.625
50,17,8,499,256,243,94.921875
50,17,9,29,512,-483,-94.3359375
50,17,10,309,1024,-715,-69.82421875
50,17,11,159,2048,-1889,-92.236328125
50,17,12,3737,4096,-359,-8.7646484375
50,17,13,2605,8192,-5587,-68.20068359375
50,17,14,3740,16384,-12644,-77.1728515625
50,17,15,14877,32768,-17891,-54.5989990234375
50,18,1,0,2,-2,-100.0
50,18,2,4,4,0,0.0
50,18,3,3,8,-5,-62.5
50,18,4,6,16,-10,-62.5
50,18,5,6,32,-26,-81.25
50,18,6,202,64,138,215.625
50,18,7,197,128,69,53.90625
50,18,8,320,256,64,25.0
50,18,9,1057,512,545,106.4453125
50,18,10,1405,1024,381,37.20703125
50,18,11,670,2048,-1378,-67.28515625
50,18,12,1914,4096,-2182,-53.271484375
50,18,13,931,8192,-7261,-88.63525390625
50,18,14,15863,16384,-521,-3.179931640625
50,18,15,8387,32768,-24381,-74.4049072265625
50,19,1,0,2,-2,-100.0
50,19,2,1,4,-3,-75.0
50,19,3,2,8,-6,-75.0
50,19,4,14,16,-2,-12.5
50,19,5,24,32,-8,-25.0
50,19,6,17,64,-47,-73.4375
50,19,7,85,128,-43,-33.59375
50,19,8,365,256,109,42.578125
50,19,9,265,512,-247,-48.2421875
50,19,10,1131,1024,107,10.44921875
50,19,11,1104,2048,-944,-46.09375
50,19,12,322,4096,-3774,-92.138671875
50,19,13,11030,8192,2838,34.6435546875
50,19,14,5493,16384,-10891,-66.473388671875
50,19,15,3876,32768,-28892,-88.17138671875
50,20,1,0,2,-2,-100.0
50,20,2,1,4,-3,-75.0
50,20,3,10,8,2,25.0
50,20,4,3,16,-13,-81.25
50,20,5,9,32,-23,-71.875
50,20,6,8,64,-56,-87.5
50,20,7,26,128,-102,-79.6875
50,20,8,237,256,-19,-7.421875
50,20,9,1019,512,507,99.0234375
50,20,10,482,1024,-542,-52.9296875
50,20,11,555,2048,-1493,-72.900390625
50,20,12,1462,4096,-2634,-64.306640625
50,20,13,13844,8192,5652,68.994140625
50,20,14,13190,16384,-3194,-19.49462890625
50,20,15,8771,32768,-23997,-73.2330322265625
50,21,1,0,2,-2,-100.0
50,21,2,2,4,-2,-50.0
50,21,3,5,8,-3,-37.5
50,21,4,5,16,-11,-68.75
50,21,5,10,32,-22,-68.75
50,21,6,62,64,-2,-3.125
50,21,7,235,128,107,83.59375
50,21,8,49,256,-207,-80.859375
50,21,9,102,512,-410,-80.078125
50,21,10,441,1024,-583,-56.93359375
50,21,11,160,2048,-1888,-92.1875
50,21,12,1795,4096,-2301,-56.1767578125
50,21,13,20055,8192,11863,144.81201171875
50,21,14,6941,16384,-9443,-57.635498046875
50,21,15,14750,32768,-18018,-54.986572265625
50,22,1,0,2,-2,-100.0
50,22,2,5,4,1,25.0
50,22,3,9,8,1,12.5
50,22,4,14,16,-2,-12.5
50,22,5,68,32,36,112.5
50,22,6,81,64,17,26.5625
50,22,7,61,128,-67,-52.34375
50,22,8,43,256,-213,-83.203125
50,22,9,309,512,-203,-39.6484375
50,22,10,3106,1024,2082,203.3203125
50,22,11,1108,2048,-940,-45.8984375
50,22,12,2507,4096,-1589,-38.7939453125
50,22,13,10375,8192,2183,26.64794921875
50,22,14,4562,16384,-11822,-72.15576171875
50,22,15,82553,32768,49785,151.9317626953125
50,23,1,0,2,-2,-100.0
50,23,2,1,4,-3,-75.0
50,23,3,3,8,-5,-62.5
50,23,4,7,16,-9,-56.25
50,23,5,15,32,-17,-53.125
50,23,6,40,64,-24,-37.5
50,23,7,262,128,134,104.6875
50,23,8,226,256,-30,-11.71875
50,23,9,31,512,-481,-93.9453125
50,23,10,677,1024,-347,-33.88671875
50,23,11,240,2048,-1808,-88.28125
50,23,12,7051,4096,2955,72.1435546875
50,23,13,23094,8192,14902,181.9091796875
50,23,14,7778,16384,-8606,-52.52685546875
50,23,15,15602,32768,-17166,-52.386474609375
50,24,1,0,2,-2,-100.0
50,24,2,1,4,-3,-75.0
50,24,3,2,8,-6,-75.0
50,24,4,25,16,9,56.25
50,24,5,47,32,15,46.875
50,24,6,15,64,-49,-76.5625
50,24,7,22,128,-106,-82.8125
50,24,8,400,256,144,56.25
50,24,9,1014,512,502,98.046875
50,24,10,1361,1024,337,32.91015625
50,24,11,5294,2048,3246,158.49609375
50,24,12,5888,4096,1792,43.75
50,24,13,1271,8192,-6921,-84.48486328125
50,24,14,11965,16384,-4419,-26.971435546875
50,24,15,67657,32768,34889,106.4727783203125
50,25,1,0,2,-2,-100.0
50,25,2,3,4,-1,-25.0
50,25,3,11,8,3,37.5
50,25,4,3,16,-13,-81.25
50,25,5,40,32,8,25.0
50,25,6,66,64,2,3.125
50,25,7,12,128,-116,-90.625
50,25,8,11,256,-245,-95.703125
50,25,9,23,512,-489,-95.5078125
50,25,10,1301,1024,277,27.05078125
50,25,11,1641,2048,-407,-19.873046875
50,25,12,2235,4096,-1861,-45.4345703125
50,25,13,5178,8192,-3014,-36.7919921875
50,25,14,1625,16384,-14759,-90.081787109375
50,25,15,19412,32768,-13356,-40.75927734375
50,26,1,0,2,-2,-100.0
50,26,2,1,4,-3,-75.0
50,26,3,2,8,-6,-75.0
50,26,4,18,16,2,12.5
50,26,5,21,32,-11,-34.375
50,26,6,47,64,-17,-26.5625
50,26,7,28,128,-100,-78.125
50,26,8,91,256,-165,-64.453125
50,26,9,268,512,-244,-47.65625
50,26,10,709,1024,-315,-30.76171875
50,26,11,12655,2048,10607,517.919921875
50,26,12,2615,4096,-1481,-36.1572265625
50,26,13,8122,8192,-70,-0.8544921875
50,26,14,4971,16384,-11413,-69.659423828125
50,26,15,15234,32768,-17534,-53.509521484375
50,27,1,0,2,-2,-100.0
50,27,2,2,4,-2,-50.0
50,27,3,4,8,-4,-50.0
50,27,4,3,16,-13,-81.25
50,27,5,19,32,-13,-40.625
50,27,6,155,64,91,142.1875
50,27,7,29,128,-99,-77.34375
50,27,8,336,256,80,31.25
50,27,9,379,512,-133,-25.9765625
50,27,10,226,1024,-798,-77.9296875
50,27,11,1179,2048,-869,-42.431640625
50,27,12,474,4096,-3622,-88.427734375
50,27,13,5318,8192,-2874,-35.0830078125
50,27,14,28244,16384,11860,72.3876953125
50,27,15,19883,32768,-12885,-39.3218994140625
50,28,1,0,2,-2,-100.0
50,28,2,3,4,-1,-25.0
50,28,3,5,8,-3,-37.5
50,28,4,4,16,-12,-75.0
50,28,5,13,32,-19,-59.375
50,28,6,33,64,-31,-48.4375
50,28,7,305,128,177,138.28125
50,28,8,136,256,-120,-46.875
50,28,9,342,512,-170,-33.203125
50,28,10,1348,1024,324,31.640625
50,28,11,481,2048,-1567,-76.513671875
50,28,12,723,4096,-3373,-82.3486328125
50,28,13,1687,8192,-6505,-79.40673828125
50,28,14,6155,16384,-10229,-62.432861328125
50,28,15,13472,32768,-19296,-58.88671875
50,29,1,0,2,-2,-100.0
50,29,2,1,4,-3,-75.0
50,29,3,4,8,-4,-50.0
50,29,4,28,16,12,75.0
50,29,5,10,32,-22,-68.75
50,29,6,18,64,-46,-71.875
50,29,7,67,128,-61,-47.65625
50,29,8,78,256,-178,-69.53125
50,29,9,392,512,-120,-23.4375
50,29,10,1110,1024,86,8.3984375
50,29,11,3984,2048,1936,94.53125
50,29,12,263,4096,-3833,-93.5791015625
50,29,13,5493,8192,-2699,-32.94677734375
50,29,14,1077,16384,-15307,-93.426513671875
50,29,15,53382,32768,20614,62.908935546875
50,30,1,0,2,-2,-100.0
50,30,2,1,4,-3,-75.0
50,30,3,4,8,-4,-50.0
50,30,4,10,16,-6,-37.5
50,30,5,44,32,12,37.5
50,30,6,16,64,-48,-75.0
50,30,7,89,128,-39,-30.46875
50,30,8,56,256,-200,-78.125
50,30,9,184,512,-328,-64.0625
50,30,10,1908,1024,884,86.328125
50,30,11,6149,2048,4101,200.244140625
50,30,12,13140,4096,9044,220.80078125
50,30,13,944,8192,-7248,-88.4765625
50,30,14,5975,16384,-10409,-63.531494140625
50,30,15,19853,32768,-12915,-39.4134521484375
50,31,1,0,2,-2,-100.0
50,31,2,3,4,-1,-25.0
50,31,3,2,8,-6,-75.0
50,31,4,3,16,-13,-81.25
50,31,5,56,32,24,75.0
50,31,6,5,64,-59,-92.1875
50,31,7,210,128,82,64.0625
50,31,8,134,256,-122,-47.65625
50,31,9,121,512,-391,-76.3671875
50,31,10,65,1024,-959,-93.65234375
50,31,11,836,2048,-1212,-59.1796875
50,31,12,2557,4096,-1539,-37.5732421875
50,31,13,2413,8192,-5779,-70.54443359375
50,31,14,982,16384,-15402,-94.00634765625
50,31,15,7637,32768,-25131,-76.6937255859375
50,32,1,0,2,-2,-100.0
50,32,2,4,4,0,0.0
50,32,3,3,8,-5,-62.5
50,32,4,3,16,-13,-81.25
50,32,5,4,32,-28,-87.5
50,32,6,41,64,-23,-35.9375
50,32,7,39,128,-89,-69.53125
50,32,8,433,256,177,69.140625
50,32,9,305,512,-207,-40.4296875
50,32,10,846,1024,-178,-17.3828125
50,32,11,48,2048,-2000,-97.65625
50,32,12,399,4096,-3697,-90.2587890625
50,32,13,1192,8192,-7000,-85.44921875
50,32,14,58094,16384,41710,254.57763671875
50,32,15,24454,32768,-8314,-25.372314453125
50,33,1,0,2,-2,-100.0
50,33,2,2,4,-2,-50.0
50,33,3,6,8,-2,-25.0
50,33,4,3,16,-13,-81.25
50,33,5,139,32,107,334.375
50,33,6,30,64,-34,-53.125
50,33,7,910,128,782,610.9375
50,33,8,96,256,-160,-62.5
50,33,9,367,512,-145,-28.3203125
50,33,10,1502,1024,478,46.6796875
50,33,11,6615,2048,4567,222.998046875
50,33,12,2084,4096,-2012,-49.12109375
50,33,13,917,8192,-7275,-88.80615234375
50,33,14,9385,16384,-6999,-42.718505859375
50,33,15,23173,32768,-9595,-29.2816162109375
50,34,1,0,2,-2,-100.0
50,34,2,1,4,-3,-75.0
50,34,3,8,8,0,0.0
50,34,4,9,16,-7,-43.75
50,34,5,46,32,14,43.75
50,34,6,53,64,-11,-17.1875
50,34,7,214,128,86,67.1875
50,34,8,513,256,257,100.390625
50,34,9,307,512,-205,-40.0390625
50,34,10,410,1024,-614,-59.9609375
50,34,11,2807,2048,759,37.060546875
50,34,12,1312,4096,-2784,-67.96875
50,34,13,15128,8192,6936,84.66796875
50,34,14,10994,16384,-5390,-32.89794921875
50,34,15,70468,32768,37700,115.05126953125
50,35,1,0,2,-2,-100.0
50,35,2,4,4,0,0.0
50,35,3,2,8,-6,-75.0
50,35,4,3,16,-13,-81.25
50,35,5,12,32,-20,-62.5
50,35,6,27,64,-37,-57.8125
50,35,7,171,128,43,33.59375
50,35,8,1275,256,1019,398.046875
50,35,9,108,512,-404,-78.90625
50,35,10,88,1024,-936,-91.40625
50,35,11,1667,2048,-381,-18.603515625
50,35,12,11407,4096,7311,178.4912109375
50,35,13,3152,8192,-5040,-61.5234375
50,35,14,66547,16384,50163,306.170654296875
50,35,15,10318,32768,-22450,-68.511962890625
50,36,1,0,2,-2,-100.0
50,36,2,2,4,-2,-50.0
50,36,3,3,8,-5,-62.5
50,36,4,9,16,-7,-43.75
50,36,5,10,32,-22,-68.75
50,36,6,129,64,65,101.5625
50,36,7,9,128,-119,-92.96875
50,36,8,476,256,220,85.9375
50,36,9,98,512,-414,-80.859375
50,36,10,9,1024,-1015,-99.12109375
50,36,11,3406,2048,1358,66.30859375
50,36,12,1939,4096,-2157,-52.6611328125
50,36,13,2106,8192,-6086,-74.2919921875
50,36,14,10332,16384,-6052,-36.9384765625
50,36,15,24697,32768,-8071,-24.6307373046875
50,37,1,0,2,-2,-100.0
50,37,2,2,4,-2,-50.0
50,37,3,4,8,-4,-50.0
50,37,4,10,16,-6,-37.5
50,37,5,20,32,-12,-37.5
50,37,6,170,64,106,165.625
50,37,7,28,128,-100,-78.125
50,37,8,419,256,163,63.671875
50,37,9,219,512,-293,-57.2265625
50,37,10,408,1024,-616,-60.15625
50,37,11,274,2048,-1774,-86.62109375
50,37,12,29141,4096,25045,611.4501953125
50,37,13,218,8192,-7974,-97.3388671875
50,37,14,13388,16384,-2996,-18.2861328125
50,37,15,59330,32768,26562,81.060791015625
50,38,1,0,2,-2,-100.0
50,38,2,1,4,-3,-75.0
50,38,3,6,8,-2,-25.0
50,38,4,7,16,-9,-56.25
50,38,5,9,32,-23,-71.875
50,38,6,18,64,-46,-71.875
50,38,7,71,128,-57,-44.53125
50,38,8,674,256,418,163.28125
50,38,9,110,512,-402,-78.515625
50,38,10,953,1024,-71,-6.93359375
50,38,11,3664,2048,1616,78.90625
50,38,12,95,4096,-4001,-97.6806640625
50,38,13,1508,8192,-6684,-81.591796875
50,38,14,6950,16384,-9434,-57.58056640625
50,38,15,26997,32768,-5771,-17.6116943359375
50,39,1,0,2,-2,-100.0
50,39,2,2,4,-2,-50.0
50,39,3,2,8,-6,-75.0
50,39,4,22,16,6,37.5
50,39,5,11,32,-21,-65.625
50,39,6,49,64,-15,-23.4375
50,39,7,161,128,33,25.78125
50,39,8,385,256,129,50.390625
50,39,9,715,512,203,39.6484375
50,39,10,130,1024,-894,-87.3046875
50,39,11,5121,2048,3073,150.048828125
50,39,12,10546,4096,6450,157.470703125
50,39,13,3418,8192,-4774,-58.2763671875
50,39,14,2891,16384,-13493,-82.354736328125
50,39,15,22131,32768,-10637,-32.4615478515625
50,40,1,0,2,-2,-100.0
50,40,2,1,4,-3,-75.0
50,40,3,2,8,-6,-75.0
50,40,4,10,16,-6,-37.5
50,40,5,37,32,5,15.625
50,40,6,18,64,-46,-71.875
50,40,7,18,128,-110,-85.9375
50,40,8,40,256,-216,-84.375
50,40,9,921,512,409,79.8828125
50,40,10,136,1024,-888,-86.71875
50,40,11,2177,2048,129,6.298828125
50,40,12,8478,4096,4382,106.982421875
50,40,13,15590,8192,7398,90.3076171875
50,40,14,27905,16384,11521,70.318603515625
50,40,15,2735,32768,-30033,-91.6534423828125
50,41,1,0,2,-2,-100.0
50,41,2,2,4,-2,-50.0
50,41,3,3,8,-5,-62.5
50,41,4,15,16,-1,-6.25
50,41,5,11,32,-21,-65.625
50,41,6,53,64,-11,-17.1875
50,41,7,17,128,-111,-86.71875
50,41,8,284,256,28,10.9375
50,41,9,732,512,220,42.96875
50,41,10,274,1024,-750,-73.2421875
50,41,11,1518,2048,-530,-25.87890625
50,41,12,2072,4096,-2024,-49.4140625
50,41,13,12510,8192,4318,52.7099609375
50,41,14,12902,16384,-3482,-21.25244140625
50,41,15,12389,32768,-20379,-62.1917724609375
50,42,1,0,2,-2,-100.0
50,42,2,3,4,-1,-25.0
50,42,3,3,8,-5,-62.5
50,42,4,12,16,-4,-25.0
50,42,5,50,32,18,56.25
50,42,6,44,64,-20,-31.25
50,42,7,31,128,-97,-75.78125
50,42,8,90,256,-166,-64.84375
50,42,9,1032,512,520,101.5625
50,42,10,400,1024,-624,-60.9375
50,42,11,81,2048,-1967,-96.044921875
50,42,12,4641,4096,545,13.3056640625
50,42,13,35938,8192,27746,338.6962890625
50,42,14,24969,16384,8585,52.398681640625
50,42,15,16858,32768,-15910,-48.553466796875
50,43,1,0,2,-2,-100.0
50,43,2,1,4,-3,-75.0
50,43,3,3,8,-5,-62.5
50,43,4,5,16,-11,-68.75
50,43,5,9,32,-23,-71.875
50,43,6,275,64,211,329.6875
50,43,7,47,128,-81,-63.28125
50,43,8,320,256,64,25.0
50,43,9,65,512,-447,-87.3046875
50,43,10,142,1024,-882,-86.1328125
50,43,11,1276,2048,-772,-37.6953125
50,43,12,1297,4096,-2799,-68.3349609375
50,43,13,10822,8192,2630,32.1044921875
50,43,14,204,16384,-16180,-98.7548828125
50,43,15,90306,32768,57538,175.592041015625
50,44,1,0,2,-2,-100.0
50,44,2,1,4,-3,-75.0
50,44,3,2,8,-6,-75.0
50,44,4,9,16,-7,-43.75
50,44,5,14,32,-18,-56.25
50,44,6,61,64,-3,-4.6875
50,44,7,70,128,-58,-45.3125
50,44,8,258,256,2,0.78125
50,44,9,109,512,-403,-78.7109375
50,44,10,1292,1024,268,26.171875
50,44,11,630,2048,-1418,-69.23828125
50,44,12,10237,4096,6141,149.9267578125
50,44,13,2847,8192,-5345,-65.24658203125
50,44,14,3882,16384,-12502,-76.30615234375
50,44,15,7550,32768,-25218,-76.959228515625
50,45,1,0,2,-2,-100.0
50,45,2,1,4,-3,-75.0
50,45,3,2,8,-6,-75.0
50,45,4,6,16,-10,-62.5
50,45,5,14,32,-18,-56.25
50,45,6,24,64,-40,-62.5
50,45,7,43,128,-85,-66.40625
50,45,8,130,256,-126,-49.21875
50,45,9,787,512,275,53.7109375
50,45,10,995,1024,-29,-2.83203125
50,45,11,3894,2048,1846,90.13671875
50,45,12,1714,4096,-2382,-58.154296875
50,45,13,12182,8192,3990,48.7060546875
50,45,14,13119,16384,-3265,-19.927978515625
50,45,15,4610,32768,-28158,-85.931396484375
50,46,1,0,2,-2,-100.0
50,46,2,6,4,2,50.0
50,46,3,4,8,-4,-50.0
50,46,4,19,16,3,18.75
50,46,5,79,32,47,146.875
50,46,6,248,64,184,287.5
50,46,7,9,128,-119,-92.96875
50,46,8,351,256,95,37.109375
50,46,9,1465,512,953,186.1328125
50,46,10,655,1024,-369,-36.03515625
50,46,11,4178,2048,2130,104.00390625
50,46,12,1120,4096,-2976,-72.65625
50,46,13,1912,8192,-6280,-76.66015625
50,46,14,9468,16384,-6916,-42.2119140625
50,46,15,5720,32768,-27048,-82.5439453125
50,47,1,0,2,-2,-100.0
50,47,2,1,4,-3,-75.0
50,47,3,5,8,-3,-37.5
50,47,4,3,16,-13,-81.25
50,47,5,37,32,5,15.625
50,47,6,126,64,62,96.875
50,47,7,8,128,-120,-93.75
50,47,8,254,256,-2,-0.78125
50,47,9,1038,512,526,102.734375
50,47,10,1587,1024,563,54.98046875
50,47,11,453,2048,-1595,-77.880859375
50,47,12,12916,4096,8820,215.33203125
50,47,13,2169,8192,-6023,-73.52294921875
50,47,14,690,16384,-15694,-95.78857421875
50,47,15,16574,32768,-16194,-49.420166015625
50,48,1,0,2,-2,-100.0
50,48,2,1,4,-3,-75.0
50,48,3,2,8,-6,-75.0
50,48,4,9,16,-7,-43.75
50,48,5,36,32,4,12.5
50,48,6,5,64,-59,-92.1875
50,48,7,135,128,7,5.46875
50,48,8,684,256,428,167.1875
50,48,9,502,512,-10,-1.953125
50,48,10,577,1024,-447,-43.65234375
50,48,11,1858,2048,-190,-9.27734375
50,48,12,21381,4096,17285,421.9970703125
50,48,13,5829,8192,-2363,-28.84521484375
50,48,14,20576,16384,4192,25.5859375
50,48,15,34762,32768,1994,6.085205078125
50,49,1,0,2,-2,-100.0
50,49,2,4,4,0,0.0
50,49,3,2,8,-6,-75.0
50,49,4,8,16,-8,-50.0
50,49,5,42,32,10,31.25
50,49,6,34,64,-30,-46.875
50,49,7,68,128,-60,-46.875
50,49,8,16,256,-240,-93.75
50,49,9,30,512,-482,-94.140625
50,49,10,752,1024,-272,-26.5625
50,49,11,1771,2048,-277,-13.525390625
50,49,12,2087,4096,-2009,-49.0478515625
50,49,13,6844,8192,-1348,-16.455078125
50,49,14,7942,16384,-8442,-51.52587890625
50,49,15,6833,32768,-25935,-79.1473388671875
50,50,1,0,2,-2,-100.0
50,50,2,1,4,-3,-75.0
50,50,3,2,8,-6,-75.0
50,50,4,12,16,-4,-25.0
50,50,5,18,32,-14,-43.75
50,50,6,78,64,14,21.875
50,50,7,22,128,-106,-82.8125
50,50,8,107,256,-149,-58.203125
50,50,9,18,512,-494,-96.484375
50,50,10,342,1024,-682,-66.6015625
50,50,11,1443,2048,-605,-29.541015625
50,50,12,13991,4096,9895,241.5771484375
50,50,13,6458,8192,-1734,-21.1669921875
50,50,14,11454,16384,-4930,-30.09033203125
50,50,15,56606,32768,23838,72.747802734375
51,1,1,0,2,-2,-100.0
51,1,2,1,4,-3,-75.0
51,1,3,14,8,6,75.0
51,1,4,3,16,-13,-81.25
51,1,5,9,32,-23,-71.875
51,1,6,22,64,-42,-65.625
51,1,7,215,128,87,67.96875
51,1,8,308,256,52,20.3125
51,1,9,295,512,-217,-42.3828125
51,1,10,122,1024,-902,-88.0859375
51,1,11,2477,2048,429,20.947265625
51,1,12,6703,4096,2607,63.6474609375
51,1,13,17984,8192,9792,119.53125
51,1,14,5055,16384,-11329,-69.146728515625
51,1,15,14234,32768,-18534,-56.561279296875
51,2,1,0,2,-2,-100.0
51,2,2,3,4,-1,-25.0
51,2,3,12,8,4,50.0
51,2,4,4,16,-12,-75.0
51,2,5,22,32,-10,-31.25
51,2,6,23,64,-41,-64.0625
51,2,7,6,128,-122,-95.3125
51,2,8,621,256,365,142.578125
51,2,9,154,512,-358,-69.921875
51,2,10,204,1024,-820,-80.078125
51,2,11,208,2048,-1840,-89.84375
51,2,12,69,4096,-4027,-98.3154296875
51,2,13,21353,8192,13161,160.65673828125
51,2,14,14731,16384,-1653,-10.089111328125
51,2,15,12303,32768,-20465,-62.4542236328125
51,3,1,0,2,-2,-100.0
51,3,2,2,4,-2,-50.0
51,3,3,7,8,-1,-12.5
51,3,4,5,16,-11,-68.75
51,3,5,31,32,-1,-3.125
51,3,6,22,64,-42,-65.625
51,3,7,44,128,-84,-65.625
51,3,8,187,256,-69,-26.953125
51,3,9,72,512,-440,-85.9375
51,3,10,276,1024,-748,-73.046875
51,3,11,2219,2048,171,8.349609375
51,3,12,9288,4096,5192,126.7578125
51,3,13,11288,8192,3096,37.79296875
51,3,14,4684,16384,-11700,-71.4111328125
51,3,15,30046,32768,-2722,-8.306884765625
51,4,1,0,2,-2,-100.0
51,4,2,1,4,-3,-75.0
51,4,3,5,8,-3,-37.5
51,4,4,24,16,8,50.0
51,4,5,7,32,-25,-78.125
51,4,6,39,64,-25,-39.0625
51,4,7,293,128,165,128.90625
51,4,8,13,256,-243,-94.921875
51,4,9,136,512,-376,-73.4375
51,4,10,2869,1024,1845,180.17578125
51,4,11,5764,2048,3716,181.4453125
51,4,12,70,4096,-4026,-98.291015625
51,4,13,13676,8192,5484,66.943359375
51,4,14,483,16384,-15901,-97.052001953125
51,4,15,26255,32768,-6513,-19.8760986328125
51,5,1,0,2,-2,-100.0
51,5,2,1,4,-3,-75.0
51,5,3,4,8,-4,-50.0
51,5,4,12,16,-4,-25.0
51,5,5,40,32,8,25.0
51,5,6,52,64,-12,-18.75
51,5,7,75,128,-53,-41.40625
51,5,8,62,256,-194,-75.78125
51,5,9,470,512,-42,-8.203125
51,5,10,1662,1024,638,62.3046875
51,5,11,1317,2048,-731,-35.693359375
51,5,12,1711,4096,-2385,-58.2275390625
51,5,13,5039,8192,-3153,-38.48876953125
51,5,14,9601,16384,-6783,-41.400146484375
51,5,15,22180,32768,-10588,-32.31201171875
51,6,1,0,2,-2,-100.0
51,6,2,2,4,-2,-50.0
51,6,3,10,8,2,25.0
51,6,4,13,16,-3,-18.75
51,6,5,19,32,-13,-40.625
51,6,6,158,64,94,146.875
51,6,7,52,128,-76,-59.375
51,6,8,446,256,190,74.21875
51,6,9,268,512,-244,-47.65625
51,6,10,77,1024,-947,-92.48046875
51,6,11,775,2048,-1273,-62.158203125
51,6,12,4334,4096,238,5.810546875
51,6,13,12587,8192,4395,53.64990234375
51,6,14,4239,16384,-12145,-74.127197265625
51,6,15,5387,32768,-27381,-83.5601806640625
51,7,1,0,2,-2,-100.0
51,7,2,3,4,-1,-25.0
51,7,3,6,8,-2,-25.0
51,7,4,3,16,-13,-81.25
51,7,5,9,32,-23,-71.875
51,7,6,10,64,-54,-84.375
51,7,7,27,128,-101,-78.90625
51,7,8,409,256,153,59.765625
51,7,9,359,512,-153,-29.8828125
51,7,10,627,1024,-397,-38.76953125
51,7,11,1501,2048,-547,-26.708984375
51,7,12,1150,4096,-2946,-71.923828125
51,7,13,2544,8192,-5648,-68.9453125
51,7,14,7688,16384,-8696,-53.076171875
51,7,15,96025,32768,63257,193.0450439453125
51,8,1,0,2,-2,-100.0
51,8,2,2,4,-2,-50.0
51,8,3,6,8,-2,-25.0
51,8,4,9,16,-7,-43.75
51,8,5,41,32,9,28.125
51,8,6,170,64,106,165.625
51,8,7,211,128,83,64.84375
51,8,8,229,256,-27,-10.546875
51,8,9,474,512,-38,-7.421875
51,8,10,1841,1024,817,79.78515625
51,8,11,15225,2048,13177,643.408203125
51,8,12,1782,4096,-2314,-56.494140625
51,8,13,24640,8192,16448,200.78125
51,8,14,29898,16384,13514,82.48291015625
51,8,15,14724,32768,-18044,-55.06591796875
51,9,1,0,2,-2,-100.0
51,9,2,2,4,-2,-50.0
51,9,3,7,8,-1,-12.5
51,9,4,50,16,34,212.5
51,9,5,56,32,24,75.0
51,9,6,161,64,97,151.5625
51,9,7,50,128,-78,-60.9375
51,9,8,144,256,-112,-43.75
51,9,9,409,512,-103,-20.1171875
51,9,10,927,1024,-97,-9.47265625
51,9,11,121,2048,-1927,-94.091796875
51,9,12,1542,4096,-2554,-62.353515625
51,9,13,19310,8192,11118,135.7177734375
51,9,14,20535,16384,4151,25.335693359375
51,9,15,26611,32768,-6157,-18.7896728515625
51,10,1,0,2,-2,-100.0
51,10,2,4,4,0,0.0
51,10,3,4,8,-4,-50.0
51,10,4,5,16,-11,-68.75
51,10,5,16,32,-16,-50.0
51,10,6,12,64,-52,-81.25
51,10,7,199,128,71,55.46875
51,10,8,87,256,-169,-66.015625
51,10,9,2641,512,2129,415.8203125
51,10,10,759,1024,-265,-25.87890625
51,10,11,687,2048,-1361,-66.455078125
51,10,12,8557,4096,4461,108.9111328125
51,10,13,10707,8192,2515,30.70068359375
51,10,14,9706,16384,-6678,-40.75927734375
51,10,15,14534,32768,-18234,-55.645751953125
51,11,1,0,2,-2,-100.0
51,11,2,1,4,-3,-75.0
51,11,3,2,8,-6,-75.0
51,11,4,22,16,6,37.5
51,11,5,57,32,25,78.125
51,11,6,26,64,-38,-59.375
51,11,7,219,128,91,71.09375
51,11,8,483,256,227,88.671875
51,11,9,188,512,-324,-63.28125
51,11,10,131,1024,-893,-87.20703125
51,11,11,3620,2048,1572,76.7578125
51,11,12,1141,4096,-2955,-72.1435546875
51,11,13,2878,8192,-5314,-64.8681640625
51,11,14,18887,16384,2503,15.277099609375
51,11,15,59287,32768,26519,80.9295654296875
51,12,1,0,2,-2,-100.0
51,12,2,1,4,-3,-75.0
51,12,3,11,8,3,37.5
51,12,4,5,16,-11,-68.75
51,12,5,12,32,-20,-62.5
51,12,6,82,64,18,28.125
51,12,7,128,128,0,0.0
51,12,8,16,256,-240,-93.75
51,12,9,1139,512,627,122.4609375
51,12,10,649,1024,-375,-36.62109375
51,12,11,412,2048,-1636,-79.8828125
51,12,12,402,4096,-3694,-90.185546875
51,12,13,11398,8192,3206,39.1357421875
51,12,14,12860,16384,-3524,-21.5087890625
51,12,15,65177,32768,32409,98.9044189453125
51,13,1,0,2,-2,-100.0
51,13,2,4,4,0,0.0
51,13,3,4,8,-4,-50.0
51,13,4,3,16,-13,-81.25
51,13,5,24,32,-8,-25.0
51,13,6,79,64,15,23.4375
51,13,7,21,128,-107,-83.59375
51,13,8,590,256,334,130.46875
51,13,9,798,512,286,55.859375
51,13,10,3197,1024,2173,212.20703125
51,13,11,355,2048,-1693,-82.666015625
51,13,12,1017,4096,-3079,-75.1708984375
51,13,13,10909,8192,2717,33.16650390625
51,13,14,5594,16384,-10790,-65.85693359375
51,13,15,4340,32768,-28428,-86.75537109375
51,14,1,0,2,-2,-100.0
51,14,2,1,4,-3,-75.0
51,14,3,8,8,0,0.0
51,14,4,6,16,-10,-62.5
51,14,5,38,32,6,18.75
51,14,6,72,64,8,12.5
51,14,7,32,128,-96,-75.0
51,14,8,157,256,-99,-38.671875
51,14,9,417,512,-95,-18.5546875
51,14,10,410,1024,-614,-59.9609375
51,14,11,1480,2048,-568,-27.734375
51,14,12,3661,4096,-435,-10.6201171875
51,14,13,17776,8192,9584,116.9921875
51,14,14,779,16384,-15605,-95.245361328125
51,14,15,47399,32768,14631,44.6502685546875
51,15,1,0,2,-2,-100.0
51,15,2,2,4,-2,-50.0
51,15,3,5,8,-3,-37.5
51,15,4,19,16,3,18.75
51,15,5,13,32,-19,-59.375
51,15,6,43,64,-21,-32.8125
51,15,7,11,128,-117,-91.40625
51,15,8,106,256,-150,-58.59375
51,15,9,401,512,-111,-21.6796875
51,15,10,1623,1024,599,58.49609375
51,15,11,1218,2048,-830,-40.52734375
51,15,12,4987,4096,891,21.7529296875
51,15,13,5634,8192,-2558,-31.2255859375
51,15,14,2122,16384,-14262,-87.04833984375
51,15,15,14087,32768,-18681,-57.0098876953125
51,16,1,0,2,-2,-100.0
51,16,2,2,4,-2,-50.0
51,16,3,2,8,-6,-75.0
51,16,4,31,16,15,93.75
51,16,5,36,32,4,12.5
51,16,6,82,64,18,28.125
51,16,7,131,128,3,2.34375
51,16,8,831,256,575,224.609375
51,16,9,307,512,-205,-40.0390625
51,16,10,80,1024,-944,-92.1875
51,16,11,1891,2048,-157,-7.666015625
51,16,12,918,4096,-3178,-77.587890625
51,16,13,16504,8192,8312,101.46484375
51,16,14,6098,16384,-10286,-62.78076171875
51,16,15,23993,32768,-8775,-26.7791748046875
51,17,1,0,2,-2,-100.0
51,17,2,1,4,-3,-75.0
51,17,3,33,8,25,312.5
51,17,4,9,16,-7,-43.75
51,17,5,19,32,-13,-40.625
51,17,6,35,64,-29,-45.3125
51,17,7,364,128,236,184.375
51,17,8,617,256,361,141.015625
51,17,9,689,512,177,34.5703125
51,17,10,1236,1024,212,20.703125
51,17,11,2134,2048,86,4.19921875
51,17,12,3585,4096,-511,-12.4755859375
51,17,13,16469,8192,8277,101.03759765625
51,17,14,15424,16384,-960,-5.859375
51,17,15,18425,32768,-14343,-43.7713623046875
51,18,1,0,2,-2,-100.0
51,18,2,1,4,-3,-75.0
51,18,3,4,8,-4,-50.0
51,18,4,7,16,-9,-56.25
51,18,5,11,32,-21,-65.625
51,18,6,44,64,-20,-31.25
51,18,7,143,128,15,11.71875
51,18,8,87,256,-169,-66.015625
51,18,9,130,512,-382,-74.609375
51,18,10,470,1024,-554,-54.1015625
51,18,11,664,2048,-1384,-67.578125
51,18,12,3427,4096,-669,-16.3330078125
51,18,13,871,8192,-7321,-89.36767578125
51,18,14,14103,16384,-2281,-13.922119140625
51,18,15,15483,32768,-17285,-52.7496337890625
51,19,1,0,2,-2,-100.0
51,19,2,1,4,-3,-75.0
51,19,3,2,8,-6,-75.0
51,19,4,23,16,7,43.75
51,19,5,67,32,35,109.375
51,19,6,146,64,82,128.125
51,19,7,79,128,-49,-38.28125
51,19,8,65,256,-191,-74.609375
51,19,9,963,512,451,88.0859375
51,19,10,910,1024,-114,-11.1328125
51,19,11,3541,2048,1493,72.900390625
51,19,12,9121,4096,5025,122.6806640625
51,19,13,2947,8192,-5245,-64.02587890625
51,19,14,36071,16384,19687,120.159912109375
51,19,15,4754,32768,-28014,-85.491943359375
51,20,1,0,2,-2,-100.0
51,20,2,3,4,-1,-25.0
51,20,3,2,8,-6,-75.0
51,20,4,30,16,14,87.5
51,20,5,15,32,-17,-53.125
51,20,6,43,64,-21,-32.8125
51,20,7,12,128,-116,-90.625
51,20,8,35,256,-221,-86.328125
51,20,9,246,512,-266,-51.953125
51,20,10,1660,1024,636,62.109375
51,20,11,2044,2048,-4,-0.1953125
51,20,12,851,4096,-3245,-79.2236328125
51,20,13,8680,8192,488,5.95703125
51,20,14,10421,16384,-5963,-36.395263671875
51,20,15,25376,32768,-7392,-22.55859375
51,21,1,0,2,-2,-100.0
51,21,2,1,4,-3,-75.0
51,21,3,3,8,-5,-62.5
51,21,4,54,16,38,237.5
51,21,5,8,32,-24,-75.0
51,21,6,6,64,-58,-90.625
51,21,7,52,128,-76,-59.375
51,21,8,32,256,-224,-87.5
51,21,9,559,512,47,9.1796875
51,21,10,887,1024,-137,-13.37890625
51,21,11,5204,2048,3156,154.1015625
51,21,12,6802,4096,2706,66.064453125
51,21,13,3375,8192,-4817,-58.80126953125
51,21,14,18988,16384,2604,15.8935546875
51,21,15,42371,32768,9603,29.3060302734375
51,22,1,0,2,-2,-100.0
51,22,2,2,4,-2,-50.0
51,22,3,2,8,-6,-75.0
51,22,4,3,16,-13,-81.25
51,22,5,21,32,-11,-34.375
51,22,6,32,64,-32,-50.0
51,22,7,18,128,-110,-85.9375
51,22,8,1186,256,930,363.28125
51,22,9,566,512,54,10.546875
51,22,10,2711,1024,1687,164.74609375
51,22,11,3263,2048,1215,59.326171875
51,22,12,1384,4096,-2712,-66.2109375
51,22,13,3337,8192,-4855,-59.26513671875
51,22,14,32515,16384,16131,98.455810546875
51,22,15,5808,32768,-26960,-82.275390625
51,23,1,0,2,-2,-100.0
51,23,2,2,4,-2,-50.0
51,23,3,9,8,1,12.5
51,23,4,18,16,2,12.5
51,23,5,4,32,-28,-87.5
51,23,6,77,64,13,20.3125
51,23,7,279,128,151,117.96875
51,23,8,273,256,17,6.640625
51,23,9,1499,512,987,192.7734375
51,23,10,67,1024,-957,-93.45703125
51,23,11,283,2048,-1765,-86.181640625
51,23,12,1447,4096,-2649,-64.6728515625
51,23,13,772,8192,-7420,-90.576171875
51,23,14,14613,16384,-1771,-10.809326171875
51,23,15,17659,32768,-15109,-46.1090087890625
51,24,1,0,2,-2,-100.0
51,24,2,2,4,-2,-50.0
51,24,3,2,8,-6,-75.0
51,24,4,23,16,7,43.75
51,24,5,20,32,-12,-37.5
51,24,6,30,64,-34,-53.125
51,24,7,194,128,66,51.5625
51,24,8,113,256,-143,-55.859375
51,24,9,229,512,-283,-55.2734375
51,24,10,3353,1024,2329,227.44140625
51,24,11,116,2048,-1932,-94.3359375
51,24,12,2900,4096,-1196,-29.19921875
51,24,13,840,8192,-7352,-89.74609375
51,24,14,44890,16384,28506,173.98681640625
51,24,15,90675,32768,57907,176.7181396484375
51,25,1,0,2,-2,-100.0
51,25,2,1,4,-3,-75.0
51,25,3,3,8,-5,-62.5
51,25,4,3,16,-13,-81.25
51,25,5,36,32,4,12.5
51,25,6,83,64,19,29.6875
51,25,7,66,128,-62,-48.4375
51,25,8,32,256,-224,-87.5
51,25,9,284,512,-228,-44.53125
51,25,10,799,1024,-225,-21.97265625
51,25,11,253,2048,-1795,-87.646484375
51,25,12,3497,4096,-599,-14.6240234375
51,25,13,5036,8192,-3156,-38.525390625
51,25,14,6121,16384,-10263,-62.640380859375
51,25,15,18272,32768,-14496,-44.23828125
51,26,1,0,2,-2,-100.0
51,26,2,2,4,-2,-50.0
51,26,3,10,8,2,25.0
51,26,4,27,16,11,68.75
51,26,5,43,32,11,34.375
51,26,6,52,64,-12,-18.75
51,26,7,89,128,-39,-30.46875
51,26,8,609,256,353,137.890625
51,26,9,842,512,330,64.453125
51,26,10,130,1024,-894,-87.3046875
51,26,11,4044,2048,1996,97.4609375
51,26,12,7132,4096,3036,74.12109375
51,26,13,24510,8192,16318,199.1943359375
51,26,14,114,16384,-16270,-99.30419921875
51,26,15,13739,32768,-19029,-58.0718994140625
51,27,1,0,2,-2,-100.0
51,27,2,5,4,1,25.0
51,27,3,2,8,-6,-75.0
51,27,4,24,16,8,50.0
51,27,5,32,32,0,0.0
51,27,6,12,64,-52,-81.25
51,27,7,49,128,-79,-61.71875
51,27,8,151,256,-105,-41.015625
51,27,9,2775,512,2263,441.9921875
51,27,10,2826,1024,1802,175.9765625
51,27,11,3742,2048,1694,82.71484375
51,27,12,424,4096,-3672,-89.6484375
51,27,13,2554,8192,-5638,-68.8232421875
51,27,14,5572,16384,-10812,-65.9912109375
51,27,15,31826,32768,-942,-2.874755859375
51,28,1,0,2,-2,-100.0
51,28,2,3,4,-1,-25.0
51,28,3,2,8,-6,-75.0
51,28,4,4,16,-12,-75.0
51,28,5,70,32,38,118.75
51,28,6,43,64,-21,-32.8125
51,28,7,241,128,113,88.28125
51,28,8,103,256,-153,-59.765625
51,28,9,355,512,-157,-30.6640625
51,28,10,2703,1024,1679,163.96484375
51,28,11,1453,2048,-595,-29.052734375
51,28,12,1601,4096,-2495,-60.9130859375
51,28,13,9570,8192,1378,16.8212890625
51,28,14,21034,16384,4650,28.38134765625
51,28,15,7872,32768,-24896,-75.9765625
51,29,1,0,2,-2,-100.0
51,29,2,1,4,-3,-75.0
51,29,3,2,8,-6,-75.0
51,29,4,9,16,-7,-43.75
51,29,5,61,32,29,90.625
51,29,6,5,64,-59,-92.1875
51,29,7,35,128,-93,-72.65625
51,29,8,108,256,-148,-57.8125
51,29,9,179,512,-333,-65.0390625
51,29,10,358,1024,-666,-65.0390625
51,29,11,3760,2048,1712,83.59375
51,29,12,4955,4096,859,20.9716796875
51,29,13,22405,8192,14213,173.49853515625
51,29,14,34373,16384,17989,109.796142578125
51,29,15,22786,32768,-9982,-30.462646484375
51,30,1,0,2,-2,-100.0
51,30,2,2,4,-2,-50.0
51,30,3,3,8,-5,-62.5
51,30,4,3,16,-13,-81.25
51,30,5,12,32,-20,-62.5
51,30,6,38,64,-26,-40.625
51,30,7,41,128,-87,-67.96875
51,30,8,461,256,205,80.078125
51,30,9,448,512,-64,-12.5
51,30,10,206,1024,-818,-79.8828125
51,30,11,4061,2048,2013,98.291015625
51,30,12,1628,4096,-2468,-60.25390625
51,30,13,17755,8192,9563,116.73583984375
51,30,14,5678,16384,-10706,-65.34423828125
51,30,15,13378,32768,-19390,-59.173583984375
51,31,1,0,2,-2,-100.0
51,31,2,1,4,-3,-75.0
51,31,3,11,8,3,37.5
51,31,4,8,16,-8,-50.0
51,31,5,29,32,-3,-9.375
51,31,6,45,64,-19,-29.6875
51,31,7,19,128,-109,-85.15625
51,31,8,295,256,39,15.234375
51,31,9,385,512,-127,-24.8046875
51,31,10,474,1024,-550,-53.7109375
51,31,11,219,2048,-1829,-89.306640625
51,31,12,1654,4096,-2442,-59.619140625
51,31,13,7334,8192,-858,-10.4736328125
51,31,14,8920,16384,-7464,-45.556640625
51,31,15,13078,32768,-19690,-60.089111328125
51,32,1,0,2,-2,-100.0
51,32,2,1,4,-3,-75.0
51,32,3,4,8,-4,-50.0
51,32,4,5,16,-11,-68.75
51,32,5,47,32,15,46.875
51,32,6,40,64,-24,-37.5
51,32,7,218,128,90,70.3125
51,32,8,56,256,-200,-78.125
51,32,9,1064,512,552,107.8125
51,32,10,515,1024,-509,-49.70703125
51,32,11,437,2048,-1611,-78.662109375
51,32,12,2873,4096,-1223,-29.8583984375
51,32,13,10478,8192,2286,27.9052734375
51,32,14,13,16384,-16371,-99.920654296875
51,32,15,12971,32768,-19797,-60.4156494140625
51,33,1,0,2,-2,-100.0
51,33,2,2,4,-2,-50.0
51,33,3,5,8,-3,-37.5
51,33,4,10,16,-6,-37.5
51,33,5,13,32,-19,-59.375
51,33,6,9,64,-55,-85.9375
51,33,7,40,128,-88,-68.75
51,33,8,261,256,5,1.953125
51,33,9,171,512,-341,-66.6015625
51,33,10,177,1024,-847,-82.71484375
51,33,11,890,2048,-1158,-56.54296875
51,33,12,8416,4096,4320,105.46875
51,33,13,7550,8192,-642,-7.8369140625
51,33,14,12415,16384,-3969,-24.224853515625
51,33,15,6467,32768,-26301,-80.2642822265625
51,34,1,0,2,-2,-100.0
51,34,2,1,4,-3,-75.0
51,34,3,8,8,0,0.0
51,34,4,3,16,-13,-81.25
51,34,5,10,32,-22,-68.75
51,34,6,46,64,-18,-28.125
51,34,7,20,128,-108,-84.375
51,34,8,42,256,-214,-83.59375
51,34,9,1368,512,856,167.1875
51,34,10,2868,1024,1844,180.078125
51,34,11,1834,2048,-214,-10.44921875
51,34,12,55,4096,-4041,-98.6572265625
51,34,13,1700,8192,-6492,-79.248046875
51,34,14,11813,16384,-4571,-27.899169921875
51,34,15,39878,32768,7110,21.697998046875
51,35,1,0,2,-2,-100.0
51,35,2,2,4,-2,-50.0
51,35,3,10,8,2,25.0
51,35,4,12,16,-4,-25.0
51,35,5,105,32,73,228.125
51,35,6,140,64,76,118.75
51,35,7,619,128,491,383.59375
51,35,8,955,256,699,273.046875
51,35,9,351,512,-161,-31.4453125
51,35,10,732,1024,-292,-28.515625
51,35,11,1594,2048,-454,-22.16796875
51,35,12,393,4096,-3703,-90.4052734375
51,35,13,13796,8192,5604,68.408203125
51,35,14,8862,16384,-7522,-45.91064453125
51,35,15,8662,32768,-24106,-73.565673828125
51,36,1,0,2,-2,-100.0
51,36,2,3,4,-1,-25.0
51,36,3,24,8,16,200.0
51,36,4,14,16,-2,-12.5
51,36,5,35,32,3,9.375
51,36,6,26,64,-38,-59.375
51,36,7,21,128,-107,-83.59375
51,36,8,101,256,-155,-60.546875
51,36,9,62,512,-450,-87.890625
51,36,10,585,1024,-439,-42.87109375
51,36,11,500,2048,-1548,-75.5859375
51,36,12,2683,4096,-1413,-34.4970703125
51,36,13,9915,8192,1723,21.03271484375
51,36,14,11640,16384,-4744,-28.955078125
51,36,15,26738,32768,-6030,-18.402099609375
51,37,1,0,2,-2,-100.0
51,37,2,2,4,-2,-50.0
51,37,3,11,8,3,37.5
51,37,4,5,16,-11,-68.75
51,37,5,39,32,7,21.875
51,37,6,96,64,32,50.0
51,37,7,49,128,-79,-61.71875
51,37,8,61,256,-195,-76.171875
51,37,9,111,512,-401,-78.3203125
51,37,10,2119,1024,1095,106.93359375
51,37,11,7450,2048,5402,263.76953125
51,37,12,11777,4096,7681,187.5244140625
51,37,13,8850,8192,658,8.0322265625
51,37,14,15147,16384,-1237,-7.550048828125
51,37,15,51769,32768,19001,57.9864501953125
51,38,1,0,2,-2,-100.0
51,38,2,3,4,-1,-25.0
51,38,3,5,8,-3,-37.5
51,38,4,5,16,-11,-68.75
51,38,5,59,32,27,84.375
51,38,6,55,64,-9,-14.0625
51,38,7,249,128,121,94.53125
51,38,8,13,256,-243,-94.921875
51,38,9,327,512,-185,-36.1328125
51,38,10,182,1024,-842,-82.2265625
51,38,11,3321,2048,1273,62.158203125
51,38,12,814,4096,-3282,-80.126953125
51,38,13,2832,8192,-5360,-65.4296875
51,38,14,5554,16384,-10830,-66.10107421875
51,38,15,13738,32768,-19030,-58.074951171875
51,39,1,0,2,-2,-100.0
51,39,2,1,4,-3,-75.0
51,39,3,4,8,-4,-50.0
51,39,4,37,16,21,131.25
51,39,5,17,32,-15,-46.875
51,39,6,62,64,-2,-3.125
51,39,7,42,128,-86,-67.1875
51,39,8,39,256,-217,-84.765625
51,39,9,833,512,321,62.6953125
51,39,10,1664,1024,640,62.5
51,39,11,2783,2048,735,35.888671875
51,39,12,239,4096,-3857,-94.1650390625
51,39,13,348,8192,-7844,-95.751953125
51,39,14,5218,16384,-11166,-68.15185546875
51,39,15,54723,32768,21955,67.0013427734375
51,40,1,0,2,-2,-100.0
51,40,2,1,4,-3,-75.0
51,40,3,5,8,-3,-37.5
51,40,4,7,16,-9,-56.25
51,40,5,7,32,-25,-78.125
51,40,6,17,64,-47,-73.4375
51,40,7,64,128,-64,-50.0
51,40,8,257,256,1,0.390625
51,40,9,102,512,-410,-80.078125
51,40,10,796,1024,-228,-22.265625
51,40,11,1708,2048,-340,-16.6015625
51,40,12,5784,4096,1688,41.2109375
51,40,13,9234,8192,1042,12.7197265625
51,40,14,2455,16384,-13929,-85.015869140625
51,40,15,724,32768,-32044,-97.79052734375
51,41,1,0,2,-2,-100.0
51,41,2,1,4,-3,-75.0
51,41,3,2,8,-6,-75.0
51,41,4,45,16,29,181.25
51,41,5,66,32,34,106.25
51,41,6,88,64,24,37.5
51,41,7,184,128,56,43.75
51,41,8,295,256,39,15.234375
51,41,9,53,512,-459,-89.6484375
51,41,10,803,1024,-221,-21.58203125
51,41,11,8187,2048,6139,299.755859375
51,41,12,1063,4096,-3033,-74.0478515625
51,41,13,10542,8192,2350,28.6865234375
51,41,14,3097,16384,-13287,-81.097412109375
51,41,15,7022,32768,-25746,-78.570556640625
51,42,1,0,2,-2,-100.0
51,42,2,3,4,-1,-25.0
51,42,3,2,8,-6,-75.0
51,42,4,41,16,25,156.25
51,42,5,5,32,-27,-84.375
51,42,6,5,64,-59,-92.1875
51,42,7,143,128,15,11.71875
51,42,8,499,256,243,94.921875
51,42,9,566,512,54,10.546875
51,42,10,540,1024,-484,-47.265625
51,42,11,1128,2048,-920,-44.921875
51,42,12,82,4096,-4014,-97.998046875
51,42,13,5338,8192,-2854,-34.8388671875
51,42,14,2484,16384,-13900,-84.8388671875
51,42,15,4891,32768,-27877,-85.0738525390625
51,43,1,0,2,-2,-100.0
51,43,2,1,4,-3,-75.0
51,43,3,3,8,-5,-62.5
51,43,4,28,16,12,75.0
51,43,5,26,32,-6,-18.75
51,43,6,244,64,180,281.25
51,43,7,68,128,-60,-46.875
51,43,8,8,256,-248,-96.875
51,43,9,214,512,-298,-58.203125
51,43,10,1288,1024,264,25.78125
51,43,11,944,2048,-1104,-53.90625
51,43,12,3554,4096,-542,-13.232421875
51,43,13,1902,8192,-6290,-76.7822265625
51,43,14,10173,16384,-6211,-37.908935546875
51,43,15,53780,32768,21012,64.12353515625
51,44,1,0,2,-2,-100.0
51,44,2,1,4,-3,-75.0
51,44,3,2,8,-6,-75.0
51,44,4,3,16,-13,-81.25
51,44,5,17,32,-15,-46.875
51,44,6,17,64,-47,-73.4375
51,44,7,114,128,-14,-10.9375
51,44,8,864,256,608,237.5
51,44,9,816,512,304,59.375
51,44,10,181,1024,-843,-82.32421875
51,44,11,1065,2048,-983,-47.998046875
51,44,12,1717,4096,-2379,-58.0810546875
51,44,13,5545,8192,-2647,-32.31201171875
51,44,14,13053,16384,-3331,-20.330810546875
51,44,15,5325,32768,-27443,-83.7493896484375
51,45,1,0,2,-2,-100.0
51,45,2,1,4,-3,-75.0
51,45,3,3,8,-5,-62.5
51,45,4,17,16,1,6.25
51,45,5,15,32,-17,-53.125
51,45,6,37,64,-27,-42.1875
51,45,7,179,128,51,39.84375
51,45,8,23,256,-233,-91.015625
51,45,9,2466,512,1954,381.640625
51,45,10,2368,1024,1344,131.25
51,45,11,2427,2048,379,18.505859375
51,45,12,375,4096,-3721,-90.8447265625
51,45,13,1616,8192,-6576,-80.2734375
51,45,14,21193,16384,4809,29.351806640625
51,45,15,97104,32768,64336,196.337890625
51,46,1,0,2,-2,-100.0
51,46,2,1,4,-3,-75.0
51,46,3,10,8,2,25.0
51,46,4,18,16,2,12.5
51,46,5,5,32,-27,-84.375
51,46,6,10,64,-54,-84.375
51,46,7,175,128,47,36.71875
51,46,8,258,256,2,0.78125
51,46,9,1149,512,637,124.4140625
51,46,10,1924,1024,900,87.890625
51,46,11,45,2048,-2003,-97.802734375
51,46,12,4496,4096,400,9.765625
51,46,13,17673,8192,9481,115.73486328125
51,46,14,7495,16384,-8889,-54.254150390625
51,46,15,18590,32768,-14178,-43.267822265625
51,47,1,0,2,-2,-100.0
51,47,2,1,4,-3,-75.0
51,47,3,21,8,13,162.5
51,47,4,4,16,-12,-75.0
51,47,5,8,32,-24,-75.0
51,47,6,42,64,-22,-34.375
51,47,7,46,128,-82,-64.0625
51,47,8,609,256,353,137.890625
51,47,9,192,512,-320,-62.5
51,47,10,650,1024,-374,-36.5234375
51,47,11,1175,2048,-873,-42.626953125
51,47,12,798,4096,-3298,-80.517578125
51,47,13,23484,8192,15292,186.669921875
51,47,14,20077,16384,3693,22.540283203125
51,47,15,132763,32768,99995,305.1605224609375
51,48,1,0,2,-2,-100.0
51,48,2,3,4,-1,-25.0
51,48,3,10,8,2,25.0
51,48,4,3,16,-13,-81.25
51,48,5,52,32,20,62.5
51,48,6,56,64,-8,-12.5
51,48,7,142,128,14,10.9375
51,48,8,37,256,-219,-85.546875
51,48,9,239,512,-273,-53.3203125
51,48,10,595,1024,-429,-41.89453125
51,48,11,198,2048,-1850,-90.33203125
51,48,12,1304,4096,-2792,-68.1640625
51,48,13,5200,8192,-2992,-36.5234375
51,48,14,6035,16384,-10349,-63.165283203125
51,48,15,52083,32768,19315,58.9447021484375
51,49,1,0,2,-2,-100.0
51,49,2,2,4,-2,-50.0
51,49,3,17,8,9,112.5
51,49,4,58,16,42,262.5
51,49,5,46,32,14,43.75
51,49,6,66,64,2,3.125
51,49,7,264,128,136,106.25
51,49,8,75,256,-181,-70.703125
51,49,9,54,512,-458,-89.453125
51,49,10,251,1024,-773,-75.48828125
51,49,11,7475,2048,5427,264.990234375
51,49,12,1356,4096,-2740,-66.89453125
51,49,13,3550,8192,-4642,-56.6650390625
51,49,14,2069,16384,-14315,-87.371826171875
51,49,15,32156,32768,-612,-1.86767578125
51,50,1,0,2,-2,-100.0
51,50,2,1,4,-3,-75.0
51,50,3,7,8,-1,-12.5
51,50,4,3,16,-13,-81.25
51,50,5,34,32,2,6.25
51,50,6,141,64,77,120.3125
51,50,7,10,128,-118,-92.1875
51,50,8,410,256,154,60.15625
51,50,9,539,512,27,5.2734375
51,50,10,1944,1024,920,89.84375
51,50,11,231,2048,-1817,-88.720703125
51,50,12,11728,4096,7632,186.328125
51,50,13,5876,8192,-2316,-28.271484375
51,50,14,22005,16384,5621,34.307861328125
51,50,15,6653,32768,-26115,-79.6966552734375
51,51,1,0,2,-2,-100.0
51,51,2,1,4,-3,-75.0
51,51,3,3,8,-5,-62.5
51,51,4,35,16,19,118.75
51,51,5,49,32,17,53.125
51,51,6,71,64,7,10.9375
51,51,7,153,128,25,19.53125
51,51,8,347,256,91,35.546875
51,51,9,156,512,-356,-69.53125
51,51,10,3134,1024,2110,206.0546875
51,51,11,1505,2048,-543,-26.513671875
51,51,12,1294,4096,-2802,-68.408203125
51,51,13,15765,8192,7573,92.44384765625
51,51,14,6944,16384,-9440,-57.6171875
51,51,15,61298,32768,28530,87.066650390625
52,1,1,0,2,-2,-100.0
52,1,2,4,4,0,0.0
52,1,3,3,8,-5,-62.5
52,1,4,30,16,14,87.5
52,1,5,8,32,-24,-75.0
52,1,6,107,64,43,67.1875
52,1,7,252,128,124,96.875
52,1,8,223,256,-33,-12.890625
52,1,9,132,512,-380,-74.21875
52,1,10,408,1024,-616,-60.15625
52,1,11,1368,2048,-680,-33.203125
52,1,12,1271,4096,-2825,-68.9697265625
52,1,13,19460,8192,11268,137.548828125
52,1,14,16592,16384,208,1.26953125
52,1,15,37318,32768,4550,13.885498046875
52,2,1,0,2,-2,-100.0
52,2,2,1,4,-3,-75.0
52,2,3,3,8,-5,-62.5
52,2,4,22,16,6,37.5
52,2,5,57,32,25,78.125
52,2,6,8,64,-56,-87.5
52,2,7,27,128,-101,-78.90625
52,2,8,425,256,169,66.015625
52,2,9,134,512,-378,-73.828125
52,2,10,4312,1024,3288,321.09375
52,2,11,1363,2048,-685,-33.447265625
52,2,12,1460,4096,-2636,-64.35546875
52,2,13,418,8192,-7774,-94.8974609375
52,2,14,1272,16384,-15112,-92.236328125
52,2,15,23778,32768,-8990,-27.435302734375
52,3,1,0,2,-2,-100.0
52,3,2,3,4,-1,-25.0
52,3,3,2,8,-6,-75.0
52,3,4,19,16,3,18.75
52,3,5,9,32,-23,-71.875
52,3,6,55,64,-9,-14.0625
52,3,7,81,128,-47,-36.71875
52,3,8,396,256,140,54.6875
52,3,9,102,512,-410,-80.078125
52,3,10,627,1024,-397,-38.76953125
52,3,11,44,2048,-2004,-97.8515625
52,3,12,457,4096,-3639,-88.8427734375
52,3,13,255,8192,-7937,-96.88720703125
52,3,14,3226,16384,-13158,-80.31005859375
52,3,15,3204,32768,-29564,-90.22216796875
52,4,1,0,2,-2,-100.0
52,4,2,1,4,-3,-75.0
52,4,3,8,8,0,0.0
52,4,4,12,16,-4,-25.0
52,4,5,28,32,-4,-12.5
52,4,6,90,64,26,40.625
52,4,7,119,128,-9,-7.03125
52,4,8,22,256,-234,-91.40625
52,4,9,90,512,-422,-82.421875
52,4,10,1240,1024,216,21.09375
52,4,11,1697,2048,-351,-17.138671875
52,4,12,3102,4096,-994,-24.267578125
52,4,13,19581,8192,11389,139.02587890625
52,4,14,6047,16384,-10337,-63.092041015625
52,4,15,120930,32768,88162,269.049072265625
52,5,1,0,2,-2,-100.0
52,5,2,1,4,-3,-75.0
52,5,3,2,8,-6,-75.0
52,5,4,3,16,-13,-81.25
52,5,5,32,32,0,0.0
52,5,6,70,64,6,9.375
52,5,7,68,128,-60,-46.875
52,5,8,445,256,189,73.828125
52,5,9,100,512,-412,-80.46875
52,5,10,1794,1024,770,75.1953125
52,5,11,1412,2048,-636,-31.0546875
52,5,12,15356,4096,11260,274.90234375
52,5,13,3673,8192,-4519,-55.16357421875
52,5,14,15950,16384,-434,-2.64892578125
52,5,15,12046,32768,-20722,-63.238525390625
52,6,1,0,2,-2,-100.0
52,6,2,1,4,-3,-75.0
52,6,3,2,8,-6,-75.0
52,6,4,24,16,8,50.0
52,6,5,44,32,12,37.5
52,6,6,70,64,6,9.375
52,6,7,53,128,-75,-58.59375
52,6,8,209,256,-47,-18.359375
52,6,9,109,512,-403,-78.7109375
52,6,10,300,1024,-724,-70.703125
52,6,11,511,2048,-1537,-75.048828125
52,6,12,7501,4096,3405,83.1298828125
52,6,13,1031,8192,-7161,-87.41455078125
52,6,14,6757,16384,-9627,-58.758544921875
52,6,15,36491,32768,3723,11.3616943359375
52,7,1,0,2,-2,-100.0
52,7,2,2,4,-2,-50.0
52,7,3,5,8,-3,-37.5
52,7,4,3,16,-13,-81.25
52,7,5,18,32,-14,-43.75
52,7,6,32,64,-32,-50.0
52,7,7,205,128,77,60.15625
52,7,8,289,256,33,12.890625
52,7,9,810,512,298,58.203125
52,7,10,316,1024,-708,-69.140625
52,7,11,1366,2048,-682,-33.30078125
52,7,12,1356,4096,-2740,-66.89453125
52,7,13,3772,8192,-4420,-53.955078125
52,7,14,12540,16384,-3844,-23.4619140625
52,7,15,42650,32768,9882,30.157470703125
52,8,1,0,2,-2,-100.0
52,8,2,1,4,-3,-75.0
52,8,3,3,8,-5,-62.5
52,8,4,11,16,-5,-31.25
52,8,5,37,32,5,15.625
52,8,6,61,64,-3,-4.6875
52,8,7,19,128,-109,-85.15625
52,8,8,366,256,110,42.96875
52,8,9,338,512,-174,-33.984375
52,8,10,394,1024,-630,-61.5234375
52,8,11,2325,2048,277,13.525390625
52,8,12,1201,4096,-2895,-70.6787109375
52,8,13,4776,8192,-3416,-41.69921875
52,8,14,29308,16384,12924,78.8818359375
52,8,15,67838,32768,35070,107.025146484375
52,9,1,0,2,-2,-100.0
52,9,2,4,4,0,0.0
52,9,3,9,8,1,12.5
52,9,4,11,16,-5,-31.25
52,9,5,126,32,94,293.75
52,9,6,24,64,-40,-62.5
52,9,7,160,128,32,25.0
52,9,8,30,256,-226,-88.28125
52,9,9,3196,512,2684,524.21875
52,9,10,178,1024,-846,-82.6171875
52,9,11,1362,2048,-686,-33.49609375
52,9,12,1089,4096,-3007,-73.4130859375
52,9,13,6978,8192,-1214,-14.8193359375
52,9,14,18543,16384,2159,13.177490234375
52,9,15,7553,32768,-25215,-76.9500732421875
52,10,1,0,2,-2,-100.0
52,10,2,3,4,-1,-25.0
52,10,3,5,8,-3,-37.5
52,10,4,5,16,-11,-68.75
52,10,5,8,32,-24,-75.0
52,10,6,38,64,-26,-40.625
52,10,7,78,128,-50,-39.0625
52,10,8,297,256,41,16.015625
52,10,9,534,512,22,4.296875
52,10,10,625,1024,-399,-38.96484375
52,10,11,357,2048,-1691,-82.568359375
52,10,12,4923,4096,827,20.1904296875
52,10,13,710,8192,-7482,-91.3330078125
52,10,14,2696,16384,-13688,-83.544921875
52,10,15,50594,32768,17826,54.400634765625
52,11,1,0,2,-2,-100.0
52,11,2,1,4,-3,-75.0
52,11,3,5,8,-3,-37.5
52,11,4,3,16,-13,-81.25
52,11,5,43,32,11,34.375
52,11,6,5,64,-59,-92.1875
52,11,7,23,128,-105,-82.03125
52,11,8,313,256,57,22.265625
52,11,9,122,512,-390,-76.171875
52,11,10,1242,1024,218,21.2890625
52,11,11,1060,2048,-988,-48.2421875
52,11,12,3453,4096,-643,-15.6982421875
52,11,13,5865,8192,-2327,-28.40576171875
52,11,14,25635,16384,9251,56.463623046875
52,11,15,53881,32768,21113,64.4317626953125
52,12,1,0,2,-2,-100.0
52,12,2,1,4,-3,-75.0
52,12,3,13,8,5,62.5
52,12,4,15,16,-1,-6.25
52,12,5,48,32,16,50.0
52,12,6,45,64,-19,-29.6875
52,12,7,70,128,-58,-45.3125
52,12,8,272,256,16,6.25
52,12,9,60,512,-452,-88.28125
52,12,10,546,1024,-478,-46.6796875
52,12,11,1333,2048,-715,-34.912109375
52,12,12,1723,4096,-2373,-57.9345703125
52,12,13,7084,8192,-1108,-13.525390625
52,12,14,3330,16384,-13054,-79.67529296875
52,12,15,70572,32768,37804,115.36865234375
52,13,1,0,2,-2,-100.0
52,13,2,4,4,0,0.0
52,13,3,3,8,-5,-62.5
52,13,4,15,16,-1,-6.25
52,13,5,23,32,-9,-28.125
52,13,6,54,64,-10,-15.625
52,13,7,152,128,24,18.75
52,13,8,66,256,-190,-74.21875
52,13,9,148,512,-364,-71.09375
52,13,10,161,1024,-863,-84.27734375
52,13,11,1859,2048,-189,-9.228515625
52,13,12,244,4096,-3852,-94.04296875
52,13,13,6346,8192,-1846,-22.5341796875
52,13,14,9331,16384,-7053,-43.048095703125
52,13,15,9847,32768,-22921,-69.9493408203125
52,14,1,0,2,-2,-100.0
52,14,2,4,4,0,0.0
52,14,3,2,8,-6,-75.0
52,14,4,38,16,22,137.5
52,14,5,12,32,-20,-62.5
52,14,6,9,64,-55,-85.9375
52,14,7,50,128,-78,-60.9375
52,14,8,97,256,-159,-62.109375
52,14,9,651,512,139,27.1484375
52,14,10,1006,1024,-18,-1.7578125
52,14,11,2479,2048,431,21.044921875
52,14,12,401,4096,-3695,-90.2099609375
52,14,13,4707,8192,-3485,-42.54150390625
52,14,14,2572,16384,-13812,-84.3017578125
52,14,15,78213,32768,45445,138.6871337890625
52,15,1,0,2,-2,-100.0
52,15,2,1,4,-3,-75.0
52,15,3,16,8,8,100.0
52,15,4,9,16,-7,-43.75
52,15,5,94,32,62,193.75
52,15,6,27,64,-37,-57.8125
52,15,7,91,128,-37,-28.90625
52,15,8,12,256,-244,-95.3125
52,15,9,322,512,-190,-37.109375
52,15,10,43,1024,-981,-95.80078125
52,15,11,655,2048,-1393,-68.017578125
52,15,12,2711,4096,-1385,-33.8134765625
52,15,13,4127,8192,-4065,-49.62158203125
52,15,14,44547,16384,28163,171.893310546875
52,15,15,38988,32768,6220,18.98193359375
52,16,1,0,2,-2,-100.0
52,16,2,1,4,-3,-75.0
52,16,3,2,8,-6,-75.0
52,16,4,29,16,13,81.25
52,16,5,4,32,-28,-87.5
52,16,6,50,64,-14,-21.875
52,16,7,295,128,167,130.46875
52,16,8,141,256,-115,-44.921875
52,16,9,126,512,-386,-75.390625
52,16,10,366,1024,-658,-64.2578125
52,16,11,6050,2048,4002,195.41015625
52,16,12,1988,4096,-2108,-51.46484375
52,16,13,848,8192,-7344,-89.6484375
52,16,14,27058,16384,10674,65.14892578125
52,16,15,17230,32768,-15538,-47.418212890625
52,17,1,0,2,-2,-100.0
52,17,2,2,4,-2,-50.0
52,17,3,3,8,-5,-62.5
52,17,4,17,16,1,6.25
52,17,5,26,32,-6,-18.75
52,17,6,138,64,74,115.625
52,17,7,182,128,54,42.1875
52,17,8,262,256,6,2.34375
52,17,9,437,512,-75,-14.6484375
52,17,10,4712,1024,3688,360.15625
52,17,11,1678,2048,-370,-18.06640625
52,17,12,794,4096,-3302,-80.615234375
52,17,13,12859,8192,4667,56.97021484375
52,17,14,888,16384,-15496,-94.580078125
52,17,15,2406,32768,-30362,-92.657470703125
52,18,1,0,2,-2,-100.0
52,18,2,1,4,-3,-75.0
52,18,3,2,8,-6,-75.0
52,18,4,15,16,-1,-6.25
52,18,5,4,32,-28,-87.5
52,18,6,177,64,113,176.5625
52,18,7,87,128,-41,-32.03125
52,18,8,231,256,-25,-9.765625
52,18,9,1097,512,585,114.2578125
52,18,10,1011,1024,-13,-1.26953125
52,18,11,157,2048,-1891,-92.333984375
52,18,12,6633,4096,2537,61.9384765625
52,18,13,125,8192,-8067,-98.47412109375
52,18,14,45388,16384,29004,177.0263671875
52,18,15,13318,32768,-19450,-59.356689453125
52,19,1,0,2,-2,-100.0
52,19,2,1,4,-3,-75.0
52,19,3,17,8,9,112.5
52,19,4,16,16,0,0.0
52,19,5,83,32,51,159.375
52,19,6,29,64,-35,-54.6875
52,19,7,80,128,-48,-37.5
52,19,8,73,256,-183,-71.484375
52,19,9,1229,512,717,140.0390625
52,19,10,69,1024,-955,-93.26171875
52,19,11,4837,2048,2789,136.181640625
52,19,12,3948,4096,-148,-3.61328125
52,19,13,19002,8192,10810,131.9580078125
52,19,14,1901,16384,-14483,-88.397216796875
52,19,15,21868,32768,-10900,-33.26416015625
52,20,1,0,2,-2,-100.0
52,20,2,3,4,-1,-25.0
52,20,3,9,8,1,12.5
52,20,4,21,16,5,31.25
52,20,5,7,32,-25,-78.125
52,20,6,5,64,-59,-92.1875
52,20,7,68,128,-60,-46.875
52,20,8,13,256,-243,-94.921875
52,20,9,221,512,-291,-56.8359375
52,20,10,658,1024,-366,-35.7421875
52,20,11,7519,2048,5471,267.138671875
52,20,12,8063,4096,3967,96.8505859375
52,20,13,2441,8192,-5751,-70.20263671875
52,20,14,13987,16384,-2397,-14.630126953125
52,20,15,136976,32768,104208,318.017578125
52,21,1,0,2,-2,-100.0
52,21,2,6,4,2,50.0
52,21,3,2,8,-6,-75.0
52,21,4,22,16,6,37.5
52,21,5,34,32,2,6.25
52,21,6,68,64,4,6.25
52,21,7,48,128,-80,-62.5
52,21,8,69,256,-187,-73.046875
52,21,9,267,512,-245,-47.8515625
52,21,10,1250,1024,226,22.0703125
52,21,11,1997,2048,-51,-2.490234375
52,21,12,3003,4096,-1093,-26.6845703125
52,21,13,1061,8192,-7131,-87.04833984375
52,21,14,2873,16384,-13511,-82.464599609375
52,21,15,10706,32768,-22062,-67.327880859375
52,22,1,0,2,-2,-100.0
52,22,2,2,4,-2,-50.0
52,22,3,3,8,-5,-62.5
52,22,4,7,16,-9,-56.25
52,22,5,21,32,-11,-34.375
52,22,6,7,64,-57,-89.0625
52,22,7,37,128,-91,-71.09375
52,22,8,55,256,-201,-78.515625
52,22,9,313,512,-199,-38.8671875
52,22,10,1593,1024,569,55.56640625
52,22,11,543,2048,-1505,-73.486328125
52,22,12,1015,4096,-3081,-75.2197265625
52,22,13,16559,8192,8367,102.13623046875
52,22,14,4050,16384,-12334,-75.28076171875
52,22,15,10234,32768,-22534,-68.768310546875
52,23,1,0,2,-2,-100.0
52,23,2,1,4,-3,-75.0
52,23,3,2,8,-6,-75.0
52,23,4,24,16,8,50.0
52,23,5,193,32,161,503.125
52,23,6,66,64,2,3.125
52,23,7,125,128,-3,-2.34375
52,23,8,312,256,56,21.875
52,23,9,422,512,-90,-17.578125
52,23,10,690,1024,-334,-32.6171875
52,23,11,703,2048,-1345,-65.673828125
52,23,12,10104,4096,6008,146.6796875
52,23,13,711,8192,-7481,-91.32080078125
52,23,14,558,16384,-15826,-96.59423828125
52,23,15,24151,32768,-8617,-26.2969970703125
52,24,1,0,2,-2,-100.0
52,24,2,2,4,-2,-50.0
52,24,3,8,8,0,0.0
52,24,4,25,16,9,56.25
52,24,5,11,32,-21,-65.625
52,24,6,8,64,-56,-87.5
52,24,7,79,128,-49,-38.28125
52,24,8,682,256,426,166.40625
52,24,9,1046,512,534,104.296875
52,24,10,1032,1024,8,0.78125
52,24,11,1347,2048,-701,-34.228515625
52,24,12,4617,4096,521,12.7197265625
52,24,13,8651,8192,459,5.60302734375
52,24,14,22948,16384,6564,40.0634765625
52,24,15,33428,32768,660,2.01416015625
52,25,1,0,2,-2,-100.0
52,25,2,1,4,-3,-75.0
52,25,3,6,8,-2,-25.0
52,25,4,9,16,-7,-43.75
52,25,5,21,32,-11,-34.375
52,25,6,20,64,-44,-68.75
52,25,7,121,128,-7,-5.46875
52,25,8,47,256,-209,-81.640625
52,25,9,36,512,-476,-92.96875
52,25,10,72,1024,-952,-92.96875
52,25,11,463,2048,-1585,-77.392578125
52,25,12,8630,4096,4534,110.693359375
52,25,13,6456,8192,-1736,-21.19140625
52,25,14,12403,16384,-3981,-24.298095703125
52,25,15,23692,32768,-9076,-27.69775390625
52,26,1,0,2,-2,-100.0
52,26,2,1,4,-3,-75.0
52,26,3,2,8,-6,-75.0
52,26,4,7,16,-9,-56.25
52,26,5,6,32,-26,-81.25
52,26,6,16,64,-48,-75.0
52,26,7,222,128,94,73.4375
52,26,8,54,256,-202,-78.90625
52,26,9,899,512,387,75.5859375
52,26,10,273,1024,-751,-73.33984375
52,26,11,2896,2048,848,41.40625
52,26,12,4747,4096,651,15.8935546875
52,26,13,7419,8192,-773,-9.43603515625
52,26,14,14252,16384,-2132,-13.0126953125
52,26,15,56416,32768,23648,72.16796875
52,27,1,0,2,-2,-100.0
52,27,2,1,4,-3,-75.0
52,27,3,2,8,-6,-75.0
52,27,4,3,16,-13,-81.25
52,27,5,30,32,-2,-6.25
52,27,6,161,64,97,151.5625
52,27,7,74,128,-54,-42.1875
52,27,8,59,256,-197,-76.953125
52,27,9,206,512,-306,-59.765625
52,27,10,987,1024,-37,-3.61328125
52,27,11,2673,2048,625,30.517578125
52,27,12,3432,4096,-664,-16.2109375
52,27,13,13072,8192,4880,59.5703125
52,27,14,12224,16384,-4160,-25.390625
52,27,15,13969,32768,-18799,-57.3699951171875
52,28,1,0,2,-2,-100.0
52,28,2,4,4,0,0.0
52,28,3,4,8,-4,-50.0
52,28,4,3,16,-13,-81.25
52,28,5,25,32,-7,-21.875
52,28,6,40,64,-24,-37.5
52,28,7,35,128,-93,-72.65625
52,28,8,115,256,-141,-55.078125
52,28,9,212,512,-300,-58.59375
52,28,10,2221,1024,1197,116.89453125
52,28,11,2342,2048,294,14.35546875
52,28,12,5360,4096,1264,30.859375
52,28,13,9744,8192,1552,18.9453125
52,28,14,7809,16384,-8575,-52.337646484375
52,28,15,26825,32768,-5943,-18.1365966796875
52,29,1,0,2,-2,-100.0
52,29,2,3,4,-1,-25.0
52,29,3,7,8,-1,-12.5
52,29,4,12,16,-4,-25.0
52,29,5,31,32,-1,-3.125
52,29,6,18,64,-46,-71.875
52,29,7,149,128,21,16.40625
52,29,8,273,256,17,6.640625
52,29,9,244,512,-268,-52.34375
52,29,10,1268,1024,244,23.828125
52,29,11,1140,2048,-908,-44.3359375
52,29,12,5014,4096,918,22.412109375
52,29,13,6337,8192,-1855,-22.64404296875
52,29,14,9808,16384,-6576,-40.13671875
52,29,15,16947,32768,-15821,-48.2818603515625
52,30,1,0,2,-2,-100.0
52,30,2,1,4,-3,-75.0
52,30,3,2,8,-6,-75.0
52,30,4,4,16,-12,-75.0
52,30,5,8,32,-24,-75.0
52,30,6,10,64,-54,-84.375
52,30,7,252,128,124,96.875
52,30,8,355,256,99,38.671875
52,30,9,82,512,-430,-83.984375
52,30,10,202,1024,-822,-80.2734375
52,30,11,21,2048,-2027,-98.974609375
52,30,12,871,4096,-3225,-78.7353515625
52,30,13,11291,8192,3099,37.82958984375
52,30,14,802,16384,-15582,-95.10498046875
52,30,15,17245,32768,-15523,-47.3724365234375
52,31,1,0,2,-2,-100.0
52,31,2,1,4,-3,-75.0
52,31,3,2,8,-6,-75.0
52,31,4,3,16,-13,-81.25
52,31,5,15,32,-17,-53.125
52,31,6,201,64,137,214.0625
52,31,7,37,128,-91,-71.09375
52,31,8,405,256,149,58.203125
52,31,9,466,512,-46,-8.984375
52,31,10,3062,1024,2038,199.0234375
52,31,11,411,2048,-1637,-79.931640625
52,31,12,5915,4096,1819,44.4091796875
52,31,13,10954,8192,2762,33.7158203125
52,31,14,5672,16384,-10712,-65.380859375
52,31,15,6579,32768,-26189,-79.9224853515625
52,32,1,0,2,-2,-100.0
52,32,2,1,4,-3,-75.0
52,32,3,3,8,-5,-62.5
52,32,4,24,16,8,50.0
52,32,5,14,32,-18,-56.25
52,32,6,19,64,-45,-70.3125
52,32,7,6,128,-122,-95.3125
52,32,8,12,256,-244,-95.3125
52,32,9,735,512,223,43.5546875
52,32,10,1642,1024,618,60.3515625
52,32,11,1101,2048,-947,-46.240234375
52,32,12,1688,4096,-2408,-58.7890625
52,32,13,2004,8192,-6188,-75.537109375
52,32,14,3281,16384,-13103,-79.974365234375
52,32,15,44618,32768,11850,36.163330078125
52,33,1,0,2,-2,-100.0
52,33,2,2,4,-2,-50.0
52,33,3,2,8,-6,-75.0
52,33,4,34,16,18,112.5
52,33,5,44,32,12,37.5
52,33,6,62,64,-2,-3.125
52,33,7,117,128,-11,-8.59375
52,33,8,148,256,-108,-42.1875
52,33,9,264,512,-248,-48.4375
52,33,10,325,1024,-699,-68.26171875
52,33,11,336,2048,-1712,-83.59375
52,33,12,794,4096,-3302,-80.615234375
52,33,13,6288,8192,-1904,-23.2421875
52,33,14,385,16384,-15999,-97.650146484375
52,33,15,12777,32768,-19991,-61.0076904296875
52,34,1,0,2,-2,-100.0
52,34,2,1,4,-3,-75.0
52,34,3,17,8,9,112.5
52,34,4,7,16,-9,-56.25
52,34,5,64,32,32,100.0
52,34,6,5,64,-59,-92.1875
52,34,7,44,128,-84,-65.625
52,34,8,38,256,-218,-85.15625
52,34,9,2170,512,1658,323.828125
52,34,10,913,1024,-111,-10.83984375
52,34,11,1452,2048,-596,-29.1015625
52,34,12,4229,4096,133,3.2470703125
52,34,13,2312,8192,-5880,-71.77734375
52,34,14,40628,16384,24244,147.9736328125
52,34,15,103321,32768,70553,215.3106689453125
52,35,1,0,2,-2,-100.0
52,35,2,1,4,-3,-75.0
52,35,3,4,8,-4,-50.0
52,35,4,9,16,-7,-43.75
52,35,5,19,32,-13,-40.625
52,35,6,187,64,123,192.1875
52,35,7,74,128,-54,-42.1875
52,35,8,224,256,-32,-12.5
52,35,9,77,512,-435,-84.9609375
52,35,10,181,1024,-843,-82.32421875
52,35,11,125,2048,-1923,-93.896484375
52,35,12,1953,4096,-2143,-52.3193359375
52,35,13,2489,8192,-5703,-69.61669921875
52,35,14,38421,16384,22037,134.503173828125
52,35,15,38044,32768,5276,16.10107421875
52,36,1,0,2,-2,-100.0
52,36,2,1,4,-3,-75.0
52,36,3,5,8,-3,-37.5
52,36,4,3,16,-13,-81.25
52,36,5,5,32,-27,-84.375
52,36,6,12,64,-52,-81.25
52,36,7,21,128,-107,-83.59375
52,36,8,927,256,671,262.109375
52,36,9,431,512,-81,-15.8203125
52,36,10,55,1024,-969,-94.62890625
52,36,11,27,2048,-2021,-98.681640625
52,36,12,3581,4096,-515,-12.5732421875
52,36,13,3412,8192,-4780,-58.349609375
52,36,14,943,16384,-15441,-94.244384765625
52,36,15,4584,32768,-28184,-86.0107421875
52,37,1,0,2,-2,-100.0
52,37,2,2,4,-2,-50.0
52,37,3,11,8,3,37.5
52,37,4,15,16,-1,-6.25
52,37,5,29,32,-3,-9.375
52,37,6,35,64,-29,-45.3125
52,37,7,14,128,-114,-89.0625
52,37,8,146,256,-110,-42.96875
52,37,9,3045,512,2533,494.7265625
52,37,10,2135,1024,1111,108.49609375
52,37,11,1050,2048,-998,-48.73046875
52,37,12,7266,4096,3170,77.392578125
52,37,13,10921,8192,2729,33.31298828125
52,37,14,6639,16384,-9745,-59.478759765625
52,37,15,22516,32768,-10252,-31.28662109375
52,38,1,0,2,-2,-100.0
52,38,2,2,4,-2,-50.0
52,38,3,2,8,-6,-75.0
52,38,4,4,16,-12,-75.0
52,38,5,36,32,4,12.5
52,38,6,21,64,-43,-67.1875
52,38,7,252,128,124,96.875
52,38,8,195,256,-61,-23.828125
52,38,9,626,512,114,22.265625
52,38,10,504,1024,-520,-50.78125
52,38,11,14,2048,-2034,-99.31640625
52,38,12,5722,4096,1626,39.697265625
52,38,13,13382,8192,5190,63.3544921875
52,38,14,1295,16384,-15089,-92.095947265625
52,38,15,96244,32768,63476,193.71337890625
52,39,1,0,2,-2,-100.0
52,39,2,1,4,-3,-75.0
52,39,3,3,8,-5,-62.5
52,39,4,12,16,-4,-25.0
52,39,5,7,32,-25,-78.125
52,39,6,34,64,-30,-46.875
52,39,7,47,128,-81,-63.28125
52,39,8,230,256,-26,-10.15625
52,39,9,206,512,-306,-59.765625
52,39,10,881,1024,-143,-13.96484375
52,39,11,1290,2048,-758,-37.01171875
52,39,12,2083,4096,-2013,-49.1455078125
52,39,13,4989,8192,-3203,-39.09912109375
52,39,14,13841,16384,-2543,-15.521240234375
52,39,15,30022,32768,-2746,-8.380126953125
52,40,1,0,2,-2,-100.0
52,40,2,2,4,-2,-50.0
52,40,3,5,8,-3,-37.5
52,40,4,36,16,20,125.0
52,40,5,18,32,-14,-43.75
52,40,6,17,64,-47,-73.4375
52,40,7,106,128,-22,-17.1875
52,40,8,148,256,-108,-42.1875
52,40,9,376,512,-136,-26.5625
52,40,10,325,1024,-699,-68.26171875
52,40,11,2557,2048,509,24.853515625
52,40,12,11123,4096,7027,171.5576171875
52,40,13,17500,8192,9308,113.623046875
52,40,14,1974,16384,-14410,-87.95166015625
52,40,15,24342,32768,-8426,-25.714111328125
52,41,1,0,2,-2,-100.0
52,41,2,1,4,-3,-75.0
52,41,3,4,8,-4,-50.0
52,41,4,9,16,-7,-43.75
52,41,5,12,32,-20,-62.5
52,41,6,19,64,-45,-70.3125
52,41,7,15,128,-113,-88.28125
52,41,8,123,256,-133,-51.953125
52,41,9,448,512,-64,-12.5
52,41,10,2280,1024,1256,122.65625
52,41,11,266,2048,-1782,-87.01171875
52,41,12,5543,4096,1447,35.3271484375
52,41,13,18494,8192,10302,125.7568359375
52,41,14,10653,16384,-5731,-34.979248046875
52,41,15,112620,32768,79852,243.68896484375
52,42,1,0,2,-2,-100.0
52,42,2,2,4,-2,-50.0
52,42,3,9,8,1,12.5
52,42,4,3,16,-13,-81.25
52,42,5,18,32,-14,-43.75
52,42,6,5,64,-59,-92.1875
52,42,7,17,128,-111,-86.71875
52,42,8,535,256,279,108.984375
52,42,9,111,512,-401,-78.3203125
52,42,10,321,1024,-703,-68.65234375
52,42,11,5374,2048,3326,162.40234375
52,42,12,6732,4096,2636,64.35546875
52,42,13,13282,8192,5090,62.1337890625
52,42,14,15161,16384,-1223,-7.464599609375
52,42,15,30044,32768,-2724,-8.31298828125
52,43,1,0,2,-2,-100.0
52,43,2,3,4,-1,-25.0
52,43,3,2,8,-6,-75.0
52,43,4,8,16,-8,-50.0
52,43,5,6,32,-26,-81.25
52,43,6,27,64,-37,-57.8125
52,43,7,61,128,-67,-52.34375
52,43,8,1130,256,874,341.40625
52,43,9,1559,512,1047,204.4921875
52,43,10,60,1024,-964,-94.140625
52,43,11,454,2048,-1594,-77.83203125
52,43,12,633,4096,-3463,-84.5458984375
52,43,13,15753,8192,7561,92.29736328125
52,43,14,6569,16384,-9815,-59.906005859375
52,43,15,7439,32768,-25329,-77.2979736328125
52,44,1,0,2,-2,-100.0
52,44,2,4,4,0,0.0
52,44,3,2,8,-6,-75.0
52,44,4,19,16,3,18.75
52,44,5,47,32,15,46.875
52,44,6,23,64,-41,-64.0625
52,44,7,69,128,-59,-46.09375
52,44,8,72,256,-184,-71.875
52,44,9,44,512,-468,-91.40625
52,44,10,150,1024,-874,-85.3515625
52,44,11,4090,2048,2042,99.70703125
52,44,12,13708,4096,9612,234.66796875
52,44,13,2118,8192,-6074,-74.1455078125
52,44,14,3515,16384,-12869,-78.546142578125
52,44,15,14320,32768,-18448,-56.298828125
52,45,1,0,2,-2,-100.0
52,45,2,8,4,4,100.0
52,45,3,6,8,-2,-25.0
52,45,4,4,16,-12,-75.0
52,45,5,38,32,6,18.75
52,45,6,9,64,-55,-85.9375
52,45,7,52,128,-76,-59.375
52,45,8,364,256,108,42.1875
52,45,9,541,512,29,5.6640625
52,45,10,333,1024,-691,-67.48046875
52,45,11,1097,2048,-951,-46.435546875
52,45,12,5554,4096,1458,35.595703125
52,45,13,6078,8192,-2114,-25.8056640625
52,45,14,5278,16384,-11106,-67.78564453125
52,45,15,1050,32768,-31718,-96.795654296875
52,46,1,0,2,-2,-100.0
52,46,2,1,4,-3,-75.0
52,46,3,3,8,-5,-62.5
52,46,4,8,16,-8,-50.0
52,46,5,7,32,-25,-78.125
52,46,6,12,64,-52,-81.25
52,46,7,118,128,-10,-7.8125
52,46,8,445,256,189,73.828125
52,46,9,249,512,-263,-51.3671875
52,46,10,2030,1024,1006,98.2421875
52,46,11,688,2048,-1360,-66.40625
52,46,12,7892,4096,3796,92.67578125
52,46,13,8727,8192,535,6.53076171875
52,46,14,3255,16384,-13129,-80.133056640625
52,46,15,79212,32768,46444,141.73583984375
52,47,1,0,2,-2,-100.0
52,47,2,3,4,-1,-25.0
52,47,3,6,8,-2,-25.0
52,47,4,8,16,-8,-50.0
52,47,5,14,32,-18,-56.25
52,47,6,7,64,-57,-89.0625
52,47,7,108,128,-20,-15.625
52,47,8,33,256,-223,-87.109375
52,47,9,235,512,-277,-54.1015625
52,47,10,1080,1024,56,5.46875
52,47,11,511,2048,-1537,-75.048828125
52,47,12,4968,4096,872,21.2890625
52,47,13,4231,8192,-3961,-48.35205078125
52,47,14,20391,16384,4007,24.456787109375
52,47,15,16415,32768,-16353,-49.9053955078125
52,48,1,0,2,-2,-100.0
52,48,2,5,4,1,25.0
52,48,3,3,8,-5,-62.5
52,48,4,10,16,-6,-37.5
52,48,5,4,32,-28,-87.5
52,48,6,48,64,-16,-25.0
52,48,7,19,128,-109,-85.15625
52,48,8,241,256,-15,-5.859375
52,48,9,191,512,-321,-62.6953125
52,48,10,109,1024,-915,-89.35546875
52,48,11,500,2048,-1548,-75.5859375
52,48,12,5946,4096,1850,45.166015625
52,48,13,5373,8192,-2819,-34.41162109375
52,48,14,22059,16384,5675,34.637451171875
52,48,15,114844,32768,82076,250.47607421875
52,49,1,0,2,-2,-100.0
52,49,2,1,4,-3,-75.0
52,49,3,8,8,0,0.0
52,49,4,6,16,-10,-62.5
52,49,5,21,32,-11,-34.375
52,49,6,129,64,65,101.5625
52,49,7,72,128,-56,-43.75
52,49,8,89,256,-167,-65.234375
52,49,9,40,512,-472,-92.1875
52,49,10,1477,1024,453,44.23828125
52,49,11,197,2048,-1851,-90.380859375
52,49,12,4710,4096,614,14.990234375
52,49,13,47267,8192,39075,476.98974609375
52,49,14,33323,16384,16939,103.387451171875
52,49,15,6024,32768,-26744,-81.6162109375
52,50,1,0,2,-2,-100.0
52,50,2,2,4,-2,-50.0
52,50,3,3,8,-5,-62.5
52,50,4,15,16,-1,-6.25
52,50,5,50,32,18,56.25
52,50,6,105,64,41,64.0625
52,50,7,72,128,-56,-43.75
52,50,8,102,256,-154,-60.15625
52,50,9,1247,512,735,143.5546875
52,50,10,9,1024,-1015,-99.12109375
52,50,11,1988,2048,-60,-2.9296875
52,50,12,6220,4096,2124,51.85546875
52,50,13,2297,8192,-5895,-71.96044921875
52,50,14,29613,16384,13229,80.743408203125
52,50,15,6044,32768,-26724,-81.55517578125
52,51,1,0,2,-2,-100.0
52,51,2,2,4,-2,-50.0
52,51,3,2,8,-6,-75.0
52,51,4,3,16,-13,-81.25
52,51,5,32,32,0,0.0
52,51,6,243,64,179,279.6875
52,51,7,142,128,14,10.9375
52,51,8,128,256,-128,-50.0
52,51,9,127,512,-385,-75.1953125
52,51,10,442,1024,-582,-56.8359375
52,51,11,375,2048,-1673,-81.689453125
52,51,12,8211,4096,4115,100.4638671875
52,51,13,8613,8192,421,5.13916015625
52,51,14,5689,16384,-10695,-65.277099609375
52,51,15,1571,32768,-31197,-95.2056884765625
52,52,1,0,2,-2,-100.0
52,52,2,1,4,-3,-75.0
52,52,3,8,8,0,0.0
52,52,4,9,16,-7,-43.75
52,52,5,9,32,-23,-71.875
52,52,6,10,64,-54,-84.375
52,52,7,203,128,75,58.59375
52,52,8,905,256,649,253.515625
52,52,9,57,512,-455,-88.8671875
52,52,10,618,1024,-406,-39.6484375
52,52,11,935,2048,-1113,-54.345703125
52,52,12,5708,4096,1612,39.35546875
52,52,13,20612,8192,12420,151.611328125
52,52,14,40367,16384,23983,146.380615234375
52,52,15,8575,32768,-24193,-73.8311767578125
53,1,1,0,2,-2,-100.0
53,1,2,1,4,-3,-75.0
53,1,3,3,8,-5,-62.5
53,1,4,10,16,-6,-37.5
53,1,5,20,32,-12,-37.5
53,1,6,50,64,-14,-21.875
53,1,7,98,128,-30,-23.4375
53,1,8,185,256,-71,-27.734375
53,1,9,157,512,-355,-69.3359375
53,1,10,491,1024,-533,-52.05078125
53,1,11,1346,2048,-702,-34.27734375
53,1,12,1196,4096,-2900,-70.80078125
53,1,13,1656,8192,-6536,-79.78515625
53,1,14,65212,16384,48828,298.0224609375
53,1,15,21068,32768,-11700,-35.70556640625
53,2,1,0,2,-2,-100.0
53,2,2,4,4,0,0.0
53,2,3,3,8,-5,-62.5
53,2,4,11,16,-5,-31.25
53,2,5,17,32,-15,-46.875
53,2,6,49,64,-15,-23.4375
53,2,7,72,128,-56,-43.75
53,2,8,635,256,379,148.046875
53,2,9,784,512,272,53.125
53,2,10,1089,1024,65,6.34765625
53,2,11,4573,2048,2525,123.291015625
53,2,12,877,4096,-3219,-78.5888671875
53,2,13,149,8192,-8043,-98.18115234375
53,2,14,36329,16384,19945,121.734619140625
53,2,15,71833,32768,39065,119.2169189453125
53,3,1,0,2,-2,-100.0
53,3,2,3,4,-1,-25.0
53,3,3,2,8,-6,-75.0
53,3,4,9,16,-7,-43.75
53,3,5,4,32,-28,-87.5
53,3,6,9,64,-55,-85.9375
53,3,7,321,128,193,150.78125
53,3,8,240,256,-16,-6.25
53,3,9,2796,512,2284,446.09375
53,3,10,350,1024,-674,-65.8203125
53,3,11,2154,2048,106,5.17578125
53,3,12,3583,4096,-513,-12.5244140625
53,3,13,369,8192,-7823,-95.49560546875
53,3,14,839,16384,-15545,-94.879150390625
53,3,15,4286,32768,-28482,-86.920166015625
53,4,1,0,2,-2,-100.0
53,4,2,1,4,-3,-75.0
53,4,3,6,8,-2,-25.0
53,4,4,5,16,-11,-68.75
53,4,5,23,32,-9,-28.125
53,4,6,86,64,22,34.375
53,4,7,51,128,-77,-60.15625
53,4,8,18,256,-238,-92.96875
53,4,9,8,512,-504,-98.4375
53,4,10,119,1024,-905,-88.37890625
53,4,11,2656,2048,608,29.6875
53,4,12,5531,4096,1435,35.0341796875
53,4,13,401,8192,-7791,-95.10498046875
53,4,14,37627,16384,21243,129.656982421875
53,4,15,5374,32768,-27394,-83.599853515625
53,5,1,0,2,-2,-100.0
53,5,2,1,4,-3,-75.0
53,5,3,3,8,-5,-62.5
53,5,4,28,16,12,75.0
53,5,5,5,32,-27,-84.375
53,5,6,124,64,60,93.75
53,5,7,131,128,3,2.34375
53,5,8,427,256,171,66.796875
53,5,9,378,512,-134,-26.171875
53,5,10,1457,1024,433,42.28515625
53,5,11,3642,2048,1594,77.83203125
53,5,12,5939,4096,1843,44.9951171875
53,5,13,38016,8192,29824,364.0625
53,5,14,21163,16384,4779,29.168701171875
53,5,15,78855,32768,46087,140.6463623046875
53,6,1,0,2,-2,-100.0
53,6,2,1,4,-3,-75.0
53,6,3,3,8,-5,-62.5
53,6,4,27,16,11,68.75
53,6,5,9,32,-23,-71.875
53,6,6,20,64,-44,-68.75
53,6,7,57,128,-71,-55.46875
53,6,8,101,256,-155,-60.546875
53,6,9,102,512,-410,-80.078125
53,6,10,1628,1024,604,58.984375
53,6,11,1682,2048,-366,-17.87109375
53,6,12,2984,4096,-1112,-27.1484375
53,6,13,430,8192,-7762,-94.7509765625
53,6,14,342,16384,-16042,-97.91259765625
53,6,15,29487,32768,-3281,-10.0128173828125
53,7,1,0,2,-2,-100.0
53,7,2,1,4,-3,-75.0
53,7,3,12,8,4,50.0
53,7,4,60,16,44,275.0
53,7,5,22,32,-10,-31.25
53,7,6,102,64,38,59.375
53,7,7,68,128,-60,-46.875
53,7,8,471,256,215,83.984375
53,7,9,3343,512,2831,552.9296875
53,7,10,97,1024,-927,-90.52734375
53,7,11,19938,2048,17890,873.53515625
53,7,12,317,4096,-3779,-92.2607421875
53,7,13,2611,8192,-5581,-68.12744140625
53,7,14,2628,16384,-13756,-83.9599609375
53,7,15,12583,32768,-20185,-61.5997314453125
53,8,1,0,2,-2,-100.0
53,8,2,2,4,-2,-50.0
53,8,3,4,8,-4,-50.0
53,8,4,41,16,25,156.25
53,8,5,25,32,-7,-21.875
53,8,6,42,64,-22,-34.375
53,8,7,230,128,102,79.6875
53,8,8,308,256,52,20.3125
53,8,9,366,512,-146,-28.515625
53,8,10,140,1024,-884,-86.328125
53,8,11,2470,2048,422,20.60546875
53,8,12,8319,4096,4223,103.1005859375
53,8,13,18297,8192,10105,123.35205078125
53,8,14,56614,16384,40230,245.54443359375
53,8,15,95447,32768,62679,191.2811279296875
53,9,1,0,2,-2,-100.0
53,9,2,2,4,-2,-50.0
53,9,3,6,8,-2,-25.0
53,9,4,6,16,-10,-62.5
53,9,5,68,32,36,112.5
53,9,6,68,64,4,6.25
53,9,7,43,128,-85,-66.40625
53,9,8,105,256,-151,-58.984375
53,9,9,1088,512,576,112.5
53,9,10,2779,1024,1755,171.38671875
53,9,11,765,2048,-1283,-62.646484375
53,9,12,14107,4096,10011,244.4091796875
53,9,13,1509,8192,-6683,-81.57958984375
53,9,14,3251,16384,-13133,-80.157470703125
53,9,15,9238,32768,-23530,-71.807861328125
53,10,1,0,2,-2,-100.0
53,10,2,1,4,-3,-75.0
53,10,3,6,8,-2,-25.0
53,10,4,4,16,-12,-75.0
53,10,5,56,32,24,75.0
53,10,6,71,64,7,10.9375
53,10,7,172,128,44,34.375
53,10,8,1175,256,919,358.984375
53,10,9,844,512,332,64.84375
53,10,10,131,1024,-893,-87.20703125
53,10,11,1464,2048,-584,-28.515625
53,10,12,2633,4096,-1463,-35.7177734375
53,10,13,33386,8192,25194,307.5439453125
53,10,14,8964,16384,-7420,-45.2880859375
53,10,15,26068,32768,-6700,-20.44677734375
53,11,1,0,2,-2,-100.0
53,11,2,1,4,-3,-75.0
53,11,3,28,8,20,250.0
53,11,4,3,16,-13,-81.25
53,11,5,9,32,-23,-71.875
53,11,6,54,64,-10,-15.625
53,11,7,138,128,10,7.8125
53,11,8,702,256,446,174.21875
53,11,9,146,512,-366,-71.484375
53,11,10,58,1024,-966,-94.3359375
53,11,11,3586,2048,1538,75.09765625
53,11,12,4075,4096,-21,-0.5126953125
53,11,13,11432,8192,3240,39.55078125
53,11,14,21127,16384,4743,28.948974609375
53,11,15,39868,32768,7100,21.66748046875
53,12,1,0,2,-2,-100.0
53,12,2,1,4,-3,-75.0
53,12,3,2,8,-6,-75.0
53,12,4,16,16,0,0.0
53,12,5,81,32,49,153.125
53,12,6,37,64,-27,-42.1875
53,12,7,346,128,218,170.3125
53,12,8,78,256,-178,-69.53125
53,12,9,2441,512,1929,376.7578125
53,12,10,1368,1024,344,33.59375
53,12,11,1624,2048,-424,-20.703125
53,12,12,4923,4096,827,20.1904296875
53,12,13,2810,8192,-5382,-65.6982421875
53,12,14,56710,16384,40326,246.13037109375
53,12,15,9726,32768,-23042,-70.318603515625
53,13,1,0,2,-2,-100.0
53,13,2,2,4,-2,-50.0
53,13,3,2,8,-6,-75.0
53,13,4,39,16,23,143.75
53,13,5,21,32,-11,-34.375
53,13,6,382,64,318,496.875
53,13,7,358,128,230,179.6875
53,13,8,40,256,-216,-84.375
53,13,9,377,512,-135,-26.3671875
53,13,10,307,1024,-717,-70.01953125
53,13,11,1571,2048,-477,-23.291015625
53,13,12,457,4096,-3639,-88.8427734375
53,13,13,17510,8192,9318,113.7451171875
53,13,14,16107,16384,-277,-1.690673828125
53,13,15,9676,32768,-23092,-70.47119140625
53,14,1,0,2,-2,-100.0
53,14,2,1,4,-3,-75.0
53,14,3,4,8,-4,-50.0
53,14,4,14,16,-2,-12.5
53,14,5,12,32,-20,-62.5
53,14,6,48,64,-16,-25.0
53,14,7,57,128,-71,-55.46875
53,14,8,641,256,385,150.390625
53,14,9,77,512,-435,-84.9609375
53,14,10,647,1024,-377,-36.81640625
53,14,11,366,2048,-1682,-82.12890625
53,14,12,5562,4096,1466,35.791015625
53,14,13,1744,8192,-6448,-78.7109375
53,14,14,20736,16384,4352,26.5625
53,14,15,5104,32768,-27664,-84.423828125
53,15,1,0,2,-2,-100.0
53,15,2,1,4,-3,-75.0
53,15,3,2,8,-6,-75.0
53,15,4,23,16,7,43.75
53,15,5,9,32,-23,-71.875
53,15,6,45,64,-19,-29.6875
53,15,7,54,128,-74,-57.8125
53,15,8,344,256,88,34.375
53,15,9,318,512,-194,-37.890625
53,15,10,1389,1024,365,35.64453125
53,15,11,6628,2048,4580,223.6328125
53,15,12,5285,4096,1189,29.0283203125
53,15,13,4728,8192,-3464,-42.28515625
53,15,14,4466,16384,-11918,-72.74169921875
53,15,15,42836,32768,10068,30.72509765625
53,16,1,0,2,-2,-100.0
53,16,2,1,4,-3,-75.0
53,16,3,2,8,-6,-75.0
53,16,4,3,16,-13,-81.25
53,16,5,26,32,-6,-18.75
53,16,6,115,64,51,79.6875
53,16,7,567,128,439,342.96875
53,16,8,338,256,82,32.03125
53,16,9,193,512,-319,-62.3046875
53,16,10,1559,1024,535,52.24609375
53,16,11,3130,2048,1082,52.83203125
53,16,12,936,4096,-3160,-77.1484375
53,16,13,8823,8192,631,7.70263671875
53,16,14,27793,16384,11409,69.635009765625
53,16,15,85025,32768,52257,159.4757080078125
53,17,1,0,2,-2,-100.0
53,17,2,1,4,-3,-75.0
53,17,3,6,8,-2,-25.0
53,17,4,9,16,-7,-43.75
53,17,5,20,32,-12,-37.5
53,17,6,123,64,59,92.1875
53,17,7,39,128,-89,-69.53125
53,17,8,461,256,205,80.078125
53,17,9,452,512,-60,-11.71875
53,17,10,445,1024,-579,-56.54296875
53,17,11,1031,2048,-1017,-49.658203125
53,17,12,2942,4096,-1154,-28.173828125
53,17,13,548,8192,-7644,-93.310546875
53,17,14,348,16384,-16036,-97.8759765625
53,17,15,1701,32768,-31067,-94.8089599609375
53,18,1,0,2,-2,-100.0
53,18,2,1,4,-3,-75.0
53,18,3,9,8,1,12.5
53,18,4,9,16,-7,-43.75
53,18,5,10,32,-22,-68.75
53,18,6,34,64,-30,-46.875
53,18,7,211,128,83,64.84375
53,18,8,1088,256,832,325.0
53,18,9,171,512,-341,-66.6015625
53,18,10,174,1024,-850,-83.0078125
53,18,11,3108,2048,1060,51.7578125
53,18,12,3094,4096,-1002,-24.462890625
53,18,13,2680,8192,-5512,-67.28515625
53,18,14,5628,16384,-10756,-65.6494140625
53,18,15,1811,32768,-30957,-94.4732666015625
53,19,1,0,2,-2,-100.0
53,19,2,3,4,-1,-25.0
53,19,3,5,8,-3,-37.5
53,19,4,23,16,7,43.75
53,19,5,70,32,38,118.75
53,19,6,41,64,-23,-35.9375
53,19,7,255,128,127,99.21875
53,19,8,284,256,28,10.9375
53,19,9,171,512,-341,-66.6015625
53,19,10,1084,1024,60,5.859375
53,19,11,87,2048,-1961,-95.751953125
53,19,12,671,4096,-3425,-83.6181640625
53,19,13,4313,8192,-3879,-47.35107421875
53,19,14,14200,16384,-2184,-13.330078125
53,19,15,14292,32768,-18476,-56.38427734375
53,20,1,0,2,-2,-100.0
53,20,2,1,4,-3,-75.0
53,20,3,3,8,-5,-62.5
53,20,4,6,16,-10,-62.5
53,20,5,70,32,38,118.75
53,20,6,84,64,20,31.25
53,20,7,192,128,64,50.0
53,20,8,147,256,-109,-42.578125
53,20,9,667,512,155,30.2734375
53,20,10,2412,1024,1388,135.546875
53,20,11,279,2048,-1769,-86.376953125
53,20,12,18955,4096,14859,362.7685546875
53,20,13,16500,8192,8308,101.416015625
53,20,14,39957,16384,23573,143.878173828125
53,20,15,39710,32768,6942,21.185302734375
53,21,1,0,2,-2,-100.0
53,21,2,2,4,-2,-50.0
53,21,3,6,8,-2,-25.0
53,21,4,4,16,-12,-75.0
53,21,5,81,32,49,153.125
53,21,6,18,64,-46,-71.875
53,21,7,60,128,-68,-53.125
53,21,8,38,256,-218,-85.15625
53,21,9,141,512,-371,-72.4609375
53,21,10,1114,1024,90,8.7890625
53,21,11,8010,2048,5962,291.11328125
53,21,12,3254,4096,-842,-20.556640625
53,21,13,17322,8192,9130,111.4501953125
53,21,14,17244,16384,860,5.2490234375
53,21,15,23797,32768,-8971,-27.3773193359375
53,22,1,0,2,-2,-100.0
53,22,2,1,4,-3,-75.0
53,22,3,2,8,-6,-75.0
53,22,4,15,16,-1,-6.25
53,22,5,26,32,-6,-18.75
53,22,6,180,64,116,181.25
53,22,7,70,128,-58,-45.3125
53,22,8,280,256,24,9.375
53,22,9,240,512,-272,-53.125
53,22,10,864,1024,-160,-15.625
53,22,11,700,2048,-1348,-65.8203125
53,22,12,683,4096,-3413,-83.3251953125
53,22,13,287,8192,-7905,-96.49658203125
53,22,14,830,16384,-15554,-94.93408203125
53,22,15,51395,32768,18627,56.8450927734375
53,23,1,0,2,-2,-100.0
53,23,2,6,4,2,50.0
53,23,3,7,8,-1,-12.5
53,23,4,14,16,-2,-12.5
53,23,5,20,32,-12,-37.5
53,23,6,60,64,-4,-6.25
53,23,7,132,128,4,3.125
53,23,8,10,256,-246,-96.09375
53,23,9,321,512,-191,-37.3046875
53,23,10,1238,1024,214,20.8984375
53,23,11,1787,2048,-261,-12.744140625
53,23,12,3404,4096,-692,-16.89453125
53,23,13,16454,8192,8262,100.8544921875
53,23,14,649,16384,-15735,-96.038818359375
53,23,15,17279,32768,-15489,-47.2686767578125
53,24,1,0,2,-2,-100.0
53,24,2,6,4,2,50.0
53,24,3,2,8,-6,-75.0
53,24,4,13,16,-3,-18.75
53,24,5,39,32,7,21.875
53,24,6,58,64,-6,-9.375
53,24,7,203,128,75,58.59375
53,24,8,32,256,-224,-87.5
53,24,9,326,512,-186,-36.328125
53,24,10,771,1024,-253,-24.70703125
53,24,11,174,2048,-1874,-91.50390625
53,24,12,4072,4096,-24,-0.5859375
53,24,13,12464,8192,4272,52.1484375
53,24,14,899,16384,-15485,-94.512939453125
53,24,15,53968,32768,21200,64.697265625
53,25,1,0,2,-2,-100.0
53,25,2,5,4,1,25.0
53,25,3,2,8,-6,-75.0
53,25,4,3,16,-13,-81.25
53,25,5,13,32,-19,-59.375
53,25,6,163,64,99,154.6875
53,25,7,157,128,29,22.65625
53,25,8,52,256,-204,-79.6875
53,25,9,408,512,-104,-20.3125
53,25,10,62,1024,-962,-93.9453125
53,25,11,1946,2048,-102,-4.98046875
53,25,12,2166,4096,-1930,-47.119140625
53,25,13,1273,8192,-6919,-84.46044921875
53,25,14,2948,16384,-13436,-82.0068359375
53,25,15,15276,32768,-17492,-53.38134765625
53,26,1,0,2,-2,-100.0
53,26,2,1,4,-3,-75.0
53,26,3,6,8,-2,-25.0
53,26,4,12,16,-4,-25.0
53,26,5,82,32,50,156.25
53,26,6,12,64,-52,-81.25
53,26,7,67,128,-61,-47.65625
53,26,8,295,256,39,15.234375
53,26,9,762,512,250,48.828125
53,26,10,2419,1024,1395,136.23046875
53,26,11,1796,2048,-252,-12.3046875
53,26,12,21143,4096,17047,416.1865234375
53,26,13,10019,8192,1827,22.30224609375
53,26,14,17833,16384,1449,8.843994140625
53,26,15,42176,32768,9408,28.7109375
53,27,1,0,2,-2,-100.0
53,27,2,1,4,-3,-75.0
53,27,3,12,8,4,50.0
53,27,4,3,16,-13,-81.25
53,27,5,14,32,-18,-56.25
53,27,6,18,64,-46,-71.875
53,27,7,93,128,-35,-27.34375
53,27,8,308,256,52,20.3125
53,27,9,255,512,-257,-50.1953125
53,27,10,363,1024,-661,-64.55078125
53,27,11,310,2048,-1738,-84.86328125
53,27,12,126,4096,-3970,-96.923828125
53,27,13,3566,8192,-4626,-56.4697265625
53,27,14,24803,16384,8419,51.385498046875
53,27,15,17345,32768,-15423,-47.0672607421875
53,28,1,0,2,-2,-100.0
53,28,2,4,4,0,0.0
53,28,3,4,8,-4,-50.0
53,28,4,7,16,-9,-56.25
53,28,5,20,32,-12,-37.5
53,28,6,49,64,-15,-23.4375
53,28,7,77,128,-51,-39.84375
53,28,8,219,256,-37,-14.453125
53,28,9,21,512,-491,-95.8984375
53,28,10,537,1024,-487,-47.55859375
53,28,11,469,2048,-1579,-77.099609375
53,28,12,1588,4096,-2508,-61.23046875
53,28,13,8177,8192,-15,-0.18310546875
53,28,14,35891,16384,19507,119.061279296875
53,28,15,10504,32768,-22264,-67.9443359375
53,29,1,0,2,-2,-100.0
53,29,2,4,4,0,0.0
53,29,3,15,8,7,87.5
53,29,4,53,16,37,231.25
53,29,5,9,32,-23,-71.875
53,29,6,15,64,-49,-76.5625
53,29,7,183,128,55,42.96875
53,29,8,86,256,-170,-66.40625
53,29,9,468,512,-44,-8.59375
53,29,10,3531,1024,2507,244.82421875
53,29,11,6766,2048,4718,230.37109375
53,29,12,1121,4096,-2975,-72.6318359375
53,29,13,1991,8192,-6201,-75.69580078125
53,29,14,51001,16384,34617,211.285400390625
53,29,15,18442,32768,-14326,-43.719482421875
53,30,1,0,2,-2,-100.0
53,30,2,1,4,-3,-75.0
53,30,3,9,8,1,12.5
53,30,4,28,16,12,75.0
53,30,5,16,32,-16,-50.0
53,30,6,89,64,25,39.0625
53,30,7,318,128,190,148.4375
53,30,8,478,256,222,86.71875
53,30,9,975,512,463,90.4296875
53,30,10,80,1024,-944,-92.1875
53,30,11,989,2048,-1059,-51.708984375
53,30,12,2413,4096,-1683,-41.0888671875
53,30,13,1092,8192,-7100,-86.669921875
53,30,14,33424,16384,17040,104.00390625
53,30,15,63640,32768,30872,94.2138671875
53,31,1,0,2,-2,-100.0
53,31,2,2,4,-2,-50.0
53,31,3,15,8,7,87.5
53,31,4,22,16,6,37.5
53,31,5,21,32,-11,-34.375
53,31,6,138,64,74,115.625
53,31,7,93,128,-35,-27.34375
53,31,8,437,256,181,70.703125
53,31,9,167,512,-345,-67.3828125
53,31,10,260,1024,-764,-74.609375
53,31,11,1081,2048,-967,-47.216796875
53,31,12,3306,4096,-790,-19.287109375
53,31,13,6884,8192,-1308,-15.966796875
53,31,14,29212,16384,12828,78.2958984375
53,31,15,23220,32768,-9548,-29.13818359375
53,32,1,0,2,-2,-100.0
53,32,2,1,4,-3,-75.0
53,32,3,11,8,3,37.5
53,32,4,3,16,-13,-81.25
53,32,5,63,32,31,96.875
53,32,6,77,64,13,20.3125
53,32,7,99,128,-29,-22.65625
53,32,8,238,256,-18,-7.03125
53,32,9,178,512,-334,-65.234375
53,32,10,3830,1024,2806,274.0234375
53,32,11,2005,2048,-43,-2.099609375
53,32,12,2692,4096,-1404,-34.27734375
53,32,13,1175,8192,-7017,-85.65673828125
53,32,14,10478,16384,-5906,-36.04736328125
53,32,15,105573,32768,72805,222.1832275390625
53,33,1,0,2,-2,-100.0
53,33,2,1,4,-3,-75.0
53,33,3,2,8,-6,-75.0
53,33,4,14,16,-2,-12.5
53,33,5,9,32,-23,-71.875
53,33,6,42,64,-22,-34.375
53,33,7,207,128,79,61.71875
53,33,8,312,256,56,21.875
53,33,9,1472,512,960,187.5
53,33,10,1033,1024,9,0.87890625
53,33,11,21,2048,-2027,-98.974609375
53,33,12,6516,4096,2420,59.08203125
53,33,13,11424,8192,3232,39.453125
53,33,14,24028,16384,7644,46.6552734375
53,33,15,33543,32768,775,2.3651123046875
53,34,1,0,2,-2,-100.0
53,34,2,1,4,-3,-75.0
53,34,3,2,8,-6,-75.0
53,34,4,42,16,26,162.5
53,34,5,26,32,-6,-18.75
53,34,6,5,64,-59,-92.1875
53,34,7,84,128,-44,-34.375
53,34,8,260,256,4,1.5625
53,34,9,452,512,-60,-11.71875
53,34,10,949,1024,-75,-7.32421875
53,34,11,1112,2048,-936,-45.703125
53,34,12,10278,4096,6182,150.927734375
53,34,13,7995,8192,-197,-2.40478515625
53,34,14,18342,16384,1958,11.95068359375
53,34,15,1750,32768,-31018,-94.659423828125
53,35,1,0,2,-2,-100.0
53,35,2,2,4,-2,-50.0
53,35,3,9,8,1,12.5
53,35,4,45,16,29,181.25
53,35,5,36,32,4,12.5
53,35,6,22,64,-42,-65.625
53,35,7,15,128,-113,-88.28125
53,35,8,123,256,-133,-51.953125
53,35,9,37,512,-475,-92.7734375
53,35,10,539,1024,-485,-47.36328125
53,35,11,1680,2048,-368,-17.96875
53,35,12,6336,4096,2240,54.6875
53,35,13,3495,8192,-4697,-57.33642578125
53,35,14,3003,16384,-13381,-81.671142578125
53,35,15,2141,32768,-30627,-93.4661865234375
53,36,1,0,2,-2,-100.0
53,36,2,3,4,-1,-25.0
53,36,3,7,8,-1,-12.5
53,36,4,15,16,-1,-6.25
53,36,5,8,32,-24,-75.0
53,36,6,52,64,-12,-18.75
53,36,7,81,128,-47,-36.71875
53,36,8,855,256,599,233.984375
53,36,9,20,512,-492,-96.09375
53,36,10,89,1024,-935,-91.30859375
53,36,11,5001,2048,2953,144.189453125
53,36,12,997,4096,-3099,-75.6591796875
53,36,13,38184,8192,29992,366.11328125
53,36,14,3905,16384,-12479,-76.165771484375
53,36,15,3999,32768,-28769,-87.7960205078125
53,37,1,0,2,-2,-100.0
53,37,2,1,4,-3,-75.0
53,37,3,16,8,8,100.0
53,37,4,3,16,-13,-81.25
53,37,5,93,32,61,190.625
53,37,6,50,64,-14,-21.875
53,37,7,758,128,630,492.1875
53,37,8,113,256,-143,-55.859375
53,37,9,574,512,62,12.109375
53,37,10,1828,1024,804,78.515625
53,37,11,3711,2048,1663,81.201171875
53,37,12,249,4096,-3847,-93.9208984375
53,37,13,2191,8192,-6001,-73.25439453125
53,37,14,10045,16384,-6339,-38.690185546875
53,37,15,49745,32768,16977,51.8096923828125
53,38,1,0,2,-2,-100.0
53,38,2,6,4,2,50.0
53,38,3,3,8,-5,-62.5
53,38,4,20,16,4,25.0
53,38,5,48,32,16,50.0
53,38,6,85,64,21,32.8125
53,38,7,223,128,95,74.21875
53,38,8,283,256,27,10.546875
53,38,9,146,512,-366,-71.484375
53,38,10,1106,1024,82,8.0078125
53,38,11,3354,2048,1306,63.76953125
53,38,12,1423,4096,-2673,-65.2587890625
53,38,13,7769,8192,-423,-5.16357421875
53,38,14,748,16384,-15636,-95.4345703125
53,38,15,59847,32768,27079,82.6385498046875
53,39,1,0,2,-2,-100.0
53,39,2,1,4,-3,-75.0
53,39,3,2,8,-6,-75.0
53,39,4,20,16,4,25.0
53,39,5,7,32,-25,-78.125
53,39,6,73,64,9,14.0625
53,39,7,184,128,56,43.75
53,39,8,174,256,-82,-32.03125
53,39,9,14,512,-498,-97.265625
53,39,10,3375,1024,2351,229.58984375
53,39,11,3696,2048,1648,80.46875
53,39,12,400,4096,-3696,-90.234375
53,39,13,2306,8192,-5886,-71.8505859375
53,39,14,6318,16384,-10066,-61.43798828125
53,39,15,1588,32768,-31180,-95.15380859375
53,40,1,0,2,-2,-100.0
53,40,2,1,4,-3,-75.0
53,40,3,2,8,-6,-75.0
53,40,4,10,16,-6,-37.5
53,40,5,44,32,12,37.5
53,40,6,34,64,-30,-46.875
53,40,7,53,128,-75,-58.59375
53,40,8,20,256,-236,-92.1875
53,40,9,509,512,-3,-0.5859375
53,40,10,418,1024,-606,-59.1796875
53,40,11,1105,2048,-943,-46.044921875
53,40,12,1272,4096,-2824,-68.9453125
53,40,13,11058,8192,2866,34.9853515625
53,40,14,40983,16384,24599,150.140380859375
53,40,15,40643,32768,7875,24.0325927734375
53,41,1,0,2,-2,-100.0
53,41,2,4,4,0,0.0
53,41,3,4,8,-4,-50.0
53,41,4,14,16,-2,-12.5
53,41,5,24,32,-8,-25.0
53,41,6,5,64,-59,-92.1875
53,41,7,168,128,40,31.25
53,41,8,404,256,148,57.8125
53,41,9,1078,512,566,110.546875
53,41,10,999,1024,-25,-2.44140625
53,41,11,105,2048,-1943,-94.873046875
53,41,12,396,4096,-3700,-90.33203125
53,41,13,996,8192,-7196,-87.841796875
53,41,14,32944,16384,16560,101.07421875
53,41,15,12779,32768,-19989,-61.0015869140625
53,42,1,0,2,-2,-100.0
53,42,2,4,4,0,0.0
53,42,3,4,8,-4,-50.0
53,42,4,12,16,-4,-25.0
53,42,5,25,32,-7,-21.875
53,42,6,101,64,37,57.8125
53,42,7,88,128,-40,-31.25
53,42,8,930,256,674,263.28125
53,42,9,2629,512,2117,413.4765625
53,42,10,859,1024,-165,-16.11328125
53,42,11,1115,2048,-933,-45.556640625
53,42,12,531,4096,-3565,-87.0361328125
53,42,13,7259,8192,-933,-11.38916015625
53,42,14,20000,16384,3616,22.0703125
53,42,15,65726,32768,32958,100.579833984375
53,43,1,0,2,-2,-100.0
53,43,2,1,4,-3,-75.0
53,43,3,11,8,3,37.5
53,43,4,30,16,14,87.5
53,43,5,8,32,-24,-75.0
53,43,6,19,64,-45,-70.3125
53,43,7,244,128,116,90.625
53,43,8,114,256,-142,-55.46875
53,43,9,339,512,-173,-33.7890625
53,43,10,282,1024,-742,-72.4609375
53,43,11,1360,2048,-688,-33.59375
53,43,12,3830,4096,-266,-6.494140625
53,43,13,25807,8192,17615,215.02685546875
53,43,14,4327,16384,-12057,-73.590087890625
53,43,15,9873,32768,-22895,-69.8699951171875
53,44,1,0,2,-2,-100.0
53,44,2,3,4,-1,-25.0
53,44,3,4,8,-4,-50.0
53,44,4,6,16,-10,-62.5
53,44,5,43,32,11,34.375
53,44,6,15,64,-49,-76.5625
53,44,7,122,128,-6,-4.6875
53,44,8,152,256,-104,-40.625
53,44,9,27,512,-485,-94.7265625
53,44,10,325,1024,-699,-68.26171875
53,44,11,958,2048,-1090,-53.22265625
53,44,12,7431,4096,3335,81.4208984375
53,44,13,4216,8192,-3976,-48.53515625
53,44,14,13525,16384,-2859,-17.449951171875
53,44,15,62714,32768,29946,91.387939453125
53,45,1,0,2,-2,-100.0
53,45,2,2,4,-2,-50.0
53,45,3,9,8,1,12.5
53,45,4,5,16,-11,-68.75
53,45,5,60,32,28,87.5
53,45,6,161,64,97,151.5625
53,45,7,23,128,-105,-82.03125
53,45,8,220,256,-36,-14.0625
53,45,9,200,512,-312,-60.9375
53,45,10,98,1024,-926,-90.4296875
53,45,11,1405,2048,-643,-31.396484375
53,45,12,6391,4096,2295,56.0302734375
53,45,13,24530,8192,16338,199.4384765625
53,45,14,22361,16384,5977,36.480712890625
53,45,15,16029,32768,-16739,-51.0833740234375
53,46,1,0,2,-2,-100.0
53,46,2,2,4,-2,-50.0
53,46,3,2,8,-6,-75.0
53,46,4,6,16,-10,-62.5
53,46,5,70,32,38,118.75
53,46,6,5,64,-59,-92.1875
53,46,7,155,128,27,21.09375
53,46,8,32,256,-224,-87.5
53,46,9,189,512,-323,-63.0859375
53,46,10,738,1024,-286,-27.9296875
53,46,11,3070,2048,1022,49.90234375
53,46,12,13815,4096,9719,237.2802734375
53,46,13,24230,8192,16038,195.7763671875
53,46,14,71604,16384,55220,337.0361328125
53,46,15,29538,32768,-3230,-9.857177734375
53,47,1,0,2,-2,-100.0
53,47,2,1,4,-3,-75.0
53,47,3,2,8,-6,-75.0
53,47,4,6,16,-10,-62.5
53,47,5,34,32,2,6.25
53,47,6,54,64,-10,-15.625
53,47,7,26,128,-102,-79.6875
53,47,8,683,256,427,166.796875
53,47,9,1179,512,667,130.2734375
53,47,10,2625,1024,1601,156.34765625
53,47,11,1597,2048,-451,-22.021484375
53,47,12,1895,4096,-2201,-53.7353515625
53,47,13,10133,8192,1941,23.69384765625
53,47,14,13706,16384,-2678,-16.34521484375
53,47,15,90768,32768,58000,177.001953125
53,48,1,0,2,-2,-100.0
53,48,2,1,4,-3,-75.0
53,48,3,8,8,0,0.0
53,48,4,5,16,-11,-68.75
53,48,5,6,32,-26,-81.25
53,48,6,34,64,-30,-46.875
53,48,7,63,128,-65,-50.78125
53,48,8,345,256,89,34.765625
53,48,9,399,512,-113,-22.0703125
53,48,10,824,1024,-200,-19.53125
53,48,11,1698,2048,-350,-17.08984375
53,48,12,8310,4096,4214,102.880859375
53,48,13,11149,8192,2957,36.09619140625
53,48,14,48056,16384,31672,193.310546875
53,48,15,29193,32768,-3575,-10.9100341796875
53,49,1,0,2,-2,-100.0
53,49,2,1,4,-3,-75.0
53,49,3,5,8,-3,-37.5
53,49,4,23,16,7,43.75
53,49,5,4,32,-28,-87.5
53,49,6,10,64,-54,-84.375
53,49,7,61,128,-67,-52.34375
53,49,8,380,256,124,48.4375
53,49,9,335,512,-177,-34.5703125
53,49,10,327,1024,-697,-68.06640625
53,49,11,1097,2048,-951,-46.435546875
53,49,12,969,4096,-3127,-76.3427734375
53,49,13,621,8192,-7571,-92.41943359375
53,49,14,4421,16384,-11963,-73.016357421875
53,49,15,16139,32768,-16629,-50.7476806640625
53,50,1,0,2,-2,-100.0
53,50,2,2,4,-2,-50.0
53,50,3,11,8,3,37.5
53,50,4,11,16,-5,-31.25
53,50,5,4,32,-28,-87.5
53,50,6,72,64,8,12.5
53,50,7,166,128,38,29.6875
53,50,8,853,256,597,233.203125
53,50,9,44,512,-468,-91.40625
53,50,10,889,1024,-135,-13.18359375
53,50,11,9773,2048,7725,377.197265625
53,50,12,1250,4096,-2846,-69.482421875
53,50,13,19921,8192,11729,143.17626953125
53,50,14,69894,16384,53510,326.59912109375
53,50,15,11393,32768,-21375,-65.2313232421875
53,51,1,0,2,-2,-100.0
53,51,2,1,4,-3,-75.0
53,51,3,5,8,-3,-37.5
53,51,4,4,16,-12,-75.0
53,51,5,79,32,47,146.875
53,51,6,98,64,34,53.125
53,51,7,57,128,-71,-55.46875
53,51,8,714,256,458,178.90625
53,51,9,209,512,-303,-59.1796875
53,51,10,385,1024,-639,-62.40234375
53,51,11,6015,2048,3967,193.701171875
53,51,12,3499,4096,-597,-14.5751953125
53,51,13,6083,8192,-2109,-25.74462890625
53,51,14,4788,16384,-11596,-70.7763671875
53,51,15,28696,32768,-4072,-12.4267578125
53,52,1,0,2,-2,-100.0
53,52,2,2,4,-2,-50.0
53,52,3,2,8,-6,-75.0
53,52,4,43,16,27,168.75
53,52,5,35,32,3,9.375
53,52,6,17,64,-47,-73.4375
53,52,7,15,128,-113,-88.28125
53,52,8,422,256,166,64.84375
53,52,9,747,512,235,45.8984375
53,52,10,3890,1024,2866,279.8828125
53,52,11,136,2048,-1912,-93.359375
53,52,12,17724,4096,13628,332.71484375
53,52,13,3697,8192,-4495,-54.87060546875
53,52,14,4288,16384,-12096,-73.828125
53,52,15,13834,32768,-18934,-57.781982421875
53,53,1,0,2,-2,-100.0
53,53,2,3,4,-1,-25.0
53,53,3,5,8,-3,-37.5
53,53,4,22,16,6,37.5
53,53,5,10,32,-22,-68.75
53,53,6,41,64,-23,-35.9375
53,53,7,249,128,121,94.53125
53,53,8,108,256,-148,-57.8125
53,53,9,653,512,141,27.5390625
53,53,10,271,1024,-753,-73.53515625
53,53,11,1778,2048,-270,-13.18359375
53,53,12,7617,4096,3521,85.9619140625
53,53,13,4379,8192,-3813,-46.54541015625
53,53,14,54728,16384,38344,234.033203125
53,53,15,8895,32768,-23873,-72.8546142578125
54,1,1,0,2,-2,-100.0
54,1,2,4,4,0,0.0
54,1,3,8,8,0,0.0
54,1,4,35,16,19,118.75
54,1,5,80,32,48,150.0
54,1,6,13,64,-51,-79.6875
54,1,7,74,128,-54,-42.1875
54,1,8,17,256,-239,-93.359375
54,1,9,957,512,445,86.9140625
54,1,10,1604,1024,580,56.640625
54,1,11,117,2048,-1931,-94.287109375
54,1,12,365,4096,-3731,-91.0888671875
54,1,13,927,8192,-7265,-88.68408203125
54,1,14,334,16384,-16050,-97.96142578125
54,1,15,26014,32768,-6754,-20.611572265625
54,2,1,0,2,-2,-100.0
54,2,2,1,4,-3,-75.0
54,2,3,14,8,6,75.0
54,2,4,8,16,-8,-50.0
54,2,5,92,32,60,187.5
54,2,6,24,64,-40,-62.5
54,2,7,63,128,-65,-50.78125
54,2,8,7,256,-249,-97.265625
54,2,9,214,512,-298,-58.203125
54,2,10,31,1024,-993,-96.97265625
54,2,11,5424,2048,3376,164.84375
54,2,12,280,4096,-3816,-93.1640625
54,2,13,6653,8192,-1539,-18.78662109375
54,2,14,9512,16384,-6872,-41.943359375
54,2,15,12709,32768,-20059,-61.2152099609375
54,3,1,0,2,-2,-100.0
54,3,2,1,4,-3,-75.0
54,3,3,2,8,-6,-75.0
54,3,4,5,16,-11,-68.75
54,3,5,5,32,-27,-84.375
54,3,6,66,64,2,3.125
54,3,7,316,128,188,146.875
54,3,8,332,256,76,29.6875
54,3,9,715,512,203,39.6484375
54,3,10,65,1024,-959,-93.65234375
54,3,11,4059,2048,2011,98.193359375
54,3,12,3723,4096,-373,-9.1064453125
54,3,13,14630,8192,6438,78.5888671875
54,3,14,6170,16384,-10214,-62.34130859375
54,3,15,35557,32768,2789,8.5113525390625
54,4,1,0,2,-2,-100.0
54,4,2,2,4,-2,-50.0
54,4,3,10,8,2,25.0
54,4,4,9,16,-7,-43.75
54,4,5,33,32,1,3.125
54,4,6,22,64,-42,-65.625
54,4,7,78,128,-50,-39.0625
54,4,8,396,256,140,54.6875
54,4,9,523,512,11,2.1484375
54,4,10,1364,1024,340,33.203125
54,4,11,1176,2048,-872,-42.578125
54,4,12,2183,4096,-1913,-46.7041015625
54,4,13,920,8192,-7272,-88.76953125
54,4,14,114,16384,-16270,-99.30419921875
54,4,15,31268,32768,-1500,-4.57763671875
54,5,1,0,2,-2,-100.0
54,5,2,6,4,2,50.0
54,5,3,2,8,-6,-75.0
54,5,4,5,16,-11,-68.75
54,5,5,7,32,-25,-78.125
54,5,6,31,64,-33,-51.5625
54,5,7,116,128,-12,-9.375
54,5,8,26,256,-230,-89.84375
54,5,9,17,512,-495,-96.6796875
54,5,10,368,1024,-656,-64.0625
54,5,11,1262,2048,-786,-38.37890625
54,5,12,1859,4096,-2237,-54.6142578125
54,5,13,10997,8192,2805,34.24072265625
54,5,14,23933,16384,7549,46.075439453125
54,5,15,13363,32768,-19405,-59.2193603515625
54,6,1,0,2,-2,-100.0
54,6,2,1,4,-3,-75.0
54,6,3,4,8,-4,-50.0
54,6,4,17,16,1,6.25
54,6,5,18,32,-14,-43.75
54,6,6,37,64,-27,-42.1875
54,6,7,25,128,-103,-80.46875
54,6,8,232,256,-24,-9.375
54,6,9,635,512,123,24.0234375
54,6,10,622,1024,-402,-39.2578125
54,6,11,10600,2048,8552,417.578125
54,6,12,4215,4096,119,2.9052734375
54,6,13,6395,8192,-1797,-21.93603515625
54,6,14,21164,16384,4780,29.1748046875
54,6,15,19506,32768,-13262,-40.472412109375
54,7,1,0,2,-2,-100.0
54,7,2,3,4,-1,-25.0
54,7,3,6,8,-2,-25.0
54,7,4,5,16,-11,-68.75
54,7,5,42,32,10,31.25
54,7,6,14,64,-50,-78.125
54,7,7,28,128,-100,-78.125
54,7,8,120,256,-136,-53.125
54,7,9,122,512,-390,-76.171875
54,7,10,431,1024,-593,-57.91015625
54,7,11,109,2048,-1939,-94.677734375
54,7,12,492,4096,-3604,-87.98828125
54,7,13,2563,8192,-5629,-68.71337890625
54,7,14,48768,16384,32384,197.65625
54,7,15,23401,32768,-9367,-28.5858154296875
54,8,1,0,2,-2,-100.0
54,8,2,1,4,-3,-75.0
54,8,3,5,8,-3,-37.5
54,8,4,29,16,13,81.25
54,8,5,17,32,-15,-46.875
54,8,6,59,64,-5,-7.8125
54,8,7,298,128,170,132.8125
54,8,8,454,256,198,77.34375
54,8,9,296,512,-216,-42.1875
54,8,10,271,1024,-753,-73.53515625
54,8,11,1711,2048,-337,-16.455078125
54,8,12,155,4096,-3941,-96.2158203125
54,8,13,9069,8192,877,10.70556640625
54,8,14,1440,16384,-14944,-91.2109375
54,8,15,55868,32768,23100,70.49560546875
54,9,1,0,2,-2,-100.0
54,9,2,4,4,0,0.0
54,9,3,10,8,2,25.0
54,9,4,6,16,-10,-62.5
54,9,5,70,32,38,118.75
54,9,6,39,64,-25,-39.0625
54,9,7,219,128,91,71.09375
54,9,8,160,256,-96,-37.5
54,9,9,811,512,299,58.3984375
54,9,10,1754,1024,730,71.2890625
54,9,11,750,2048,-1298,-63.37890625
54,9,12,4395,4096,299,7.2998046875
54,9,13,34048,8192,25856,315.625
54,9,14,12591,16384,-3793,-23.150634765625
54,9,15,9637,32768,-23131,-70.5902099609375
54,10,1,0,2,-2,-100.0
54,10,2,3,4,-1,-25.0
54,10,3,6,8,-2,-25.0
54,10,4,9,16,-7,-43.75
54,10,5,82,32,50,156.25
54,10,6,46,64,-18,-28.125
54,10,7,142,128,14,10.9375
54,10,8,185,256,-71,-27.734375
54,10,9,77,512,-435,-84.9609375
54,10,10,712,1024,-312,-30.46875
54,10,11,1643,2048,-405,-19.775390625
54,10,12,1299,4096,-2797,-68.2861328125
54,10,13,2814,8192,-5378,-65.6494140625
54,10,14,2523,16384,-13861,-84.600830078125
54,10,15,3827,32768,-28941,-88.3209228515625
54,11,1,0,2,-2,-100.0
54,11,2,1,4,-3,-75.0
54,11,3,4,8,-4,-50.0
54,11,4,8,16,-8,-50.0
54,11,5,11,32,-21,-65.625
54,11,6,172,64,108,168.75
54,11,7,30,128,-98,-76.5625
54,11,8,463,256,207,80.859375
54,11,9,156,512,-356,-69.53125
54,11,10,1307,1024,283,27.63671875
54,11,11,1765,2048,-283,-13.818359375
54,11,12,9628,4096,5532,135.05859375
54,11,13,12761,8192,4569,55.77392578125
54,11,14,21558,16384,5174,31.57958984375
54,11,15,32208,32768,-560,-1.708984375
54,12,1,0,2,-2,-100.0
54,12,2,1,4,-3,-75.0
54,12,3,10,8,2,25.0
54,12,4,12,16,-4,-25.0
54,12,5,59,32,27,84.375
54,12,6,60,64,-4,-6.25
54,12,7,19,128,-109,-85.15625
54,12,8,528,256,272,106.25
54,12,9,1535,512,1023,199.8046875
54,12,10,2264,1024,1240,121.09375
54,12,11,1079,2048,-969,-47.314453125
54,12,12,2225,4096,-1871,-45.6787109375
54,12,13,484,8192,-7708,-94.091796875
54,12,14,785,16384,-15599,-95.208740234375
54,12,15,50145,32768,17377,53.0303955078125
54,13,1,0,2,-2,-100.0
54,13,2,2,4,-2,-50.0
54,13,3,2,8,-6,-75.0
54,13,4,21,16,5,31.25
54,13,5,29,32,-3,-9.375
54,13,6,10,64,-54,-84.375
54,13,7,61,128,-67,-52.34375
54,13,8,298,256,42,16.40625
54,13,9,177,512,-335,-65.4296875
54,13,10,891,1024,-133,-12.98828125
54,13,11,1207,2048,-841,-41.064453125
54,13,12,3103,4096,-993,-24.2431640625
54,13,13,421,8192,-7771,-94.86083984375
54,13,14,18124,16384,1740,10.6201171875
54,13,15,1568,32768,-31200,-95.21484375
54,14,1,0,2,-2,-100.0
54,14,2,1,4,-3,-75.0
54,14,3,3,8,-5,-62.5
54,14,4,7,16,-9,-56.25
54,14,5,40,32,8,25.0
54,14,6,27,64,-37,-57.8125
54,14,7,26,128,-102,-79.6875
54,14,8,27,256,-229,-89.453125
54,14,9,121,512,-391,-76.3671875
54,14,10,37,1024,-987,-96.38671875
54,14,11,1263,2048,-785,-38.330078125
54,14,12,2855,4096,-1241,-30.2978515625
54,14,13,615,8192,-7577,-92.49267578125
54,14,14,16080,16384,-304,-1.85546875
54,14,15,19270,32768,-13498,-41.192626953125
54,15,1,0,2,-2,-100.0
54,15,2,1,4,-3,-75.0
54,15,3,7,8,-1,-12.5
54,15,4,10,16,-6,-37.5
54,15,5,64,32,32,100.0
54,15,6,56,64,-8,-12.5
54,15,7,20,128,-108,-84.375
54,15,8,243,256,-13,-5.078125
54,15,9,202,512,-310,-60.546875
54,15,10,1305,1024,281,27.44140625
54,15,11,3591,2048,1543,75.341796875
54,15,12,7886,4096,3790,92.529296875
54,15,13,4922,8192,-3270,-39.9169921875
54,15,14,6194,16384,-10190,-62.19482421875
54,15,15,41042,32768,8274,25.250244140625
54,16,1,0,2,-2,-100.0
54,16,2,1,4,-3,-75.0
54,16,3,6,8,-2,-25.0
54,16,4,4,16,-12,-75.0
54,16,5,70,32,38,118.75
54,16,6,71,64,7,10.9375
54,16,7,13,128,-115,-89.84375
54,16,8,89,256,-167,-65.234375
54,16,9,245,512,-267,-52.1484375
54,16,10,422,1024,-602,-58.7890625
54,16,11,1426,2048,-622,-30.37109375
54,16,12,12149,4096,8053,196.6064453125
54,16,13,16021,8192,7829,95.56884765625
54,16,14,17112,16384,728,4.443359375
54,16,15,6432,32768,-26336,-80.37109375
54,17,1,0,2,-2,-100.0
54,17,2,3,4,-1,-25.0
54,17,3,4,8,-4,-50.0
54,17,4,17,16,1,6.25
54,17,5,18,32,-14,-43.75
54,17,6,166,64,102,159.375
54,17,7,197,128,69,53.90625
54,17,8,22,256,-234,-91.40625
54,17,9,969,512,457,89.2578125
54,17,10,1324,1024,300,29.296875
54,17,11,1359,2048,-689,-33.642578125
54,17,12,1429,4096,-2667,-65.1123046875
54,17,13,23886,8192,15694,191.5771484375
54,17,14,1000,16384,-15384,-93.896484375
54,17,15,10126,32768,-22642,-69.097900390625
54,18,1,0,2,-2,-100.0
54,18,2,1,4,-3,-75.0
54,18,3,11,8,3,37.5
54,18,4,4,16,-12,-75.0
54,18,5,17,32,-15,-46.875
54,18,6,24,64,-40,-62.5
54,18,7,101,128,-27,-21.09375
54,18,8,466,256,210,82.03125
54,18,9,128,512,-384,-75.0
54,18,10,1932,1024,908,88.671875
54,18,11,149,2048,-1899,-92.724609375
54,18,12,1766,4096,-2330,-56.884765625
54,18,13,1320,8192,-6872,-83.88671875
54,18,14,1510,16384,-14874,-90.78369140625
54,18,15,15213,32768,-17555,-53.5736083984375
54,19,1,0,2,-2,-100.0
54,19,2,1,4,-3,-75.0
54,19,3,3,8,-5,-62.5
54,19,4,27,16,11,68.75
54,19,5,5,32,-27,-84.375
54,19,6,32,64,-32,-50.0
54,19,7,117,128,-11,-8.59375
54,19,8,37,256,-219,-85.546875
54,19,9,774,512,262,51.171875
54,19,10,142,1024,-882,-86.1328125
54,19,11,8076,2048,6028,294.3359375
54,19,12,6839,4096,2743,66.9677734375
54,19,13,9480,8192,1288,15.72265625
54,19,14,8948,16384,-7436,-45.3857421875
54,19,15,47626,32768,14858,45.343017578125
54,20,1,0,2,-2,-100.0
54,20,2,5,4,1,25.0
54,20,3,4,8,-4,-50.0
54,20,4,10,16,-6,-37.5
54,20,5,19,32,-13,-40.625
54,20,6,7,64,-57,-89.0625
54,20,7,387,128,259,202.34375
54,20,8,408,256,152,59.375
54,20,9,1223,512,711,138.8671875
54,20,10,13,1024,-1011,-98.73046875
54,20,11,2135,2048,87,4.248046875
54,20,12,131,4096,-3965,-96.8017578125
54,20,13,1129,8192,-7063,-86.21826171875
54,20,14,84345,16384,67961,414.801025390625
54,20,15,15955,32768,-16813,-51.3092041015625
54,21,1,0,2,-2,-100.0
54,21,2,2,4,-2,-50.0
54,21,3,4,8,-4,-50.0
54,21,4,20,16,4,25.0
54,21,5,9,32,-23,-71.875
54,21,6,26,64,-38,-59.375
54,21,7,419,128,291,227.34375
54,21,8,398,256,142,55.46875
54,21,9,226,512,-286,-55.859375
54,21,10,156,1024,-868,-84.765625
54,21,11,643,2048,-1405,-68.603515625
54,21,12,8749,4096,4653,113.5986328125
54,21,13,15645,8192,7453,90.97900390625
54,21,14,19964,16384,3580,21.8505859375
54,21,15,9992,32768,-22776,-69.5068359375
54,22,1,0,2,-2,-100.0
54,22,2,1,4,-3,-75.0
54,22,3,8,8,0,0.0
54,22,4,29,16,13,81.25
54,22,5,18,32,-14,-43.75
54,22,6,130,64,66,103.125
54,22,7,135,128,7,5.46875
54,22,8,19,256,-237,-92.578125
54,22,9,731,512,219,42.7734375
54,22,10,419,1024,-605,-59.08203125
54,22,11,5929,2048,3881,189.501953125
54,22,12,4509,4096,413,10.0830078125
54,22,13,3897,8192,-4295,-52.42919921875
54,22,14,28992,16384,12608,76.953125
54,22,15,10870,32768,-21898,-66.827392578125
54,23,1,0,2,-2,-100.0
54,23,2,5,4,1,25.0
54,23,3,5,8,-3,-37.5
54,23,4,59,16,43,268.75
54,23,5,30,32,-2,-6.25
54,23,6,215,64,151,235.9375
54,23,7,230,128,102,79.6875
54,23,8,498,256,242,94.53125
54,23,9,266,512,-246,-48.046875
54,23,10,1827,1024,803,78.41796875
54,23,11,2138,2048,90,4.39453125
54,23,12,1605,4096,-2491,-60.8154296875
54,23,13,9631,8192,1439,17.56591796875
54,23,14,1817,16384,-14567,-88.909912109375
54,23,15,2779,32768,-29989,-91.5191650390625
54,24,1,0,2,-2,-100.0
54,24,2,2,4,-2,-50.0
54,24,3,11,8,3,37.5
54,24,4,7,16,-9,-56.25
54,24,5,4,32,-28,-87.5
54,24,6,21,64,-43,-67.1875
54,24,7,103,128,-25,-19.53125
54,24,8,95,256,-161,-62.890625
54,24,9,199,512,-313,-61.1328125
54,24,10,4151,1024,3127,305.37109375
54,24,11,891,2048,-1157,-56.494140625
54,24,12,9798,4096,5702,139.208984375
54,24,13,15917,8192,7725,94.29931640625
54,24,14,17405,16384,1021,6.231689453125
54,24,15,3289,32768,-29479,-89.9627685546875
54,25,1,0,2,-2,-100.0
54,25,2,1,4,-3,-75.0
54,25,3,2,8,-6,-75.0
54,25,4,50,16,34,212.5
54,25,5,23,32,-9,-28.125
54,25,6,43,64,-21,-32.8125
54,25,7,57,128,-71,-55.46875
54,25,8,138,256,-118,-46.09375
54,25,9,237,512,-275,-53.7109375
54,25,10,439,1024,-585,-57.12890625
54,25,11,2647,2048,599,29.248046875
54,25,12,2730,4096,-1366,-33.349609375
54,25,13,8356,8192,164,2.001953125
54,25,14,13620,16384,-2764,-16.8701171875
54,25,15,53895,32768,21127,64.4744873046875
54,26,1,0,2,-2,-100.0
54,26,2,2,4,-2,-50.0
54,26,3,3,8,-5,-62.5
54,26,4,3,16,-13,-81.25
54,26,5,5,32,-27,-84.375
54,26,6,36,64,-28,-43.75
54,26,7,86,128,-42,-32.8125
54,26,8,206,256,-50,-19.53125
54,26,9,73,512,-439,-85.7421875
54,26,10,685,1024,-339,-33.10546875
54,26,11,3136,2048,1088,53.125
54,26,12,5630,4096,1534,37.451171875
54,26,13,9135,8192,943,11.51123046875
54,26,14,1634,16384,-14750,-90.02685546875
54,26,15,38179,32768,5411,16.5130615234375
54,27,1,0,2,-2,-100.0
54,27,2,3,4,-1,-25.0
54,27,3,13,8,5,62.5
54,27,4,3,16,-13,-81.25
54,27,5,34,32,2,6.25
54,27,6,14,64,-50,-78.125
54,27,7,80,128,-48,-37.5
54,27,8,28,256,-228,-89.0625
54,27,9,12,512,-500,-97.65625
54,27,10,681,1024,-343,-33.49609375
54,27,11,283,2048,-1765,-86.181640625
54,27,12,353,4096,-3743,-91.3818359375
54,27,13,1872,8192,-6320,-77.1484375
54,27,14,3166,16384,-13218,-80.67626953125
54,27,15,38895,32768,6127,18.6981201171875
54,28,1,0,2,-2,-100.0
54,28,2,1,4,-3,-75.0
54,28,3,4,8,-4,-50.0
54,28,4,25,16,9,56.25
54,28,5,28,32,-4,-12.5
54,28,6,28,64,-36,-56.25
54,28,7,63,128,-65,-50.78125
54,28,8,200,256,-56,-21.875
54,28,9,175,512,-337,-65.8203125
54,28,10,2533,1024,1509,147.36328125
54,28,11,2335,2048,287,14.013671875
54,28,12,6880,4096,2784,67.96875
54,28,13,4835,8192,-3357,-40.97900390625
54,28,14,5859,16384,-10525,-64.239501953125
54,28,15,11497,32768,-21271,-64.9139404296875
54,29,1,0,2,-2,-100.0
54,29,2,1,4,-3,-75.0
54,29,3,16,8,8,100.0
54,29,4,14,16,-2,-12.5
54,29,5,92,32,60,187.5
54,29,6,90,64,26,40.625
54,29,7,488,128,360,281.25
54,29,8,453,256,197,76.953125
54,29,9,535,512,23,4.4921875
54,29,10,586,1024,-438,-42.7734375
54,29,11,839,2048,-1209,-59.033203125
54,29,12,2901,4096,-1195,-29.1748046875
54,29,13,433,8192,-7759,-94.71435546875
54,29,14,30383,16384,13999,85.443115234375
54,29,15,11395,32768,-21373,-65.2252197265625
54,30,1,0,2,-2,-100.0
54,30,2,2,4,-2,-50.0
54,30,3,2,8,-6,-75.0
54,30,4,10,16,-6,-37.5
54,30,5,37,32,5,15.625
54,30,6,52,64,-12,-18.75
54,30,7,15,128,-113,-88.28125
54,30,8,498,256,242,94.53125
54,30,9,301,512,-211,-41.2109375
54,30,10,402,1024,-622,-60.7421875
54,30,11,535,2048,-1513,-73.876953125
54,30,12,2401,4096,-1695,-41.3818359375
54,30,13,766,8192,-7426,-90.6494140625
54,30,14,13888,16384,-2496,-15.234375
54,30,15,7534,32768,-25234,-77.008056640625
54,31,1,0,2,-2,-100.0
54,31,2,1,4,-3,-75.0
54,31,3,3,8,-5,-62.5
54,31,4,3,16,-13,-81.25
54,31,5,58,32,26,81.25
54,31,6,101,64,37,57.8125
54,31,7,142,128,14,10.9375
54,31,8,364,256,108,42.1875
54,31,9,1069,512,557,108.7890625
54,31,10,249,1024,-775,-75.68359375
54,31,11,1285,2048,-763,-37.255859375
54,31,12,1979,4096,-2117,-51.6845703125
54,31,13,18133,8192,9941,121.35009765625
54,31,14,378,16384,-16006,-97.69287109375
54,31,15,2108,32768,-30660,-93.56689453125
54,32,1,0,2,-2,-100.0
54,32,2,2,4,-2,-50.0
54,32,3,14,8,6,75.0
54,32,4,5,16,-11,-68.75
54,32,5,16,32,-16,-50.0
54,32,6,31,64,-33,-51.5625
54,32,7,24,128,-104,-81.25
54,32,8,165,256,-91,-35.546875
54,32,9,10,512,-502,-98.046875
54,32,10,9,1024,-1015,-99.12109375
54,32,11,159,2048,-1889,-92.236328125
54,32,12,1668,4096,-2428,-59.27734375
54,32,13,1599,8192,-6593,-80.48095703125
54,32,14,11662,16384,-4722,-28.82080078125
54,32,15,4578,32768,-28190,-86.029052734375
54,33,1,0,2,-2,-100.0
54,33,2,2,4,-2,-50.0
54,33,3,2,8,-6,-75.0
54,33,4,7,16,-9,-56.25
54,33,5,16,32,-16,-50.0
54,33,6,48,64,-16,-25.0
54,33,7,292,128,164,128.125
54,33,8,134,256,-122,-47.65625
54,33,9,201,512,-311,-60.7421875
54,33,10,2517,1024,1493,145.80078125
54,33,11,1227,2048,-821,-40.087890625
54,33,12,3642,4096,-454,-11.083984375
54,33,13,11897,8192,3705,45.22705078125
54,33,14,11763,16384,-4621,-28.204345703125
54,33,15,24298,32768,-8470,-25.848388671875
54,34,1,0,2,-2,-100.0
54,34,2,2,4,-2,-50.0
54,34,3,5,8,-3,-37.5
54,34,4,3,16,-13,-81.25
54,34,5,5,32,-27,-84.375
54,34,6,225,64,161,251.5625
54,34,7,8,128,-120,-93.75
54,34,8,80,256,-176,-68.75
54,34,9,31,512,-481,-93.9453125
54,34,10,806,1024,-218,-21.2890625
54,34,11,2145,2048,97,4.736328125
54,34,12,2283,4096,-1813,-44.2626953125
54,34,13,2724,8192,-5468,-66.748046875
54,34,14,11394,16384,-4990,-30.45654296875
54,34,15,15972,32768,-16796,-51.25732421875
54,35,1,0,2,-2,-100.0
54,35,2,2,4,-2,-50.0
54,35,3,6,8,-2,-25.0
54,35,4,15,16,-1,-6.25
54,35,5,16,32,-16,-50.0
54,35,6,12,64,-52,-81.25
54,35,7,63,128,-65,-50.78125
54,35,8,145,256,-111,-43.359375
54,35,9,1757,512,1245,243.1640625
54,35,10,106,1024,-918,-89.6484375
54,35,11,3901,2048,1853,90.478515625
54,35,12,3021,4096,-1075,-26.2451171875
54,35,13,5182,8192,-3010,-36.7431640625
54,35,14,42418,16384,26034,158.89892578125
54,35,15,24970,32768,-7798,-23.797607421875
54,36,1,0,2,-2,-100.0
54,36,2,3,4,-1,-25.0
54,36,3,12,8,4,50.0
54,36,4,12,16,-4,-25.0
54,36,5,22,32,-10,-31.25
54,36,6,73,64,9,14.0625
54,36,7,216,128,88,68.75
54,36,8,231,256,-25,-9.765625
54,36,9,649,512,137,26.7578125
54,36,10,34,1024,-990,-96.6796875
54,36,11,163,2048,-1885,-92.041015625
54,36,12,2231,4096,-1865,-45.5322265625
54,36,13,13942,8192,5750,70.1904296875
54,36,14,4370,16384,-12014,-73.32763671875
54,36,15,13362,32768,-19406,-59.222412109375
54,37,1,0,2,-2,-100.0
54,37,2,2,4,-2,-50.0
54,37,3,2,8,-6,-75.0
54,37,4,6,16,-10,-62.5
54,37,5,6,32,-26,-81.25
54,37,6,143,64,79,123.4375
54,37,7,83,128,-45,-35.15625
54,37,8,109,256,-147,-57.421875
54,37,9,83,512,-429,-83.7890625
54,37,10,396,1024,-628,-61.328125
54,37,11,547,2048,-1501,-73.291015625
54,37,12,1205,4096,-2891,-70.5810546875
54,37,13,1381,8192,-6811,-83.14208984375
54,37,14,19041,16384,2657,16.217041015625
54,37,15,27093,32768,-5675,-17.3187255859375
54,38,1,0,2,-2,-100.0
54,38,2,2,4,-2,-50.0
54,38,3,5,8,-3,-37.5
54,38,4,27,16,11,68.75
54,38,5,6,32,-26,-81.25
54,38,6,22,64,-42,-65.625
54,38,7,32,128,-96,-75.0
54,38,8,617,256,361,141.015625
54,38,9,896,512,384,75.0
54,38,10,303,1024,-721,-70.41015625
54,38,11,2566,2048,518,25.29296875
54,38,12,883,4096,-3213,-78.4423828125
54,38,13,20293,8192,12101,147.71728515625
54,38,14,82342,16384,65958,402.57568359375
54,38,15,686,32768,-32082,-97.906494140625
54,39,1,0,2,-2,-100.0
54,39,2,1,4,-3,-75.0
54,39,3,8,8,0,0.0
54,39,4,3,16,-13,-81.25
54,39,5,15,32,-17,-53.125
54,39,6,53,64,-11,-17.1875
54,39,7,178,128,50,39.0625
54,39,8,105,256,-151,-58.984375
54,39,9,63,512,-449,-87.6953125
54,39,10,660,1024,-364,-35.546875
54,39,11,3688,2048,1640,80.078125
54,39,12,246,4096,-3850,-93.994140625
54,39,13,20113,8192,11921,145.52001953125
54,39,14,47371,16384,30987,189.129638671875
54,39,15,13869,32768,-18899,-57.6751708984375
54,40,1,0,2,-2,-100.0
54,40,2,2,4,-2,-50.0
54,40,3,3,8,-5,-62.5
54,40,4,5,16,-11,-68.75
54,40,5,5,32,-27,-84.375
54,40,6,51,64,-13,-20.3125
54,40,7,186,128,58,45.3125
54,40,8,72,256,-184,-71.875
54,40,9,992,512,480,93.75
54,40,10,293,1024,-731,-71.38671875
54,40,11,322,2048,-1726,-84.27734375
54,40,12,4813,4096,717,17.5048828125
54,40,13,2037,8192,-6155,-75.13427734375
54,40,14,17950,16384,1566,9.55810546875
54,40,15,2312,32768,-30456,-92.9443359375
54,41,1,0,2,-2,-100.0
54,41,2,1,4,-3,-75.0
54,41,3,15,8,7,87.5
54,41,4,9,16,-7,-43.75
54,41,5,24,32,-8,-25.0
54,41,6,36,64,-28,-43.75
54,41,7,134,128,6,4.6875
54,41,8,280,256,24,9.375
54,41,9,581,512,69,13.4765625
54,41,10,216,1024,-808,-78.90625
54,41,11,3307,2048,1259,61.474609375
54,41,12,411,4096,-3685,-89.9658203125
54,41,13,2922,8192,-5270,-64.3310546875
54,41,14,5237,16384,-11147,-68.035888671875
54,41,15,78398,32768,45630,139.251708984375
54,42,1,0,2,-2,-100.0
54,42,2,2,4,-2,-50.0
54,42,3,2,8,-6,-75.0
54,42,4,3,16,-13,-81.25
54,42,5,8,32,-24,-75.0
54,42,6,11,64,-53,-82.8125
54,42,7,95,128,-33,-25.78125
54,42,8,15,256,-241,-94.140625
54,42,9,893,512,381,74.4140625
54,42,10,1684,1024,660,64.453125
54,42,11,146,2048,-1902,-92.87109375
54,42,12,457,4096,-3639,-88.8427734375
54,42,13,4023,8192,-4169,-50.89111328125
54,42,14,9409,16384,-6975,-42.572021484375
54,42,15,7049,32768,-25719,-78.4881591796875
54,43,1,0,2,-2,-100.0
54,43,2,1,4,-3,-75.0
54,43,3,4,8,-4,-50.0
54,43,4,25,16,9,56.25
54,43,5,8,32,-24,-75.0
54,43,6,48,64,-16,-25.0
54,43,7,265,128,137,107.03125
54,43,8,61,256,-195,-76.171875
54,43,9,494,512,-18,-3.515625
54,43,10,396,1024,-628,-61.328125
54,43,11,366,2048,-1682,-82.12890625
54,43,12,11815,4096,7719,188.4521484375
54,43,13,5862,8192,-2330,-28.4423828125
54,43,14,2141,16384,-14243,-86.932373046875
54,43,15,35009,32768,2241,6.8389892578125
54,44,1,0,2,-2,-100.0
54,44,2,1,4,-3,-75.0
54,44,3,7,8,-1,-12.5
54,44,4,3,16,-13,-81.25
54,44,5,97,32,65,203.125
54,44,6,63,64,-1,-1.5625
54,44,7,101,128,-27,-21.09375
54,44,8,598,256,342,133.59375
54,44,9,420,512,-92,-17.96875
54,44,10,405,1024,-619,-60.44921875
54,44,11,463,2048,-1585,-77.392578125
54,44,12,7563,4096,3467,84.6435546875
54,44,13,7635,8192,-557,-6.79931640625
54,44,14,7601,16384,-8783,-53.607177734375
54,44,15,27453,32768,-5315,-16.2200927734375
54,45,1,0,2,-2,-100.0
54,45,2,1,4,-3,-75.0
54,45,3,2,8,-6,-75.0
54,45,4,20,16,4,25.0
54,45,5,24,32,-8,-25.0
54,45,6,42,64,-22,-34.375
54,45,7,75,128,-53,-41.40625
54,45,8,678,256,422,164.84375
54,45,9,240,512,-272,-53.125
54,45,10,2377,1024,1353,132.12890625
54,45,11,1700,2048,-348,-16.9921875
54,45,12,5472,4096,1376,33.59375
54,45,13,1383,8192,-6809,-83.11767578125
54,45,14,25147,16384,8763,53.485107421875
54,45,15,6670,32768,-26098,-79.644775390625
54,46,1,0,2,-2,-100.0
54,46,2,5,4,1,25.0
54,46,3,4,8,-4,-50.0
54,46,4,3,16,-13,-81.25
54,46,5,27,32,-5,-15.625
54,46,6,6,64,-58,-90.625
54,46,7,52,128,-76,-59.375
54,46,8,67,256,-189,-73.828125
54,46,9,432,512,-80,-15.625
54,46,10,2101,1024,1077,105.17578125
54,46,11,399,2048,-1649,-80.517578125
54,46,12,3288,4096,-808,-19.7265625
54,46,13,2333,8192,-5859,-71.52099609375
54,46,14,48128,16384,31744,193.75
54,46,15,50931,32768,18163,55.4290771484375
54,47,1,0,2,-2,-100.0
54,47,2,1,4,-3,-75.0
54,47,3,12,8,4,50.0
54,47,4,5,16,-11,-68.75
54,47,5,35,32,3,9.375
54,47,6,12,64,-52,-81.25
54,47,7,59,128,-69,-53.90625
54,47,8,1060,256,804,314.0625
54,47,9,734,512,222,43.359375
54,47,10,46,1024,-978,-95.5078125
54,47,11,173,2048,-1875,-91.552734375
54,47,12,16409,4096,12313,300.6103515625
54,47,13,4243,8192,-3949,-48.20556640625
54,47,14,10086,16384,-6298,-38.43994140625
54,47,15,22701,32768,-10067,-30.7220458984375
54,48,1,0,2,-2,-100.0
54,48,2,1,4,-3,-75.0
54,48,3,5,8,-3,-37.5
54,48,4,7,16,-9,-56.25
54,48,5,28,32,-4,-12.5
54,48,6,109,64,45,70.3125
54,48,7,89,128,-39,-30.46875
54,48,8,85,256,-171,-66.796875
54,48,9,613,512,101,19.7265625
54,48,10,121,1024,-903,-88.18359375
54,48,11,3872,2048,1824,89.0625
54,48,12,229,4096,-3867,-94.4091796875
54,48,13,10164,8192,1972,24.072265625
54,48,14,14252,16384,-2132,-13.0126953125
54,48,15,49291,32768,16523,50.4241943359375
54,49,1,0,2,-2,-100.0
54,49,2,2,4,-2,-50.0
54,49,3,8,8,0,0.0
54,49,4,33,16,17,106.25
54,49,5,40,32,8,25.0
54,49,6,121,64,57,89.0625
54,49,7,323,128,195,152.34375
54,49,8,608,256,352,137.5
54,49,9,914,512,402,78.515625
54,49,10,754,1024,-270,-26.3671875
54,49,11,6298,2048,4250,207.51953125
54,49,12,3057,4096,-1039,-25.3662109375
54,49,13,1721,8192,-6471,-78.99169921875
54,49,14,4701,16384,-11683,-71.307373046875
54,49,15,9761,32768,-23007,-70.2117919921875
54,50,1,0,2,-2,-100.0
54,50,2,1,4,-3,-75.0
54,50,3,5,8,-3,-37.5
54,50,4,26,16,10,62.5
54,50,5,25,32,-7,-21.875
54,50,6,63,64,-1,-1.5625
54,50,7,100,128,-28,-21.875
54,50,8,55,256,-201,-78.515625
54,50,9,32,512,-480,-93.75
54,50,10,880,1024,-144,-14.0625
54,50,11,533,2048,-1515,-73.974609375
54,50,12,534,4096,-3562,-86.962890625
54,50,13,9933,8192,1741,21.25244140625
54,50,14,2231,16384,-14153,-86.383056640625
54,50,15,14471,32768,-18297,-55.8380126953125
54,51,1,0,2,-2,-100.0
54,51,2,1,4,-3,-75.0
54,51,3,4,8,-4,-50.0
54,51,4,20,16,4,25.0
54,51,5,28,32,-4,-12.5
54,51,6,55,64,-9,-14.0625
54,51,7,89,128,-39,-30.46875
54,51,8,248,256,-8,-3.125
54,51,9,444,512,-68,-13.28125
54,51,10,424,1024,-600,-58.59375
54,51,11,203,2048,-1845,-90.087890625
54,51,12,3717,4096,-379,-9.2529296875
54,51,13,541,8192,-7651,-93.39599609375
54,51,14,6719,16384,-9665,-58.990478515625
54,51,15,7312,32768,-25456,-77.685546875
54,52,1,0,2,-2,-100.0
54,52,2,6,4,2,50.0
54,52,3,5,8,-3,-37.5
54,52,4,69,16,53,331.25
54,52,5,12,32,-20,-62.5
54,52,6,20,64,-44,-68.75
54,52,7,116,128,-12,-9.375
54,52,8,26,256,-230,-89.84375
54,52,9,544,512,32,6.25
54,52,10,1089,1024,65,6.34765625
54,52,11,3568,2048,1520,74.21875
54,52,12,4266,4096,170,4.150390625
54,52,13,2942,8192,-5250,-64.0869140625
54,52,14,20282,16384,3898,23.79150390625
54,52,15,45553,32768,12785,39.0167236328125
54,53,1,0,2,-2,-100.0
54,53,2,1,4,-3,-75.0
54,53,3,7,8,-1,-12.5
54,53,4,17,16,1,6.25
54,53,5,32,32,0,0.0
54,53,6,114,64,50,78.125
54,53,7,267,128,139,108.59375
54,53,8,187,256,-69,-26.953125
54,53,9,390,512,-122,-23.828125
54,53,10,1339,1024,315,30.76171875
54,53,11,1488,2048,-560,-27.34375
54,53,12,880,4096,-3216,-78.515625
54,53,13,1224,8192,-6968,-85.05859375
54,53,14,29504,16384,13120,80.078125
54,53,15,59543,32768,26775,81.7108154296875
54,54,1,0,2,-2,-100.0
54,54,2,1,4,-3,-75.0
54,54,3,2,8,-6,-75.0
54,54,4,7,16,-9,-56.25
54,54,5,14,32,-18,-56.25
54,54,6,37,64,-27,-42.1875
54,54,7,114,128,-14,-10.9375
54,54,8,168,256,-88,-34.375
54,54,9,2357,512,1845,360.3515625
54,54,10,440,1024,-584,-57.03125
54,54,11,1979,2048,-69,-3.369140625
54,54,12,748,4096,-3348,-81.73828125
54,54,13,31871,8192,23679,289.05029296875
54,54,14,32398,16384,16014,97.74169921875
54,54,15,70061,32768,37293,113.8092041015625
55,1,1,0,2,-2,-100.0
55,1,2,4,4,0,0.0
55,1,3,2,8,-6,-75.0
55,1,4,5,16,-11,-68.75
55,1,5,7,32,-25,-78.125
55,1,6,12,64,-52,-81.25
55,1,7,72,128,-56,-43.75
55,1,8,513,256,257,100.390625
55,1,9,1090,512,578,112.890625
55,1,10,1829,1024,805,78.61328125
55,1,11,1117,2048,-931,-45.458984375
55,1,12,2528,4096,-1568,-38.28125
55,1,13,3061,8192,-5131,-62.63427734375
55,1,14,3753,16384,-12631,-77.093505859375
55,1,15,48275,32768,15507,47.3236083984375
55,2,1,0,2,-2,-100.0
55,2,2,2,4,-2,-50.0
55,2,3,3,8,-5,-62.5
55,2,4,3,16,-13,-81.25
55,2,5,108,32,76,237.5
55,2,6,163,64,99,154.6875
55,2,7,128,128,0,0.0
55,2,8,127,256,-129,-50.390625
55,2,9,221,512,-291,-56.8359375
55,2,10,1499,1024,475,46.38671875
55,2,11,3395,2048,1347,65.771484375
55,2,12,2236,4096,-1860,-45.41015625
55,2,13,2185,8192,-6007,-73.32763671875
55,2,14,6341,16384,-10043,-61.297607421875
55,2,15,41942,32768,9174,27.996826171875
55,3,1,0,2,-2,-100.0
55,3,2,3,4,-1,-25.0
55,3,3,14,8,6,75.0
55,3,4,4,16,-12,-75.0
55,3,5,24,32,-8,-25.0
55,3,6,49,64,-15,-23.4375
55,3,7,732,128,604,471.875
55,3,8,67,256,-189,-73.828125
55,3,9,250,512,-262,-51.171875
55,3,10,945,1024,-79,-7.71484375
55,3,11,690,2048,-1358,-66.30859375
55,3,12,7568,4096,3472,84.765625
55,3,13,10400,8192,2208,26.953125
55,3,14,9558,16384,-6826,-41.66259765625
55,3,15,20710,32768,-12058,-36.798095703125
55,4,1,0,2,-2,-100.0
55,4,2,1,4,-3,-75.0
55,4,3,7,8,-1,-12.5
55,4,4,9,16,-7,-43.75
55,4,5,18,32,-14,-43.75
55,4,6,11,64,-53,-82.8125
55,4,7,11,128,-117,-91.40625
55,4,8,85,256,-171,-66.796875
55,4,9,121,512,-391,-76.3671875
55,4,10,1931,1024,907,88.57421875
55,4,11,3672,2048,1624,79.296875
55,4,12,3827,4096,-269,-6.5673828125
55,4,13,9490,8192,1298,15.8447265625
55,4,14,1768,16384,-14616,-89.208984375
55,4,15,23288,32768,-9480,-28.9306640625
55,5,1,0,2,-2,-100.0
55,5,2,1,4,-3,-75.0
55,5,3,12,8,4,50.0
55,5,4,5,16,-11,-68.75
55,5,5,15,32,-17,-53.125
55,5,6,147,64,83,129.6875
55,5,7,150,128,22,17.1875
55,5,8,182,256,-74,-28.90625
55,5,9,253,512,-259,-50.5859375
55,5,10,961,1024,-63,-6.15234375
55,5,11,1748,2048,-300,-14.6484375
55,5,12,4815,4096,719,17.5537109375
55,5,13,3110,8192,-5082,-62.0361328125
55,5,14,6181,16384,-10203,-62.274169921875
55,5,15,3261,32768,-29507,-90.0482177734375
55,6,1,0,2,-2,-100.0
55,6,2,1,4,-3,-75.0
55,6,3,7,8,-1,-12.5
55,6,4,3,16,-13,-81.25
55,6,5,37,32,5,15.625
55,6,6,80,64,16,25.0
55,6,7,258,128,130,101.5625
55,6,8,179,256,-77,-30.078125
55,6,9,343,512,-169,-33.0078125
55,6,10,2942,1024,1918,187.3046875
55,6,11,156,2048,-1892,-92.3828125
55,6,12,1631,4096,-2465,-60.1806640625
55,6,13,648,8192,-7544,-92.08984375
55,6,14,14661,16384,-1723,-10.516357421875
55,6,15,41026,32768,8258,25.201416015625
55,7,1,0,2,-2,-100.0
55,7,2,5,4,1,25.0
55,7,3,8,8,0,0.0
55,7,4,3,16,-13,-81.25
55,7,5,5,32,-27,-84.375
55,7,6,28,64,-36,-56.25
55,7,7,84,128,-44,-34.375
55,7,8,98,256,-158,-61.71875
55,7,9,1009,512,497,97.0703125
55,7,10,231,1024,-793,-77.44140625
55,7,11,1323,2048,-725,-35.400390625
55,7,12,7108,4096,3012,73.53515625
55,7,13,1814,8192,-6378,-77.8564453125
55,7,14,2241,16384,-14143,-86.322021484375
55,7,15,49672,32768,16904,51.5869140625
55,8,1,0,2,-2,-100.0
55,8,2,3,4,-1,-25.0
55,8,3,2,8,-6,-75.0
55,8,4,36,16,20,125.0
55,8,5,12,32,-20,-62.5
55,8,6,16,64,-48,-75.0
55,8,7,28,128,-100,-78.125
55,8,8,346,256,90,35.15625
55,8,9,20,512,-492,-96.09375
55,8,10,2229,1024,1205,117.67578125
55,8,11,13220,2048,11172,545.5078125
55,8,12,220,4096,-3876,-94.62890625
55,8,13,1601,8192,-6591,-80.45654296875
55,8,14,10966,16384,-5418,-33.06884765625
55,8,15,41053,32768,8285,25.2838134765625
55,9,1,0,2,-2,-100.0
55,9,2,1,4,-3,-75.0
55,9,3,2,8,-6,-75.0
55,9,4,6,16,-10,-62.5
55,9,5,17,32,-15,-46.875
55,9,6,19,64,-45,-70.3125
55,9,7,15,128,-113,-88.28125
55,9,8,97,256,-159,-62.109375
55,9,9,123,512,-389,-75.9765625
55,9,10,520,1024,-504,-49.21875
55,9,11,1566,2048,-482,-23.53515625
55,9,12,799,4096,-3297,-80.4931640625
55,9,13,13164,8192,4972,60.693359375
55,9,14,2615,16384,-13769,-84.039306640625
55,9,15,2073,32768,-30695,-93.6737060546875
55,10,1,0,2,-2,-100.0
55,10,2,1,4,-3,-75.0
55,10,3,2,8,-6,-75.0
55,10,4,6,16,-10,-62.5
55,10,5,8,32,-24,-75.0
55,10,6,234,64,170,265.625
55,10,7,164,128,36,28.125
55,10,8,74,256,-182,-71.09375
55,10,9,1112,512,600,117.1875
55,10,10,1433,1024,409,39.94140625
55,10,11,1952,2048,-96,-4.6875
55,10,12,4432,4096,336,8.203125
55,10,13,6655,8192,-1537,-18.76220703125
55,10,14,10897,16384,-5487,-33.489990234375
55,10,15,9767,32768,-23001,-70.1934814453125
55,11,1,0,2,-2,-100.0
55,11,2,5,4,1,25.0
55,11,3,5,8,-3,-37.5
55,11,4,13,16,-3,-18.75
55,11,5,9,32,-23,-71.875
55,11,6,55,64,-9,-14.0625
55,11,7,159,128,31,24.21875
55,11,8,327,256,71,27.734375
55,11,9,1217,512,705,137.6953125
55,11,10,2918,1024,1894,184.9609375
55,11,11,2439,2048,391,19.091796875
55,11,12,3575,4096,-521,-12.7197265625
55,11,13,9280,8192,1088,13.28125
55,11,14,13506,16384,-2878,-17.56591796875
55,11,15,5396,32768,-27372,-83.53271484375
55,12,1,0,2,-2,-100.0
55,12,2,2,4,-2,-50.0
55,12,3,9,8,1,12.5
55,12,4,30,16,14,87.5
55,12,5,4,32,-28,-87.5
55,12,6,13,64,-51,-79.6875
55,12,7,262,128,134,104.6875
55,12,8,476,256,220,85.9375
55,12,9,525,512,13,2.5390625
55,12,10,83,1024,-941,-91.89453125
55,12,11,5766,2048,3718,181.54296875
55,12,12,1981,4096,-2115,-51.6357421875
55,12,13,2848,8192,-5344,-65.234375
55,12,14,26705,16384,10321,62.994384765625
55,12,15,4763,32768,-28005,-85.4644775390625
55,13,1,0,2,-2,-100.0
55,13,2,2,4,-2,-50.0
55,13,3,5,8,-3,-37.5
55,13,4,48,16,32,200.0
55,13,5,86,32,54,168.75
55,13,6,22,64,-42,-65.625
55,13,7,81,128,-47,-36.71875
55,13,8,349,256,93,36.328125
55,13,9,234,512,-278,-54.296875
55,13,10,1102,1024,78,7.6171875
55,13,11,3683,2048,1635,79.833984375
55,13,12,6586,4096,2490,60.791015625
55,13,13,16481,8192,8289,101.18408203125
55,13,14,19245,16384,2861,17.462158203125
55,13,15,38580,32768,5812,17.73681640625
55,14,1,0,2,-2,-100.0
55,14,2,2,4,-2,-50.0
55,14,3,6,8,-2,-25.0
55,14,4,45,16,29,181.25
55,14,5,30,32,-2,-6.25
55,14,6,10,64,-54,-84.375
55,14,7,227,128,99,77.34375
55,14,8,129,256,-127,-49.609375
55,14,9,129,512,-383,-74.8046875
55,14,10,627,1024,-397,-38.76953125
55,14,11,935,2048,-1113,-54.345703125
55,14,12,1375,4096,-2721,-66.4306640625
55,14,13,6735,8192,-1457,-17.78564453125
55,14,14,23005,16384,6621,40.411376953125
55,14,15,23539,32768,-9229,-28.1646728515625
55,15,1,0,2,-2,-100.0
55,15,2,1,4,-3,-75.0
55,15,3,7,8,-1,-12.5
55,15,4,10,16,-6,-37.5
55,15,5,16,32,-16,-50.0
55,15,6,78,64,14,21.875
55,15,7,29,128,-99,-77.34375
55,15,8,118,256,-138,-53.90625
55,15,9,273,512,-239,-46.6796875
55,15,10,378,1024,-646,-63.0859375
55,15,11,2014,2048,-34,-1.66015625
55,15,12,7673,4096,3577,87.3291015625
55,15,13,245,8192,-7947,-97.00927734375
55,15,14,17463,16384,1079,6.585693359375
55,15,15,62039,32768,29271,89.3280029296875
55,16,1,0,2,-2,-100.0
55,16,2,1,4,-3,-75.0
55,16,3,2,8,-6,-75.0
55,16,4,6,16,-10,-62.5
55,16,5,28,32,-4,-12.5
55,16,6,37,64,-27,-42.1875
55,16,7,73,128,-55,-42.96875
55,16,8,86,256,-170,-66.40625
55,16,9,372,512,-140,-27.34375
55,16,10,2801,1024,1777,173.53515625
55,16,11,1033,2048,-1015,-49.560546875
55,16,12,2943,4096,-1153,-28.1494140625
55,16,13,9941,8192,1749,21.35009765625
55,16,14,8524,16384,-7860,-47.9736328125
55,16,15,12294,32768,-20474,-62.481689453125
55,17,1,0,2,-2,-100.0
55,17,2,3,4,-1,-25.0
55,17,3,2,8,-6,-75.0
55,17,4,6,16,-10,-62.5
55,17,5,17,32,-15,-46.875
55,17,6,214,64,150,234.375
55,17,7,29,128,-99,-77.34375
55,17,8,257,256,1,0.390625
55,17,9,599,512,87,16.9921875
55,17,10,1585,1024,561,54.78515625
55,17,11,243,2048,-1805,-88.134765625
55,17,12,1888,4096,-2208,-53.90625
55,17,13,1141,8192,-7051,-86.07177734375
55,17,14,5655,16384,-10729,-65.484619140625
55,17,15,13511,32768,-19257,-58.7677001953125
55,18,1,0,2,-2,-100.0
55,18,2,3,4,-1,-25.0
55,18,3,5,8,-3,-37.5
55,18,4,5,16,-11,-68.75
55,18,5,16,32,-16,-50.0
55,18,6,129,64,65,101.5625
55,18,7,152,128,24,18.75
55,18,8,317,256,61,23.828125
55,18,9,67,512,-445,-86.9140625
55,18,10,1001,1024,-23,-2.24609375
55,18,11,48,2048,-2000,-97.65625
55,18,12,8548,4096,4452,108.69140625
55,18,13,4490,8192,-3702,-45.1904296875
55,18,14,56724,16384,40340,246.2158203125
55,18,15,31110,32768,-1658,-5.059814453125
55,19,1,0,2,-2,-100.0
55,19,2,6,4,2,50.0
55,19,3,11,8,3,37.5
55,19,4,48,16,32,200.0
55,19,5,19,32,-13,-40.625
55,19,6,264,64,200,312.5
55,19,7,24,128,-104,-81.25
55,19,8,42,256,-214,-83.59375
55,19,9,531,512,19,3.7109375
55,19,10,531,1024,-493,-48.14453125
55,19,11,5440,2048,3392,165.625
55,19,12,3892,4096,-204,-4.98046875
55,19,13,28236,8192,20044,244.677734375
55,19,14,2461,16384,-13923,-84.979248046875
55,19,15,30901,32768,-1867,-5.6976318359375
55,20,1,0,2,-2,-100.0
55,20,2,13,4,9,225.0
55,20,3,4,8,-4,-50.0
55,20,4,9,16,-7,-43.75
55,20,5,36,32,4,12.5
55,20,6,9,64,-55,-85.9375
55,20,7,143,128,15,11.71875
55,20,8,229,256,-27,-10.546875
55,20,9,1122,512,610,119.140625
55,20,10,930,1024,-94,-9.1796875
55,20,11,19,2048,-2029,-99.072265625
55,20,12,2008,4096,-2088,-50.9765625
55,20,13,3729,8192,-4463,-54.47998046875
55,20,14,18597,16384,2213,13.507080078125
55,20,15,7510,32768,-25258,-77.081298828125
55,21,1,0,2,-2,-100.0
55,21,2,1,4,-3,-75.0
55,21,3,3,8,-5,-62.5
55,21,4,8,16,-8,-50.0
55,21,5,19,32,-13,-40.625
55,21,6,79,64,15,23.4375
55,21,7,172,128,44,34.375
55,21,8,60,256,-196,-76.5625
55,21,9,126,512,-386,-75.390625
55,21,10,292,1024,-732,-71.484375
55,21,11,4122,2048,2074,101.26953125
55,21,12,5153,4096,1057,25.8056640625
55,21,13,749,8192,-7443,-90.85693359375
55,21,14,3995,16384,-12389,-75.616455078125
55,21,15,33276,32768,508,1.55029296875
55,22,1,0,2,-2,-100.0
55,22,2,2,4,-2,-50.0
55,22,3,7,8,-1,-12.5
55,22,4,4,16,-12,-75.0
55,22,5,46,32,14,43.75
55,22,6,294,64,230,359.375
55,22,7,249,128,121,94.53125
55,22,8,623,256,367,143.359375
55,22,9,186,512,-326,-63.671875
55,22,10,318,1024,-706,-68.9453125
55,22,11,1280,2048,-768,-37.5
55,22,12,4472,4096,376,9.1796875
55,22,13,2275,8192,-5917,-72.22900390625
55,22,14,42118,16384,25734,157.06787109375
55,22,15,12018,32768,-20750,-63.323974609375
55,23,1,0,2,-2,-100.0
55,23,2,1,4,-3,-75.0
55,23,3,8,8,0,0.0
55,23,4,23,16,7,43.75
55,23,5,26,32,-6,-18.75
55,23,6,29,64,-35,-54.6875
55,23,7,61,128,-67,-52.34375
55,23,8,10,256,-246,-96.09375
55,23,9,86,512,-426,-83.203125
55,23,10,1180,1024,156,15.234375
55,23,11,85,2048,-1963,-95.849609375
55,23,12,3347,4096,-749,-18.2861328125
55,23,13,865,8192,-7327,-89.44091796875
55,23,14,73819,16384,57435,350.555419921875
55,23,15,13990,32768,-18778,-57.305908203125
55,24,1,0,2,-2,-100.0
55,24,2,2,4,-2,-50.0
55,24,3,2,8,-6,-75.0
55,24,4,7,16,-9,-56.25
55,24,5,147,32,115,359.375
55,24,6,17,64,-47,-73.4375
55,24,7,99,128,-29,-22.65625
55,24,8,1007,256,751,293.359375
55,24,9,413,512,-99,-19.3359375
55,24,10,1041,1024,17,1.66015625
55,24,11,1285,2048,-763,-37.255859375
55,24,12,19076,4096,14980,365.72265625
55,24,13,2533,8192,-5659,-69.07958984375
55,24,14,30228,16384,13844,84.4970703125
55,24,15,36086,32768,3318,10.125732421875
55,25,1,0,2,-2,-100.0
55,25,2,3,4,-1,-25.0
55,25,3,2,8,-6,-75.0
55,25,4,3,16,-13,-81.25
55,25,5,19,32,-13,-40.625
55,25,6,61,64,-3,-4.6875
55,25,7,63,128,-65,-50.78125
55,25,8,17,256,-239,-93.359375
55,25,9,47,512,-465,-90.8203125
55,25,10,80,1024,-944,-92.1875
55,25,11,2436,2048,388,18.9453125
55,25,12,1387,4096,-2709,-66.1376953125
55,25,13,32294,8192,24102,294.2138671875
55,25,14,22694,16384,6310,38.51318359375
55,25,15,23655,32768,-9113,-27.8106689453125
55,26,1,0,2,-2,-100.0
55,26,2,1,4,-3,-75.0
55,26,3,6,8,-2,-25.0
55,26,4,15,16,-1,-6.25
55,26,5,17,32,-15,-46.875
55,26,6,83,64,19,29.6875
55,26,7,51,128,-77,-60.15625
55,26,8,370,256,114,44.53125
55,26,9,145,512,-367,-71.6796875
55,26,10,2450,1024,1426,139.2578125
55,26,11,1099,2048,-949,-46.337890625
55,26,12,2402,4096,-1694,-41.357421875
55,26,13,10207,8192,2015,24.59716796875
55,26,14,236,16384,-16148,-98.5595703125
55,26,15,12681,32768,-20087,-61.3006591796875
55,27,1,0,2,-2,-100.0
55,27,2,4,4,0,0.0
55,27,3,13,8,5,62.5
55,27,4,3,16,-13,-81.25
55,27,5,11,32,-21,-65.625
55,27,6,69,64,5,7.8125
55,27,7,117,128,-11,-8.59375
55,27,8,61,256,-195,-76.171875
55,27,9,1349,512,837,163.4765625
55,27,10,2392,1024,1368,133.59375
55,27,11,4417,2048,2369,115.673828125
55,27,12,1982,4096,-2114,-51.611328125
55,27,13,13406,8192,5214,63.6474609375
55,27,14,13039,16384,-3345,-20.416259765625
55,27,15,5110,32768,-27658,-84.405517578125
55,28,1,0,2,-2,-100.0
55,28,2,3,4,-1,-25.0
55,28,3,5,8,-3,-37.5
55,28,4,41,16,25,156.25
55,28,5,9,32,-23,-71.875
55,28,6,53,64,-11,-17.1875
55,28,7,8,128,-120,-93.75
55,28,8,155,256,-101,-39.453125
55,28,9,674,512,162,31.640625
55,28,10,861,1024,-163,-15.91796875
55,28,11,3938,2048,1890,92.28515625
55,28,12,2584,4096,-1512,-36.9140625
55,28,13,10418,8192,2226,27.1728515625
55,28,14,755,16384,-15629,-95.391845703125
55,28,15,35238,32768,2470,7.537841796875
55,29,1,0,2,-2,-100.0
55,29,2,1,4,-3,-75.0
55,29,3,2,8,-6,-75.0
55,29,4,3,16,-13,-81.25
55,29,5,12,32,-20,-62.5
55,29,6,7,64,-57,-89.0625
55,29,7,35,128,-93,-72.65625
55,29,8,22,256,-234,-91.40625
55,29,9,1268,512,756,147.65625
55,29,10,234,1024,-790,-77.1484375
55,29,11,4190,2048,2142,104.58984375
55,29,12,4690,4096,594,14.501953125
55,29,13,12388,8192,4196,51.220703125
55,29,14,7281,16384,-9103,-55.560302734375
55,29,15,30282,32768,-2486,-7.586669921875
55,30,1,0,2,-2,-100.0
55,30,2,1,4,-3,-75.0
55,30,3,9,8,1,12.5
55,30,4,26,16,10,62.5
55,30,5,8,32,-24,-75.0
55,30,6,135,64,71,110.9375
55,30,7,113,128,-15,-11.71875
55,30,8,1009,256,753,294.140625
55,30,9,1236,512,724,141.40625
55,30,10,2300,1024,1276,124.609375
55,30,11,1140,2048,-908,-44.3359375
55,30,12,3311,4096,-785,-19.1650390625
55,30,13,10311,8192,2119,25.86669921875
55,30,14,19689,16384,3305,20.172119140625
55,30,15,47570,32768,14802,45.172119140625
55,31,1,0,2,-2,-100.0
55,31,2,3,4,-1,-25.0
55,31,3,13,8,5,62.5
55,31,4,17,16,1,6.25
55,31,5,12,32,-20,-62.5
55,31,6,25,64,-39,-60.9375
55,31,7,360,128,232,181.25
55,31,8,488,256,232,90.625
55,31,9,84,512,-428,-83.59375
55,31,10,605,1024,-419,-40.91796875
55,31,11,2153,2048,105,5.126953125
55,31,12,2151,4096,-1945,-47.4853515625
55,31,13,1630,8192,-6562,-80.1025390625
55,31,14,2704,16384,-13680,-83.49609375
55,31,15,83472,32768,50704,154.736328125
55,32,1,0,2,-2,-100.0
55,32,2,1,4,-3,-75.0
55,32,3,6,8,-2,-25.0
55,32,4,8,16,-8,-50.0
55,32,5,6,32,-26,-81.25
55,32,6,37,64,-27,-42.1875
55,32,7,85,128,-43,-33.59375
55,32,8,447,256,191,74.609375
55,32,9,616,512,104,20.3125
55,32,10,2784,1024,1760,171.875
55,32,11,2903,2048,855,41.748046875
55,32,12,13251,4096,9155,223.5107421875
55,32,13,100,8192,-8092,-98.779296875
55,32,14,5975,16384,-10409,-63.531494140625
55,32,15,13647,32768,-19121,-58.3526611328125
55,33,1,0,2,-2,-100.0
55,33,2,2,4,-2,-50.0
55,33,3,2,8,-6,-75.0
55,33,4,48,16,32,200.0
55,33,5,13,32,-19,-59.375
55,33,6,165,64,101,157.8125
55,33,7,10,128,-118,-92.1875
55,33,8,144,256,-112,-43.75
55,33,9,116,512,-396,-77.34375
55,33,10,263,1024,-761,-74.31640625
55,33,11,2337,2048,289,14.111328125
55,33,12,2299,4096,-1797,-43.8720703125
55,33,13,149,8192,-8043,-98.18115234375
55,33,14,16457,16384,73,0.445556640625
55,33,15,4900,32768,-27868,-85.04638671875
55,34,1,0,2,-2,-100.0
55,34,2,3,4,-1,-25.0
55,34,3,23,8,15,187.5
55,34,4,22,16,6,37.5
55,34,5,24,32,-8,-25.0
55,34,6,75,64,11,17.1875
55,34,7,18,128,-110,-85.9375
55,34,8,26,256,-230,-89.84375
55,34,9,701,512,189,36.9140625
55,34,10,1443,1024,419,40.91796875
55,34,11,277,2048,-1771,-86.474609375
55,34,12,597,4096,-3499,-85.4248046875
55,34,13,9429,8192,1237,15.10009765625
55,34,14,27100,16384,10716,65.4052734375
55,34,15,34998,32768,2230,6.805419921875
55,35,1,0,2,-2,-100.0
55,35,2,1,4,-3,-75.0
55,35,3,5,8,-3,-37.5
55,35,4,5,16,-11,-68.75
55,35,5,12,32,-20,-62.5
55,35,6,23,64,-41,-64.0625
55,35,7,87,128,-41,-32.03125
55,35,8,7,256,-249,-97.265625
55,35,9,265,512,-247,-48.2421875
55,35,10,1127,1024,103,10.05859375
55,35,11,5186,2048,3138,153.22265625
55,35,12,116,4096,-3980,-97.16796875
55,35,13,3242,8192,-4950,-60.4248046875
55,35,14,5923,16384,-10461,-63.848876953125
55,35,15,1495,32768,-31273,-95.4376220703125
55,36,1,0,2,-2,-100.0
55,36,2,4,4,0,0.0
55,36,3,6,8,-2,-25.0
55,36,4,4,16,-12,-75.0
55,36,5,4,32,-28,-87.5
55,36,6,30,64,-34,-53.125
55,36,7,111,128,-17,-13.28125
55,36,8,49,256,-207,-80.859375
55,36,9,1275,512,763,149.0234375
55,36,10,1222,1024,198,19.3359375
55,36,11,282,2048,-1766,-86.23046875
55,36,12,434,4096,-3662,-89.404296875
55,36,13,2994,8192,-5198,-63.4521484375
55,36,14,3763,16384,-12621,-77.032470703125
55,36,15,38186,32768,5418,16.534423828125
55,37,1,0,2,-2,-100.0
55,37,2,2,4,-2,-50.0
55,37,3,3,8,-5,-62.5
55,37,4,6,16,-10,-62.5
55,37,5,50,32,18,56.25
55,37,6,92,64,28,43.75
55,37,7,301,128,173,135.15625
55,37,8,177,256,-79,-30.859375
55,37,9,21,512,-491,-95.8984375
55,37,10,667,1024,-357,-34.86328125
55,37,11,314,2048,-1734,-84.66796875
55,37,12,5189,4096,1093,26.6845703125
55,37,13,8672,8192,480,5.859375
55,37,14,39705,16384,23321,142.340087890625
55,37,15,30963,32768,-1805,-5.5084228515625
55,38,1,0,2,-2,-100.0
55,38,2,2,4,-2,-50.0
55,38,3,13,8,5,62.5
55,38,4,6,16,-10,-62.5
55,38,5,14,32,-18,-56.25
55,38,6,130,64,66,103.125
55,38,7,362,128,234,182.8125
55,38,8,235,256,-21,-8.203125
55,38,9,154,512,-358,-69.921875
55,38,10,568,1024,-456,-44.53125
55,38,11,225,2048,-1823,-89.013671875
55,38,12,12815,4096,8719,212.8662109375
55,38,13,14678,8192,6486,79.1748046875
55,38,14,30195,16384,13811,84.295654296875
55,38,15,649,32768,-32119,-98.0194091796875
55,39,1,0,2,-2,-100.0
55,39,2,1,4,-3,-75.0
55,39,3,16,8,8,100.0
55,39,4,15,16,-1,-6.25
55,39,5,16,32,-16,-50.0
55,39,6,93,64,29,45.3125
55,39,7,38,128,-90,-70.3125
55,39,8,14,256,-242,-94.53125
55,39,9,47,512,-465,-90.8203125
55,39,10,787,1024,-237,-23.14453125
55,39,11,36,2048,-2012,-98.2421875
55,39,12,8212,4096,4116,100.48828125
55,39,13,4680,8192,-3512,-42.87109375
55,39,14,1809,16384,-14575,-88.958740234375
55,39,15,32060,32768,-708,-2.16064453125
55,40,1,0,2,-2,-100.0
55,40,2,2,4,-2,-50.0
55,40,3,8,8,0,0.0
55,40,4,7,16,-9,-56.25
55,40,5,8,32,-24,-75.0
55,40,6,34,64,-30,-46.875
55,40,7,83,128,-45,-35.15625
55,40,8,7,256,-249,-97.265625
55,40,9,550,512,38,7.421875
55,40,10,334,1024,-690,-67.3828125
55,40,11,1467,2048,-581,-28.369140625
55,40,12,2924,4096,-1172,-28.61328125
55,40,13,3694,8192,-4498,-54.9072265625
55,40,14,8563,16384,-7821,-47.735595703125
55,40,15,53982,32768,21214,64.739990234375
55,41,1,0,2,-2,-100.0
55,41,2,2,4,-2,-50.0
55,41,3,4,8,-4,-50.0
55,41,4,15,16,-1,-6.25
55,41,5,15,32,-17,-53.125
55,41,6,28,64,-36,-56.25
55,41,7,83,128,-45,-35.15625
55,41,8,386,256,130,50.78125
55,41,9,250,512,-262,-51.171875
55,41,10,1002,1024,-22,-2.1484375
55,41,11,1947,2048,-101,-4.931640625
55,41,12,906,4096,-3190,-77.880859375
55,41,13,39822,8192,31630,386.1083984375
55,41,14,544,16384,-15840,-96.6796875
55,41,15,7049,32768,-25719,-78.4881591796875
55,42,1,0,2,-2,-100.0
55,42,2,5,4,1,25.0
55,42,3,4,8,-4,-50.0
55,42,4,35,16,19,118.75
55,42,5,9,32,-23,-71.875
55,42,6,38,64,-26,-40.625
55,42,7,62,128,-66,-51.5625
55,42,8,113,256,-143,-55.859375
55,42,9,37,512,-475,-92.7734375
55,42,10,1143,1024,119,11.62109375
55,42,11,559,2048,-1489,-72.705078125
55,42,12,8204,4096,4108,100.29296875
55,42,13,10077,8192,1885,23.01025390625
55,42,14,26715,16384,10331,63.055419921875
55,42,15,20447,32768,-12321,-37.6007080078125
55,43,1,0,2,-2,-100.0
55,43,2,1,4,-3,-75.0
55,43,3,8,8,0,0.0
55,43,4,9,16,-7,-43.75
55,43,5,29,32,-3,-9.375
55,43,6,21,64,-43,-67.1875
55,43,7,26,128,-102,-79.6875
55,43,8,177,256,-79,-30.859375
55,43,9,382,512,-130,-25.390625
55,43,10,2548,1024,1524,148.828125
55,43,11,405,2048,-1643,-80.224609375
55,43,12,3411,4096,-685,-16.7236328125
55,43,13,5376,8192,-2816,-34.375
55,43,14,312,16384,-16072,-98.095703125
55,43,15,58108,32768,25340,77.33154296875
55,44,1,0,2,-2,-100.0
55,44,2,2,4,-2,-50.0
55,44,3,6,8,-2,-25.0
55,44,4,6,16,-10,-62.5
55,44,5,53,32,21,65.625
55,44,6,17,64,-47,-73.4375
55,44,7,275,128,147,114.84375
55,44,8,194,256,-62,-24.21875
55,44,9,761,512,249,48.6328125
55,44,10,3283,1024,2259,220.60546875
55,44,11,1958,2048,-90,-4.39453125
55,44,12,17037,4096,12941,315.9423828125
55,44,13,7494,8192,-698,-8.5205078125
55,44,14,3311,16384,-13073,-79.791259765625
55,44,15,5655,32768,-27113,-82.7423095703125
55,45,1,0,2,-2,-100.0
55,45,2,1,4,-3,-75.0
55,45,3,6,8,-2,-25.0
55,45,4,32,16,16,100.0
55,45,5,32,32,0,0.0
55,45,6,96,64,32,50.0
55,45,7,143,128,15,11.71875
55,45,8,101,256,-155,-60.546875
55,45,9,1033,512,521,101.7578125
55,45,10,2088,1024,1064,103.90625
55,45,11,931,2048,-1117,-54.541015625
55,45,12,3864,4096,-232,-5.6640625
55,45,13,532,8192,-7660,-93.505859375
55,45,14,17616,16384,1232,7.51953125
55,45,15,51404,32768,18636,56.87255859375
55,46,1,0,2,-2,-100.0
55,46,2,2,4,-2,-50.0
55,46,3,4,8,-4,-50.0
55,46,4,19,16,3,18.75
55,46,5,28,32,-4,-12.5
55,46,6,24,64,-40,-62.5
55,46,7,126,128,-2,-1.5625
55,46,8,140,256,-116,-45.3125
55,46,9,67,512,-445,-86.9140625
55,46,10,713,1024,-311,-30.37109375
55,46,11,3505,2048,1457,71.142578125
55,46,12,3771,4096,-325,-7.9345703125
55,46,13,1880,8192,-6312,-77.05078125
55,46,14,6401,16384,-9983,-60.931396484375
55,46,15,70735,32768,37967,115.8660888671875
55,47,1,0,2,-2,-100.0
55,47,2,2,4,-2,-50.0
55,47,3,3,8,-5,-62.5
55,47,4,14,16,-2,-12.5
55,47,5,67,32,35,109.375
55,47,6,19,64,-45,-70.3125
55,47,7,156,128,28,21.875
55,47,8,110,256,-146,-57.03125
55,47,9,774,512,262,51.171875
55,47,10,792,1024,-232,-22.65625
55,47,11,720,2048,-1328,-64.84375
55,47,12,2644,4096,-1452,-35.44921875
55,47,13,17582,8192,9390,114.6240234375
55,47,14,37427,16384,21043,128.436279296875
55,47,15,33256,32768,488,1.4892578125
55,48,1,0,2,-2,-100.0
55,48,2,1,4,-3,-75.0
55,48,3,10,8,2,25.0
55,48,4,18,16,2,12.5
55,48,5,56,32,24,75.0
55,48,6,18,64,-46,-71.875
55,48,7,41,128,-87,-67.96875
55,48,8,406,256,150,58.59375
55,48,9,631,512,119,23.2421875
55,48,10,396,1024,-628,-61.328125
55,48,11,1480,2048,-568,-27.734375
55,48,12,4083,4096,-13,-0.3173828125
55,48,13,19190,8192,10998,134.2529296875
55,48,14,9571,16384,-6813,-41.583251953125
55,48,15,31434,32768,-1334,-4.071044921875
55,49,1,0,2,-2,-100.0
55,49,2,1,4,-3,-75.0
55,49,3,2,8,-6,-75.0
55,49,4,27,16,11,68.75
55,49,5,82,32,50,156.25
55,49,6,12,64,-52,-81.25
55,49,7,172,128,44,34.375
55,49,8,74,256,-182,-71.09375
55,49,9,139,512,-373,-72.8515625
55,49,10,1762,1024,738,72.0703125
55,49,11,414,2048,-1634,-79.78515625
55,49,12,485,4096,-3611,-88.1591796875
55,49,13,167,8192,-8025,-97.96142578125
55,49,14,34948,16384,18564,113.3056640625
55,49,15,9060,32768,-23708,-72.35107421875
55,50,1,0,2,-2,-100.0
55,50,2,1,4,-3,-75.0
55,50,3,4,8,-4,-50.0
55,50,4,3,16,-13,-81.25
55,50,5,7,32,-25,-78.125
55,50,6,8,64,-56,-87.5
55,50,7,205,128,77,60.15625
55,50,8,56,256,-200,-78.125
55,50,9,288,512,-224,-43.75
55,50,10,321,1024,-703,-68.65234375
55,50,11,1622,2048,-426,-20.80078125
55,50,12,42,4096,-4054,-98.974609375
55,50,13,4512,8192,-3680,-44.921875
55,50,14,2484,16384,-13900,-84.8388671875
55,50,15,2083,32768,-30685,-93.6431884765625
55,51,1,0,2,-2,-100.0
55,51,2,1,4,-3,-75.0
55,51,3,7,8,-1,-12.5
55,51,4,20,16,4,25.0
55,51,5,22,32,-10,-31.25
55,51,6,9,64,-55,-85.9375
55,51,7,23,128,-105,-82.03125
55,51,8,299,256,43,16.796875
55,51,9,355,512,-157,-30.6640625
55,51,10,448,1024,-576,-56.25
55,51,11,2385,2048,337,16.455078125
55,51,12,15486,4096,11390,278.076171875
55,51,13,1117,8192,-7075,-86.36474609375
55,51,14,15706,16384,-678,-4.13818359375
55,51,15,17087,32768,-15681,-47.8546142578125
55,52,1,0,2,-2,-100.0
55,52,2,2,4,-2,-50.0
55,52,3,4,8,-4,-50.0
55,52,4,28,16,12,75.0
55,52,5,68,32,36,112.5
55,52,6,103,64,39,60.9375
55,52,7,16,128,-112,-87.5
55,52,8,256,256,0,0.0
55,52,9,137,512,-375,-73.2421875
55,52,10,2051,1024,1027,100.29296875
55,52,11,79,2048,-1969,-96.142578125
55,52,12,4624,4096,528,12.890625
55,52,13,4784,8192,-3408,-41.6015625
55,52,14,1019,16384,-15365,-93.780517578125
55,52,15,47865,32768,15097,46.0723876953125
55,53,1,0,2,-2,-100.0
55,53,2,2,4,-2,-50.0
55,53,3,5,8,-3,-37.5
55,53,4,3,16,-13,-81.25
55,53,5,9,32,-23,-71.875
55,53,6,23,64,-41,-64.0625
55,53,7,111,128,-17,-13.28125
55,53,8,126,256,-130,-50.78125
55,53,9,39,512,-473,-92.3828125
55,53,10,1313,1024,289,28.22265625
55,53,11,559,2048,-1489,-72.705078125
55,53,12,2912,4096,-1184,-28.90625
55,53,13,9770,8192,1578,19.2626953125
55,53,14,5445,16384,-10939,-66.766357421875
55,53,15,59377,32768,26609,81.2042236328125
55,54,1,0,2,-2,-100.0
55,54,2,3,4,-1,-25.0
55,54,3,5,8,-3,-37.5
55,54,4,3,16,-13,-81.25
55,54,5,36,32,4,12.5
55,54,6,118,64,54,84.375
55,54,7,25,128,-103,-80.46875
55,54,8,402,256,146,57.03125
55,54,9,267,512,-245,-47.8515625
55,54,10,780,1024,-244,-23.828125
55,54,11,984,2048,-1064,-51.953125
55,54,12,2247,4096,-1849,-45.1416015625
55,54,13,864,8192,-7328,-89.453125
55,54,14,5058,16384,-11326,-69.12841796875
55,54,15,47072,32768,14304,43.65234375
55,55,1,0,2,-2,-100.0
55,55,2,1,4,-3,-75.0
55,55,3,11,8,3,37.5
55,55,4,7,16,-9,-56.25
55,55,5,6,32,-26,-81.25
55,55,6,33,64,-31,-48.4375
55,55,7,1019,128,891,696.09375
55,55,8,85,256,-171,-66.796875
55,55,9,103,512,-409,-79.8828125
55,55,10,1822,1024,798,77.9296875
55,55,11,298,2048,-1750,-85.44921875
55,55,12,8952,4096,4856,118.5546875
55,55,13,2998,8192,-5194,-63.4033203125
55,55,14,6636,16384,-9748,-59.4970703125
55,55,15,50221,32768,17453,53.2623291015625
56,1,1,0,2,-2,-100.0
56,1,2,1,4,-3,-75.0
56,1,3,2,8,-6,-75.0
56,1,4,8,16,-8,-50.0
56,1,5,47,32,15,46.875
56,1,6,13,64,-51,-79.6875
56,1,7,48,128,-80,-62.5
56,1,8,165,256,-91,-35.546875
56,1,9,328,512,-184,-35.9375
56,1,10,1127,1024,103,10.05859375
56,1,11,2969,2048,921,44.970703125
56,1,12,2855,4096,-1241,-30.2978515625
56,1,13,11984,8192,3792,46.2890625
56,1,14,9652,16384,-6732,-41.0888671875
56,1,15,13929,32768,-18839,-57.4920654296875
56,2,1,0,2,-2,-100.0
56,2,2,6,4,2,50.0
56,2,3,4,8,-4,-50.0
56,2,4,3,16,-13,-81.25
56,2,5,82,32,50,156.25
56,2,6,65,64,1,1.5625
56,2,7,8,128,-120,-93.75
56,2,8,139,256,-117,-45.703125
56,2,9,84,512,-428,-83.59375
56,2,10,435,1024,-589,-57.51953125
56,2,11,6569,2048,4521,220.751953125
56,2,12,966,4096,-3130,-76.416015625
56,2,13,3895,8192,-4297,-52.45361328125
56,2,14,57445,16384,41061,250.616455078125
56,2,15,27539,32768,-5229,-15.9576416015625
56,3,1,0,2,-2,-100.0
56,3,2,1,4,-3,-75.0
56,3,3,14,8,6,75.0
56,3,4,3,16,-13,-81.25
56,3,5,35,32,3,9.375
56,3,6,39,64,-25,-39.0625
56,3,7,68,128,-60,-46.875
56,3,8,601,256,345,134.765625
56,3,9,554,512,42,8.203125
56,3,10,825,1024,-199,-19.43359375
56,3,11,1294,2048,-754,-36.81640625
56,3,12,4843,4096,747,18.2373046875
56,3,13,2064,8192,-6128,-74.8046875
56,3,14,10384,16384,-6000,-36.62109375
56,3,15,15516,32768,-17252,-52.64892578125
56,4,1,0,2,-2,-100.0
56,4,2,1,4,-3,-75.0
56,4,3,3,8,-5,-62.5
56,4,4,16,16,0,0.0
56,4,5,6,32,-26,-81.25
56,4,6,19,64,-45,-70.3125
56,4,7,19,128,-109,-85.15625
56,4,8,12,256,-244,-95.3125
56,4,9,86,512,-426,-83.203125
56,4,10,1311,1024,287,28.02734375
56,4,11,3473,2048,1425,69.580078125
56,4,12,1307,4096,-2789,-68.0908203125
56,4,13,12149,8192,3957,48.30322265625
56,4,14,3259,16384,-13125,-80.108642578125
56,4,15,158920,32768,126152,384.9853515625
56,5,1,0,2,-2,-100.0
56,5,2,1,4,-3,-75.0
56,5,3,3,8,-5,-62.5
56,5,4,9,16,-7,-43.75
56,5,5,37,32,5,15.625
56,5,6,78,64,14,21.875
56,5,7,47,128,-81,-63.28125
56,5,8,7,256,-249,-97.265625
56,5,9,38,512,-474,-92.578125
56,5,10,483,1024,-541,-52.83203125
56,5,11,803,2048,-1245,-60.791015625
56,5,12,303,4096,-3793,-92.6025390625
56,5,13,4734,8192,-3458,-42.2119140625
56,5,14,4767,16384,-11617,-70.904541015625
56,5,15,3759,32768,-29009,-88.5284423828125
56,6,1,0,2,-2,-100.0
56,6,2,2,4,-2,-50.0
56,6,3,3,8,-5,-62.5
56,6,4,11,16,-5,-31.25
56,6,5,8,32,-24,-75.0
56,6,6,92,64,28,43.75
56,6,7,313,128,185,144.53125
56,6,8,577,256,321,125.390625
56,6,9,828,512,316,61.71875
56,6,10,146,1024,-878,-85.7421875
56,6,11,610,2048,-1438,-70.21484375
56,6,12,4161,4096,65,1.5869140625
56,6,13,14580,8192,6388,77.978515625
56,6,14,45555,16384,29171,178.045654296875
56,6,15,15529,32768,-17239,-52.6092529296875
56,7,1,0,2,-2,-100.0
56,7,2,2,4,-2,-50.0
56,7,3,7,8,-1,-12.5
56,7,4,8,16,-8,-50.0
56,7,5,7,32,-25,-78.125
56,7,6,51,64,-13,-20.3125
56,7,7,245,128,117,91.40625
56,7,8,246,256,-10,-3.90625
56,7,9,329,512,-183,-35.7421875
56,7,10,525,1024,-499,-48.73046875
56,7,11,1689,2048,-359,-17.529296875
56,7,12,5245,4096,1149,28.0517578125
56,7,13,10467,8192,2275,27.77099609375
56,7,14,26595,16384,10211,62.322998046875
56,7,15,48356,32768,15588,47.57080078125
56,8,1,0,2,-2,-100.0
56,8,2,1,4,-3,-75.0
56,8,3,4,8,-4,-50.0
56,8,4,3,16,-13,-81.25
56,8,5,41,32,9,28.125
56,8,6,100,64,36,56.25
56,8,7,11,128,-117,-91.40625
56,8,8,219,256,-37,-14.453125
56,8,9,174,512,-338,-66.015625
56,8,10,2547,1024,1523,148.73046875
56,8,11,2085,2048,37,1.806640625
56,8,12,4284,4096,188,4.58984375
56,8,13,8407,8192,215,2.62451171875
56,8,14,558,16384,-15826,-96.59423828125
56,8,15,12462,32768,-20306,-61.968994140625
56,9,1,0,2,-2,-100.0
56,9,2,2,4,-2,-50.0
56,9,3,2,8,-6,-75.0
56,9,4,15,16,-1,-6.25
56,9,5,7,32,-25,-78.125
56,9,6,43,64,-21,-32.8125
56,9,7,21,128,-107,-83.59375
56,9,8,259,256,3,1.171875
56,9,9,359,512,-153,-29.8828125
56,9,10,276,1024,-748,-73.046875
56,9,11,2187,2048,139,6.787109375
56,9,12,210,4096,-3886,-94.873046875
56,9,13,24173,8192,15981,195.08056640625
56,9,14,10331,16384,-6053,-36.944580078125
56,9,15,14423,32768,-18345,-55.9844970703125
56,10,1,0,2,-2,-100.0
56,10,2,6,4,2,50.0
56,10,3,7,8,-1,-12.5
56,10,4,17,16,1,6.25
56,10,5,4,32,-28,-87.5
56,10,6,80,64,16,25.0
56,10,7,397,128,269,210.15625
56,10,8,13,256,-243,-94.921875
56,10,9,144,512,-368,-71.875
56,10,10,537,1024,-487,-47.55859375
56,10,11,6939,2048,4891,238.818359375
56,10,12,951,4096,-3145,-76.7822265625
56,10,13,18764,8192,10572,129.052734375
56,10,14,25689,16384,9305,56.793212890625
56,10,15,34841,32768,2073,6.3262939453125
56,11,1,0,2,-2,-100.0
56,11,2,2,4,-2,-50.0
56,11,3,4,8,-4,-50.0
56,11,4,3,16,-13,-81.25
56,11,5,64,32,32,100.0
56,11,6,99,64,35,54.6875
56,11,7,169,128,41,32.03125
56,11,8,975,256,719,280.859375
56,11,9,501,512,-11,-2.1484375
56,11,10,994,1024,-30,-2.9296875
56,11,11,1153,2048,-895,-43.701171875
56,11,12,3516,4096,-580,-14.16015625
56,11,13,8577,8192,385,4.69970703125
56,11,14,48626,16384,32242,196.78955078125
56,11,15,76482,32768,43714,133.404541015625
56,12,1,0,2,-2,-100.0
56,12,2,1,4,-3,-75.0
56,12,3,2,8,-6,-75.0
56,12,4,23,16,7,43.75
56,12,5,38,32,6,18.75
56,12,6,42,64,-22,-34.375
56,12,7,234,128,106,82.8125
56,12,8,238,256,-18,-7.03125
56,12,9,973,512,461,90.0390625
56,12,10,584,1024,-440,-42.96875
56,12,11,668,2048,-1380,-67.3828125
56,12,12,4583,4096,487,11.8896484375
56,12,13,3115,8192,-5077,-61.97509765625
56,12,14,9619,16384,-6765,-41.290283203125
56,12,15,31935,32768,-833,-2.5421142578125
56,13,1,0,2,-2,-100.0
56,13,2,2,4,-2,-50.0
56,13,3,2,8,-6,-75.0
56,13,4,15,16,-1,-6.25
56,13,5,31,32,-1,-3.125
56,13,6,66,64,2,3.125
56,13,7,378,128,250,195.3125
56,13,8,617,256,361,141.015625
56,13,9,490,512,-22,-4.296875
56,13,10,57,1024,-967,-94.43359375
56,13,11,25,2048,-2023,-98.779296875
56,13,12,7244,4096,3148,76.85546875
56,13,13,26132,8192,17940,218.994140625
56,13,14,7385,16384,-8999,-54.925537109375
56,13,15,39520,32768,6752,20.60546875
56,14,1,0,2,-2,-100.0
56,14,2,2,4,-2,-50.0
56,14,3,2,8,-6,-75.0
56,14,4,11,16,-5,-31.25
56,14,5,4,32,-28,-87.5
56,14,6,12,64,-52,-81.25
56,14,7,51,128,-77,-60.15625
56,14,8,92,256,-164,-64.0625
56,14,9,961,512,449,87.6953125
56,14,10,3327,1024,2303,224.90234375
56,14,11,3554,2048,1506,73.53515625
56,14,12,7675,4096,3579,87.3779296875
56,14,13,5422,8192,-2770,-33.8134765625
56,14,14,2307,16384,-14077,-85.919189453125
56,14,15,50308,32768,17540,53.52783203125
56,15,1,0,2,-2,-100.0
56,15,2,2,4,-2,-50.0
56,15,3,4,8,-4,-50.0
56,15,4,4,16,-12,-75.0
56,15,5,8,32,-24,-75.0
56,15,6,22,64,-42,-65.625
56,15,7,171,128,43,33.59375
56,15,8,395,256,139,54.296875
56,15,9,1497,512,985,192.3828125
56,15,10,474,1024,-550,-53.7109375
56,15,11,1010,2048,-1038,-50.68359375
56,15,12,5165,4096,1069,26.0986328125
56,15,13,4210,8192,-3982,-48.6083984375
56,15,14,8680,16384,-7704,-47.021484375
56,15,15,2071,32768,-30697,-93.6798095703125
56,16,1,0,2,-2,-100.0
56,16,2,1,4,-3,-75.0
56,16,3,2,8,-6,-75.0
56,16,4,21,16,5,31.25
56,16,5,24,32,-8,-25.0
56,16,6,49,64,-15,-23.4375
56,16,7,57,128,-71,-55.46875
56,16,8,183,256,-73,-28.515625
56,16,9,488,512,-24,-4.6875
56,16,10,160,1024,-864,-84.375
56,16,11,1122,2048,-926,-45.21484375
56,16,12,62,4096,-4034,-98.486328125
56,16,13,779,8192,-7413,-90.49072265625
56,16,14,40247,16384,23863,145.648193359375
56,16,15,102030,32768,69262,211.370849609375
56,17,1,0,2,-2,-100.0
56,17,2,3,4,-1,-25.0
56,17,3,3,8,-5,-62.5
56,17,4,8,16,-8,-50.0
56,17,5,43,32,11,34.375
56,17,6,239,64,175,273.4375
56,17,7,156,128,28,21.875
56,17,8,35,256,-221,-86.328125
56,17,9,354,512,-158,-30.859375
56,17,10,764,1024,-260,-25.390625
56,17,11,584,2048,-1464,-71.484375
56,17,12,4100,4096,4,0.09765625
56,17,13,2472,8192,-5720,-69.82421875
56,17,14,26904,16384,10520,64.208984375
56,17,15,39367,32768,6599,20.1385498046875
56,18,1,0,2,-2,-100.0
56,18,2,6,4,2,50.0
56,18,3,5,8,-3,-37.5
56,18,4,20,16,4,25.0
56,18,5,33,32,1,3.125
56,18,6,23,64,-41,-64.0625
56,18,7,71,128,-57,-44.53125
56,18,8,146,256,-110,-42.96875
56,18,9,71,512,-441,-86.1328125
56,18,10,57,1024,-967,-94.43359375
56,18,11,3298,2048,1250,61.03515625
56,18,12,561,4096,-3535,-86.3037109375
56,18,13,8447,8192,255,3.11279296875
56,18,14,16787,16384,403,2.459716796875
56,18,15,14183,32768,-18585,-56.7169189453125
56,19,1,0,2,-2,-100.0
56,19,2,1,4,-3,-75.0
56,19,3,6,8,-2,-25.0
56,19,4,15,16,-1,-6.25
56,19,5,7,32,-25,-78.125
56,19,6,69,64,5,7.8125
56,19,7,49,128,-79,-61.71875
56,19,8,335,256,79,30.859375
56,19,9,244,512,-268,-52.34375
56,19,10,239,1024,-785,-76.66015625
56,19,11,3551,2048,1503,73.388671875
56,19,12,3877,4096,-219,-5.3466796875
56,19,13,7597,8192,-595,-7.26318359375
56,19,14,2168,16384,-14216,-86.767578125
56,19,15,36490,32768,3722,11.358642578125
56,20,1,0,2,-2,-100.0
56,20,2,1,4,-3,-75.0
56,20,3,8,8,0,0.0
56,20,4,18,16,2,12.5
56,20,5,23,32,-9,-28.125
56,20,6,34,64,-30,-46.875
56,20,7,19,128,-109,-85.15625
56,20,8,111,256,-145,-56.640625
56,20,9,35,512,-477,-93.1640625
56,20,10,575,1024,-449,-43.84765625
56,20,11,2976,2048,928,45.3125
56,20,12,2530,4096,-1566,-38.232421875
56,20,13,9388,8192,1196,14.599609375
56,20,14,16625,16384,241,1.470947265625
56,20,15,26881,32768,-5887,-17.9656982421875
56,21,1,0,2,-2,-100.0
56,21,2,2,4,-2,-50.0
56,21,3,4,8,-4,-50.0
56,21,4,27,16,11,68.75
56,21,5,25,32,-7,-21.875
56,21,6,237,64,173,270.3125
56,21,7,75,128,-53,-41.40625
56,21,8,274,256,18,7.03125
56,21,9,909,512,397,77.5390625
56,21,10,290,1024,-734,-71.6796875
56,21,11,1894,2048,-154,-7.51953125
56,21,12,4076,4096,-20,-0.48828125
56,21,13,621,8192,-7571,-92.41943359375
56,21,14,27388,16384,11004,67.1630859375
56,21,15,16157,32768,-16611,-50.6927490234375
56,22,1,0,2,-2,-100.0
56,22,2,1,4,-3,-75.0
56,22,3,14,8,6,75.0
56,22,4,3,16,-13,-81.25
56,22,5,39,32,7,21.875
56,22,6,131,64,67,104.6875
56,22,7,213,128,85,66.40625
56,22,8,45,256,-211,-82.421875
56,22,9,255,512,-257,-50.1953125
56,22,10,1716,1024,692,67.578125
56,22,11,47,2048,-2001,-97.705078125
56,22,12,1252,4096,-2844,-69.43359375
56,22,13,2849,8192,-5343,-65.22216796875
56,22,14,17335,16384,951,5.804443359375
56,22,15,2744,32768,-30024,-91.6259765625
56,23,1,0,2,-2,-100.0
56,23,2,1,4,-3,-75.0
56,23,3,39,8,31,387.5
56,23,4,13,16,-3,-18.75
56,23,5,24,32,-8,-25.0
56,23,6,41,64,-23,-35.9375
56,23,7,36,128,-92,-71.875
56,23,8,110,256,-146,-57.03125
56,23,9,1056,512,544,106.25
56,23,10,1862,1024,838,81.8359375
56,23,11,2330,2048,282,13.76953125
56,23,12,6797,4096,2701,65.9423828125
56,23,13,5107,8192,-3085,-37.65869140625
56,23,14,21688,16384,5304,32.373046875
56,23,15,26039,32768,-6729,-20.5352783203125
56,24,1,0,2,-2,-100.0
56,24,2,4,4,0,0.0
56,24,3,5,8,-3,-37.5
56,24,4,13,16,-3,-18.75
56,24,5,20,32,-12,-37.5
56,24,6,21,64,-43,-67.1875
56,24,7,453,128,325,253.90625
56,24,8,120,256,-136,-53.125
56,24,9,424,512,-88,-17.1875
56,24,10,857,1024,-167,-16.30859375
56,24,11,862,2048,-1186,-57.91015625
56,24,12,18807,4096,14711,359.1552734375
56,24,13,6932,8192,-1260,-15.380859375
56,24,14,18968,16384,2584,15.771484375
56,24,15,39835,32768,7067,21.5667724609375
56,25,1,0,2,-2,-100.0
56,25,2,1,4,-3,-75.0
56,25,3,3,8,-5,-62.5
56,25,4,8,16,-8,-50.0
56,25,5,18,32,-14,-43.75
56,25,6,11,64,-53,-82.8125
56,25,7,7,128,-121,-94.53125
56,25,8,838,256,582,227.34375
56,25,9,677,512,165,32.2265625
56,25,10,107,1024,-917,-89.55078125
56,25,11,3533,2048,1485,72.509765625
56,25,12,2239,4096,-1857,-45.3369140625
56,25,13,4370,8192,-3822,-46.6552734375
56,25,14,16534,16384,150,0.91552734375
56,25,15,65285,32768,32517,99.2340087890625
56,26,1,0,2,-2,-100.0
56,26,2,1,4,-3,-75.0
56,26,3,3,8,-5,-62.5
56,26,4,34,16,18,112.5
56,26,5,36,32,4,12.5
56,26,6,148,64,84,131.25
56,26,7,64,128,-64,-50.0
56,26,8,1514,256,1258,491.40625
56,26,9,244,512,-268,-52.34375
56,26,10,1800,1024,776,75.78125
56,26,11,1243,2048,-805,-39.306640625
56,26,12,390,4096,-3706,-90.478515625
56,26,13,3233,8192,-4959,-60.53466796875
56,26,14,4566,16384,-11818,-72.13134765625
56,26,15,81653,32768,48885,149.1851806640625
56,27,1,0,2,-2,-100.0
56,27,2,1,4,-3,-75.0
56,27,3,2,8,-6,-75.0
56,27,4,11,16,-5,-31.25
56,27,5,8,32,-24,-75.0
56,27,6,83,64,19,29.6875
56,27,7,123,128,-5,-3.90625
56,27,8,39,256,-217,-84.765625
56,27,9,858,512,346,67.578125
56,27,10,407,1024,-617,-60.25390625
56,27,11,1253,2048,-795,-38.818359375
56,27,12,3164,4096,-932,-22.75390625
56,27,13,13907,8192,5715,69.76318359375
56,27,14,14578,16384,-1806,-11.02294921875
56,27,15,8516,32768,-24252,-74.01123046875
56,28,1,0,2,-2,-100.0
56,28,2,2,4,-2,-50.0
56,28,3,2,8,-6,-75.0
56,28,4,26,16,10,62.5
56,28,5,18,32,-14,-43.75
56,28,6,59,64,-5,-7.8125
56,28,7,192,128,64,50.0
56,28,8,564,256,308,120.3125
56,28,9,324,512,-188,-36.71875
56,28,10,680,1024,-344,-33.59375
56,28,11,5325,2048,3277,160.009765625
56,28,12,9551,4096,5455,133.1787109375
56,28,13,1335,8192,-6857,-83.70361328125
56,28,14,3078,16384,-13306,-81.21337890625
56,28,15,60340,32768,27572,84.14306640625
56,29,1,0,2,-2,-100.0
56,29,2,1,4,-3,-75.0
56,29,3,5,8,-3,-37.5
56,29,4,21,16,5,31.25
56,29,5,29,32,-3,-9.375
56,29,6,10,64,-54,-84.375
56,29,7,81,128,-47,-36.71875
56,29,8,730,256,474,185.15625
56,29,9,176,512,-336,-65.625
56,29,10,1205,1024,181,17.67578125
56,29,11,19,2048,-2029,-99.072265625
56,29,12,1242,4096,-2854,-69.677734375
56,29,13,3025,8192,-5167,-63.07373046875
56,29,14,9521,16384,-6863,-41.888427734375
56,29,15,16538,32768,-16230,-49.530029296875
56,30,1,0,2,-2,-100.0
56,30,2,4,4,0,0.0
56,30,3,4,8,-4,-50.0
56,30,4,3,16,-13,-81.25
56,30,5,14,32,-18,-56.25
56,30,6,29,64,-35,-54.6875
56,30,7,419,128,291,227.34375
56,30,8,274,256,18,7.03125
56,30,9,354,512,-158,-30.859375
56,30,10,111,1024,-913,-89.16015625
56,30,11,3393,2048,1345,65.673828125
56,30,12,373,4096,-3723,-90.8935546875
56,30,13,6725,8192,-1467,-17.90771484375
56,30,14,4717,16384,-11667,-71.209716796875
56,30,15,5120,32768,-27648,-84.375
56,31,1,0,2,-2,-100.0
56,31,2,2,4,-2,-50.0
56,31,3,17,8,9,112.5
56,31,4,3,16,-13,-81.25
56,31,5,42,32,10,31.25
56,31,6,50,64,-14,-21.875
56,31,7,75,128,-53,-41.40625
56,31,8,365,256,109,42.578125
56,31,9,1115,512,603,117.7734375
56,31,10,244,1024,-780,-76.171875
56,31,11,516,2048,-1532,-74.8046875
56,31,12,517,4096,-3579,-87.3779296875
56,31,13,1988,8192,-6204,-75.732421875
56,31,14,9751,16384,-6633,-40.484619140625
56,31,15,4875,32768,-27893,-85.1226806640625
56,32,1,0,2,-2,-100.0
56,32,2,4,4,0,0.0
56,32,3,7,8,-1,-12.5
56,32,4,11,16,-5,-31.25
56,32,5,35,32,3,9.375
56,32,6,7,64,-57,-89.0625
56,32,7,84,128,-44,-34.375
56,32,8,343,256,87,33.984375
56,32,9,503,512,-9,-1.7578125
56,32,10,937,1024,-87,-8.49609375
56,32,11,52,2048,-1996,-97.4609375
56,32,12,8325,4096,4229,103.2470703125
56,32,13,23684,8192,15492,189.111328125
56,32,14,971,16384,-15413,-94.073486328125
56,32,15,1297,32768,-31471,-96.0418701171875
56,33,1,0,2,-2,-100.0
56,33,2,1,4,-3,-75.0
56,33,3,10,8,2,25.0
56,33,4,14,16,-2,-12.5
56,33,5,7,32,-25,-78.125
56,33,6,38,64,-26,-40.625
56,33,7,44,128,-84,-65.625
56,33,8,48,256,-208,-81.25
56,33,9,58,512,-454,-88.671875
56,33,10,1147,1024,123,12.01171875
56,33,11,923,2048,-1125,-54.931640625
56,33,12,772,4096,-3324,-81.15234375
56,33,13,1191,8192,-7001,-85.46142578125
56,33,14,17523,16384,1139,6.951904296875
56,33,15,7320,32768,-25448,-77.6611328125
56,34,1,0,2,-2,-100.0
56,34,2,1,4,-3,-75.0
56,34,3,2,8,-6,-75.0
56,34,4,5,16,-11,-68.75
56,34,5,28,32,-4,-12.5
56,34,6,58,64,-6,-9.375
56,34,7,68,128,-60,-46.875
56,34,8,184,256,-72,-28.125
56,34,9,154,512,-358,-69.921875
56,34,10,1313,1024,289,28.22265625
56,34,11,2805,2048,757,36.962890625
56,34,12,305,4096,-3791,-92.5537109375
56,34,13,1431,8192,-6761,-82.53173828125
56,34,14,19659,16384,3275,19.989013671875
56,34,15,7207,32768,-25561,-78.0059814453125
56,35,1,0,2,-2,-100.0
56,35,2,1,4,-3,-75.0
56,35,3,2,8,-6,-75.0
56,35,4,24,16,8,50.0
56,35,5,25,32,-7,-21.875
56,35,6,41,64,-23,-35.9375
56,35,7,404,128,276,215.625
56,35,8,106,256,-150,-58.59375
56,35,9,770,512,258,50.390625
56,35,10,11,1024,-1013,-98.92578125
56,35,11,2851,2048,803,39.208984375
56,35,12,1159,4096,-2937,-71.7041015625
56,35,13,24965,8192,16773,204.74853515625
56,35,14,693,16384,-15691,-95.770263671875
56,35,15,25444,32768,-7324,-22.35107421875
56,36,1,0,2,-2,-100.0
56,36,2,3,4,-1,-25.0
56,36,3,9,8,1,12.5
56,36,4,9,16,-7,-43.75
56,36,5,50,32,18,56.25
56,36,6,50,64,-14,-21.875
56,36,7,74,128,-54,-42.1875
56,36,8,247,256,-9,-3.515625
56,36,9,2137,512,1625,317.3828125
56,36,10,1377,1024,353,34.47265625
56,36,11,554,2048,-1494,-72.94921875
56,36,12,321,4096,-3775,-92.1630859375
56,36,13,2349,8192,-5843,-71.32568359375
56,36,14,26630,16384,10246,62.53662109375
56,36,15,78125,32768,45357,138.4185791015625
56,37,1,0,2,-2,-100.0
56,37,2,2,4,-2,-50.0
56,37,3,3,8,-5,-62.5
56,37,4,17,16,1,6.25
56,37,5,5,32,-27,-84.375
56,37,6,78,64,14,21.875
56,37,7,94,128,-34,-26.5625
56,37,8,28,256,-228,-89.0625
56,37,9,844,512,332,64.84375
56,37,10,295,1024,-729,-71.19140625
56,37,11,596,2048,-1452,-70.8984375
56,37,12,3098,4096,-998,-24.365234375
56,37,13,5052,8192,-3140,-38.330078125
56,37,14,4741,16384,-11643,-71.063232421875
56,37,15,16529,32768,-16239,-49.5574951171875
56,38,1,0,2,-2,-100.0
56,38,2,6,4,2,50.0
56,38,3,19,8,11,137.5
56,38,4,4,16,-12,-75.0
56,38,5,11,32,-21,-65.625
56,38,6,19,64,-45,-70.3125
56,38,7,290,128,162,126.5625
56,38,8,87,256,-169,-66.015625
56,38,9,749,512,237,46.2890625
56,38,10,470,1024,-554,-54.1015625
56,38,11,104,2048,-1944,-94.921875
56,38,12,2875,4096,-1221,-29.8095703125
56,38,13,20320,8192,12128,148.046875
56,38,14,4588,16384,-11796,-71.9970703125
56,38,15,4840,32768,-27928,-85.2294921875
56,39,1,0,2,-2,-100.0
56,39,2,3,4,-1,-25.0
56,39,3,2,8,-6,-75.0
56,39,4,6,16,-10,-62.5
56,39,5,32,32,0,0.0
56,39,6,19,64,-45,-70.3125
56,39,7,149,128,21,16.40625
56,39,8,181,256,-75,-29.296875
56,39,9,139,512,-373,-72.8515625
56,39,10,1341,1024,317,30.95703125
56,39,11,890,2048,-1158,-56.54296875
56,39,12,7300,4096,3204,78.22265625
56,39,13,4231,8192,-3961,-48.35205078125
56,39,14,9130,16384,-7254,-44.27490234375
56,39,15,11361,32768,-21407,-65.3289794921875
56,40,1,0,2,-2,-100.0
56,40,2,3,4,-1,-25.0
56,40,3,14,8,6,75.0
56,40,4,12,16,-4,-25.0
56,40,5,82,32,50,156.25
56,40,6,36,64,-28,-43.75
56,40,7,17,128,-111,-86.71875
56,40,8,256,256,0,0.0
56,40,9,831,512,319,62.3046875
56,40,10,4968,1024,3944,385.15625
56,40,11,1156,2048,-892,-43.5546875
56,40,12,1863,4096,-2233,-54.5166015625
56,40,13,37,8192,-8155,-99.54833984375
56,40,14,33317,16384,16933,103.350830078125
56,40,15,36618,32768,3850,11.749267578125
56,41,1,0,2,-2,-100.0
56,41,2,2,4,-2,-50.0
56,41,3,4,8,-4,-50.0
56,41,4,3,16,-13,-81.25
56,41,5,7,32,-25,-78.125
56,41,6,44,64,-20,-31.25
56,41,7,117,128,-11,-8.59375
56,41,8,348,256,92,35.9375
56,41,9,163,512,-349,-68.1640625
56,41,10,153,1024,-871,-85.05859375
56,41,11,2733,2048,685,33.447265625
56,41,12,2093,4096,-2003,-48.9013671875
56,41,13,17043,8192,8851,108.04443359375
56,41,14,40466,16384,24082,146.98486328125
56,41,15,6137,32768,-26631,-81.2713623046875
56,42,1,0,2,-2,-100.0
56,42,2,1,4,-3,-75.0
56,42,3,6,8,-2,-25.0
56,42,4,17,16,1,6.25
56,42,5,37,32,5,15.625
56,42,6,22,64,-42,-65.625
56,42,7,28,128,-100,-78.125
56,42,8,174,256,-82,-32.03125
56,42,9,676,512,164,32.03125
56,42,10,107,1024,-917,-89.55078125
56,42,11,1248,2048,-800,-39.0625
56,42,12,2239,4096,-1857,-45.3369140625
56,42,13,7210,8192,-982,-11.9873046875
56,42,14,14908,16384,-1476,-9.0087890625
56,42,15,34068,32768,1300,3.96728515625
56,43,1,0,2,-2,-100.0
56,43,2,1,4,-3,-75.0
56,43,3,4,8,-4,-50.0
56,43,4,19,16,3,18.75
56,43,5,13,32,-19,-59.375
56,43,6,5,64,-59,-92.1875
56,43,7,80,128,-48,-37.5
56,43,8,505,256,249,97.265625
56,43,9,303,512,-209,-40.8203125
56,43,10,385,1024,-639,-62.40234375
56,43,11,1609,2048,-439,-21.435546875
56,43,12,1760,4096,-2336,-57.03125
56,43,13,513,8192,-7679,-93.73779296875
56,43,14,18553,16384,2169,13.238525390625
56,43,15,35884,32768,3116,9.50927734375
56,44,1,0,2,-2,-100.0
56,44,2,5,4,1,25.0
56,44,3,7,8,-1,-12.5
56,44,4,7,16,-9,-56.25
56,44,5,30,32,-2,-6.25
56,44,6,8,64,-56,-87.5
56,44,7,37,128,-91,-71.09375
56,44,8,191,256,-65,-25.390625
56,44,9,488,512,-24,-4.6875
56,44,10,218,1024,-806,-78.7109375
56,44,11,761,2048,-1287,-62.841796875
56,44,12,2136,4096,-1960,-47.8515625
56,44,13,17257,8192,9065,110.65673828125
56,44,14,67403,16384,51019,311.395263671875
56,44,15,76006,32768,43238,131.951904296875
56,45,1,0,2,-2,-100.0
56,45,2,1,4,-3,-75.0
56,45,3,2,8,-6,-75.0
56,45,4,10,16,-6,-37.5
56,45,5,24,32,-8,-25.0
56,45,6,11,64,-53,-82.8125
56,45,7,77,128,-51,-39.84375
56,45,8,648,256,392,153.125
56,45,9,342,512,-170,-33.203125
56,45,10,913,1024,-111,-10.83984375
56,45,11,657,2048,-1391,-67.919921875
56,45,12,10851,4096,6755,164.9169921875
56,45,13,7418,8192,-774,-9.4482421875
56,45,14,24804,16384,8420,51.3916015625
56,45,15,124047,32768,91279,278.5614013671875
56,46,1,0,2,-2,-100.0
56,46,2,1,4,-3,-75.0
56,46,3,8,8,0,0.0
56,46,4,3,16,-13,-81.25
56,46,5,25,32,-7,-21.875
56,46,6,91,64,27,42.1875
56,46,7,161,128,33,25.78125
56,46,8,225,256,-31,-12.109375
56,46,9,1839,512,1327,259.1796875
56,46,10,2844,1024,1820,177.734375
56,46,11,953,2048,-1095,-53.466796875
56,46,12,6591,4096,2495,60.9130859375
56,46,13,23070,8192,14878,181.6162109375
56,46,14,1729,16384,-14655,-89.447021484375
56,46,15,958,32768,-31810,-97.076416015625
56,47,1,0,2,-2,-100.0
56,47,2,1,4,-3,-75.0
56,47,3,2,8,-6,-75.0
56,47,4,5,16,-11,-68.75
56,47,5,52,32,20,62.5
56,47,6,18,64,-46,-71.875
56,47,7,51,128,-77,-60.15625
56,47,8,424,256,168,65.625
56,47,9,54,512,-458,-89.453125
56,47,10,88,1024,-936,-91.40625
56,47,11,1232,2048,-816,-39.84375
56,47,12,1125,4096,-2971,-72.5341796875
56,47,13,14506,8192,6314,77.0751953125
56,47,14,38497,16384,22113,134.967041015625
56,47,15,18644,32768,-14124,-43.10302734375
56,48,1,0,2,-2,-100.0
56,48,2,2,4,-2,-50.0
56,48,3,6,8,-2,-25.0
56,48,4,19,16,3,18.75
56,48,5,30,32,-2,-6.25
56,48,6,74,64,10,15.625
56,48,7,312,128,184,143.75
56,48,8,255,256,-1,-0.390625
56,48,9,393,512,-119,-23.2421875
56,48,10,919,1024,-105,-10.25390625
56,48,11,2045,2048,-3,-0.146484375
56,48,12,4310,4096,214,5.224609375
56,48,13,295,8192,-7897,-96.39892578125
56,48,14,12327,16384,-4057,-24.761962890625
56,48,15,29237,32768,-3531,-10.7757568359375
56,49,1,0,2,-2,-100.0
56,49,2,4,4,0,0.0
56,49,3,3,8,-5,-62.5
56,49,4,28,16,12,75.0
56,49,5,12,32,-20,-62.5
56,49,6,26,64,-38,-59.375
56,49,7,45,128,-83,-64.84375
56,49,8,373,256,117,45.703125
56,49,9,471,512,-41,-8.0078125
56,49,10,46,1024,-978,-95.5078125
56,49,11,1392,2048,-656,-32.03125
56,49,12,512,4096,-3584,-87.5
56,49,13,516,8192,-7676,-93.701171875
56,49,14,3866,16384,-12518,-76.40380859375
56,49,15,118079,32768,85311,260.3485107421875
56,50,1,0,2,-2,-100.0
56,50,2,3,4,-1,-25.0
56,50,3,2,8,-6,-75.0
56,50,4,19,16,3,18.75
56,50,5,16,32,-16,-50.0
56,50,6,55,64,-9,-14.0625
56,50,7,146,128,18,14.0625
56,50,8,580,256,324,126.5625
56,50,9,160,512,-352,-68.75
56,50,10,1113,1024,89,8.69140625
56,50,11,2615,2048,567,27.685546875
56,50,12,3759,4096,-337,-8.2275390625
56,50,13,12920,8192,4728,57.71484375
56,50,14,26840,16384,10456,63.818359375
56,50,15,28594,32768,-4174,-12.738037109375
56,51,1,0,2,-2,-100.0
56,51,2,1,4,-3,-75.0
56,51,3,2,8,-6,-75.0
56,51,4,4,16,-12,-75.0
56,51,5,18,32,-14,-43.75
56,51,6,120,64,56,87.5
56,51,7,27,128,-101,-78.90625
56,51,8,88,256,-168,-65.625
56,51,9,398,512,-114,-22.265625
56,51,10,300,1024,-724,-70.703125
56,51,11,473,2048,-1575,-76.904296875
56,51,12,641,4096,-3455,-84.3505859375
56,51,13,4792,8192,-3400,-41.50390625
56,51,14,12202,16384,-4182,-25.52490234375
56,51,15,2580,32768,-30188,-92.12646484375
56,52,1,0,2,-2,-100.0
56,52,2,1,4,-3,-75.0
56,52,3,12,8,4,50.0
56,52,4,3,16,-13,-81.25
56,52,5,8,32,-24,-75.0
56,52,6,25,64,-39,-60.9375
56,52,7,93,128,-35,-27.34375
56,52,8,388,256,132,51.5625
56,52,9,791,512,279,54.4921875
56,52,10,1900,1024,876,85.546875
56,52,11,3301,2048,1253,61.181640625
56,52,12,7125,4096,3029,73.9501953125
56,52,13,6000,8192,-2192,-26.7578125
56,52,14,30996,16384,14612,89.1845703125
56,52,15,37457,32768,4689,14.3096923828125
56,53,1,0,2,-2,-100.0
56,53,2,2,4,-2,-50.0
56,53,3,9,8,1,12.5
56,53,4,3,16,-13,-81.25
56,53,5,13,32,-19,-59.375
56,53,6,129,64,65,101.5625
56,53,7,315,128,187,146.09375
56,53,8,89,256,-167,-65.234375
56,53,9,10,512,-502,-98.046875
56,53,10,769,1024,-255,-24.90234375
56,53,11,826,2048,-1222,-59.66796875
56,53,12,969,4096,-3127,-76.3427734375
56,53,13,16769,8192,8577,104.69970703125
56,53,14,2578,16384,-13806,-84.26513671875
56,53,15,11955,32768,-20813,-63.5162353515625
56,54,1,0,2,-2,-100.0
56,54,2,1,4,-3,-75.0
56,54,3,2,8,-6,-75.0
56,54,4,9,16,-7,-43.75
56,54,5,30,32,-2,-6.25
56,54,6,95,64,31,48.4375
56,54,7,13,128,-115,-89.84375
56,54,8,85,256,-171,-66.796875
56,54,9,830,512,318,62.109375
56,54,10,1171,1024,147,14.35546875
56,54,11,579,2048,-1469,-71.728515625
56,54,12,2442,4096,-1654,-40.380859375
56,54,13,31668,8192,23476,286.572265625
56,54,14,29719,16384,13335,81.390380859375
56,54,15,68344,32768,35576,108.5693359375
56,55,1,0,2,-2,-100.0
56,55,2,1,4,-3,-75.0
56,55,3,3,8,-5,-62.5
56,55,4,6,16,-10,-62.5
56,55,5,17,32,-15,-46.875
56,55,6,165,64,101,157.8125
56,55,7,167,128,39,30.46875
56,55,8,125,256,-131,-51.171875
56,55,9,52,512,-460,-89.84375
56,55,10,148,1024,-876,-85.546875
56,55,11,2753,2048,705,34.423828125
56,55,12,1580,4096,-2516,-61.42578125
56,55,13,43613,8192,35421,432.38525390625
56,55,14,21047,16384,4663,28.460693359375
56,55,15,11891,32768,-20877,-63.7115478515625
56,56,1,0,2,-2,-100.0
56,56,2,1,4,-3,-75.0
56,56,3,8,8,0,0.0
56,56,4,12,16,-4,-25.0
56,56,5,7,32,-25,-78.125
56,56,6,26,64,-38,-59.375
56,56,7,80,128,-48,-37.5
56,56,8,21,256,-235,-91.796875
56,56,9,391,512,-121,-23.6328125
56,56,10,582,1024,-442,-43.1640625
56,56,11,1635,2048,-413,-20.166015625
56,56,12,10734,4096,6638,162.060546875
56,56,13,231,8192,-7961,-97.18017578125
56,56,14,6766,16384,-9618,-58.70361328125
56,56,15,47485,32768,14717,44.9127197265625
57,1,1,0,2,-2,-100.0
57,1,2,1,4,-3,-75.0
57,1,3,16,8,8,100.0
57,1,4,13,16,-3,-18.75
57,1,5,166,32,134,418.75
57,1,6,102,64,38,59.375
57,1,7,28,128,-100,-78.125
57,1,8,21,256,-235,-91.796875
57,1,9,346,512,-166,-32.421875
57,1,10,734,1024,-290,-28.3203125
57,1,11,3248,2048,1200,58.59375
57,1,12,6266,4096,2170,52.978515625
57,1,13,847,8192,-7345,-89.66064453125
57,1,14,33984,16384,17600,107.421875
57,1,15,104138,32768,71370,217.803955078125
57,2,1,0,2,-2,-100.0
57,2,2,1,4,-3,-75.0
57,2,3,3,8,-5,-62.5
57,2,4,6,16,-10,-62.5
57,2,5,18,32,-14,-43.75
57,2,6,106,64,42,65.625
57,2,7,46,128,-82,-64.0625
57,2,8,55,256,-201,-78.515625
57,2,9,494,512,-18,-3.515625
57,2,10,482,1024,-542,-52.9296875
57,2,11,1108,2048,-940,-45.8984375
57,2,12,8372,4096,4276,104.39453125
57,2,13,9956,8192,1764,21.533203125
57,2,14,19379,16384,2995,18.280029296875
57,2,15,15010,32768,-17758,-54.193115234375
57,3,1,0,2,-2,-100.0
57,3,2,4,4,0,0.0
57,3,3,2,8,-6,-75.0
57,3,4,10,16,-6,-37.5
57,3,5,8,32,-24,-75.0
57,3,6,69,64,5,7.8125
57,3,7,67,128,-61,-47.65625
57,3,8,105,256,-151,-58.984375
57,3,9,450,512,-62,-12.109375
57,3,10,508,1024,-516,-50.390625
57,3,11,1022,2048,-1026,-50.09765625
57,3,12,13880,4096,9784,238.8671875
57,3,13,2399,8192,-5793,-70.71533203125
57,3,14,1987,16384,-14397,-87.872314453125
57,3,15,7307,32768,-25461,-77.7008056640625
57,4,1,0,2,-2,-100.0
57,4,2,2,4,-2,-50.0
57,4,3,4,8,-4,-50.0
57,4,4,3,16,-13,-81.25
57,4,5,32,32,0,0.0
57,4,6,35,64,-29,-45.3125
57,4,7,25,128,-103,-80.46875
57,4,8,211,256,-45,-17.578125
57,4,9,465,512,-47,-9.1796875
57,4,10,737,1024,-287,-28.02734375
57,4,11,2522,2048,474,23.14453125
57,4,12,309,4096,-3787,-92.4560546875
57,4,13,2967,8192,-5225,-63.78173828125
57,4,14,17937,16384,1553,9.478759765625
57,4,15,15099,32768,-17669,-53.9215087890625
57,5,1,0,2,-2,-100.0
57,5,2,1,4,-3,-75.0
57,5,3,11,8,3,37.5
57,5,4,3,16,-13,-81.25
57,5,5,66,32,34,106.25
57,5,6,26,64,-38,-59.375
57,5,7,117,128,-11,-8.59375
57,5,8,550,256,294,114.84375
57,5,9,179,512,-333,-65.0390625
57,5,10,832,1024,-192,-18.75
57,5,11,370,2048,-1678,-81.93359375
57,5,12,3280,4096,-816,-19.921875
57,5,13,6944,8192,-1248,-15.234375
57,5,14,33304,16384,16920,103.271484375
57,5,15,12392,32768,-20376,-62.1826171875
57,6,1,0,2,-2,-100.0
57,6,2,2,4,-2,-50.0
57,6,3,9,8,1,12.5
57,6,4,37,16,21,131.25
57,6,5,22,32,-10,-31.25
57,6,6,65,64,1,1.5625
57,6,7,204,128,76,59.375
57,6,8,428,256,172,67.1875
57,6,9,428,512,-84,-16.40625
57,6,10,937,1024,-87,-8.49609375
57,6,11,661,2048,-1387,-67.724609375
57,6,12,3365,4096,-731,-17.8466796875
57,6,13,10912,8192,2720,33.203125
57,6,14,20272,16384,3888,23.73046875
57,6,15,6952,32768,-25816,-78.7841796875
57,7,1,0,2,-2,-100.0
57,7,2,3,4,-1,-25.0
57,7,3,7,8,-1,-12.5
57,7,4,64,16,48,300.0
57,7,5,4,32,-28,-87.5
57,7,6,14,64,-50,-78.125
57,7,7,116,128,-12,-9.375
57,7,8,388,256,132,51.5625
57,7,9,12,512,-500,-97.65625
57,7,10,1668,1024,644,62.890625
57,7,11,353,2048,-1695,-82.763671875
57,7,12,2085,4096,-2011,-49.0966796875
57,7,13,6532,8192,-1660,-20.263671875
57,7,14,18604,16384,2220,13.5498046875
57,7,15,150837,32768,118069,360.3179931640625
57,8,1,0,2,-2,-100.0
57,8,2,4,4,0,0.0
57,8,3,20,8,12,150.0
57,8,4,3,16,-13,-81.25
57,8,5,40,32,8,25.0
57,8,6,97,64,33,51.5625
57,8,7,22,128,-106,-82.8125
57,8,8,514,256,258,100.78125
57,8,9,2309,512,1797,350.9765625
57,8,10,86,1024,-938,-91.6015625
57,8,11,800,2048,-1248,-60.9375
57,8,12,3045,4096,-1051,-25.6591796875
57,8,13,10828,8192,2636,32.177734375
57,8,14,2602,16384,-13782,-84.11865234375
57,8,15,5841,32768,-26927,-82.1746826171875
57,9,1,0,2,-2,-100.0
57,9,2,2,4,-2,-50.0
57,9,3,2,8,-6,-75.0
57,9,4,28,16,12,75.0
57,9,5,5,32,-27,-84.375
57,9,6,5,64,-59,-92.1875
57,9,7,58,128,-70,-54.6875
57,9,8,44,256,-212,-82.8125
57,9,9,118,512,-394,-76.953125
57,9,10,879,1024,-145,-14.16015625
57,9,11,1012,2048,-1036,-50.5859375
57,9,12,1449,4096,-2647,-64.6240234375
57,9,13,8893,8192,701,8.55712890625
57,9,14,23945,16384,7561,46.148681640625
57,9,15,19392,32768,-13376,-40.8203125
57,10,1,0,2,-2,-100.0
57,10,2,1,4,-3,-75.0
57,10,3,7,8,-1,-12.5
57,10,4,33,16,17,106.25
57,10,5,5,32,-27,-84.375
57,10,6,11,64,-53,-82.8125
57,10,7,60,128,-68,-53.125
57,10,8,63,256,-193,-75.390625
57,10,9,382,512,-130,-25.390625
57,10,10,543,1024,-481,-46.97265625
57,10,11,2028,2048,-20,-0.9765625
57,10,12,2530,4096,-1566,-38.232421875
57,10,13,9355,8192,1163,14.19677734375
57,10,14,7548,16384,-8836,-53.9306640625
57,10,15,9459,32768,-23309,-71.1334228515625
57,11,1,0,2,-2,-100.0
57,11,2,5,4,1,25.0
57,11,3,5,8,-3,-37.5
57,11,4,7,16,-9,-56.25
57,11,5,11,32,-21,-65.625
57,11,6,87,64,23,35.9375
57,11,7,90,128,-38,-29.6875
57,11,8,18,256,-238,-92.96875
57,11,9,960,512,448,87.5
57,11,10,79,1024,-945,-92.28515625
57,11,11,7482,2048,5434,265.33203125
57,11,12,7339,4096,3243,79.1748046875
57,11,13,12787,8192,4595,56.09130859375
57,11,14,2555,16384,-13829,-84.405517578125
57,11,15,35696,32768,2928,8.935546875
57,12,1,0,2,-2,-100.0
57,12,2,1,4,-3,-75.0
57,12,3,5,8,-3,-37.5
57,12,4,14,16,-2,-12.5
57,12,5,8,32,-24,-75.0
57,12,6,111,64,47,73.4375
57,12,7,46,128,-82,-64.0625
57,12,8,290,256,34,13.28125
57,12,9,739,512,227,44.3359375
57,12,10,301,1024,-723,-70.60546875
57,12,11,1851,2048,-197,-9.619140625
57,12,12,19080,4096,14984,365.8203125
57,12,13,25910,8192,17718,216.2841796875
57,12,14,15527,16384,-857,-5.230712890625
57,12,15,57578,32768,24810,75.714111328125
57,13,1,0,2,-2,-100.0
57,13,2,1,4,-3,-75.0
57,13,3,6,8,-2,-25.0
57,13,4,37,16,21,131.25
57,13,5,64,32,32,100.0
57,13,6,53,64,-11,-17.1875
57,13,7,388,128,260,203.125
57,13,8,8,256,-248,-96.875
57,13,9,206,512,-306,-59.765625
57,13,10,628,1024,-396,-38.671875
57,13,11,242,2048,-1806,-88.18359375
57,13,12,374,4096,-3722,-90.869140625
57,13,13,2643,8192,-5549,-67.73681640625
57,13,14,6875,16384,-9509,-58.038330078125
57,13,15,22573,32768,-10195,-31.1126708984375
57,14,1,0,2,-2,-100.0
57,14,2,4,4,0,0.0
57,14,3,2,8,-6,-75.0
57,14,4,24,16,8,50.0
57,14,5,4,32,-28,-87.5
57,14,6,32,64,-32,-50.0
57,14,7,7,128,-121,-94.53125
57,14,8,63,256,-193,-75.390625
57,14,9,260,512,-252,-49.21875
57,14,10,6990,1024,5966,582.6171875
57,14,11,947,2048,-1101,-53.759765625
57,14,12,1281,4096,-2815,-68.7255859375
57,14,13,10842,8192,2650,32.3486328125
57,14,14,3678,16384,-12706,-77.55126953125
57,14,15,67135,32768,34367,104.8797607421875
57,15,1,0,2,-2,-100.0
57,15,2,2,4,-2,-50.0
57,15,3,12,8,4,50.0
57,15,4,18,16,2,12.5
57,15,5,10,32,-22,-68.75
57,15,6,69,64,5,7.8125
57,15,7,122,128,-6,-4.6875
57,15,8,269,256,13,5.078125
57,15,9,918,512,406,79.296875
57,15,10,2017,1024,993,96.97265625
57,15,11,4053,2048,2005,97.900390625
57,15,12,4957,4096,861,21.0205078125
57,15,13,36742,8192,28550,348.5107421875
57,15,14,6297,16384,-10087,-61.566162109375
57,15,15,10276,32768,-22492,-68.64013671875
57,16,1,0,2,-2,-100.0
57,16,2,2,4,-2,-50.0
57,16,3,4,8,-4,-50.0
57,16,4,7,16,-9,-56.25
57,16,5,105,32,73,228.125
57,16,6,23,64,-41,-64.0625
57,16,7,158,128,30,23.4375
57,16,8,52,256,-204,-79.6875
57,16,9,200,512,-312,-60.9375
57,16,10,238,1024,-786,-76.7578125
57,16,11,247,2048,-1801,-87.939453125
57,16,12,26,4096,-4070,-99.365234375
57,16,13,7840,8192,-352,-4.296875
57,16,14,32092,16384,15708,95.8740234375
57,16,15,975,32768,-31793,-97.0245361328125
57,17,1,0,2,-2,-100.0
57,17,2,1,4,-3,-75.0
57,17,3,24,8,16,200.0
57,17,4,54,16,38,237.5
57,17,5,21,32,-11,-34.375
57,17,6,38,64,-26,-40.625
57,17,7,82,128,-46,-35.9375
57,17,8,394,256,138,53.90625
57,17,9,307,512,-205,-40.0390625
57,17,10,713,1024,-311,-30.37109375
57,17,11,1180,2048,-868,-42.3828125
57,17,12,2032,4096,-2064,-50.390625
57,17,13,20,8192,-8172,-99.755859375
57,17,14,9588,16384,-6796,-41.4794921875
57,17,15,857,32768,-31911,-97.3846435546875
57,18,1,0,2,-2,-100.0
57,18,2,3,4,-1,-25.0
57,18,3,8,8,0,0.0
57,18,4,15,16,-1,-6.25
57,18,5,4,32,-28,-87.5
57,18,6,85,64,21,32.8125
57,18,7,52,128,-76,-59.375
57,18,8,52,256,-204,-79.6875
57,18,9,251,512,-261,-50.9765625
57,18,10,451,1024,-573,-55.95703125
57,18,11,561,2048,-1487,-72.607421875
57,18,12,4625,4096,529,12.9150390625
57,18,13,3317,8192,-4875,-59.50927734375
57,18,14,1742,16384,-14642,-89.36767578125
57,18,15,20816,32768,-11952,-36.474609375
57,19,1,0,2,-2,-100.0
57,19,2,1,4,-3,-75.0
57,19,3,3,8,-5,-62.5
57,19,4,3,16,-13,-81.25
57,19,5,5,32,-27,-84.375
57,19,6,76,64,12,18.75
57,19,7,191,128,63,49.21875
57,19,8,391,256,135,52.734375
57,19,9,11,512,-501,-97.8515625
57,19,10,4690,1024,3666,358.0078125
57,19,11,2823,2048,775,37.841796875
57,19,12,631,4096,-3465,-84.5947265625
57,19,13,296,8192,-7896,-96.38671875
57,19,14,4527,16384,-11857,-72.369384765625
57,19,15,44000,32768,11232,34.27734375
57,20,1,0,2,-2,-100.0
57,20,2,1,4,-3,-75.0
57,20,3,6,8,-2,-25.0
57,20,4,11,16,-5,-31.25
57,20,5,44,32,12,37.5
57,20,6,31,64,-33,-51.5625
57,20,7,158,128,30,23.4375
57,20,8,47,256,-209,-81.640625
57,20,9,612,512,100,19.53125
57,20,10,498,1024,-526,-51.3671875
57,20,11,398,2048,-1650,-80.56640625
57,20,12,2014,4096,-2082,-50.830078125
57,20,13,12086,8192,3894,47.5341796875
57,20,14,12797,16384,-3587,-21.893310546875
57,20,15,105354,32768,72586,221.514892578125
57,21,1,0,2,-2,-100.0
57,21,2,2,4,-2,-50.0
57,21,3,2,8,-6,-75.0
57,21,4,13,16,-3,-18.75
57,21,5,4,32,-28,-87.5
57,21,6,81,64,17,26.5625
57,21,7,28,128,-100,-78.125
57,21,8,413,256,157,61.328125
57,21,9,33,512,-479,-93.5546875
57,21,10,590,1024,-434,-42.3828125
57,21,11,4059,2048,2011,98.193359375
57,21,12,7393,4096,3297,80.4931640625
57,21,13,3848,8192,-4344,-53.02734375
57,21,14,54385,16384,38001,231.939697265625
57,21,15,58739,32768,25971,79.2572021484375
57,22,1,0,2,-2,-100.0
57,22,2,1,4,-3,-75.0
57,22,3,2,8,-6,-75.0
57,22,4,45,16,29,181.25
57,22,5,24,32,-8,-25.0
57,22,6,152,64,88,137.5
57,22,7,161,128,33,25.78125
57,22,8,170,256,-86,-33.59375
57,22,9,33,512,-479,-93.5546875
57,22,10,271,1024,-753,-73.53515625
57,22,11,211,2048,-1837,-89.697265625
57,22,12,1649,4096,-2447,-59.7412109375
57,22,13,31693,8192,23501,286.87744140625
57,22,14,10415,16384,-5969,-36.431884765625
57,22,15,5083,32768,-27685,-84.4879150390625
57,23,1,0,2,-2,-100.0
57,23,2,2,4,-2,-50.0
57,23,3,2,8,-6,-75.0
57,23,4,16,16,0,0.0
57,23,5,45,32,13,40.625
57,23,6,97,64,33,51.5625
57,23,7,85,128,-43,-33.59375
57,23,8,482,256,226,88.28125
57,23,9,2386,512,1874,366.015625
57,23,10,3142,1024,2118,206.8359375
57,23,11,464,2048,-1584,-77.34375
57,23,12,432,4096,-3664,-89.453125
57,23,13,2995,8192,-5197,-63.43994140625
57,23,14,5472,16384,-10912,-66.6015625
57,23,15,9267,32768,-23501,-71.7193603515625
57,24,1,0,2,-2,-100.0
57,24,2,3,4,-1,-25.0
57,24,3,7,8,-1,-12.5
57,24,4,3,16,-13,-81.25
57,24,5,9,32,-23,-71.875
57,24,6,53,64,-11,-17.1875
57,24,7,68,128,-60,-46.875
57,24,8,80,256,-176,-68.75
57,24,9,24,512,-488,-95.3125
57,24,10,114,1024,-910,-88.8671875
57,24,11,4717,2048,2669,130.322265625
57,24,12,2329,4096,-1767,-43.1396484375
57,24,13,1815,8192,-6377,-77.84423828125
57,24,14,9742,16384,-6642,-40.53955078125
57,24,15,11440,32768,-21328,-65.087890625
57,25,1,0,2,-2,-100.0
57,25,2,3,4,-1,-25.0
57,25,3,7,8,-1,-12.5
57,25,4,7,16,-9,-56.25
57,25,5,88,32,56,175.0
57,25,6,21,64,-43,-67.1875
57,25,7,12,128,-116,-90.625
57,25,8,13,256,-243,-94.921875
57,25,9,482,512,-30,-5.859375
57,25,10,167,1024,-857,-83.69140625
57,25,11,5198,2048,3150,153.80859375
57,25,12,2809,4096,-1287,-31.4208984375
57,25,13,3399,8192,-4793,-58.50830078125
57,25,14,12115,16384,-4269,-26.055908203125
57,25,15,14799,32768,-17969,-54.8370361328125
57,26,1,0,2,-2,-100.0
57,26,2,1,4,-3,-75.0
57,26,3,3,8,-5,-62.5
57,26,4,8,16,-8,-50.0
57,26,5,50,32,18,56.25
57,26,6,31,64,-33,-51.5625
57,26,7,140,128,12,9.375
57,26,8,47,256,-209,-81.640625
57,26,9,291,512,-221,-43.1640625
57,26,10,62,1024,-962,-93.9453125
57,26,11,1304,2048,-744,-36.328125
57,26,12,789,4096,-3307,-80.7373046875
57,26,13,10187,8192,1995,24.35302734375
57,26,14,11703,16384,-4681,-28.570556640625
57,26,15,4056,32768,-28712,-87.6220703125
57,27,1,0,2,-2,-100.0
57,27,2,1,4,-3,-75.0
57,27,3,4,8,-4,-50.0
57,27,4,30,16,14,87.5
57,27,5,61,32,29,90.625
57,27,6,63,64,-1,-1.5625
57,27,7,68,128,-60,-46.875
57,27,8,33,256,-223,-87.109375
57,27,9,107,512,-405,-79.1015625
57,27,10,1355,1024,331,32.32421875
57,27,11,2895,2048,847,41.357421875
57,27,12,1938,4096,-2158,-52.685546875
57,27,13,9725,8192,1533,18.71337890625
57,27,14,10736,16384,-5648,-34.47265625
57,27,15,59335,32768,26567,81.0760498046875
57,28,1,0,2,-2,-100.0
57,28,2,2,4,-2,-50.0
57,28,3,7,8,-1,-12.5
57,28,4,4,16,-12,-75.0
57,28,5,39,32,7,21.875
57,28,6,22,64,-42,-65.625
57,28,7,84,128,-44,-34.375
57,28,8,266,256,10,3.90625
57,28,9,277,512,-235,-45.8984375
57,28,10,507,1024,-517,-50.48828125
57,28,11,1396,2048,-652,-31.8359375
57,28,12,22,4096,-4074,-99.462890625
57,28,13,3056,8192,-5136,-62.6953125
57,28,14,31653,16384,15269,93.194580078125
57,28,15,24969,32768,-7799,-23.8006591796875
57,29,1,0,2,-2,-100.0
57,29,2,1,4,-3,-75.0
57,29,3,8,8,0,0.0
57,29,4,39,16,23,143.75
57,29,5,55,32,23,71.875
57,29,6,6,64,-58,-90.625
57,29,7,244,128,116,90.625
57,29,8,63,256,-193,-75.390625
57,29,9,732,512,220,42.96875
57,29,10,80,1024,-944,-92.1875
57,29,11,638,2048,-1410,-68.84765625
57,29,12,406,4096,-3690,-90.087890625
57,29,13,6713,8192,-1479,-18.05419921875
57,29,14,23812,16384,7428,45.3369140625
57,29,15,63633,32768,30865,94.1925048828125
57,30,1,0,2,-2,-100.0
57,30,2,2,4,-2,-50.0
57,30,3,2,8,-6,-75.0
57,30,4,37,16,21,131.25
57,30,5,26,32,-6,-18.75
57,30,6,19,64,-45,-70.3125
57,30,7,150,128,22,17.1875
57,30,8,134,256,-122,-47.65625
57,30,9,231,512,-281,-54.8828125
57,30,10,739,1024,-285,-27.83203125
57,30,11,3128,2048,1080,52.734375
57,30,12,5773,4096,1677,40.9423828125
57,30,13,6680,8192,-1512,-18.45703125
57,30,14,19837,16384,3453,21.075439453125
57,30,15,9530,32768,-23238,-70.916748046875
57,31,1,0,2,-2,-100.0
57,31,2,1,4,-3,-75.0
57,31,3,4,8,-4,-50.0
57,31,4,14,16,-2,-12.5
57,31,5,7,32,-25,-78.125
57,31,6,21,64,-43,-67.1875
57,31,7,218,128,90,70.3125
57,31,8,88,256,-168,-65.625
57,31,9,842,512,330,64.453125
57,31,10,884,1024,-140,-13.671875
57,31,11,207,2048,-1841,-89.892578125
57,31,12,2077,4096,-2019,-49.2919921875
57,31,13,9321,8192,1129,13.78173828125
57,31,14,13145,16384,-3239,-19.769287109375
57,31,15,1564,32768,-31204,-95.22705078125
57,32,1,0,2,-2,-100.0
57,32,2,1,4,-3,-75.0
57,32,3,3,8,-5,-62.5
57,32,4,37,16,21,131.25
57,32,5,8,32,-24,-75.0
57,32,6,23,64,-41,-64.0625
57,32,7,30,128,-98,-76.5625
57,32,8,331,256,75,29.296875
57,32,9,270,512,-242,-47.265625
57,32,10,919,1024,-105,-10.25390625
57,32,11,1542,2048,-506,-24.70703125
57,32,12,4919,4096,823,20.0927734375
57,32,13,3710,8192,-4482,-54.7119140625
57,32,14,17554,16384,1170,7.14111328125
57,32,15,5214,32768,-27554,-84.088134765625
57,33,1,0,2,-2,-100.0
57,33,2,2,4,-2,-50.0
57,33,3,4,8,-4,-50.0
57,33,4,9,16,-7,-43.75
57,33,5,9,32,-23,-71.875
57,33,6,31,64,-33,-51.5625
57,33,7,21,128,-107,-83.59375
57,33,8,323,256,67,26.171875
57,33,9,518,512,6,1.171875
57,33,10,983,1024,-41,-4.00390625
57,33,11,583,2048,-1465,-71.533203125
57,33,12,10734,4096,6638,162.060546875
57,33,13,5246,8192,-2946,-35.9619140625
57,33,14,7422,16384,-8962,-54.69970703125
57,33,15,70079,32768,37311,113.8641357421875
57,34,1,0,2,-2,-100.0
57,34,2,1,4,-3,-75.0
57,34,3,3,8,-5,-62.5
57,34,4,5,16,-11,-68.75
57,34,5,49,32,17,53.125
57,34,6,9,64,-55,-85.9375
57,34,7,64,128,-64,-50.0
57,34,8,904,256,648,253.125
57,34,9,107,512,-405,-79.1015625
57,34,10,1682,1024,658,64.2578125
57,34,11,75,2048,-1973,-96.337890625
57,34,12,22847,4096,18751,457.7880859375
57,34,13,4280,8192,-3912,-47.75390625
57,34,14,4039,16384,-12345,-75.347900390625
57,34,15,56483,32768,23715,72.3724365234375
57,35,1,0,2,-2,-100.0
57,35,2,1,4,-3,-75.0
57,35,3,5,8,-3,-37.5
57,35,4,25,16,9,56.25
57,35,5,48,32,16,50.0
57,35,6,19,64,-45,-70.3125
57,35,7,115,128,-13,-10.15625
57,35,8,413,256,157,61.328125
57,35,9,173,512,-339,-66.2109375
57,35,10,3693,1024,2669,260.64453125
57,35,11,6112,2048,4064,198.4375
57,35,12,8146,4096,4050,98.876953125
57,35,13,2637,8192,-5555,-67.81005859375
57,35,14,59864,16384,43480,265.380859375
57,35,15,13726,32768,-19042,-58.111572265625
57,36,1,0,2,-2,-100.0
57,36,2,1,4,-3,-75.0
57,36,3,5,8,-3,-37.5
57,36,4,3,16,-13,-81.25
57,36,5,54,32,22,68.75
57,36,6,38,64,-26,-40.625
57,36,7,60,128,-68,-53.125
57,36,8,8,256,-248,-96.875
57,36,9,445,512,-67,-13.0859375
57,36,10,102,1024,-922,-90.0390625
57,36,11,330,2048,-1718,-83.88671875
57,36,12,3575,4096,-521,-12.7197265625
57,36,13,6616,8192,-1576,-19.23828125
57,36,14,19196,16384,2812,17.1630859375
57,36,15,16885,32768,-15883,-48.4710693359375
57,37,1,0,2,-2,-100.0
57,37,2,1,4,-3,-75.0
57,37,3,7,8,-1,-12.5
57,37,4,11,16,-5,-31.25
57,37,5,26,32,-6,-18.75
57,37,6,42,64,-22,-34.375
57,37,7,84,128,-44,-34.375
57,37,8,46,256,-210,-82.03125
57,37,9,184,512,-328,-64.0625
57,37,10,230,1024,-794,-77.5390625
57,37,11,3203,2048,1155,56.396484375
57,37,12,1867,4096,-2229,-54.4189453125
57,37,13,34196,8192,26004,317.431640625
57,37,14,15779,16384,-605,-3.692626953125
57,37,15,2147,32768,-30621,-93.4478759765625
57,38,1,0,2,-2,-100.0
57,38,2,1,4,-3,-75.0
57,38,3,2,8,-6,-75.0
57,38,4,23,16,7,43.75
57,38,5,28,32,-4,-12.5
57,38,6,81,64,17,26.5625
57,38,7,29,128,-99,-77.34375
57,38,8,73,256,-183,-71.484375
57,38,9,440,512,-72,-14.0625
57,38,10,1651,1024,627,61.23046875
57,38,11,994,2048,-1054,-51.46484375
57,38,12,8374,4096,4278,104.443359375
57,38,13,9654,8192,1462,17.8466796875
57,38,14,40108,16384,23724,144.7998046875
57,38,15,88142,32768,55374,168.988037109375
57,39,1,0,2,-2,-100.0
57,39,2,1,4,-3,-75.0
57,39,3,11,8,3,37.5
57,39,4,8,16,-8,-50.0
57,39,5,32,32,0,0.0
57,39,6,42,64,-22,-34.375
57,39,7,6,128,-122,-95.3125
57,39,8,437,256,181,70.703125
57,39,9,32,512,-480,-93.75
57,39,10,1265,1024,241,23.53515625
57,39,11,2138,2048,90,4.39453125
57,39,12,67,4096,-4029,-98.3642578125
57,39,13,12213,8192,4021,49.08447265625
57,39,14,28037,16384,11653,71.124267578125
57,39,15,67116,32768,34348,104.82177734375
57,40,1,0,2,-2,-100.0
57,40,2,2,4,-2,-50.0
57,40,3,3,8,-5,-62.5
57,40,4,3,16,-13,-81.25
57,40,5,8,32,-24,-75.0
57,40,6,28,64,-36,-56.25
57,40,7,125,128,-3,-2.34375
57,40,8,218,256,-38,-14.84375
57,40,9,2431,512,1919,374.8046875
57,40,10,22,1024,-1002,-97.8515625
57,40,11,2734,2048,686,33.49609375
57,40,12,1346,4096,-2750,-67.138671875
57,40,13,2862,8192,-5330,-65.0634765625
57,40,14,462,16384,-15922,-97.18017578125
57,40,15,33755,32768,987,3.0120849609375
57,41,1,0,2,-2,-100.0
57,41,2,5,4,1,25.0
57,41,3,2,8,-6,-75.0
57,41,4,3,16,-13,-81.25
57,41,5,5,32,-27,-84.375
57,41,6,20,64,-44,-68.75
57,41,7,573,128,445,347.65625
57,41,8,378,256,122,47.65625
57,41,9,144,512,-368,-71.875
57,41,10,1677,1024,653,63.76953125
57,41,11,7991,2048,5943,290.185546875
57,41,12,6166,4096,2070,50.537109375
57,41,13,2920,8192,-5272,-64.35546875
57,41,14,2829,16384,-13555,-82.733154296875
57,41,15,12015,32768,-20753,-63.3331298828125
57,42,1,0,2,-2,-100.0
57,42,2,2,4,-2,-50.0
57,42,3,2,8,-6,-75.0
57,42,4,5,16,-11,-68.75
57,42,5,44,32,12,37.5
57,42,6,84,64,20,31.25
57,42,7,281,128,153,119.53125
57,42,8,34,256,-222,-86.71875
57,42,9,524,512,12,2.34375
57,42,10,1457,1024,433,42.28515625
57,42,11,57,2048,-1991,-97.216796875
57,42,12,958,4096,-3138,-76.611328125
57,42,13,1743,8192,-6449,-78.72314453125
57,42,14,4444,16384,-11940,-72.8759765625
57,42,15,3341,32768,-29427,-89.8040771484375
57,43,1,0,2,-2,-100.0
57,43,2,1,4,-3,-75.0
57,43,3,4,8,-4,-50.0
57,43,4,13,16,-3,-18.75
57,43,5,52,32,20,62.5
57,43,6,62,64,-2,-3.125
57,43,7,62,128,-66,-51.5625
57,43,8,18,256,-238,-92.96875
57,43,9,1110,512,598,116.796875
57,43,10,1684,1024,660,64.453125
57,43,11,301,2048,-1747,-85.302734375
57,43,12,1837,4096,-2259,-55.1513671875
57,43,13,2119,8192,-6073,-74.13330078125
57,43,14,29937,16384,13553,82.720947265625
57,43,15,27893,32768,-4875,-14.8773193359375
57,44,1,0,2,-2,-100.0
57,44,2,1,4,-3,-75.0
57,44,3,7,8,-1,-12.5
57,44,4,32,16,16,100.0
57,44,5,6,32,-26,-81.25
57,44,6,47,64,-17,-26.5625
57,44,7,13,128,-115,-89.84375
57,44,8,207,256,-49,-19.140625
57,44,9,47,512,-465,-90.8203125
57,44,10,817,1024,-207,-20.21484375
57,44,11,3580,2048,1532,74.8046875
57,44,12,769,4096,-3327,-81.2255859375
57,44,13,211,8192,-7981,-97.42431640625
57,44,14,2685,16384,-13699,-83.612060546875
57,44,15,24418,32768,-8350,-25.482177734375
57,45,1,0,2,-2,-100.0
57,45,2,1,4,-3,-75.0
57,45,3,2,8,-6,-75.0
57,45,4,3,16,-13,-81.25
57,45,5,34,32,2,6.25
57,45,6,77,64,13,20.3125
57,45,7,185,128,57,44.53125
57,45,8,123,256,-133,-51.953125
57,45,9,18,512,-494,-96.484375
57,45,10,2663,1024,1639,160.05859375
57,45,11,1214,2048,-834,-40.72265625
57,45,12,10482,4096,6386,155.908203125
57,45,13,9796,8192,1604,19.580078125
57,45,14,10508,16384,-5876,-35.8642578125
57,45,15,6577,32768,-26191,-79.9285888671875
57,46,1,0,2,-2,-100.0
57,46,2,1,4,-3,-75.0
57,46,3,2,8,-6,-75.0
57,46,4,32,16,16,100.0
57,46,5,30,32,-2,-6.25
57,46,6,80,64,16,25.0
57,46,7,71,128,-57,-44.53125
57,46,8,49,256,-207,-80.859375
57,46,9,134,512,-378,-73.828125
57,46,10,34,1024,-990,-96.6796875
57,46,11,5322,2048,3274,159.86328125
57,46,12,3122,4096,-974,-23.779296875
57,46,13,24301,8192,16109,196.64306640625
57,46,14,25778,16384,9394,57.33642578125
57,46,15,31073,32768,-1695,-5.1727294921875
57,47,1,0,2,-2,-100.0
57,47,2,2,4,-2,-50.0
57,47,3,5,8,-3,-37.5
57,47,4,6,16,-10,-62.5
57,47,5,40,32,8,25.0
57,47,6,53,64,-11,-17.1875
57,47,7,88,128,-40,-31.25
57,47,8,59,256,-197,-76.953125
57,47,9,80,512,-432,-84.375
57,47,10,344,1024,-680,-66.40625
57,47,11,1767,2048,-281,-13.720703125
57,47,12,614,4096,-3482,-85.009765625
57,47,13,3985,8192,-4207,-51.35498046875
57,47,14,9458,16384,-6926,-42.27294921875
57,47,15,21513,32768,-11255,-34.3475341796875
57,48,1,0,2,-2,-100.0
57,48,2,1,4,-3,-75.0
57,48,3,4,8,-4,-50.0
57,48,4,38,16,22,137.5
57,48,5,14,32,-18,-56.25
57,48,6,37,64,-27,-42.1875
57,48,7,118,128,-10,-7.8125
57,48,8,81,256,-175,-68.359375
57,48,9,530,512,18,3.515625
57,48,10,19,1024,-1005,-98.14453125
57,48,11,355,2048,-1693,-82.666015625
57,48,12,6494,4096,2398,58.544921875
57,48,13,6362,8192,-1830,-22.3388671875
57,48,14,36547,16384,20163,123.065185546875
57,48,15,50290,32768,17522,53.472900390625
57,49,1,0,2,-2,-100.0
57,49,2,1,4,-3,-75.0
57,49,3,6,8,-2,-25.0
57,49,4,3,16,-13,-81.25
57,49,5,15,32,-17,-53.125
57,49,6,67,64,3,4.6875
57,49,7,78,128,-50,-39.0625
57,49,8,149,256,-107,-41.796875
57,49,9,294,512,-218,-42.578125
57,49,10,861,1024,-163,-15.91796875
57,49,11,1931,2048,-117,-5.712890625
57,49,12,6610,4096,2514,61.376953125
57,49,13,10858,8192,2666,32.5439453125
57,49,14,24086,16384,7702,47.00927734375
57,49,15,16809,32768,-15959,-48.7030029296875
57,50,1,0,2,-2,-100.0
57,50,2,1,4,-3,-75.0
57,50,3,7,8,-1,-12.5
57,50,4,25,16,9,56.25
57,50,5,26,32,-6,-18.75
57,50,6,13,64,-51,-79.6875
57,50,7,17,128,-111,-86.71875
57,50,8,483,256,227,88.671875
57,50,9,120,512,-392,-76.5625
57,50,10,258,1024,-766,-74.8046875
57,50,11,5852,2048,3804,185.7421875
57,50,12,1354,4096,-2742,-66.943359375
57,50,13,219,8192,-7973,-97.32666015625
57,50,14,19436,16384,3052,18.6279296875
57,50,15,5853,32768,-26915,-82.1380615234375
57,51,1,0,2,-2,-100.0
57,51,2,2,4,-2,-50.0
57,51,3,4,8,-4,-50.0
57,51,4,27,16,11,68.75
57,51,5,16,32,-16,-50.0
57,51,6,10,64,-54,-84.375
57,51,7,12,128,-116,-90.625
57,51,8,201,256,-55,-21.484375
57,51,9,634,512,122,23.828125
57,51,10,296,1024,-728,-71.09375
57,51,11,640,2048,-1408,-68.75
57,51,12,1874,4096,-2222,-54.248046875
57,51,13,242,8192,-7950,-97.0458984375
57,51,14,15206,16384,-1178,-7.18994140625
57,51,15,3570,32768,-29198,-89.105224609375
57,52,1,0,2,-2,-100.0
57,52,2,1,4,-3,-75.0
57,52,3,2,8,-6,-75.0
57,52,4,6,16,-10,-62.5
57,52,5,97,32,65,203.125
57,52,6,26,64,-38,-59.375
57,52,7,15,128,-113,-88.28125
57,52,8,49,256,-207,-80.859375
57,52,9,8,512,-504,-98.4375
57,52,10,648,1024,-376,-36.71875
57,52,11,4373,2048,2325,113.525390625
57,52,12,15834,4096,11738,286.572265625
57,52,13,14769,8192,6577,80.28564453125
57,52,14,2120,16384,-14264,-87.060546875
57,52,15,28894,32768,-3874,-11.822509765625
57,53,1,0,2,-2,-100.0
57,53,2,1,4,-3,-75.0
57,53,3,2,8,-6,-75.0
57,53,4,8,16,-8,-50.0
57,53,5,31,32,-1,-3.125
57,53,6,68,64,4,6.25
57,53,7,47,128,-81,-63.28125
57,53,8,711,256,455,177.734375
57,53,9,345,512,-167,-32.6171875
57,53,10,239,1024,-785,-76.66015625
57,53,11,637,2048,-1411,-68.896484375
57,53,12,4003,4096,-93,-2.2705078125
57,53,13,14716,8192,6524,79.638671875
57,53,14,7614,16384,-8770,-53.52783203125
57,53,15,19994,32768,-12774,-38.983154296875
57,54,1,0,2,-2,-100.0
57,54,2,2,4,-2,-50.0
57,54,3,7,8,-1,-12.5
57,54,4,12,16,-4,-25.0
57,54,5,30,32,-2,-6.25
57,54,6,14,64,-50,-78.125
57,54,7,96,128,-32,-25.0
57,54,8,101,256,-155,-60.546875
57,54,9,103,512,-409,-79.8828125
57,54,10,2034,1024,1010,98.6328125
57,54,11,708,2048,-1340,-65.4296875
57,54,12,15446,4096,11350,277.099609375
57,54,13,6897,8192,-1295,-15.80810546875
57,54,14,13695,16384,-2689,-16.412353515625
57,54,15,235872,32768,203104,619.82421875
57,55,1,0,2,-2,-100.0
57,55,2,1,4,-3,-75.0
57,55,3,4,8,-4,-50.0
57,55,4,47,16,31,193.75
57,55,5,25,32,-7,-21.875
57,55,6,101,64,37,57.8125
57,55,7,173,128,45,35.15625
57,55,8,222,256,-34,-13.28125
57,55,9,152,512,-360,-70.3125
57,55,10,837,1024,-187,-18.26171875
57,55,11,5635,2048,3587,175.146484375
57,55,12,2364,4096,-1732,-42.28515625
57,55,13,2383,8192,-5809,-70.91064453125
57,55,14,11118,16384,-5266,-32.14111328125
57,55,15,63390,32768,30622,93.450927734375
57,56,1,0,2,-2,-100.0
57,56,2,1,4,-3,-75.0
57,56,3,2,8,-6,-75.0
57,56,4,6,16,-10,-62.5
57,56,5,50,32,18,56.25
57,56,6,90,64,26,40.625
57,56,7,142,128,14,10.9375
57,56,8,796,256,540,210.9375
57,56,9,1815,512,1303,254.4921875
57,56,10,2668,1024,1644,160.546875
57,56,11,476,2048,-1572,-76.7578125
57,56,12,8537,4096,4441,108.4228515625
57,56,13,12297,8192,4105,50.10986328125
57,56,14,27341,16384,10957,66.876220703125
57,56,15,34610,32768,1842,5.621337890625
57,57,1,0,2,-2,-100.0
57,57,2,1,4,-3,-75.0
57,57,3,9,8,1,12.5
57,57,4,5,16,-11,-68.75
57,57,5,15,32,-17,-53.125
57,57,6,96,64,32,50.0
57,57,7,41,128,-87,-67.96875
57,57,8,325,256,69,26.953125
57,57,9,299,512,-213,-41.6015625
57,57,10,36,1024,-988,-96.484375
57,57,11,2794,2048,746,36.42578125
57,57,12,834,4096,-3262,-79.638671875
57,57,13,3055,8192,-5137,-62.70751953125
57,57,14,30125,16384,13741,83.868408203125
57,57,15,74995,32768,42227,128.8665771484375
58,1,1,0,2,-2,-100.0
58,1,2,1,4,-3,-75.0
58,1,3,6,8,-2,-25.0
58,1,4,31,16,15,93.75
58,1,5,15,32,-17,-53.125
58,1,6,14,64,-50,-78.125
58,1,7,228,128,100,78.125
58,1,8,717,256,461,180.078125
58,1,9,73,512,-439,-85.7421875
58,1,10,1060,1024,36,3.515625
58,1,11,1323,2048,-725,-35.400390625
58,1,12,243,4096,-3853,-94.0673828125
58,1,13,1453,8192,-6739,-82.26318359375
58,1,14,27842,16384,11458,69.93408203125
58,1,15,16974,32768,-15794,-48.199462890625
58,2,1,0,2,-2,-100.0
58,2,2,1,4,-3,-75.0
58,2,3,2,8,-6,-75.0
58,2,4,8,16,-8,-50.0
58,2,5,11,32,-21,-65.625
58,2,6,9,64,-55,-85.9375
58,2,7,103,128,-25,-19.53125
58,2,8,26,256,-230,-89.84375
58,2,9,289,512,-223,-43.5546875
58,2,10,1412,1024,388,37.890625
58,2,11,4076,2048,2028,99.0234375
58,2,12,743,4096,-3353,-81.8603515625
58,2,13,1008,8192,-7184,-87.6953125
58,2,14,12338,16384,-4046,-24.69482421875
58,2,15,28439,32768,-4329,-13.2110595703125
58,3,1,0,2,-2,-100.0
58,3,2,1,4,-3,-75.0
58,3,3,2,8,-6,-75.0
58,3,4,7,16,-9,-56.25
58,3,5,40,32,8,25.0
58,3,6,34,64,-30,-46.875
58,3,7,16,128,-112,-87.5
58,3,8,169,256,-87,-33.984375
58,3,9,1105,512,593,115.8203125
58,3,10,1659,1024,635,62.01171875
58,3,11,114,2048,-1934,-94.43359375
58,3,12,6882,4096,2786,68.017578125
58,3,13,39873,8192,31681,386.73095703125
58,3,14,24893,16384,8509,51.934814453125
58,3,15,5400,32768,-27368,-83.5205078125
58,4,1,0,2,-2,-100.0
58,4,2,2,4,-2,-50.0
58,4,3,7,8,-1,-12.5
58,4,4,36,16,20,125.0
58,4,5,23,32,-9,-28.125
58,4,6,132,64,68,106.25
58,4,7,90,128,-38,-29.6875
58,4,8,137,256,-119,-46.484375
58,4,9,848,512,336,65.625
58,4,10,129,1024,-895,-87.40234375
58,4,11,42,2048,-2006,-97.94921875
58,4,12,2150,4096,-1946,-47.509765625
58,4,13,2786,8192,-5406,-65.9912109375
58,4,14,5641,16384,-10743,-65.570068359375
58,4,15,6861,32768,-25907,-79.0618896484375
58,5,1,0,2,-2,-100.0
58,5,2,2,4,-2,-50.0
58,5,3,2,8,-6,-75.0
58,5,4,3,16,-13,-81.25
58,5,5,151,32,119,371.875
58,5,6,54,64,-10,-15.625
58,5,7,81,128,-47,-36.71875
58,5,8,55,256,-201,-78.515625
58,5,9,661,512,149,29.1015625
58,5,10,678,1024,-346,-33.7890625
58,5,11,4797,2048,2749,134.228515625
58,5,12,6702,4096,2606,63.623046875
58,5,13,9176,8192,984,12.01171875
58,5,14,1039,16384,-15345,-93.658447265625
58,5,15,14429,32768,-18339,-55.9661865234375
58,6,1,0,2,-2,-100.0
58,6,2,2,4,-2,-50.0
58,6,3,2,8,-6,-75.0
58,6,4,5,16,-11,-68.75
58,6,5,28,32,-4,-12.5
58,6,6,15,64,-49,-76.5625
58,6,7,87,128,-41,-32.03125
58,6,8,118,256,-138,-53.90625
58,6,9,105,512,-407,-79.4921875
58,6,10,202,1024,-822,-80.2734375
58,6,11,38,2048,-2010,-98.14453125
58,6,12,7377,4096,3281,80.1025390625
58,6,13,6453,8192,-1739,-21.22802734375
58,6,14,9323,16384,-7061,-43.096923828125
58,6,15,10564,32768,-22204,-67.76123046875
58,7,1,0,2,-2,-100.0
58,7,2,6,4,2,50.0
58,7,3,2,8,-6,-75.0
58,7,4,32,16,16,100.0
58,7,5,13,32,-19,-59.375
58,7,6,9,64,-55,-85.9375
58,7,7,201,128,73,57.03125
58,7,8,127,256,-129,-50.390625
58,7,9,285,512,-227,-44.3359375
58,7,10,1055,1024,31,3.02734375
58,7,11,2283,2048,235,11.474609375
58,7,12,485,4096,-3611,-88.1591796875
58,7,13,20298,8192,12106,147.7783203125
58,7,14,66015,16384,49631,302.923583984375
58,7,15,4100,32768,-28668,-87.48779296875
58,8,1,0,2,-2,-100.0
58,8,2,1,4,-3,-75.0
58,8,3,2,8,-6,-75.0
58,8,4,3,16,-13,-81.25
58,8,5,42,32,10,31.25
58,8,6,19,64,-45,-70.3125
58,8,7,260,128,132,103.125
58,8,8,555,256,299,116.796875
58,8,9,1697,512,1185,231.4453125
58,8,10,353,1024,-671,-65.52734375
58,8,11,3627,2048,1579,77.099609375
58,8,12,20649,4096,16553,404.1259765625
58,8,13,10729,8192,2537,30.96923828125
58,8,14,4216,16384,-12168,-74.267578125
58,8,15,11164,32768,-21604,-65.93017578125
58,9,1,0,2,-2,-100.0
58,9,2,1,4,-3,-75.0
58,9,3,3,8,-5,-62.5
58,9,4,6,16,-10,-62.5
58,9,5,29,32,-3,-9.375
58,9,6,158,64,94,146.875
58,9,7,129,128,1,0.78125
58,9,8,237,256,-19,-7.421875
58,9,9,300,512,-212,-41.40625
58,9,10,1184,1024,160,15.625
58,9,11,7674,2048,5626,274.70703125
58,9,12,2049,4096,-2047,-49.9755859375
58,9,13,8930,8192,738,9.0087890625
58,9,14,38357,16384,21973,134.112548828125
58,9,15,12143,32768,-20625,-62.9425048828125
58,10,1,0,2,-2,-100.0
58,10,2,1,4,-3,-75.0
58,10,3,4,8,-4,-50.0
58,10,4,5,16,-11,-68.75
58,10,5,47,32,15,46.875
58,10,6,54,64,-10,-15.625
58,10,7,65,128,-63,-49.21875
58,10,8,322,256,66,25.78125
58,10,9,930,512,418,81.640625
58,10,10,61,1024,-963,-94.04296875
58,10,11,2552,2048,504,24.609375
58,10,12,6337,4096,2241,54.7119140625
58,10,13,2456,8192,-5736,-70.01953125
58,10,14,10793,16384,-5591,-34.124755859375
58,10,15,9998,32768,-22770,-69.488525390625
58,11,1,0,2,-2,-100.0
58,11,2,1,4,-3,-75.0
58,11,3,10,8,2,25.0
58,11,4,11,16,-5,-31.25
58,11,5,15,32,-17,-53.125
58,11,6,25,64,-39,-60.9375
58,11,7,395,128,267,208.59375
58,11,8,241,256,-15,-5.859375
58,11,9,187,512,-325,-63.4765625
58,11,10,368,1024,-656,-64.0625
58,11,11,534,2048,-1514,-73.92578125
58,11,12,3044,4096,-1052,-25.68359375
58,11,13,6987,8192,-1205,-14.70947265625
58,11,14,38144,16384,21760,132.8125
58,11,15,33283,32768,515,1.5716552734375
58,12,1,0,2,-2,-100.0
58,12,2,6,4,2,50.0
58,12,3,5,8,-3,-37.5
58,12,4,6,16,-10,-62.5
58,12,5,18,32,-14,-43.75
58,12,6,19,64,-45,-70.3125
58,12,7,59,128,-69,-53.90625
58,12,8,25,256,-231,-90.234375
58,12,9,1106,512,594,116.015625
58,12,10,602,1024,-422,-41.2109375
58,12,11,1518,2048,-530,-25.87890625
58,12,12,1917,4096,-2179,-53.1982421875
58,12,13,2133,8192,-6059,-73.96240234375
58,12,14,6762,16384,-9622,-58.72802734375
58,12,15,36862,32768,4094,12.493896484375
58,13,1,0,2,-2,-100.0
58,13,2,2,4,-2,-50.0
58,13,3,4,8,-4,-50.0
58,13,4,4,16,-12,-75.0
58,13,5,13,32,-19,-59.375
58,13,6,73,64,9,14.0625
58,13,7,117,128,-11,-8.59375
58,13,8,97,256,-159,-62.109375
58,13,9,1173,512,661,129.1015625
58,13,10,866,1024,-158,-15.4296875
58,13,11,2004,2048,-44,-2.1484375
58,13,12,3135,4096,-961,-23.4619140625
58,13,13,449,8192,-7743,-94.51904296875
58,13,14,41073,16384,24689,150.689697265625
58,13,15,19896,32768,-12872,-39.2822265625
58,14,1,0,2,-2,-100.0
58,14,2,1,4,-3,-75.0
58,14,3,4,8,-4,-50.0
58,14,4,7,16,-9,-56.25
58,14,5,5,32,-27,-84.375
58,14,6,23,64,-41,-64.0625
58,14,7,265,128,137,107.03125
58,14,8,439,256,183,71.484375
58,14,9,361,512,-151,-29.4921875
58,14,10,533,1024,-491,-47.94921875
58,14,11,98,2048,-1950,-95.21484375
58,14,12,3967,4096,-129,-3.1494140625
58,14,13,3718,8192,-4474,-54.6142578125
58,14,14,4182,16384,-12202,-74.47509765625
58,14,15,21839,32768,-10929,-33.3526611328125
58,15,1,0,2,-2,-100.0
58,15,2,1,4,-3,-75.0
58,15,3,2,8,-6,-75.0
58,15,4,21,16,5,31.25
58,15,5,62,32,30,93.75
58,15,6,182,64,118,184.375
58,15,7,190,128,62,48.4375
58,15,8,22,256,-234,-91.40625
58,15,9,166,512,-346,-67.578125
58,15,10,172,1024,-852,-83.203125
58,15,11,16,2048,-2032,-99.21875
58,15,12,1147,4096,-2949,-71.9970703125
58,15,13,7862,8192,-330,-4.0283203125
58,15,14,28310,16384,11926,72.79052734375
58,15,15,34495,32768,1727,5.2703857421875
58,16,1,0,2,-2,-100.0
58,16,2,1,4,-3,-75.0
58,16,3,2,8,-6,-75.0
58,16,4,11,16,-5,-31.25
58,16,5,39,32,7,21.875
58,16,6,86,64,22,34.375
58,16,7,47,128,-81,-63.28125
58,16,8,481,256,225,87.890625
58,16,9,106,512,-406,-79.296875
58,16,10,1016,1024,-8,-0.78125
58,16,11,501,2048,-1547,-75.537109375
58,16,12,3874,4096,-222,-5.419921875
58,16,13,4081,8192,-4111,-50.18310546875
58,16,14,1159,16384,-15225,-92.926025390625
58,16,15,138715,32768,105947,323.3245849609375
58,17,1,0,2,-2,-100.0
58,17,2,2,4,-2,-50.0
58,17,3,12,8,4,50.0
58,17,4,5,16,-11,-68.75
58,17,5,61,32,29,90.625
58,17,6,147,64,83,129.6875
58,17,7,102,128,-26,-20.3125
58,17,8,398,256,142,55.46875
58,17,9,249,512,-263,-51.3671875
58,17,10,736,1024,-288,-28.125
58,17,11,1686,2048,-362,-17.67578125
58,17,12,5175,4096,1079,26.3427734375
58,17,13,14868,8192,6676,81.494140625
58,17,14,15051,16384,-1333,-8.135986328125
58,17,15,38154,32768,5386,16.436767578125
58,18,1,0,2,-2,-100.0
58,18,2,1,4,-3,-75.0
58,18,3,6,8,-2,-25.0
58,18,4,10,16,-6,-37.5
58,18,5,17,32,-15,-46.875
58,18,6,9,64,-55,-85.9375
58,18,7,50,128,-78,-60.9375
58,18,8,1451,256,1195,466.796875
58,18,9,208,512,-304,-59.375
58,18,10,1262,1024,238,23.2421875
58,18,11,1849,2048,-199,-9.716796875
58,18,12,7581,4096,3485,85.0830078125
58,18,13,12289,8192,4097,50.01220703125
58,18,14,567,16384,-15817,-96.539306640625
58,18,15,33250,32768,482,1.470947265625
58,19,1,0,2,-2,-100.0
58,19,2,3,4,-1,-25.0
58,19,3,3,8,-5,-62.5
58,19,4,14,16,-2,-12.5
58,19,5,8,32,-24,-75.0
58,19,6,12,64,-52,-81.25
58,19,7,104,128,-24,-18.75
58,19,8,150,256,-106,-41.40625
58,19,9,225,512,-287,-56.0546875
58,19,10,153,1024,-871,-85.05859375
58,19,11,357,2048,-1691,-82.568359375
58,19,12,10262,4096,6166,150.537109375
58,19,13,38216,8192,30024,366.50390625
58,19,14,10084,16384,-6300,-38.4521484375
58,19,15,15352,32768,-17416,-53.1494140625
58,20,1,0,2,-2,-100.0
58,20,2,1,4,-3,-75.0
58,20,3,2,8,-6,-75.0
58,20,4,3,16,-13,-81.25
58,20,5,7,32,-25,-78.125
58,20,6,20,64,-44,-68.75
58,20,7,70,128,-58,-45.3125
58,20,8,492,256,236,92.1875
58,20,9,726,512,214,41.796875
58,20,10,567,1024,-457,-44.62890625
58,20,11,1482,2048,-566,-27.63671875
58,20,12,3615,4096,-481,-11.7431640625
58,20,13,3046,8192,-5146,-62.8173828125
58,20,14,14452,16384,-1932,-11.7919921875
58,20,15,54569,32768,21801,66.5313720703125
58,21,1,0,2,-2,-100.0
58,21,2,1,4,-3,-75.0
58,21,3,3,8,-5,-62.5
58,21,4,17,16,1,6.25
58,21,5,23,32,-9,-28.125
58,21,6,15,64,-49,-76.5625
58,21,7,169,128,41,32.03125
58,21,8,129,256,-127,-49.609375
58,21,9,85,512,-427,-83.3984375
58,21,10,178,1024,-846,-82.6171875
58,21,11,3548,2048,1500,73.2421875
58,21,12,782,4096,-3314,-80.908203125
58,21,13,12438,8192,4246,51.8310546875
58,21,14,1578,16384,-14806,-90.36865234375
58,21,15,20283,32768,-12485,-38.1011962890625
58,22,1,0,2,-2,-100.0
58,22,2,1,4,-3,-75.0
58,22,3,2,8,-6,-75.0
58,22,4,12,16,-4,-25.0
58,22,5,4,32,-28,-87.5
58,22,6,124,64,60,93.75
58,22,7,25,128,-103,-80.46875
58,22,8,106,256,-150,-58.59375
58,22,9,615,512,103,20.1171875
58,22,10,601,1024,-423,-41.30859375
58,22,11,4188,2048,2140,104.4921875
58,22,12,9114,4096,5018,122.509765625
58,22,13,13626,8192,5434,66.3330078125
58,22,14,53467,16384,37083,226.336669921875
58,22,15,39695,32768,6927,21.1395263671875
58,23,1,0,2,-2,-100.0
58,23,2,3,4,-1,-25.0
58,23,3,3,8,-5,-62.5
58,23,4,16,16,0,0.0
58,23,5,52,32,20,62.5
58,23,6,18,64,-46,-71.875
58,23,7,171,128,43,33.59375
58,23,8,207,256,-49,-19.140625
58,23,9,230,512,-282,-55.078125
58,23,10,2476,1024,1452,141.796875
58,23,11,2269,2048,221,10.791015625
58,23,12,1560,4096,-2536,-61.9140625
58,23,13,10823,8192,2631,32.11669921875
58,23,14,6171,16384,-10213,-62.335205078125
58,23,15,19878,32768,-12890,-39.337158203125
58,24,1,0,2,-2,-100.0
58,24,2,1,4,-3,-75.0
58,24,3,8,8,0,0.0
58,24,4,9,16,-7,-43.75
58,24,5,61,32,29,90.625
58,24,6,5,64,-59,-92.1875
58,24,7,54,128,-74,-57.8125
58,24,8,30,256,-226,-88.28125
58,24,9,661,512,149,29.1015625
58,24,10,166,1024,-858,-83.7890625
58,24,11,5175,2048,3127,152.685546875
58,24,12,830,4096,-3266,-79.736328125
58,24,13,12490,8192,4298,52.4658203125
58,24,14,35559,16384,19175,117.034912109375
58,24,15,1992,32768,-30776,-93.9208984375
58,25,1,0,2,-2,-100.0
58,25,2,2,4,-2,-50.0
58,25,3,8,8,0,0.0
58,25,4,9,16,-7,-43.75
58,25,5,85,32,53,165.625
58,25,6,23,64,-41,-64.0625
58,25,7,60,128,-68,-53.125
58,25,8,626,256,370,144.53125
58,25,9,28,512,-484,-94.53125
58,25,10,977,1024,-47,-4.58984375
58,25,11,4634,2048,2586,126.26953125
58,25,12,850,4096,-3246,-79.248046875
58,25,13,5728,8192,-2464,-30.078125
58,25,14,24820,16384,8436,51.4892578125
58,25,15,8905,32768,-23863,-72.8240966796875
58,26,1,0,2,-2,-100.0
58,26,2,4,4,0,0.0
58,26,3,12,8,4,50.0
58,26,4,16,16,0,0.0
58,26,5,16,32,-16,-50.0
58,26,6,51,64,-13,-20.3125
58,26,7,194,128,66,51.5625
58,26,8,81,256,-175,-68.359375
58,26,9,61,512,-451,-88.0859375
58,26,10,39,1024,-985,-96.19140625
58,26,11,2227,2048,179,8.740234375
58,26,12,2118,4096,-1978,-48.291015625
58,26,13,1397,8192,-6795,-82.94677734375
58,26,14,6169,16384,-10215,-62.347412109375
58,26,15,3271,32768,-29497,-90.0177001953125
58,27,1,0,2,-2,-100.0
58,27,2,1,4,-3,-75.0
58,27,3,2,8,-6,-75.0
58,27,4,32,16,16,100.0
58,27,5,20,32,-12,-37.5
58,27,6,34,64,-30,-46.875
58,27,7,15,128,-113,-88.28125
58,27,8,126,256,-130,-50.78125
58,27,9,1107,512,595,116.2109375
58,27,10,230,1024,-794,-77.5390625
58,27,11,822,2048,-1226,-59.86328125
58,27,12,4348,4096,252,6.15234375
58,27,13,25756,8192,17564,214.404296875
58,27,14,9567,16384,-6817,-41.607666015625
58,27,15,41321,32768,8553,26.1016845703125
58,28,1,0,2,-2,-100.0
58,28,2,1,4,-3,-75.0
58,28,3,9,8,1,12.5
58,28,4,22,16,6,37.5
58,28,5,10,32,-22,-68.75
58,28,6,65,64,1,1.5625
58,28,7,292,128,164,128.125
58,28,8,78,256,-178,-69.53125
58,28,9,2078,512,1566,305.859375
58,28,10,3409,1024,2385,232.91015625
58,28,11,1999,2048,-49,-2.392578125
58,28,12,1224,4096,-2872,-70.1171875
58,28,13,60,8192,-8132,-99.267578125
58,28,14,61779,16384,45395,277.069091796875
58,28,15,36510,32768,3742,11.419677734375
58,29,1,0,2,-2,-100.0
58,29,2,1,4,-3,-75.0
58,29,3,2,8,-6,-75.0
58,29,4,14,16,-2,-12.5
58,29,5,5,32,-27,-84.375
58,29,6,202,64,138,215.625
58,29,7,132,128,4,3.125
58,29,8,593,256,337,131.640625
58,29,9,855,512,343,66.9921875
58,29,10,103,1024,-921,-89.94140625
58,29,11,1695,2048,-353,-17.236328125
58,29,12,5689,4096,1593,38.8916015625
58,29,13,1852,8192,-6340,-77.392578125
58,29,14,1339,16384,-15045,-91.827392578125
58,29,15,35458,32768,2690,8.209228515625
58,30,1,0,2,-2,-100.0
58,30,2,1,4,-3,-75.0
58,30,3,2,8,-6,-75.0
58,30,4,13,16,-3,-18.75
58,30,5,25,32,-7,-21.875
58,30,6,27,64,-37,-57.8125
58,30,7,8,128,-120,-93.75
58,30,8,460,256,204,79.6875
58,30,9,412,512,-100,-19.53125
58,30,10,661,1024,-363,-35.44921875
58,30,11,32,2048,-2016,-98.4375
58,30,12,3539,4096,-557,-13.5986328125
58,30,13,22449,8192,14257,174.03564453125
58,30,14,16860,16384,476,2.9052734375
58,30,15,17424,32768,-15344,-46.826171875
58,31,1,0,2,-2,-100.0
58,31,2,1,4,-3,-75.0
58,31,3,5,8,-3,-37.5
58,31,4,20,16,4,25.0
58,31,5,29,32,-3,-9.375
58,31,6,26,64,-38,-59.375
58,31,7,65,128,-63,-49.21875
58,31,8,7,256,-249,-97.265625
58,31,9,219,512,-293,-57.2265625
58,31,10,529,1024,-495,-48.33984375
58,31,11,1014,2048,-1034,-50.48828125
58,31,12,8616,4096,4520,110.3515625
58,31,13,3976,8192,-4216,-51.46484375
58,31,14,58404,16384,42020,256.4697265625
58,31,15,21249,32768,-11519,-35.1531982421875
58,32,1,0,2,-2,-100.0
58,32,2,2,4,-2,-50.0
58,32,3,5,8,-3,-37.5
58,32,4,12,16,-4,-25.0
58,32,5,9,32,-23,-71.875
58,32,6,196,64,132,206.25
58,32,7,207,128,79,61.71875
58,32,8,56,256,-200,-78.125
58,32,9,319,512,-193,-37.6953125
58,32,10,307,1024,-717,-70.01953125
58,32,11,1323,2048,-725,-35.400390625
58,32,12,2568,4096,-1528,-37.3046875
58,32,13,1832,8192,-6360,-77.63671875
58,32,14,3098,16384,-13286,-81.09130859375
58,32,15,2027,32768,-30741,-93.8140869140625
58,33,1,0,2,-2,-100.0
58,33,2,6,4,2,50.0
58,33,3,6,8,-2,-25.0
58,33,4,15,16,-1,-6.25
58,33,5,37,32,5,15.625
58,33,6,23,64,-41,-64.0625
58,33,7,200,128,72,56.25
58,33,8,225,256,-31,-12.109375
58,33,9,344,512,-168,-32.8125
58,33,10,455,1024,-569,-55.56640625
58,33,11,1092,2048,-956,-46.6796875
58,33,12,1489,4096,-2607,-63.6474609375
58,33,13,2776,8192,-5416,-66.11328125
58,33,14,15553,16384,-831,-5.072021484375
58,33,15,11333,32768,-21435,-65.4144287109375
58,34,1,0,2,-2,-100.0
58,34,2,3,4,-1,-25.0
58,34,3,45,8,37,462.5
58,34,4,7,16,-9,-56.25
58,34,5,39,32,7,21.875
58,34,6,13,64,-51,-79.6875
58,34,7,60,128,-68,-53.125
58,34,8,64,256,-192,-75.0
58,34,9,291,512,-221,-43.1640625
58,34,10,1364,1024,340,33.203125
58,34,11,2394,2048,346,16.89453125
58,34,12,820,4096,-3276,-79.98046875
58,34,13,7096,8192,-1096,-13.37890625
58,34,14,7663,16384,-8721,-53.228759765625
58,34,15,25653,32768,-7115,-21.7132568359375
58,35,1,0,2,-2,-100.0
58,35,2,4,4,0,0.0
58,35,3,15,8,7,87.5
58,35,4,4,16,-12,-75.0
58,35,5,6,32,-26,-81.25
58,35,6,120,64,56,87.5
58,35,7,242,128,114,89.0625
58,35,8,118,256,-138,-53.90625
58,35,9,310,512,-202,-39.453125
58,35,10,1008,1024,-16,-1.5625
58,35,11,1885,2048,-163,-7.958984375
58,35,12,700,4096,-3396,-82.91015625
58,35,13,10226,8192,2034,24.8291015625
58,35,14,12994,16384,-3390,-20.69091796875
58,35,15,2422,32768,-30346,-92.608642578125
58,36,1,0,2,-2,-100.0
58,36,2,2,4,-2,-50.0
58,36,3,2,8,-6,-75.0
58,36,4,3,16,-13,-81.25
58,36,5,5,32,-27,-84.375
58,36,6,182,64,118,184.375
58,36,7,194,128,66,51.5625
58,36,8,110,256,-146,-57.03125
58,36,9,412,512,-100,-19.53125
58,36,10,89,1024,-935,-91.30859375
58,36,11,2985,2048,937,45.751953125
58,36,12,684,4096,-3412,-83.30078125
58,36,13,2941,8192,-5251,-64.09912109375
58,36,14,8923,16384,-7461,-45.538330078125
58,36,15,16052,32768,-16716,-51.01318359375
58,37,1,0,2,-2,-100.0
58,37,2,1,4,-3,-75.0
58,37,3,14,8,6,75.0
58,37,4,3,16,-13,-81.25
58,37,5,82,32,50,156.25
58,37,6,20,64,-44,-68.75
58,37,7,142,128,14,10.9375
58,37,8,47,256,-209,-81.640625
58,37,9,484,512,-28,-5.46875
58,37,10,255,1024,-769,-75.09765625
58,37,11,461,2048,-1587,-77.490234375
58,37,12,2458,4096,-1638,-39.990234375
58,37,13,31982,8192,23790,290.4052734375
58,37,14,7879,16384,-8505,-51.910400390625
58,37,15,40759,32768,7991,24.3865966796875
58,38,1,0,2,-2,-100.0
58,38,2,5,4,1,25.0
58,38,3,8,8,0,0.0
58,38,4,29,16,13,81.25
58,38,5,39,32,7,21.875
58,38,6,44,64,-20,-31.25
58,38,7,50,128,-78,-60.9375
58,38,8,1014,256,758,296.09375
58,38,9,989,512,477,93.1640625
58,38,10,383,1024,-641,-62.59765625
58,38,11,242,2048,-1806,-88.18359375
58,38,12,8644,4096,4548,111.03515625
58,38,13,10956,8192,2764,33.740234375
58,38,14,28758,16384,12374,75.52490234375
58,38,15,12340,32768,-20428,-62.34130859375
58,39,1,0,2,-2,-100.0
58,39,2,4,4,0,0.0
58,39,3,5,8,-3,-37.5
58,39,4,3,16,-13,-81.25
58,39,5,8,32,-24,-75.0
58,39,6,11,64,-53,-82.8125
58,39,7,13,128,-115,-89.84375
58,39,8,166,256,-90,-35.15625
58,39,9,1015,512,503,98.2421875
58,39,10,1355,1024,331,32.32421875
58,39,11,325,2048,-1723,-84.130859375
58,39,12,4218,4096,122,2.978515625
58,39,13,601,8192,-7591,-92.66357421875
58,39,14,10995,16384,-5389,-32.891845703125
58,39,15,13451,32768,-19317,-58.9508056640625
58,40,1,0,2,-2,-100.0
58,40,2,2,4,-2,-50.0
58,40,3,2,8,-6,-75.0
58,40,4,27,16,11,68.75
58,40,5,17,32,-15,-46.875
58,40,6,25,64,-39,-60.9375
58,40,7,277,128,149,116.40625
58,40,8,566,256,310,121.09375
58,40,9,1555,512,1043,203.7109375
58,40,10,832,1024,-192,-18.75
58,40,11,1452,2048,-596,-29.1015625
58,40,12,6710,4096,2614,63.818359375
58,40,13,12271,8192,4079,49.79248046875
58,40,14,49372,16384,32988,201.3427734375
58,40,15,37522,32768,4754,14.508056640625
58,41,1,0,2,-2,-100.0
58,41,2,4,4,0,0.0
58,41,3,6,8,-2,-25.0
58,41,4,12,16,-4,-25.0
58,41,5,118,32,86,268.75
58,41,6,35,64,-29,-45.3125
58,41,7,135,128,7,5.46875
58,41,8,19,256,-237,-92.578125
58,41,9,967,512,455,88.8671875
58,41,10,347,1024,-677,-66.11328125
58,41,11,899,2048,-1149,-56.103515625
58,41,12,1283,4096,-2813,-68.6767578125
58,41,13,2353,8192,-5839,-71.27685546875
58,41,14,9228,16384,-7156,-43.6767578125
58,41,15,32915,32768,147,0.4486083984375
58,42,1,0,2,-2,-100.0
58,42,2,1,4,-3,-75.0
58,42,3,4,8,-4,-50.0
58,42,4,13,16,-3,-18.75
58,42,5,25,32,-7,-21.875
58,42,6,48,64,-16,-25.0
58,42,7,136,128,8,6.25
58,42,8,39,256,-217,-84.765625
58,42,9,581,512,69,13.4765625
58,42,10,198,1024,-826,-80.6640625
58,42,11,2206,2048,158,7.71484375
58,42,12,3153,4096,-943,-23.0224609375
58,42,13,11761,8192,3569,43.56689453125
58,42,14,27671,16384,11287,68.890380859375
58,42,15,80946,32768,48178,147.027587890625
58,43,1,0,2,-2,-100.0
58,43,2,1,4,-3,-75.0
58,43,3,3,8,-5,-62.5
58,43,4,5,16,-11,-68.75
58,43,5,4,32,-28,-87.5
58,43,6,47,64,-17,-26.5625
58,43,7,34,128,-94,-73.4375
58,43,8,286,256,30,11.71875
58,43,9,16,512,-496,-96.875
58,43,10,346,1024,-678,-66.2109375
58,43,11,858,2048,-1190,-58.10546875
58,43,12,6294,4096,2198,53.662109375
58,43,13,3013,8192,-5179,-63.22021484375
58,43,14,9552,16384,-6832,-41.69921875
58,43,15,44004,32768,11236,34.28955078125
58,44,1,0,2,-2,-100.0
58,44,2,5,4,1,25.0
58,44,3,22,8,14,175.0
58,44,4,8,16,-8,-50.0
58,44,5,32,32,0,0.0
58,44,6,78,64,14,21.875
58,44,7,583,128,455,355.46875
58,44,8,154,256,-102,-39.84375
58,44,9,752,512,240,46.875
58,44,10,75,1024,-949,-92.67578125
58,44,11,1371,2048,-677,-33.056640625
58,44,12,7004,4096,2908,70.99609375
58,44,13,18941,8192,10749,131.21337890625
58,44,14,2151,16384,-14233,-86.871337890625
58,44,15,33362,32768,594,1.812744140625
58,45,1,0,2,-2,-100.0
58,45,2,1,4,-3,-75.0
58,45,3,2,8,-6,-75.0
58,45,4,17,16,1,6.25
58,45,5,54,32,22,68.75
58,45,6,43,64,-21,-32.8125
58,45,7,108,128,-20,-15.625
58,45,8,262,256,6,2.34375
58,45,9,89,512,-423,-82.6171875
58,45,10,694,1024,-330,-32.2265625
58,45,11,2303,2048,255,12.451171875
58,45,12,224,4096,-3872,-94.53125
58,45,13,923,8192,-7269,-88.73291015625
58,45,14,29163,16384,12779,77.996826171875
58,45,15,67047,32768,34279,104.6112060546875
58,46,1,0,2,-2,-100.0
58,46,2,1,4,-3,-75.0
58,46,3,2,8,-6,-75.0
58,46,4,33,16,17,106.25
58,46,5,18,32,-14,-43.75
58,46,6,68,64,4,6.25
58,46,7,144,128,16,12.5
58,46,8,158,256,-98,-38.28125
58,46,9,922,512,410,80.078125
58,46,10,1395,1024,371,36.23046875
58,46,11,524,2048,-1524,-74.4140625
58,46,12,1503,4096,-2593,-63.3056640625
58,46,13,6265,8192,-1927,-23.52294921875
58,46,14,3846,16384,-12538,-76.52587890625
58,46,15,16991,32768,-15777,-48.1475830078125
58,47,1,0,2,-2,-100.0
58,47,2,2,4,-2,-50.0
58,47,3,6,8,-2,-25.0
58,47,4,16,16,0,0.0
58,47,5,88,32,56,175.0
58,47,6,6,64,-58,-90.625
58,47,7,84,128,-44,-34.375
58,47,8,909,256,653,255.078125
58,47,9,675,512,163,31.8359375
58,47,10,1256,1024,232,22.65625
58,47,11,4735,2048,2687,131.201171875
58,47,12,1420,4096,-2676,-65.33203125
58,47,13,23676,8192,15484,189.013671875
58,47,14,1518,16384,-14866,-90.73486328125
58,47,15,9105,32768,-23663,-72.2137451171875
58,48,1,0,2,-2,-100.0
58,48,2,1,4,-3,-75.0
58,48,3,3,8,-5,-62.5
58,48,4,3,16,-13,-81.25
58,48,5,53,32,21,65.625
58,48,6,16,64,-48,-75.0
58,48,7,178,128,50,39.0625
58,48,8,96,256,-160,-62.5
58,48,9,290,512,-222,-43.359375
58,48,10,1409,1024,385,37.59765625
58,48,11,4329,2048,2281,111.376953125
58,48,12,6920,4096,2824,68.9453125
58,48,13,5286,8192,-2906,-35.4736328125
58,48,14,117,16384,-16267,-99.285888671875
58,48,15,9889,32768,-22879,-69.8211669921875
58,49,1,0,2,-2,-100.0
58,49,2,3,4,-1,-25.0
58,49,3,14,8,6,75.0
58,49,4,3,16,-13,-81.25
58,49,5,14,32,-18,-56.25
58,49,6,10,64,-54,-84.375
58,49,7,15,128,-113,-88.28125
58,49,8,532,256,276,107.8125
58,49,9,72,512,-440,-85.9375
58,49,10,1024,1024,0,0.0
58,49,11,4268,2048,2220,108.3984375
58,49,12,711,4096,-3385,-82.6416015625
58,49,13,1982,8192,-6210,-75.8056640625
58,49,14,6079,16384,-10305,-62.896728515625
58,49,15,27362,32768,-5406,-16.497802734375
58,50,1,0,2,-2,-100.0
58,50,2,1,4,-3,-75.0
58,50,3,7,8,-1,-12.5
58,50,4,3,16,-13,-81.25
58,50,5,18,32,-14,-43.75
58,50,6,20,64,-44,-68.75
58,50,7,48,128,-80,-62.5
58,50,8,247,256,-9,-3.515625
58,50,9,85,512,-427,-83.3984375
58,50,10,2070,1024,1046,102.1484375
58,50,11,350,2048,-1698,-82.91015625
58,50,12,1901,4096,-2195,-53.5888671875
58,50,13,9204,8192,1012,12.353515625
58,50,14,1361,16384,-15023,-91.693115234375
58,50,15,5661,32768,-27107,-82.7239990234375
58,51,1,0,2,-2,-100.0
58,51,2,1,4,-3,-75.0
58,51,3,4,8,-4,-50.0
58,51,4,10,16,-6,-37.5
58,51,5,20,32,-12,-37.5
58,51,6,24,64,-40,-62.5
58,51,7,119,128,-9,-7.03125
58,51,8,223,256,-33,-12.890625
58,51,9,1424,512,912,178.125
58,51,10,1434,1024,410,40.0390625
58,51,11,1765,2048,-283,-13.818359375
58,51,12,544,4096,-3552,-86.71875
58,51,13,2161,8192,-6031,-73.62060546875
58,51,14,2309,16384,-14075,-85.906982421875
58,51,15,13991,32768,-18777,-57.3028564453125
58,52,1,0,2,-2,-100.0
58,52,2,3,4,-1,-25.0
58,52,3,5,8,-3,-37.5
58,52,4,20,16,4,25.0
58,52,5,4,32,-28,-87.5
58,52,6,124,64,60,93.75
58,52,7,225,128,97,75.78125
58,52,8,249,256,-7,-2.734375
58,52,9,882,512,370,72.265625
58,52,10,341,1024,-683,-66.69921875
58,52,11,653,2048,-1395,-68.115234375
58,52,12,2357,4096,-1739,-42.4560546875
58,52,13,68,8192,-8124,-99.169921875
58,52,14,44028,16384,27644,168.7255859375
58,52,15,41599,32768,8831,26.9500732421875
58,53,1,0,2,-2,-100.0
58,53,2,2,4,-2,-50.0
58,53,3,3,8,-5,-62.5
58,53,4,9,16,-7,-43.75
58,53,5,5,32,-27,-84.375
58,53,6,141,64,77,120.3125
58,53,7,116,128,-12,-9.375
58,53,8,290,256,34,13.28125
58,53,9,529,512,17,3.3203125
58,53,10,2743,1024,1719,167.87109375
58,53,11,1865,2048,-183,-8.935546875
58,53,12,1149,4096,-2947,-71.9482421875
58,53,13,205,8192,-7987,-97.49755859375
58,53,14,8777,16384,-7607,-46.429443359375
58,53,15,53091,32768,20323,62.0208740234375
58,54,1,0,2,-2,-100.0
58,54,2,3,4,-1,-25.0
58,54,3,17,8,9,112.5
58,54,4,24,16,8,50.0
58,54,5,23,32,-9,-28.125
58,54,6,15,64,-49,-76.5625
58,54,7,118,128,-10,-7.8125
58,54,8,143,256,-113,-44.140625
58,54,9,878,512,366,71.484375
58,54,10,63,1024,-961,-93.84765625
58,54,11,747,2048,-1301,-63.525390625
58,54,12,11074,4096,6978,170.361328125
58,54,13,1092,8192,-7100,-86.669921875
58,54,14,3215,16384,-13169,-80.377197265625
58,54,15,25452,32768,-7316,-22.32666015625
58,55,1,0,2,-2,-100.0
58,55,2,1,4,-3,-75.0
58,55,3,9,8,1,12.5
58,55,4,5,16,-11,-68.75
58,55,5,10,32,-22,-68.75
58,55,6,74,64,10,15.625
58,55,7,58,128,-70,-54.6875
58,55,8,292,256,36,14.0625
58,55,9,471,512,-41,-8.0078125
58,55,10,602,1024,-422,-41.2109375
58,55,11,657,2048,-1391,-67.919921875
58,55,12,2765,4096,-1331,-32.4951171875
58,55,13,13327,8192,5135,62.68310546875
58,55,14,12045,16384,-4339,-26.483154296875
58,55,15,23085,32768,-9683,-29.5501708984375
58,56,1,0,2,-2,-100.0
58,56,2,1,4,-3,-75.0
58,56,3,7,8,-1,-12.5
58,56,4,18,16,2,12.5
58,56,5,31,32,-1,-3.125
58,56,6,57,64,-7,-10.9375
58,56,7,84,128,-44,-34.375
58,56,8,35,256,-221,-86.328125
58,56,9,154,512,-358,-69.921875
58,56,10,737,1024,-287,-28.02734375
58,56,11,251,2048,-1797,-87.744140625
58,56,12,628,4096,-3468,-84.66796875
58,56,13,22789,8192,14597,178.18603515625
58,56,14,14912,16384,-1472,-8.984375
58,56,15,7870,32768,-24898,-75.982666015625
58,57,1,0,2,-2,-100.0
58,57,2,1,4,-3,-75.0
58,57,3,3,8,-5,-62.5
58,57,4,26,16,10,62.5
58,57,5,4,32,-28,-87.5
58,57,6,53,64,-11,-17.1875
58,57,7,16,128,-112,-87.5
58,57,8,99,256,-157,-61.328125
58,57,9,94,512,-418,-81.640625
58,57,10,1329,1024,305,29.78515625
58,57,11,1212,2048,-836,-40.8203125
58,57,12,3401,4096,-695,-16.9677734375
58,57,13,2456,8192,-5736,-70.01953125
58,57,14,12988,16384,-3396,-20.7275390625
58,57,15,7627,32768,-25141,-76.7242431640625
58,58,1,0,2,-2,-100.0
58,58,2,2,4,-2,-50.0
58,58,3,5,8,-3,-37.5
58,58,4,9,16,-7,-43.75
58,58,5,12,32,-20,-62.5
58,58,6,7,64,-57,-89.0625
58,58,7,88,128,-40,-31.25
58,58,8,62,256,-194,-75.78125
58,58,9,212,512,-300,-58.59375
58,58,10,525,1024,-499,-48.73046875
58,58,11,1219,2048,-829,-40.478515625
58,58,12,9540,4096,5444,132.91015625
58,58,13,5079,8192,-3113,-38.00048828125
58,58,14,29283,16384,12899,78.729248046875
58,58,15,3917,32768,-28851,-88.0462646484375
59,1,1,0,2,-2,-100.0
59,1,2,1,4,-3,-75.0
59,1,3,2,8,-6,-75.0
59,1,4,9,16,-7,-43.75
59,1,5,5,32,-27,-84.375
59,1,6,27,64,-37,-57.8125
59,1,7,18,128,-110,-85.9375
59,1,8,23,256,-233,-91.015625
59,1,9,757,512,245,47.8515625
59,1,10,437,1024,-587,-57.32421875
59,1,11,3597,2048,1549,75.634765625
59,1,12,15850,4096,11754,286.962890625
59,1,13,1025,8192,-7167,-87.48779296875
59,1,14,1500,16384,-14884,-90.8447265625
59,1,15,5671,32768,-27097,-82.6934814453125
59,2,1,0,2,-2,-100.0
59,2,2,5,4,1,25.0
59,2,3,2,8,-6,-75.0
59,2,4,14,16,-2,-12.5
59,2,5,8,32,-24,-75.0
59,2,6,38,64,-26,-40.625
59,2,7,51,128,-77,-60.15625
59,2,8,47,256,-209,-81.640625
59,2,9,355,512,-157,-30.6640625
59,2,10,1079,1024,55,5.37109375
59,2,11,1215,2048,-833,-40.673828125
59,2,12,2038,4096,-2058,-50.244140625
59,2,13,3224,8192,-4968,-60.64453125
59,2,14,12750,16384,-3634,-22.18017578125
59,2,15,27048,32768,-5720,-17.4560546875
59,3,1,0,2,-2,-100.0
59,3,2,1,4,-3,-75.0
59,3,3,4,8,-4,-50.0
59,3,4,22,16,6,37.5
59,3,5,18,32,-14,-43.75
59,3,6,47,64,-17,-26.5625
59,3,7,241,128,113,88.28125
59,3,8,167,256,-89,-34.765625
59,3,9,202,512,-310,-60.546875
59,3,10,57,1024,-967,-94.43359375
59,3,11,1401,2048,-647,-31.591796875
59,3,12,1401,4096,-2695,-65.7958984375
59,3,13,3958,8192,-4234,-51.6845703125
59,3,14,2189,16384,-14195,-86.639404296875
59,3,15,65654,32768,32886,100.360107421875
59,4,1,0,2,-2,-100.0
59,4,2,1,4,-3,-75.0
59,4,3,2,8,-6,-75.0
59,4,4,39,16,23,143.75
59,4,5,35,32,3,9.375
59,4,6,45,64,-19,-29.6875
59,4,7,534,128,406,317.1875
59,4,8,190,256,-66,-25.78125
59,4,9,767,512,255,49.8046875
59,4,10,535,1024,-489,-47.75390625
59,4,11,2018,2048,-30,-1.46484375
59,4,12,994,4096,-3102,-75.732421875
59,4,13,4661,8192,-3531,-43.10302734375
59,4,14,22681,16384,6297,38.433837890625
59,4,15,491,32768,-32277,-98.5015869140625
59,5,1,0,2,-2,-100.0
59,5,2,2,4,-2,-50.0
59,5,3,4,8,-4,-50.0
59,5,4,19,16,3,18.75
59,5,5,7,32,-25,-78.125
59,5,6,38,64,-26,-40.625
59,5,7,223,128,95,74.21875
59,5,8,90,256,-166,-64.84375
59,5,9,870,512,358,69.921875
59,5,10,95,1024,-929,-90.72265625
59,5,11,434,2048,-1614,-78.80859375
59,5,12,127,4096,-3969,-96.8994140625
59,5,13,155,8192,-8037,-98.10791015625
59,5,14,5665,16384,-10719,-65.423583984375
59,5,15,52119,32768,19351,59.0545654296875
59,6,1,0,2,-2,-100.0
59,6,2,2,4,-2,-50.0
59,6,3,12,8,4,50.0
59,6,4,25,16,9,56.25
59,6,5,9,32,-23,-71.875
59,6,6,85,64,21,32.8125
59,6,7,129,128,1,0.78125
59,6,8,390,256,134,52.34375
59,6,9,95,512,-417,-81.4453125
59,6,10,2152,1024,1128,110.15625
59,6,11,1422,2048,-626,-30.56640625
59,6,12,5903,4096,1807,44.1162109375
59,6,13,1912,8192,-6280,-76.66015625
59,6,14,9003,16384,-7381,-45.050048828125
59,6,15,37488,32768,4720,14.404296875
59,7,1,0,2,-2,-100.0
59,7,2,1,4,-3,-75.0
59,7,3,5,8,-3,-37.5
59,7,4,40,16,24,150.0
59,7,5,37,32,5,15.625
59,7,6,24,64,-40,-62.5
59,7,7,138,128,10,7.8125
59,7,8,378,256,122,47.65625
59,7,9,1276,512,764,149.21875
59,7,10,3560,1024,2536,247.65625
59,7,11,1688,2048,-360,-17.578125
59,7,12,3448,4096,-648,-15.8203125
59,7,13,10340,8192,2148,26.220703125
59,7,14,478,16384,-15906,-97.08251953125
59,7,15,4070,32768,-28698,-87.579345703125
59,8,1,0,2,-2,-100.0
59,8,2,4,4,0,0.0
59,8,3,7,8,-1,-12.5
59,8,4,24,16,8,50.0
59,8,5,49,32,17,53.125
59,8,6,111,64,47,73.4375
59,8,7,7,128,-121,-94.53125
59,8,8,23,256,-233,-91.015625
59,8,9,57,512,-455,-88.8671875
59,8,10,739,1024,-285,-27.83203125
59,8,11,2468,2048,420,20.5078125
59,8,12,6596,4096,2500,61.03515625
59,8,13,386,8192,-7806,-95.2880859375
59,8,14,3999,16384,-12385,-75.592041015625
59,8,15,38399,32768,5631,17.1844482421875
59,9,1,0,2,-2,-100.0
59,9,2,1,4,-3,-75.0
59,9,3,5,8,-3,-37.5
59,9,4,10,16,-6,-37.5
59,9,5,20,32,-12,-37.5
59,9,6,207,64,143,223.4375
59,9,7,69,128,-59,-46.09375
59,9,8,477,256,221,86.328125
59,9,9,365,512,-147,-28.7109375
59,9,10,893,1024,-131,-12.79296875
59,9,11,8154,2048,6106,298.14453125
59,9,12,333,4096,-3763,-91.8701171875
59,9,13,6889,8192,-1303,-15.90576171875
59,9,14,11693,16384,-4691,-28.631591796875
59,9,15,3433,32768,-29335,-89.5233154296875
59,10,1,0,2,-2,-100.0
59,10,2,2,4,-2,-50.0
59,10,3,2,8,-6,-75.0
59,10,4,4,16,-12,-75.0
59,10,5,14,32,-18,-56.25
59,10,6,174,64,110,171.875
59,10,7,115,128,-13,-10.15625
59,10,8,69,256,-187,-73.046875
59,10,9,91,512,-421,-82.2265625
59,10,10,168,1024,-856,-83.59375
59,10,11,1578,2048,-470,-22.94921875
59,10,12,134,4096,-3962,-96.728515625
59,10,13,2543,8192,-5649,-68.95751953125
59,10,14,5832,16384,-10552,-64.404296875
59,10,15,32217,32768,-551,-1.6815185546875
59,11,1,0,2,-2,-100.0
59,11,2,2,4,-2,-50.0
59,11,3,2,8,-6,-75.0
59,11,4,18,16,2,12.5
59,11,5,23,32,-9,-28.125
59,11,6,72,64,8,12.5
59,11,7,78,128,-50,-39.0625
59,11,8,596,256,340,132.8125
59,11,9,1468,512,956,186.71875
59,11,10,517,1024,-507,-49.51171875
59,11,11,8647,2048,6599,322.216796875
59,11,12,1400,4096,-2696,-65.8203125
59,11,13,13880,8192,5688,69.43359375
59,11,14,1373,16384,-15011,-91.619873046875
59,11,15,14272,32768,-18496,-56.4453125
59,12,1,0,2,-2,-100.0
59,12,2,3,4,-1,-25.0
59,12,3,2,8,-6,-75.0
59,12,4,4,16,-12,-75.0
59,12,5,18,32,-14,-43.75
59,12,6,78,64,14,21.875
59,12,7,98,128,-30,-23.4375
59,12,8,21,256,-235,-91.796875
59,12,9,147,512,-365,-71.2890625
59,12,10,1655,1024,631,61.62109375
59,12,11,3445,2048,1397,68.212890625
59,12,12,3625,4096,-471,-11.4990234375
59,12,13,73,8192,-8119,-99.10888671875
59,12,14,1285,16384,-15099,-92.156982421875
59,12,15,83325,32768,50557,154.2877197265625
59,13,1,0,2,-2,-100.0
59,13,2,1,4,-3,-75.0
59,13,3,5,8,-3,-37.5
59,13,4,27,16,11,68.75
59,13,5,45,32,13,40.625
59,13,6,50,64,-14,-21.875
59,13,7,73,128,-55,-42.96875
59,13,8,33,256,-223,-87.109375
59,13,9,732,512,220,42.96875
59,13,10,982,1024,-42,-4.1015625
59,13,11,2056,2048,8,0.390625
59,13,12,575,4096,-3521,-85.9619140625
59,13,13,5409,8192,-2783,-33.97216796875
59,13,14,20924,16384,4540,27.7099609375
59,13,15,78798,32768,46030,140.472412109375
59,14,1,0,2,-2,-100.0
59,14,2,1,4,-3,-75.0
59,14,3,3,8,-5,-62.5
59,14,4,15,16,-1,-6.25
59,14,5,18,32,-14,-43.75
59,14,6,110,64,46,71.875
59,14,7,126,128,-2,-1.5625
59,14,8,149,256,-107,-41.796875
59,14,9,998,512,486,94.921875
59,14,10,433,1024,-591,-57.71484375
59,14,11,667,2048,-1381,-67.431640625
59,14,12,3644,4096,-452,-11.03515625
59,14,13,24346,8192,16154,197.1923828125
59,14,14,3737,16384,-12647,-77.191162109375
59,14,15,25013,32768,-7755,-23.6663818359375
59,15,1,0,2,-2,-100.0
59,15,2,1,4,-3,-75.0
59,15,3,8,8,0,0.0
59,15,4,42,16,26,162.5
59,15,5,28,32,-4,-12.5
59,15,6,213,64,149,232.8125
59,15,7,66,128,-62,-48.4375
59,15,8,85,256,-171,-66.796875
59,15,9,737,512,225,43.9453125
59,15,10,259,1024,-765,-74.70703125
59,15,11,10,2048,-2038,-99.51171875
59,15,12,941,4096,-3155,-77.0263671875
59,15,13,2625,8192,-5567,-67.95654296875
59,15,14,16937,16384,553,3.375244140625
59,15,15,17393,32768,-15375,-46.9207763671875
59,16,1,0,2,-2,-100.0
59,16,2,4,4,0,0.0
59,16,3,3,8,-5,-62.5
59,16,4,8,16,-8,-50.0
59,16,5,4,32,-28,-87.5
59,16,6,48,64,-16,-25.0
59,16,7,88,128,-40,-31.25
59,16,8,329,256,73,28.515625
59,16,9,842,512,330,64.453125
59,16,10,90,1024,-934,-91.2109375
59,16,11,571,2048,-1477,-72.119140625
59,16,12,10655,4096,6559,160.1318359375
59,16,13,10145,8192,1953,23.84033203125
59,16,14,17133,16384,749,4.571533203125
59,16,15,1430,32768,-31338,-95.635986328125
59,17,1,0,2,-2,-100.0
59,17,2,1,4,-3,-75.0
59,17,3,4,8,-4,-50.0
59,17,4,5,16,-11,-68.75
59,17,5,34,32,2,6.25
59,17,6,24,64,-40,-62.5
59,17,7,22,128,-106,-82.8125
59,17,8,361,256,105,41.015625
59,17,9,396,512,-116,-22.65625
59,17,10,886,1024,-138,-13.4765625
59,17,11,1251,2048,-797,-38.916015625
59,17,12,1245,4096,-2851,-69.6044921875
59,17,13,6704,8192,-1488,-18.1640625
59,17,14,17405,16384,1021,6.231689453125
59,17,15,11312,32768,-21456,-65.478515625
59,18,1,0,2,-2,-100.0
59,18,2,2,4,-2,-50.0
59,18,3,7,8,-1,-12.5
59,18,4,21,16,5,31.25
59,18,5,22,32,-10,-31.25
59,18,6,229,64,165,257.8125
59,18,7,92,128,-36,-28.125
59,18,8,90,256,-166,-64.84375
59,18,9,253,512,-259,-50.5859375
59,18,10,167,1024,-857,-83.69140625
59,18,11,5839,2048,3791,185.107421875
59,18,12,5057,4096,961,23.4619140625
59,18,13,3548,8192,-4644,-56.689453125
59,18,14,15967,16384,-417,-2.545166015625
59,18,15,51821,32768,19053,58.1451416015625
59,19,1,0,2,-2,-100.0
59,19,2,1,4,-3,-75.0
59,19,3,2,8,-6,-75.0
59,19,4,7,16,-9,-56.25
59,19,5,21,32,-11,-34.375
59,19,6,8,64,-56,-87.5
59,19,7,114,128,-14,-10.9375
59,19,8,87,256,-169,-66.015625
59,19,9,101,512,-411,-80.2734375
59,19,10,1799,1024,775,75.68359375
59,19,11,784,2048,-1264,-61.71875
59,19,12,1717,4096,-2379,-58.0810546875
59,19,13,2962,8192,-5230,-63.8427734375
59,19,14,2814,16384,-13570,-82.82470703125
59,19,15,4413,32768,-28355,-86.5325927734375
59,20,1,0,2,-2,-100.0
59,20,2,3,4,-1,-25.0
59,20,3,2,8,-6,-75.0
59,20,4,10,16,-6,-37.5
59,20,5,11,32,-21,-65.625
59,20,6,49,64,-15,-23.4375
59,20,7,187,128,59,46.09375
59,20,8,497,256,241,94.140625
59,20,9,119,512,-393,-76.7578125
59,20,10,177,1024,-847,-82.71484375
59,20,11,8981,2048,6933,338.525390625
59,20,12,7132,4096,3036,74.12109375
59,20,13,2862,8192,-5330,-65.0634765625
59,20,14,9343,16384,-7041,-42.974853515625
59,20,15,75935,32768,43167,131.7352294921875
59,21,1,0,2,-2,-100.0
59,21,2,1,4,-3,-75.0
59,21,3,11,8,3,37.5
59,21,4,16,16,0,0.0
59,21,5,50,32,18,56.25
59,21,6,97,64,33,51.5625
59,21,7,82,128,-46,-35.9375
59,21,8,29,256,-227,-88.671875
59,21,9,1260,512,748,146.09375
59,21,10,102,1024,-922,-90.0390625
59,21,11,53,2048,-1995,-97.412109375
59,21,12,1959,4096,-2137,-52.1728515625
59,21,13,7425,8192,-767,-9.36279296875
59,21,14,9385,16384,-6999,-42.718505859375
59,21,15,46284,32768,13516,41.24755859375
59,22,1,0,2,-2,-100.0
59,22,2,3,4,-1,-25.0
59,22,3,2,8,-6,-75.0
59,22,4,43,16,27,168.75
59,22,5,16,32,-16,-50.0
59,22,6,116,64,52,81.25
59,22,7,143,128,15,11.71875
59,22,8,351,256,95,37.109375
59,22,9,579,512,67,13.0859375
59,22,10,879,1024,-145,-14.16015625
59,22,11,2758,2048,710,34.66796875
59,22,12,5225,4096,1129,27.5634765625
59,22,13,6114,8192,-2078,-25.3662109375
59,22,14,60189,16384,43805,267.364501953125
59,22,15,25729,32768,-7039,-21.4813232421875
59,23,1,0,2,-2,-100.0
59,23,2,1,4,-3,-75.0
59,23,3,7,8,-1,-12.5
59,23,4,6,16,-10,-62.5
59,23,5,4,32,-28,-87.5
59,23,6,65,64,1,1.5625
59,23,7,37,128,-91,-71.09375
59,23,8,123,256,-133,-51.953125
59,23,9,1385,512,873,170.5078125
59,23,10,3164,1024,2140,208.984375
59,23,11,3733,2048,1685,82.275390625
59,23,12,2317,4096,-1779,-43.4326171875
59,23,13,29825,8192,21633,264.07470703125
59,23,14,8695,16384,-7689,-46.929931640625
59,23,15,49805,32768,17037,51.9927978515625
59,24,1,0,2,-2,-100.0
59,24,2,1,4,-3,-75.0
59,24,3,2,8,-6,-75.0
59,24,4,3,16,-13,-81.25
59,24,5,30,32,-2,-6.25
59,24,6,110,64,46,71.875
59,24,7,106,128,-22,-17.1875
59,24,8,243,256,-13,-5.078125
59,24,9,1218,512,706,137.890625
59,24,10,84,1024,-940,-91.796875
59,24,11,9271,2048,7223,352.685546875
59,24,12,1627,4096,-2469,-60.2783203125
59,24,13,1389,8192,-6803,-83.04443359375
59,24,14,11778,16384,-4606,-28.11279296875
59,24,15,10413,32768,-22355,-68.2220458984375
59,25,1,0,2,-2,-100.0
59,25,2,2,4,-2,-50.0
59,25,3,2,8,-6,-75.0
59,25,4,3,16,-13,-81.25
59,25,5,30,32,-2,-6.25
59,25,6,39,64,-25,-39.0625
59,25,7,31,128,-97,-75.78125
59,25,8,321,256,65,25.390625
59,25,9,241,512,-271,-52.9296875
59,25,10,43,1024,-981,-95.80078125
59,25,11,12,2048,-2036,-99.4140625
59,25,12,2751,4096,-1345,-32.8369140625
59,25,13,16065,8192,7873,96.10595703125
59,25,14,2607,16384,-13777,-84.088134765625
59,25,15,81534,32768,48766,148.822021484375
59,26,1,0,2,-2,-100.0
59,26,2,2,4,-2,-50.0
59,26,3,2,8,-6,-75.0
59,26,4,9,16,-7,-43.75
59,26,5,16,32,-16,-50.0
59,26,6,24,64,-40,-62.5
59,26,7,92,128,-36,-28.125
59,26,8,417,256,161,62.890625
59,26,9,52,512,-460,-89.84375
59,26,10,423,1024,-601,-58.69140625
59,26,11,3141,2048,1093,53.369140625
59,26,12,3727,4096,-369,-9.0087890625
59,26,13,3036,8192,-5156,-62.939453125
59,26,14,1305,16384,-15079,-92.034912109375
59,26,15,33014,32768,246,0.750732421875
59,27,1,0,2,-2,-100.0
59,27,2,6,4,2,50.0
59,27,3,3,8,-5,-62.5
59,27,4,11,16,-5,-31.25
59,27,5,101,32,69,215.625
59,27,6,182,64,118,184.375
59,27,7,243,128,115,89.84375
59,27,8,442,256,186,72.65625
59,27,9,1152,512,640,125.0
59,27,10,1060,1024,36,3.515625
59,27,11,1219,2048,-829,-40.478515625
59,27,12,5072,4096,976,23.828125
59,27,13,3693,8192,-4499,-54.91943359375
59,27,14,26835,16384,10451,63.787841796875
59,27,15,22882,32768,-9886,-30.169677734375
59,28,1,0,2,-2,-100.0
59,28,2,1,4,-3,-75.0
59,28,3,12,8,4,50.0
59,28,4,7,16,-9,-56.25
59,28,5,87,32,55,171.875
59,28,6,6,64,-58,-90.625
59,28,7,100,128,-28,-21.875
59,28,8,670,256,414,161.71875
59,28,9,264,512,-248,-48.4375
59,28,10,984,1024,-40,-3.90625
59,28,11,4152,2048,2104,102.734375
59,28,12,8746,4096,4650,113.525390625
59,28,13,5158,8192,-3034,-37.0361328125
59,28,14,15252,16384,-1132,-6.9091796875
59,28,15,22839,32768,-9929,-30.3009033203125
59,29,1,0,2,-2,-100.0
59,29,2,4,4,0,0.0
59,29,3,3,8,-5,-62.5
59,29,4,79,16,63,393.75
59,29,5,15,32,-17,-53.125
59,29,6,87,64,23,35.9375
59,29,7,283,128,155,121.09375
59,29,8,18,256,-238,-92.96875
59,29,9,413,512,-99,-19.3359375
59,29,10,282,1024,-742,-72.4609375
59,29,11,1077,2048,-971,-47.412109375
59,29,12,1915,4096,-2181,-53.2470703125
59,29,13,3214,8192,-4978,-60.7666015625
59,29,14,6730,16384,-9654,-58.92333984375
59,29,15,15844,32768,-16924,-51.64794921875
59,30,1,0,2,-2,-100.0
59,30,2,2,4,-2,-50.0
59,30,3,2,8,-6,-75.0
59,30,4,14,16,-2,-12.5
59,30,5,11,32,-21,-65.625
59,30,6,43,64,-21,-32.8125
59,30,7,79,128,-49,-38.28125
59,30,8,1478,256,1222,477.34375
59,30,9,203,512,-309,-60.3515625
59,30,10,144,1024,-880,-85.9375
59,30,11,1158,2048,-890,-43.45703125
59,30,12,627,4096,-3469,-84.6923828125
59,30,13,12837,8192,4645,56.70166015625
59,30,14,45485,16384,29101,177.618408203125
59,30,15,27769,32768,-4999,-15.2557373046875
59,31,1,0,2,-2,-100.0
59,31,2,3,4,-1,-25.0
59,31,3,5,8,-3,-37.5
59,31,4,3,16,-13,-81.25
59,31,5,36,32,4,12.5
59,31,6,26,64,-38,-59.375
59,31,7,281,128,153,119.53125
59,31,8,418,256,162,63.28125
59,31,9,490,512,-22,-4.296875
59,31,10,112,1024,-912,-89.0625
59,31,11,1068,2048,-980,-47.8515625
59,31,12,73,4096,-4023,-98.2177734375
59,31,13,15927,8192,7735,94.42138671875
59,31,14,350,16384,-16034,-97.86376953125
59,31,15,108582,32768,75814,231.365966796875
59,32,1,0,2,-2,-100.0
59,32,2,1,4,-3,-75.0
59,32,3,4,8,-4,-50.0
59,32,4,13,16,-3,-18.75
59,32,5,15,32,-17,-53.125
59,32,6,17,64,-47,-73.4375
59,32,7,143,128,15,11.71875
59,32,8,257,256,1,0.390625
59,32,9,467,512,-45,-8.7890625
59,32,10,621,1024,-403,-39.35546875
59,32,11,589,2048,-1459,-71.240234375
59,32,12,1790,4096,-2306,-56.298828125
59,32,13,17479,8192,9287,113.36669921875
59,32,14,9753,16384,-6631,-40.472412109375
59,32,15,9359,32768,-23409,-71.4385986328125
59,33,1,0,2,-2,-100.0
59,33,2,1,4,-3,-75.0
59,33,3,9,8,1,12.5
59,33,4,6,16,-10,-62.5
59,33,5,27,32,-5,-15.625
59,33,6,22,64,-42,-65.625
59,33,7,187,128,59,46.09375
59,33,8,381,256,125,48.828125
59,33,9,1549,512,1037,202.5390625
59,33,10,70,1024,-954,-93.1640625
59,33,11,41,2048,-2007,-97.998046875
59,33,12,954,4096,-3142,-76.708984375
59,33,13,2979,8192,-5213,-63.63525390625
59,33,14,2814,16384,-13570,-82.82470703125
59,33,15,9714,32768,-23054,-70.355224609375
59,34,1,0,2,-2,-100.0
59,34,2,1,4,-3,-75.0
59,34,3,3,8,-5,-62.5
59,34,4,13,16,-3,-18.75
59,34,5,61,32,29,90.625
59,34,6,106,64,42,65.625
59,34,7,79,128,-49,-38.28125
59,34,8,849,256,593,231.640625
59,34,9,678,512,166,32.421875
59,34,10,867,1024,-157,-15.33203125
59,34,11,3961,2048,1913,93.408203125
59,34,12,8116,4096,4020,98.14453125
59,34,13,18870,8192,10678,130.3466796875
59,34,14,29387,16384,13003,79.364013671875
59,34,15,3174,32768,-29594,-90.313720703125
59,35,1,0,2,-2,-100.0
59,35,2,1,4,-3,-75.0
59,35,3,14,8,6,75.0
59,35,4,11,16,-5,-31.25
59,35,5,21,32,-11,-34.375
59,35,6,122,64,58,90.625
59,35,7,126,128,-2,-1.5625
59,35,8,261,256,5,1.953125
59,35,9,2123,512,1611,314.6484375
59,35,10,966,1024,-58,-5.6640625
59,35,11,864,2048,-1184,-57.8125
59,35,12,4415,4096,319,7.7880859375
59,35,13,33170,8192,24978,304.9072265625
59,35,14,20739,16384,4355,26.580810546875
59,35,15,15651,32768,-17117,-52.2369384765625
59,36,1,0,2,-2,-100.0
59,36,2,1,4,-3,-75.0
59,36,3,5,8,-3,-37.5
59,36,4,6,16,-10,-62.5
59,36,5,13,32,-19,-59.375
59,36,6,33,64,-31,-48.4375
59,36,7,35,128,-93,-72.65625
59,36,8,23,256,-233,-91.015625
59,36,9,300,512,-212,-41.40625
59,36,10,3773,1024,2749,268.45703125
59,36,11,325,2048,-1723,-84.130859375
59,36,12,10635,4096,6539,159.6435546875
59,36,13,20382,8192,12190,148.8037109375
59,36,14,12992,16384,-3392,-20.703125
59,36,15,21919,32768,-10849,-33.1085205078125
59,37,1,0,2,-2,-100.0
59,37,2,5,4,1,25.0
59,37,3,2,8,-6,-75.0
59,37,4,5,16,-11,-68.75
59,37,5,8,32,-24,-75.0
59,37,6,103,64,39,60.9375
59,37,7,146,128,18,14.0625
59,37,8,34,256,-222,-86.71875
59,37,9,1885,512,1373,268.1640625
59,37,10,1675,1024,651,63.57421875
59,37,11,616,2048,-1432,-69.921875
59,37,12,2721,4096,-1375,-33.5693359375
59,37,13,22764,8192,14572,177.880859375
59,37,14,42989,16384,26605,162.384033203125
59,37,15,369,32768,-32399,-98.8739013671875
59,38,1,0,2,-2,-100.0
59,38,2,3,4,-1,-25.0
59,38,3,13,8,5,62.5
59,38,4,6,16,-10,-62.5
59,38,5,9,32,-23,-71.875
59,38,6,114,64,50,78.125
59,38,7,82,128,-46,-35.9375
59,38,8,48,256,-208,-81.25
59,38,9,52,512,-460,-89.84375
59,38,10,3156,1024,2132,208.203125
59,38,11,2831,2048,783,38.232421875
59,38,12,870,4096,-3226,-78.759765625
59,38,13,2006,8192,-6186,-75.5126953125
59,38,14,19679,16384,3295,20.111083984375
59,38,15,36534,32768,3766,11.492919921875
59,39,1,0,2,-2,-100.0
59,39,2,2,4,-2,-50.0
59,39,3,10,8,2,25.0
59,39,4,24,16,8,50.0
59,39,5,8,32,-24,-75.0
59,39,6,17,64,-47,-73.4375
59,39,7,133,128,5,3.90625
59,39,8,23,256,-233,-91.015625
59,39,9,1152,512,640,125.0
59,39,10,68,1024,-956,-93.359375
59,39,11,3627,2048,1579,77.099609375
59,39,12,5572,4096,1476,36.03515625
59,39,13,6153,8192,-2039,-24.89013671875
59,39,14,35410,16384,19026,116.12548828125
59,39,15,16390,32768,-16378,-49.981689453125
59,40,1,0,2,-2,-100.0
59,40,2,2,4,-2,-50.0
59,40,3,2,8,-6,-75.0
59,40,4,4,16,-12,-75.0
59,40,5,53,32,21,65.625
59,40,6,36,64,-28,-43.75
59,40,7,39,128,-89,-69.53125
59,40,8,498,256,242,94.53125
59,40,9,82,512,-430,-83.984375
59,40,10,571,1024,-453,-44.23828125
59,40,11,666,2048,-1382,-67.48046875
59,40,12,3479,4096,-617,-15.0634765625
59,40,13,9078,8192,886,10.8154296875
59,40,14,36500,16384,20116,122.7783203125
59,40,15,17537,32768,-15231,-46.4813232421875
59,41,1,0,2,-2,-100.0
59,41,2,1,4,-3,-75.0
59,41,3,3,8,-5,-62.5
59,41,4,21,16,5,31.25
59,41,5,54,32,22,68.75
59,41,6,14,64,-50,-78.125
59,41,7,107,128,-21,-16.40625
59,41,8,95,256,-161,-62.890625
59,41,9,331,512,-181,-35.3515625
59,41,10,272,1024,-752,-73.4375
59,41,11,416,2048,-1632,-79.6875
59,41,12,1811,4096,-2285,-55.7861328125
59,41,13,3573,8192,-4619,-56.38427734375
59,41,14,12585,16384,-3799,-23.187255859375
59,41,15,27925,32768,-4843,-14.7796630859375
59,42,1,0,2,-2,-100.0
59,42,2,3,4,-1,-25.0
59,42,3,23,8,15,187.5
59,42,4,43,16,27,168.75
59,42,5,4,32,-28,-87.5
59,42,6,137,64,73,114.0625
59,42,7,16,128,-112,-87.5
59,42,8,227,256,-29,-11.328125
59,42,9,904,512,392,76.5625
59,42,10,50,1024,-974,-95.1171875
59,42,11,902,2048,-1146,-55.95703125
59,42,12,6829,4096,2733,66.7236328125
59,42,13,23480,8192,15288,186.62109375
59,42,14,14694,16384,-1690,-10.31494140625
59,42,15,54772,32768,22004,67.15087890625
59,43,1,0,2,-2,-100.0
59,43,2,1,4,-3,-75.0
59,43,3,2,8,-6,-75.0
59,43,4,20,16,4,25.0
59,43,5,4,32,-28,-87.5
59,43,6,7,64,-57,-89.0625
59,43,7,24,128,-104,-81.25
59,43,8,188,256,-68,-26.5625
59,43,9,356,512,-156,-30.46875
59,43,10,1400,1024,376,36.71875
59,43,11,2165,2048,117,5.712890625
59,43,12,997,4096,-3099,-75.6591796875
59,43,13,7753,8192,-439,-5.35888671875
59,43,14,6690,16384,-9694,-59.16748046875
59,43,15,9194,32768,-23574,-71.942138671875
59,44,1,0,2,-2,-100.0
59,44,2,1,4,-3,-75.0
59,44,3,4,8,-4,-50.0
59,44,4,14,16,-2,-12.5
59,44,5,13,32,-19,-59.375
59,44,6,88,64,24,37.5
59,44,7,120,128,-8,-6.25
59,44,8,383,256,127,49.609375
59,44,9,21,512,-491,-95.8984375
59,44,10,153,1024,-871,-85.05859375
59,44,11,1237,2048,-811,-39.599609375
59,44,12,16401,4096,12305,300.4150390625
59,44,13,5839,8192,-2353,-28.72314453125
59,44,14,12732,16384,-3652,-22.2900390625
59,44,15,53217,32768,20449,62.4053955078125
59,45,1,0,2,-2,-100.0
59,45,2,1,4,-3,-75.0
59,45,3,6,8,-2,-25.0
59,45,4,24,16,8,50.0
59,45,5,11,32,-21,-65.625
59,45,6,9,64,-55,-85.9375
59,45,7,42,128,-86,-67.1875
59,45,8,592,256,336,131.25
59,45,9,171,512,-341,-66.6015625
59,45,10,791,1024,-233,-22.75390625
59,45,11,2031,2048,-17,-0.830078125
59,45,12,1777,4096,-2319,-56.6162109375
59,45,13,7904,8192,-288,-3.515625
59,45,14,88373,16384,71989,439.385986328125
59,45,15,28539,32768,-4229,-12.9058837890625
59,46,1,0,2,-2,-100.0
59,46,2,2,4,-2,-50.0
59,46,3,7,8,-1,-12.5
59,46,4,11,16,-5,-31.25
59,46,5,5,32,-27,-84.375
59,46,6,71,64,7,10.9375
59,46,7,163,128,35,27.34375
59,46,8,131,256,-125,-48.828125
59,46,9,448,512,-64,-12.5
59,46,10,927,1024,-97,-9.47265625
59,46,11,4971,2048,2923,142.724609375
59,46,12,8982,4096,4886,119.287109375
59,46,13,9564,8192,1372,16.748046875
59,46,14,3842,16384,-12542,-76.55029296875
59,46,15,13843,32768,-18925,-57.7545166015625
59,47,1,0,2,-2,-100.0
59,47,2,1,4,-3,-75.0
59,47,3,18,8,10,125.0
59,47,4,10,16,-6,-37.5
59,47,5,4,32,-28,-87.5
59,47,6,136,64,72,112.5
59,47,7,216,128,88,68.75
59,47,8,50,256,-206,-80.46875
59,47,9,946,512,434,84.765625
59,47,10,1130,1024,106,10.3515625
59,47,11,164,2048,-1884,-91.9921875
59,47,12,2862,4096,-1234,-30.126953125
59,47,13,4754,8192,-3438,-41.9677734375
59,47,14,20767,16384,4383,26.751708984375
59,47,15,28310,32768,-4458,-13.604736328125
59,48,1,0,2,-2,-100.0
59,48,2,2,4,-2,-50.0
59,48,3,7,8,-1,-12.5
59,48,4,3,16,-13,-81.25
59,48,5,81,32,49,153.125
59,48,6,56,64,-8,-12.5
59,48,7,24,128,-104,-81.25
59,48,8,151,256,-105,-41.015625
59,48,9,1676,512,1164,227.34375
59,48,10,299,1024,-725,-70.80078125
59,48,11,617,2048,-1431,-69.873046875
59,48,12,10072,4096,5976,145.8984375
59,48,13,1871,8192,-6321,-77.16064453125
59,48,14,3822,16384,-12562,-76.67236328125
59,48,15,44789,32768,12021,36.6851806640625
59,49,1,0,2,-2,-100.0
59,49,2,4,4,0,0.0
59,49,3,30,8,22,275.0
59,49,4,7,16,-9,-56.25
59,49,5,38,32,6,18.75
59,49,6,35,64,-29,-45.3125
59,49,7,255,128,127,99.21875
59,49,8,266,256,10,3.90625
59,49,9,247,512,-265,-51.7578125
59,49,10,756,1024,-268,-26.171875
59,49,11,1500,2048,-548,-26.7578125
59,49,12,2336,4096,-1760,-42.96875
59,49,13,7184,8192,-1008,-12.3046875
59,49,14,25313,16384,8929,54.498291015625
59,49,15,59880,32768,27112,82.7392578125
59,50,1,0,2,-2,-100.0
59,50,2,1,4,-3,-75.0
59,50,3,8,8,0,0.0
59,50,4,9,16,-7,-43.75
59,50,5,13,32,-19,-59.375
59,50,6,29,64,-35,-54.6875
59,50,7,35,128,-93,-72.65625
59,50,8,227,256,-29,-11.328125
59,50,9,141,512,-371,-72.4609375
59,50,10,1926,1024,902,88.0859375
59,50,11,2660,2048,612,29.8828125
59,50,12,14807,4096,10711,261.4990234375
59,50,13,52,8192,-8140,-99.365234375
59,50,14,7965,16384,-8419,-51.385498046875
59,50,15,9136,32768,-23632,-72.119140625
59,51,1,0,2,-2,-100.0
59,51,2,1,4,-3,-75.0
59,51,3,2,8,-6,-75.0
59,51,4,6,16,-10,-62.5
59,51,5,11,32,-21,-65.625
59,51,6,89,64,25,39.0625
59,51,7,77,128,-51,-39.84375
59,51,8,187,256,-69,-26.953125
59,51,9,458,512,-54,-10.546875
59,51,10,519,1024,-505,-49.31640625
59,51,11,5147,2048,3099,151.318359375
59,51,12,6008,4096,1912,46.6796875
59,51,13,5141,8192,-3051,-37.24365234375
59,51,14,52492,16384,36108,220.3857421875
59,51,15,6289,32768,-26479,-80.8074951171875
59,52,1,0,2,-2,-100.0
59,52,2,1,4,-3,-75.0
59,52,3,4,8,-4,-50.0
59,52,4,8,16,-8,-50.0
59,52,5,36,32,4,12.5
59,52,6,94,64,30,46.875
59,52,7,26,128,-102,-79.6875
59,52,8,102,256,-154,-60.15625
59,52,9,18,512,-494,-96.484375
59,52,10,466,1024,-558,-54.4921875
59,52,11,756,2048,-1292,-63.0859375
59,52,12,8542,4096,4446,108.544921875
59,52,13,6479,8192,-1713,-20.91064453125
59,52,14,4842,16384,-11542,-70.44677734375
59,52,15,3363,32768,-29405,-89.7369384765625
59,53,1,0,2,-2,-100.0
59,53,2,7,4,3,75.0
59,53,3,21,8,13,162.5
59,53,4,8,16,-8,-50.0
59,53,5,10,32,-22,-68.75
59,53,6,98,64,34,53.125
59,53,7,337,128,209,163.28125
59,53,8,32,256,-224,-87.5
59,53,9,40,512,-472,-92.1875
59,53,10,239,1024,-785,-76.66015625
59,53,11,2392,2048,344,16.796875
59,53,12,8600,4096,4504,109.9609375
59,53,13,2940,8192,-5252,-64.111328125
59,53,14,4462,16384,-11922,-72.76611328125
59,53,15,8825,32768,-23943,-73.0682373046875
59,54,1,0,2,-2,-100.0
59,54,2,1,4,-3,-75.0
59,54,3,28,8,20,250.0
59,54,4,4,16,-12,-75.0
59,54,5,4,32,-28,-87.5
59,54,6,91,64,27,42.1875
59,54,7,46,128,-82,-64.0625
59,54,8,104,256,-152,-59.375
59,54,9,126,512,-386,-75.390625
59,54,10,1482,1024,458,44.7265625
59,54,11,1099,2048,-949,-46.337890625
59,54,12,3436,4096,-660,-16.11328125
59,54,13,4729,8192,-3463,-42.27294921875
59,54,14,7016,16384,-9368,-57.177734375
59,54,15,7989,32768,-24779,-75.6195068359375
59,55,1,0,2,-2,-100.0
59,55,2,2,4,-2,-50.0
59,55,3,5,8,-3,-37.5
59,55,4,11,16,-5,-31.25
59,55,5,40,32,8,25.0
59,55,6,5,64,-59,-92.1875
59,55,7,310,128,182,142.1875
59,55,8,386,256,130,50.78125
59,55,9,475,512,-37,-7.2265625
59,55,10,210,1024,-814,-79.4921875
59,55,11,5817,2048,3769,184.033203125
59,55,12,1867,4096,-2229,-54.4189453125
59,55,13,2799,8192,-5393,-65.83251953125
59,55,14,31867,16384,15483,94.500732421875
59,55,15,24875,32768,-7893,-24.0875244140625
59,56,1,0,2,-2,-100.0
59,56,2,2,4,-2,-50.0
59,56,3,31,8,23,287.5
59,56,4,6,16,-10,-62.5
59,56,5,4,32,-28,-87.5
59,56,6,163,64,99,154.6875
59,56,7,106,128,-22,-17.1875
59,56,8,80,256,-176,-68.75
59,56,9,1016,512,504,98.4375
59,56,10,49,1024,-975,-95.21484375
59,56,11,2074,2048,26,1.26953125
59,56,12,10277,4096,6181,150.9033203125
59,56,13,2434,8192,-5758,-70.2880859375
59,56,14,1111,16384,-15273,-93.218994140625
59,56,15,31574,32768,-1194,-3.643798828125
59,57,1,0,2,-2,-100.0
59,57,2,3,4,-1,-25.0
59,57,3,5,8,-3,-37.5
59,57,4,3,16,-13,-81.25
59,57,5,27,32,-5,-15.625
59,57,6,68,64,4,6.25
59,57,7,39,128,-89,-69.53125
59,57,8,231,256,-25,-9.765625
59,57,9,174,512,-338,-66.015625
59,57,10,83,1024,-941,-91.89453125
59,57,11,360,2048,-1688,-82.421875
59,57,12,3613,4096,-483,-11.7919921875
59,57,13,11202,8192,3010,36.7431640625
59,57,14,2840,16384,-13544,-82.666015625
59,57,15,52003,32768,19235,58.7005615234375
59,58,1,0,2,-2,-100.0
59,58,2,1,4,-3,-75.0
59,58,3,10,8,2,25.0
59,58,4,8,16,-8,-50.0
59,58,5,7,32,-25,-78.125
59,58,6,5,64,-59,-92.1875
59,58,7,20,128,-108,-84.375
59,58,8,811,256,555,216.796875
59,58,9,573,512,61,11.9140625
59,58,10,1244,1024,220,21.484375
59,58,11,461,2048,-1587,-77.490234375
59,58,12,2409,4096,-1687,-41.1865234375
59,58,13,3190,8192,-5002,-61.0595703125
59,58,14,3421,16384,-12963,-79.119873046875
59,58,15,17539,32768,-15229,-46.4752197265625
59,59,1,0,2,-2,-100.0
59,59,2,2,4,-2,-50.0
59,59,3,4,8,-4,-50.0
59,59,4,12,16,-4,-25.0
59,59,5,18,32,-14,-43.75
59,59,6,17,64,-47,-73.4375
59,59,7,22,128,-106,-82.8125
59,59,8,151,256,-105,-41.015625
59,59,9,239,512,-273,-53.3203125
59,59,10,209,1024,-815,-79.58984375
59,59,11,3403,2048,1355,66.162109375
59,59,12,8963,4096,4867,118.8232421875
59,59,13,3449,8192,-4743,-57.89794921875
59,59,14,36755,16384,20371,124.334716796875
59,59,15,28763,32768,-4005,-12.2222900390625
60,1,1,0,2,-2,-100.0
60,1,2,1,4,-3,-75.0
60,1,3,7,8,-1,-12.5
60,1,4,11,16,-5,-31.25
60,1,5,46,32,14,43.75
60,1,6,72,64,8,12.5
60,1,7,37,128,-91,-71.09375
60,1,8,192,256,-64,-25.0
60,1,9,471,512,-41,-8.0078125
60,1,10,187,1024,-837,-81.73828125
60,1,11,7609,2048,5561,271.533203125
60,1,12,2414,4096,-1682,-41.064453125
60,1,13,6300,8192,-1892,-23.095703125
60,1,14,1251,16384,-15133,-92.364501953125
60,1,15,53444,32768,20676,63.09814453125
60,2,1,0,2,-2,-100.0
60,2,2,9,4,5,125.0
60,2,3,5,8,-3,-37.5
60,2,4,11,16,-5,-31.25
60,2,5,34,32,2,6.25
60,2,6,16,64,-48,-75.0
60,2,7,128,128,0,0.0
60,2,8,486,256,230,89.84375
60,2,9,1126,512,614,119.921875
60,2,10,815,1024,-209,-20.41015625
60,2,11,1821,2048,-227,-11.083984375
60,2,12,3172,4096,-924,-22.55859375
60,2,13,5935,8192,-2257,-27.55126953125
60,2,14,7088,16384,-9296,-56.73828125
60,2,15,41134,32768,8366,25.531005859375
60,3,1,0,2,-2,-100.0
60,3,2,3,4,-1,-25.0
60,3,3,6,8,-2,-25.0
60,3,4,6,16,-10,-62.5
60,3,5,55,32,23,71.875
60,3,6,134,64,70,109.375
60,3,7,71,128,-57,-44.53125
60,3,8,670,256,414,161.71875
60,3,9,55,512,-457,-89.2578125
60,3,10,394,1024,-630,-61.5234375
60,3,11,567,2048,-1481,-72.314453125
60,3,12,1765,4096,-2331,-56.9091796875
60,3,13,2211,8192,-5981,-73.01025390625
60,3,14,14712,16384,-1672,-10.205078125
60,3,15,48105,32768,15337,46.8048095703125
60,4,1,0,2,-2,-100.0
60,4,2,3,4,-1,-25.0
60,4,3,28,8,20,250.0
60,4,4,23,16,7,43.75
60,4,5,20,32,-12,-37.5
60,4,6,14,64,-50,-78.125
60,4,7,38,128,-90,-70.3125
60,4,8,249,256,-7,-2.734375
60,4,9,272,512,-240,-46.875
60,4,10,2169,1024,1145,111.81640625
60,4,11,1108,2048,-940,-45.8984375
60,4,12,7533,4096,3437,83.9111328125
60,4,13,5126,8192,-3066,-37.4267578125
60,4,14,12949,16384,-3435,-20.965576171875
60,4,15,18582,32768,-14186,-43.292236328125
60,5,1,0,2,-2,-100.0
60,5,2,2,4,-2,-50.0
60,5,3,4,8,-4,-50.0
60,5,4,18,16,2,12.5
60,5,5,20,32,-12,-37.5
60,5,6,32,64,-32,-50.0
60,5,7,69,128,-59,-46.09375
60,5,8,325,256,69,26.953125
60,5,9,199,512,-313,-61.1328125
60,5,10,1605,1024,581,56.73828125
60,5,11,1734,2048,-314,-15.33203125
60,5,12,14694,4096,10598,258.740234375
60,5,13,17341,8192,9149,111.68212890625
60,5,14,17111,16384,727,4.437255859375
60,5,15,15235,32768,-17533,-53.5064697265625
60,6,1,0,2,-2,-100.0
60,6,2,2,4,-2,-50.0
60,6,3,2,8,-6,-75.0
60,6,4,8,16,-8,-50.0
60,6,5,4,32,-28,-87.5
60,6,6,5,64,-59,-92.1875
60,6,7,241,128,113,88.28125
60,6,8,226,256,-30,-11.71875
60,6,9,180,512,-332,-64.84375
60,6,10,199,1024,-825,-80.56640625
60,6,11,677,2048,-1371,-66.943359375
60,6,12,7370,4096,3274,79.931640625
60,6,13,5754,8192,-2438,-29.7607421875
60,6,14,1208,16384,-15176,-92.626953125
60,6,15,5798,32768,-26970,-82.305908203125
60,7,1,0,2,-2,-100.0
60,7,2,2,4,-2,-50.0
60,7,3,5,8,-3,-37.5
60,7,4,3,16,-13,-81.25
60,7,5,12,32,-20,-62.5
60,7,6,19,64,-45,-70.3125
60,7,7,80,128,-48,-37.5
60,7,8,70,256,-186,-72.65625
60,7,9,43,512,-469,-91.6015625
60,7,10,620,1024,-404,-39.453125
60,7,11,1547,2048,-501,-24.462890625
60,7,12,11601,4096,7505,183.2275390625
60,7,13,2847,8192,-5345,-65.24658203125
60,7,14,1796,16384,-14588,-89.0380859375
60,7,15,28454,32768,-4314,-13.165283203125
60,8,1,0,2,-2,-100.0
60,8,2,1,4,-3,-75.0
60,8,3,3,8,-5,-62.5
60,8,4,9,16,-7,-43.75
60,8,5,60,32,28,87.5
60,8,6,134,64,70,109.375
60,8,7,26,128,-102,-79.6875
60,8,8,219,256,-37,-14.453125
60,8,9,327,512,-185,-36.1328125
60,8,10,1080,1024,56,5.46875
60,8,11,5932,2048,3884,189.6484375
60,8,12,2610,4096,-1486,-36.279296875
60,8,13,23,8192,-8169,-99.71923828125
60,8,14,13531,16384,-2853,-17.413330078125
60,8,15,31632,32768,-1136,-3.466796875
60,9,1,0,2,-2,-100.0
60,9,2,4,4,0,0.0
60,9,3,28,8,20,250.0
60,9,4,21,16,5,31.25
60,9,5,6,32,-26,-81.25
60,9,6,46,64,-18,-28.125
60,9,7,96,128,-32,-25.0
60,9,8,157,256,-99,-38.671875
60,9,9,282,512,-230,-44.921875
60,9,10,1374,1024,350,34.1796875
60,9,11,429,2048,-1619,-79.052734375
60,9,12,3447,4096,-649,-15.8447265625
60,9,13,1861,8192,-6331,-77.28271484375
60,9,14,6396,16384,-9988,-60.9619140625
60,9,15,16583,32768,-16185,-49.3927001953125
60,10,1,0,2,-2,-100.0
60,10,2,1,4,-3,-75.0
60,10,3,2,8,-6,-75.0
60,10,4,36,16,20,125.0
60,10,5,9,32,-23,-71.875
60,10,6,52,64,-12,-18.75
60,10,7,440,128,312,243.75
60,10,8,172,256,-84,-32.8125
60,10,9,258,512,-254,-49.609375
60,10,10,244,1024,-780,-76.171875
60,10,11,1522,2048,-526,-25.68359375
60,10,12,294,4096,-3802,-92.822265625
60,10,13,1462,8192,-6730,-82.1533203125
60,10,14,9347,16384,-7037,-42.950439453125
60,10,15,15211,32768,-17557,-53.5797119140625
60,11,1,0,2,-2,-100.0
60,11,2,3,4,-1,-25.0
60,11,3,2,8,-6,-75.0
60,11,4,3,16,-13,-81.25
60,11,5,19,32,-13,-40.625
60,11,6,33,64,-31,-48.4375
60,11,7,76,128,-52,-40.625
60,11,8,140,256,-116,-45.3125
60,11,9,371,512,-141,-27.5390625
60,11,10,1893,1024,869,84.86328125
60,11,11,3036,2048,988,48.2421875
60,11,12,479,4096,-3617,-88.3056640625
60,11,13,7287,8192,-905,-11.04736328125
60,11,14,6283,16384,-10101,-61.651611328125
60,11,15,29702,32768,-3066,-9.356689453125
60,12,1,0,2,-2,-100.0
60,12,2,3,4,-1,-25.0
60,12,3,2,8,-6,-75.0
60,12,4,5,16,-11,-68.75
60,12,5,58,32,26,81.25
60,12,6,45,64,-19,-29.6875
60,12,7,106,128,-22,-17.1875
60,12,8,100,256,-156,-60.9375
60,12,9,766,512,254,49.609375
60,12,10,547,1024,-477,-46.58203125
60,12,11,2696,2048,648,31.640625
60,12,12,6115,4096,2019,49.2919921875
60,12,13,3090,8192,-5102,-62.2802734375
60,12,14,41084,16384,24700,150.7568359375
60,12,15,23246,32768,-9522,-29.058837890625
60,13,1,0,2,-2,-100.0
60,13,2,1,4,-3,-75.0
60,13,3,4,8,-4,-50.0
60,13,4,3,16,-13,-81.25
60,13,5,6,32,-26,-81.25
60,13,6,7,64,-57,-89.0625
60,13,7,167,128,39,30.46875
60,13,8,72,256,-184,-71.875
60,13,9,83,512,-429,-83.7890625
60,13,10,1206,1024,182,17.7734375
60,13,11,491,2048,-1557,-76.025390625
60,13,12,4071,4096,-25,-0.6103515625
60,13,13,8590,8192,398,4.8583984375
60,13,14,1431,16384,-14953,-91.265869140625
60,13,15,31510,32768,-1258,-3.839111328125
60,14,1,0,2,-2,-100.0
60,14,2,2,4,-2,-50.0
60,14,3,3,8,-5,-62.5
60,14,4,3,16,-13,-81.25
60,14,5,4,32,-28,-87.5
60,14,6,138,64,74,115.625
60,14,7,18,128,-110,-85.9375
60,14,8,333,256,77,30.078125
60,14,9,99,512,-413,-80.6640625
60,14,10,385,1024,-639,-62.40234375
60,14,11,335,2048,-1713,-83.642578125
60,14,12,3129,4096,-967,-23.6083984375
60,14,13,7315,8192,-877,-10.70556640625
60,14,14,18097,16384,1713,10.455322265625
60,14,15,149,32768,-32619,-99.5452880859375
60,15,1,0,2,-2,-100.0
60,15,2,3,4,-1,-25.0
60,15,3,7,8,-1,-12.5
60,15,4,11,16,-5,-31.25
60,15,5,10,32,-22,-68.75
60,15,6,16,64,-48,-75.0
60,15,7,144,128,16,12.5
60,15,8,135,256,-121,-47.265625
60,15,9,38,512,-474,-92.578125
60,15,10,772,1024,-252,-24.609375
60,15,11,3048,2048,1000,48.828125
60,15,12,8165,4096,4069,99.3408203125
60,15,13,3310,8192,-4882,-59.5947265625
60,15,14,13536,16384,-2848,-17.3828125
60,15,15,13397,32768,-19371,-59.1156005859375
60,16,1,0,2,-2,-100.0
60,16,2,1,4,-3,-75.0
60,16,3,2,8,-6,-75.0
60,16,4,12,16,-4,-25.0
60,16,5,72,32,40,125.0
60,16,6,41,64,-23,-35.9375
60,16,7,140,128,12,9.375
60,16,8,434,256,178,69.53125
60,16,9,584,512,72,14.0625
60,16,10,1110,1024,86,8.3984375
60,16,11,12493,2048,10445,510.009765625
60,16,12,4548,4096,452,11.03515625
60,16,13,378,8192,-7814,-95.3857421875
60,16,14,42398,16384,26014,158.77685546875
60,16,15,10711,32768,-22057,-67.3126220703125
60,17,1,0,2,-2,-100.0
60,17,2,1,4,-3,-75.0
60,17,3,3,8,-5,-62.5
60,17,4,16,16,0,0.0
60,17,5,14,32,-18,-56.25
60,17,6,180,64,116,181.25
60,17,7,7,128,-121,-94.53125
60,17,8,81,256,-175,-68.359375
60,17,9,100,512,-412,-80.46875
60,17,10,300,1024,-724,-70.703125
60,17,11,3022,2048,974,47.55859375
60,17,12,3175,4096,-921,-22.4853515625
60,17,13,5915,8192,-2277,-27.79541015625
60,17,14,2605,16384,-13779,-84.100341796875
60,17,15,7306,32768,-25462,-77.703857421875
60,18,1,0,2,-2,-100.0
60,18,2,2,4,-2,-50.0
60,18,3,5,8,-3,-37.5
60,18,4,24,16,8,50.0
60,18,5,12,32,-20,-62.5
60,18,6,30,64,-34,-53.125
60,18,7,147,128,19,14.84375
60,18,8,94,256,-162,-63.28125
60,18,9,1092,512,580,113.28125
60,18,10,153,1024,-871,-85.05859375
60,18,11,3045,2048,997,48.681640625
60,18,12,2397,4096,-1699,-41.4794921875
60,18,13,24676,8192,16484,201.220703125
60,18,14,25297,16384,8913,54.400634765625
60,18,15,124798,32768,92030,280.853271484375
60,19,1,0,2,-2,-100.0
60,19,2,1,4,-3,-75.0
60,19,3,3,8,-5,-62.5
60,19,4,7,16,-9,-56.25
60,19,5,21,32,-11,-34.375
60,19,6,110,64,46,71.875
60,19,7,25,128,-103,-80.46875
60,19,8,19,256,-237,-92.578125
60,19,9,759,512,247,48.2421875
60,19,10,486,1024,-538,-52.5390625
60,19,11,2837,2048,789,38.525390625
60,19,12,12818,4096,8722,212.939453125
60,19,13,21171,8192,12979,158.43505859375
60,19,14,430,16384,-15954,-97.37548828125
60,19,15,47598,32768,14830,45.257568359375
60,20,1,0,2,-2,-100.0
60,20,2,1,4,-3,-75.0
60,20,3,7,8,-1,-12.5
60,20,4,12,16,-4,-25.0
60,20,5,36,32,4,12.5
60,20,6,53,64,-11,-17.1875
60,20,7,110,128,-18,-14.0625
60,20,8,87,256,-169,-66.015625
60,20,9,815,512,303,59.1796875
60,20,10,1011,1024,-13,-1.26953125
60,20,11,1270,2048,-778,-37.98828125
60,20,12,878,4096,-3218,-78.564453125
60,20,13,21007,8192,12815,156.43310546875
60,20,14,33199,16384,16815,102.630615234375
60,20,15,3446,32768,-29322,-89.483642578125
60,21,1,0,2,-2,-100.0
60,21,2,1,4,-3,-75.0
60,21,3,19,8,11,137.5
60,21,4,53,16,37,231.25
60,21,5,5,32,-27,-84.375
60,21,6,70,64,6,9.375
60,21,7,56,128,-72,-56.25
60,21,8,12,256,-244,-95.3125
60,21,9,205,512,-307,-59.9609375
60,21,10,282,1024,-742,-72.4609375
60,21,11,3138,2048,1090,53.22265625
60,21,12,1102,4096,-2994,-73.095703125
60,21,13,32301,8192,24109,294.29931640625
60,21,14,16217,16384,-167,-1.019287109375
60,21,15,51778,32768,19010,58.013916015625
60,22,1,0,2,-2,-100.0
60,22,2,6,4,2,50.0
60,22,3,4,8,-4,-50.0
60,22,4,9,16,-7,-43.75
60,22,5,17,32,-15,-46.875
60,22,6,10,64,-54,-84.375
60,22,7,151,128,23,17.96875
60,22,8,7,256,-249,-97.265625
60,22,9,919,512,407,79.4921875
60,22,10,1626,1024,602,58.7890625
60,22,11,202,2048,-1846,-90.13671875
60,22,12,355,4096,-3741,-91.3330078125
60,22,13,1167,8192,-7025,-85.75439453125
60,22,14,9095,16384,-7289,-44.488525390625
60,22,15,89055,32768,56287,171.7742919921875
60,23,1,0,2,-2,-100.0
60,23,2,1,4,-3,-75.0
60,23,3,3,8,-5,-62.5
60,23,4,7,16,-9,-56.25
60,23,5,15,32,-17,-53.125
60,23,6,328,64,264,412.5
60,23,7,13,128,-115,-89.84375
60,23,8,494,256,238,92.96875
60,23,9,138,512,-374,-73.046875
60,23,10,325,1024,-699,-68.26171875
60,23,11,254,2048,-1794,-87.59765625
60,23,12,4892,4096,796,19.43359375
60,23,13,2093,8192,-6099,-74.45068359375
60,23,14,15196,16384,-1188,-7.2509765625
60,23,15,19096,32768,-13672,-41.7236328125
60,24,1,0,2,-2,-100.0
60,24,2,1,4,-3,-75.0
60,24,3,5,8,-3,-37.5
60,24,4,9,16,-7,-43.75
60,24,5,22,32,-10,-31.25
60,24,6,159,64,95,148.4375
60,24,7,107,128,-21,-16.40625
60,24,8,29,256,-227,-88.671875
60,24,9,1390,512,878,171.484375
60,24,10,1424,1024,400,39.0625
60,24,11,2457,2048,409,19.970703125
60,24,12,756,4096,-3340,-81.54296875
60,24,13,1106,8192,-7086,-86.4990234375
60,24,14,12953,16384,-3431,-20.941162109375
60,24,15,64329,32768,31561,96.3165283203125
60,25,1,0,2,-2,-100.0
60,25,2,1,4,-3,-75.0
60,25,3,2,8,-6,-75.0
60,25,4,6,16,-10,-62.5
60,25,5,43,32,11,34.375
60,25,6,88,64,24,37.5
60,25,7,78,128,-50,-39.0625
60,25,8,87,256,-169,-66.015625
60,25,9,503,512,-9,-1.7578125
60,25,10,1269,1024,245,23.92578125
60,25,11,873,2048,-1175,-57.373046875
60,25,12,4140,4096,44,1.07421875
60,25,13,8260,8192,68,0.830078125
60,25,14,3381,16384,-13003,-79.364013671875
60,25,15,65391,32768,32623,99.5574951171875
60,26,1,0,2,-2,-100.0
60,26,2,1,4,-3,-75.0
60,26,3,6,8,-2,-25.0
60,26,4,10,16,-6,-37.5
60,26,5,47,32,15,46.875
60,26,6,53,64,-11,-17.1875
60,26,7,101,128,-27,-21.09375
60,26,8,144,256,-112,-43.75
60,26,9,652,512,140,27.34375
60,26,10,880,1024,-144,-14.0625
60,26,11,1229,2048,-819,-39.990234375
60,26,12,5037,4096,941,22.9736328125
60,26,13,1383,8192,-6809,-83.11767578125
60,26,14,1563,16384,-14821,-90.460205078125
60,26,15,5503,32768,-27265,-83.2061767578125
60,27,1,0,2,-2,-100.0
60,27,2,1,4,-3,-75.0
60,27,3,3,8,-5,-62.5
60,27,4,17,16,1,6.25
60,27,5,20,32,-12,-37.5
60,27,6,102,64,38,59.375
60,27,7,164,128,36,28.125
60,27,8,810,256,554,216.40625
60,27,9,700,512,188,36.71875
60,27,10,168,1024,-856,-83.59375
60,27,11,834,2048,-1214,-59.27734375
60,27,12,327,4096,-3769,-92.0166015625
60,27,13,7936,8192,-256,-3.125
60,27,14,1790,16384,-14594,-89.07470703125
60,27,15,33976,32768,1208,3.6865234375
60,28,1,0,2,-2,-100.0
60,28,2,2,4,-2,-50.0
60,28,3,6,8,-2,-25.0
60,28,4,19,16,3,18.75
60,28,5,6,32,-26,-81.25
60,28,6,73,64,9,14.0625
60,28,7,57,128,-71,-55.46875
60,28,8,184,256,-72,-28.125
60,28,9,223,512,-289,-56.4453125
60,28,10,379,1024,-645,-62.98828125
60,28,11,1064,2048,-984,-48.046875
60,28,12,2984,4096,-1112,-27.1484375
60,28,13,8611,8192,419,5.11474609375
60,28,14,3429,16384,-12955,-79.071044921875
60,28,15,11296,32768,-21472,-65.52734375
60,29,1,0,2,-2,-100.0
60,29,2,1,4,-3,-75.0
60,29,3,4,8,-4,-50.0
60,29,4,14,16,-2,-12.5
60,29,5,58,32,26,81.25
60,29,6,6,64,-58,-90.625
60,29,7,65,128,-63,-49.21875
60,29,8,79,256,-177,-69.140625
60,29,9,385,512,-127,-24.8046875
60,29,10,1041,1024,17,1.66015625
60,29,11,5464,2048,3416,166.796875
60,29,12,2358,4096,-1738,-42.431640625
60,29,13,1107,8192,-7085,-86.48681640625
60,29,14,4444,16384,-11940,-72.8759765625
60,29,15,1521,32768,-31247,-95.3582763671875
60,30,1,0,2,-2,-100.0
60,30,2,4,4,0,0.0
60,30,3,2,8,-6,-75.0
60,30,4,6,16,-10,-62.5
60,30,5,28,32,-4,-12.5
60,30,6,21,64,-43,-67.1875
60,30,7,83,128,-45,-35.15625
60,30,8,617,256,361,141.015625
60,30,9,636,512,124,24.21875
60,30,10,464,1024,-560,-54.6875
60,30,11,475,2048,-1573,-76.806640625
60,30,12,2394,4096,-1702,-41.552734375
60,30,13,2929,8192,-5263,-64.24560546875
60,30,14,22010,16384,5626,34.33837890625
60,30,15,3701,32768,-29067,-88.7054443359375
60,31,1,0,2,-2,-100.0
60,31,2,1,4,-3,-75.0
60,31,3,2,8,-6,-75.0
60,31,4,3,16,-13,-81.25
60,31,5,15,32,-17,-53.125
60,31,6,7,64,-57,-89.0625
60,31,7,40,128,-88,-68.75
60,31,8,125,256,-131,-51.171875
60,31,9,324,512,-188,-36.71875
60,31,10,1871,1024,847,82.71484375
60,31,11,4251,2048,2203,107.568359375
60,31,12,2444,4096,-1652,-40.33203125
60,31,13,1529,8192,-6663,-81.33544921875
60,31,14,1477,16384,-14907,-90.985107421875
60,31,15,1862,32768,-30906,-94.317626953125
60,32,1,0,2,-2,-100.0
60,32,2,1,4,-3,-75.0
60,32,3,3,8,-5,-62.5
60,32,4,5,16,-11,-68.75
60,32,5,102,32,70,218.75
60,32,6,47,64,-17,-26.5625
60,32,7,88,128,-40,-31.25
60,32,8,7,256,-249,-97.265625
60,32,9,679,512,167,32.6171875
60,32,10,311,1024,-713,-69.62890625
60,32,11,431,2048,-1617,-78.955078125
60,32,12,499,4096,-3597,-87.8173828125
60,32,13,3862,8192,-4330,-52.8564453125
60,32,14,991,16384,-15393,-93.951416015625
60,32,15,8655,32768,-24113,-73.5870361328125
60,33,1,0,2,-2,-100.0
60,33,2,1,4,-3,-75.0
60,33,3,4,8,-4,-50.0
60,33,4,7,16,-9,-56.25
60,33,5,9,32,-23,-71.875
60,33,6,140,64,76,118.75
60,33,7,199,128,71,55.46875
60,33,8,118,256,-138,-53.90625
60,33,9,1282,512,770,150.390625
60,33,10,231,1024,-793,-77.44140625
60,33,11,130,2048,-1918,-93.65234375
60,33,12,10888,4096,6792,165.8203125
60,33,13,20589,8192,12397,151.33056640625
60,33,14,8265,16384,-8119,-49.554443359375
60,33,15,2358,32768,-30410,-92.803955078125
60,34,1,0,2,-2,-100.0
60,34,2,1,4,-3,-75.0
60,34,3,8,8,0,0.0
60,34,4,13,16,-3,-18.75
60,34,5,7,32,-25,-78.125
60,34,6,67,64,3,4.6875
60,34,7,59,128,-69,-53.90625
60,34,8,86,256,-170,-66.40625
60,34,9,1350,512,838,163.671875
60,34,10,1407,1024,383,37.40234375
60,34,11,1942,2048,-106,-5.17578125
60,34,12,4702,4096,606,14.794921875
60,34,13,6928,8192,-1264,-15.4296875
60,34,14,13922,16384,-2462,-15.02685546875
60,34,15,65130,32768,32362,98.760986328125
60,35,1,0,2,-2,-100.0
60,35,2,1,4,-3,-75.0
60,35,3,11,8,3,37.5
60,35,4,3,16,-13,-81.25
60,35,5,12,32,-20,-62.5
60,35,6,44,64,-20,-31.25
60,35,7,16,128,-112,-87.5
60,35,8,409,256,153,59.765625
60,35,9,1519,512,1007,196.6796875
60,35,10,381,1024,-643,-62.79296875
60,35,11,175,2048,-1873,-91.455078125
60,35,12,367,4096,-3729,-91.0400390625
60,35,13,7404,8192,-788,-9.619140625
60,35,14,1134,16384,-15250,-93.07861328125
60,35,15,11115,32768,-21653,-66.0797119140625
60,36,1,0,2,-2,-100.0
60,36,2,2,4,-2,-50.0
60,36,3,4,8,-4,-50.0
60,36,4,30,16,14,87.5
60,36,5,7,32,-25,-78.125
60,36,6,67,64,3,4.6875
60,36,7,10,128,-118,-92.1875
60,36,8,250,256,-6,-2.34375
60,36,9,262,512,-250,-48.828125
60,36,10,3589,1024,2565,250.48828125
60,36,11,615,2048,-1433,-69.970703125
60,36,12,1091,4096,-3005,-73.3642578125
60,36,13,3278,8192,-4914,-59.9853515625
60,36,14,30253,16384,13869,84.649658203125
60,36,15,10492,32768,-22276,-67.98095703125
60,37,1,0,2,-2,-100.0
60,37,2,3,4,-1,-25.0
60,37,3,2,8,-6,-75.0
60,37,4,4,16,-12,-75.0
60,37,5,13,32,-19,-59.375
60,37,6,7,64,-57,-89.0625
60,37,7,84,128,-44,-34.375
60,37,8,133,256,-123,-48.046875
60,37,9,14,512,-498,-97.265625
60,37,10,1419,1024,395,38.57421875
60,37,11,813,2048,-1235,-60.302734375
60,37,12,814,4096,-3282,-80.126953125
60,37,13,6240,8192,-1952,-23.828125
60,37,14,5637,16384,-10747,-65.594482421875
60,37,15,5354,32768,-27414,-83.660888671875
60,38,1,0,2,-2,-100.0
60,38,2,1,4,-3,-75.0
60,38,3,2,8,-6,-75.0
60,38,4,15,16,-1,-6.25
60,38,5,4,32,-28,-87.5
60,38,6,31,64,-33,-51.5625
60,38,7,6,128,-122,-95.3125
60,38,8,53,256,-203,-79.296875
60,38,9,1309,512,797,155.6640625
60,38,10,2551,1024,1527,149.12109375
60,38,11,878,2048,-1170,-57.12890625
60,38,12,4856,4096,760,18.5546875
60,38,13,16557,8192,8365,102.11181640625
60,38,14,15699,16384,-685,-4.180908203125
60,38,15,2814,32768,-29954,-91.412353515625
60,39,1,0,2,-2,-100.0
60,39,2,3,4,-1,-25.0
60,39,3,3,8,-5,-62.5
60,39,4,7,16,-9,-56.25
60,39,5,8,32,-24,-75.0
60,39,6,123,64,59,92.1875
60,39,7,335,128,207,161.71875
60,39,8,132,256,-124,-48.4375
60,39,9,83,512,-429,-83.7890625
60,39,10,1144,1024,120,11.71875
60,39,11,535,2048,-1513,-73.876953125
60,39,12,1298,4096,-2798,-68.310546875
60,39,13,9291,8192,1099,13.41552734375
60,39,14,14636,16384,-1748,-10.6689453125
60,39,15,29596,32768,-3172,-9.68017578125
60,40,1,0,2,-2,-100.0
60,40,2,1,4,-3,-75.0
60,40,3,8,8,0,0.0
60,40,4,10,16,-6,-37.5
60,40,5,30,32,-2,-6.25
60,40,6,99,64,35,54.6875
60,40,7,76,128,-52,-40.625
60,40,8,157,256,-99,-38.671875
60,40,9,318,512,-194,-37.890625
60,40,10,3722,1024,2698,263.4765625
60,40,11,2666,2048,618,30.17578125
60,40,12,5423,4096,1327,32.3974609375
60,40,13,2919,8192,-5273,-64.36767578125
60,40,14,7217,16384,-9167,-55.950927734375
60,40,15,23874,32768,-8894,-27.142333984375
60,41,1,0,2,-2,-100.0
60,41,2,1,4,-3,-75.0
60,41,3,6,8,-2,-25.0
60,41,4,6,16,-10,-62.5
60,41,5,39,32,7,21.875
60,41,6,149,64,85,132.8125
60,41,7,88,128,-40,-31.25
60,41,8,7,256,-249,-97.265625
60,41,9,32,512,-480,-93.75
60,41,10,151,1024,-873,-85.25390625
60,41,11,457,2048,-1591,-77.685546875
60,41,12,2668,4096,-1428,-34.86328125
60,41,13,3939,8192,-4253,-51.91650390625
60,41,14,8423,16384,-7961,-48.590087890625
60,41,15,284,32768,-32484,-99.13330078125
60,42,1,0,2,-2,-100.0
60,42,2,2,4,-2,-50.0
60,42,3,13,8,5,62.5
60,42,4,19,16,3,18.75
60,42,5,10,32,-22,-68.75
60,42,6,53,64,-11,-17.1875
60,42,7,22,128,-106,-82.8125
60,42,8,295,256,39,15.234375
60,42,9,611,512,99,19.3359375
60,42,10,580,1024,-444,-43.359375
60,42,11,956,2048,-1092,-53.3203125
60,42,12,349,4096,-3747,-91.4794921875
60,42,13,5829,8192,-2363,-28.84521484375
60,42,14,30256,16384,13872,84.66796875
60,42,15,59188,32768,26420,80.62744140625
60,43,1,0,2,-2,-100.0
60,43,2,1,4,-3,-75.0
60,43,3,2,8,-6,-75.0
60,43,4,18,16,2,12.5
60,43,5,4,32,-28,-87.5
60,43,6,46,64,-18,-28.125
60,43,7,143,128,15,11.71875
60,43,8,60,256,-196,-76.5625
60,43,9,92,512,-420,-82.03125
60,43,10,240,1024,-784,-76.5625
60,43,11,175,2048,-1873,-91.455078125
60,43,12,1384,4096,-2712,-66.2109375
60,43,13,9537,8192,1345,16.41845703125
60,43,14,10296,16384,-6088,-37.158203125
60,43,15,64773,32768,32005,97.6715087890625
60,44,1,0,2,-2,-100.0
60,44,2,1,4,-3,-75.0
60,44,3,2,8,-6,-75.0
60,44,4,3,16,-13,-81.25
60,44,5,23,32,-9,-28.125
60,44,6,55,64,-9,-14.0625
60,44,7,284,128,156,121.875
60,44,8,960,256,704,275.0
60,44,9,47,512,-465,-90.8203125
60,44,10,1030,1024,6,0.5859375
60,44,11,1386,2048,-662,-32.32421875
60,44,12,1584,4096,-2512,-61.328125
60,44,13,15509,8192,7317,89.31884765625
60,44,14,606,16384,-15778,-96.30126953125
60,44,15,66253,32768,33485,102.1881103515625
60,45,1,0,2,-2,-100.0
60,45,2,1,4,-3,-75.0
60,45,3,2,8,-6,-75.0
60,45,4,30,16,14,87.5
60,45,5,11,32,-21,-65.625
60,45,6,97,64,33,51.5625
60,45,7,133,128,5,3.90625
60,45,8,273,256,17,6.640625
60,45,9,525,512,13,2.5390625
60,45,10,356,1024,-668,-65.234375
60,45,11,486,2048,-1562,-76.26953125
60,45,12,2195,4096,-1901,-46.4111328125
60,45,13,8549,8192,357,4.35791015625
60,45,14,2346,16384,-14038,-85.68115234375
60,45,15,13870,32768,-18898,-57.672119140625
60,46,1,0,2,-2,-100.0
60,46,2,1,4,-3,-75.0
60,46,3,6,8,-2,-25.0
60,46,4,10,16,-6,-37.5
60,46,5,6,32,-26,-81.25
60,46,6,228,64,164,256.25
60,46,7,81,128,-47,-36.71875
60,46,8,91,256,-165,-64.453125
60,46,9,511,512,-1,-0.1953125
60,46,10,52,1024,-972,-94.921875
60,46,11,757,2048,-1291,-63.037109375
60,46,12,2907,4096,-1189,-29.0283203125
60,46,13,17776,8192,9584,116.9921875
60,46,14,3487,16384,-12897,-78.717041015625
60,46,15,26131,32768,-6637,-20.2545166015625
60,47,1,0,2,-2,-100.0
60,47,2,4,4,0,0.0
60,47,3,6,8,-2,-25.0
60,47,4,4,16,-12,-75.0
60,47,5,9,32,-23,-71.875
60,47,6,16,64,-48,-75.0
60,47,7,130,128,2,1.5625
60,47,8,194,256,-62,-24.21875
60,47,9,418,512,-94,-18.359375
60,47,10,1019,1024,-5,-0.48828125
60,47,11,1130,2048,-918,-44.82421875
60,47,12,3707,4096,-389,-9.4970703125
60,47,13,7038,8192,-1154,-14.0869140625
60,47,14,3083,16384,-13301,-81.182861328125
60,47,15,30027,32768,-2741,-8.3648681640625
60,48,1,0,2,-2,-100.0
60,48,2,2,4,-2,-50.0
60,48,3,2,8,-6,-75.0
60,48,4,35,16,19,118.75
60,48,5,17,32,-15,-46.875
60,48,6,52,64,-12,-18.75
60,48,7,128,128,0,0.0
60,48,8,594,256,338,132.03125
60,48,9,957,512,445,86.9140625
60,48,10,1284,1024,260,25.390625
60,48,11,2003,2048,-45,-2.197265625
60,48,12,5196,4096,1100,26.85546875
60,48,13,767,8192,-7425,-90.63720703125
60,48,14,3709,16384,-12675,-77.362060546875
60,48,15,6192,32768,-26576,-81.103515625
60,49,1,0,2,-2,-100.0
60,49,2,1,4,-3,-75.0
60,49,3,3,8,-5,-62.5
60,49,4,4,16,-12,-75.0
60,49,5,21,32,-11,-34.375
60,49,6,6,64,-58,-90.625
60,49,7,52,128,-76,-59.375
60,49,8,12,256,-244,-95.3125
60,49,9,253,512,-259,-50.5859375
60,49,10,23,1024,-1001,-97.75390625
60,49,11,3803,2048,1755,85.693359375
60,49,12,2989,4096,-1107,-27.0263671875
60,49,13,6289,8192,-1903,-23.22998046875
60,49,14,4219,16384,-12165,-74.249267578125
60,49,15,40418,32768,7650,23.345947265625
60,50,1,0,2,-2,-100.0
60,50,2,2,4,-2,-50.0
60,50,3,12,8,4,50.0
60,50,4,6,16,-10,-62.5
60,50,5,9,32,-23,-71.875
60,50,6,18,64,-46,-71.875
60,50,7,105,128,-23,-17.96875
60,50,8,15,256,-241,-94.140625
60,50,9,360,512,-152,-29.6875
60,50,10,5151,1024,4127,403.02734375
60,50,11,4387,2048,2339,114.208984375
60,50,12,5286,4096,1190,29.052734375
60,50,13,1387,8192,-6805,-83.06884765625
60,50,14,13769,16384,-2615,-15.960693359375
60,50,15,18882,32768,-13886,-42.376708984375
60,51,1,0,2,-2,-100.0
60,51,2,2,4,-2,-50.0
60,51,3,3,8,-5,-62.5
60,51,4,3,16,-13,-81.25
60,51,5,13,32,-19,-59.375
60,51,6,5,64,-59,-92.1875
60,51,7,333,128,205,160.15625
60,51,8,499,256,243,94.921875
60,51,9,555,512,43,8.3984375
60,51,10,2015,1024,991,96.77734375
60,51,11,4759,2048,2711,132.373046875
60,51,12,12736,4096,8640,210.9375
60,51,13,11047,8192,2855,34.85107421875
60,51,14,4248,16384,-12136,-74.072265625
60,51,15,24722,32768,-8046,-24.554443359375
60,52,1,0,2,-2,-100.0
60,52,2,1,4,-3,-75.0
60,52,3,2,8,-6,-75.0
60,52,4,16,16,0,0.0
60,52,5,118,32,86,268.75
60,52,6,94,64,30,46.875
60,52,7,126,128,-2,-1.5625
60,52,8,14,256,-242,-94.53125
60,52,9,830,512,318,62.109375
60,52,10,804,1024,-220,-21.484375
60,52,11,455,2048,-1593,-77.783203125
60,52,12,6971,4096,2875,70.1904296875
60,52,13,3592,8192,-4600,-56.15234375
60,52,14,26306,16384,9922,60.55908203125
60,52,15,5226,32768,-27542,-84.051513671875
60,53,1,0,2,-2,-100.0
60,53,2,3,4,-1,-25.0
60,53,3,2,8,-6,-75.0
60,53,4,23,16,7,43.75
60,53,5,20,32,-12,-37.5
60,53,6,102,64,38,59.375
60,53,7,90,128,-38,-29.6875
60,53,8,247,256,-9,-3.515625
60,53,9,535,512,23,4.4921875
60,53,10,3399,1024,2375,231.93359375
60,53,11,7133,2048,5085,248.291015625
60,53,12,10102,4096,6006,146.630859375
60,53,13,15573,8192,7381,90.10009765625
60,53,14,44340,16384,27956,170.6298828125
60,53,15,51928,32768,19160,58.4716796875
60,54,1,0,2,-2,-100.0
60,54,2,1,4,-3,-75.0
60,54,3,11,8,3,37.5
60,54,4,4,16,-12,-75.0
60,54,5,39,32,7,21.875
60,54,6,97,64,33,51.5625
60,54,7,96,128,-32,-25.0
60,54,8,322,256,66,25.78125
60,54,9,1157,512,645,125.9765625
60,54,10,2874,1024,1850,180.6640625
60,54,11,191,2048,-1857,-90.673828125
60,54,12,1337,4096,-2759,-67.3583984375
60,54,13,907,8192,-7285,-88.92822265625
60,54,14,5370,16384,-11014,-67.22412109375
60,54,15,23077,32768,-9691,-29.5745849609375
60,55,1,0,2,-2,-100.0
60,55,2,3,4,-1,-25.0
60,55,3,2,8,-6,-75.0
60,55,4,9,16,-7,-43.75
60,55,5,5,32,-27,-84.375
60,55,6,64,64,0,0.0
60,55,7,167,128,39,30.46875
60,55,8,108,256,-148,-57.8125
60,55,9,143,512,-369,-72.0703125
60,55,10,39,1024,-985,-96.19140625
60,55,11,970,2048,-1078,-52.63671875
60,55,12,3699,4096,-397,-9.6923828125
60,55,13,667,8192,-7525,-91.85791015625
60,55,14,21350,16384,4966,30.31005859375
60,55,15,69754,32768,36986,112.872314453125
60,56,1,0,2,-2,-100.0
60,56,2,1,4,-3,-75.0
60,56,3,11,8,3,37.5
60,56,4,19,16,3,18.75
60,56,5,4,32,-28,-87.5
60,56,6,47,64,-17,-26.5625
60,56,7,99,128,-29,-22.65625
60,56,8,150,256,-106,-41.40625
60,56,9,1028,512,516,100.78125
60,56,10,1768,1024,744,72.65625
60,56,11,2456,2048,408,19.921875
60,56,12,3119,4096,-977,-23.8525390625
60,56,13,6652,8192,-1540,-18.798828125
60,56,14,20541,16384,4157,25.372314453125
60,56,15,11949,32768,-20819,-63.5345458984375
60,57,1,0,2,-2,-100.0
60,57,2,1,4,-3,-75.0
60,57,3,15,8,7,87.5
60,57,4,51,16,35,218.75
60,57,5,4,32,-28,-87.5
60,57,6,17,64,-47,-73.4375
60,57,7,248,128,120,93.75
60,57,8,151,256,-105,-41.015625
60,57,9,463,512,-49,-9.5703125
60,57,10,1874,1024,850,83.0078125
60,57,11,126,2048,-1922,-93.84765625
60,57,12,7755,4096,3659,89.3310546875
60,57,13,15407,8192,7215,88.07373046875
60,57,14,17785,16384,1401,8.551025390625
60,57,15,35916,32768,3148,9.60693359375
60,58,1,0,2,-2,-100.0
60,58,2,1,4,-3,-75.0
60,58,3,2,8,-6,-75.0
60,58,4,10,16,-6,-37.5
60,58,5,57,32,25,78.125
60,58,6,16,64,-48,-75.0
60,58,7,35,128,-93,-72.65625
60,58,8,372,256,116,45.3125
60,58,9,844,512,332,64.84375
60,58,10,383,1024,-641,-62.59765625
60,58,11,65,2048,-1983,-96.826171875
60,58,12,1306,4096,-2790,-68.115234375
60,58,13,14117,8192,5925,72.32666015625
60,58,14,12378,16384,-4006,-24.45068359375
60,58,15,10248,32768,-22520,-68.7255859375
60,59,1,0,2,-2,-100.0
60,59,2,2,4,-2,-50.0
60,59,3,2,8,-6,-75.0
60,59,4,5,16,-11,-68.75
60,59,5,133,32,101,315.625
60,59,6,74,64,10,15.625
60,59,7,323,128,195,152.34375
60,59,8,105,256,-151,-58.984375
60,59,9,533,512,21,4.1015625
60,59,10,605,1024,-419,-40.91796875
60,59,11,1702,2048,-346,-16.89453125
60,59,12,1290,4096,-2806,-68.505859375
60,59,13,12981,8192,4789,58.45947265625
60,59,14,12654,16384,-3730,-22.76611328125
60,59,15,54436,32768,21668,66.12548828125
60,60,1,0,2,-2,-100.0
60,60,2,3,4,-1,-25.0
60,60,3,6,8,-2,-25.0
60,60,4,9,16,-7,-43.75
60,60,5,9,32,-23,-71.875
60,60,6,15,64,-49,-76.5625
60,60,7,171,128,43,33.59375
60,60,8,170,256,-86,-33.59375
60,60,9,57,512,-455,-88.8671875
60,60,10,107,1024,-917,-89.55078125
60,60,11,686,2048,-1362,-66.50390625
60,60,12,71,4096,-4025,-98.2666015625
60,60,13,12676,8192,4484,54.736328125
60,60,14,4154,16384,-12230,-74.64599609375
60,60,15,39449,32768,6681,20.3887939453125
61,1,1,0,2,-2,-100.0
61,1,2,2,4,-2,-50.0
61,1,3,10,8,2,25.0
61,1,4,6,16,-10,-62.5
61,1,5,33,32,1,3.125
61,1,6,35,64,-29,-45.3125
61,1,7,397,128,269,210.15625
61,1,8,92,256,-164,-64.0625
61,1,9,215,512,-297,-58.0078125
61,1,10,1954,1024,930,90.8203125
61,1,11,4043,2048,1995,97.412109375
61,1,12,480,4096,-3616,-88.28125
61,1,13,5558,8192,-2634,-32.1533203125
61,1,14,11035,16384,-5349,-32.647705078125
61,1,15,11318,32768,-21450,-65.460205078125
61,2,1,0,2,-2,-100.0
61,2,2,1,4,-3,-75.0
61,2,3,3,8,-5,-62.5
61,2,4,13,16,-3,-18.75
61,2,5,33,32,1,3.125
61,2,6,26,64,-38,-59.375
61,2,7,18,128,-110,-85.9375
61,2,8,39,256,-217,-84.765625
61,2,9,181,512,-331,-64.6484375
61,2,10,1142,1024,118,11.5234375
61,2,11,2127,2048,79,3.857421875
61,2,12,1392,4096,-2704,-66.015625
61,2,13,7250,8192,-942,-11.4990234375
61,2,14,22341,16384,5957,36.358642578125
61,2,15,14405,32768,-18363,-56.0394287109375
61,3,1,0,2,-2,-100.0
61,3,2,1,4,-3,-75.0
61,3,3,6,8,-2,-25.0
61,3,4,12,16,-4,-25.0
61,3,5,30,32,-2,-6.25
61,3,6,23,64,-41,-64.0625
61,3,7,447,128,319,249.21875
61,3,8,133,256,-123,-48.046875
61,3,9,86,512,-426,-83.203125
61,3,10,1419,1024,395,38.57421875
61,3,11,221,2048,-1827,-89.208984375
61,3,12,4385,4096,289,7.0556640625
61,3,13,20205,8192,12013,146.64306640625
61,3,14,754,16384,-15630,-95.39794921875
61,3,15,7977,32768,-24791,-75.6561279296875
61,4,1,0,2,-2,-100.0
61,4,2,2,4,-2,-50.0
61,4,3,7,8,-1,-12.5
61,4,4,22,16,6,37.5
61,4,5,25,32,-7,-21.875
61,4,6,55,64,-9,-14.0625
61,4,7,62,128,-66,-51.5625
61,4,8,18,256,-238,-92.96875
61,4,9,555,512,43,8.3984375
61,4,10,461,1024,-563,-54.98046875
61,4,11,2120,2048,72,3.515625
61,4,12,4414,4096,318,7.763671875
61,4,13,51644,8192,43452,530.419921875
61,4,14,7790,16384,-8594,-52.45361328125
61,4,15,81114,32768,48346,147.540283203125
61,5,1,0,2,-2,-100.0
61,5,2,2,4,-2,-50.0
61,5,3,4,8,-4,-50.0
61,5,4,5,16,-11,-68.75
61,5,5,17,32,-15,-46.875
61,5,6,89,64,25,39.0625
61,5,7,124,128,-4,-3.125
61,5,8,35,256,-221,-86.328125
61,5,9,139,512,-373,-72.8515625
61,5,10,421,1024,-603,-58.88671875
61,5,11,189,2048,-1859,-90.771484375
61,5,12,1538,4096,-2558,-62.451171875
61,5,13,140,8192,-8052,-98.291015625
61,5,14,8774,16384,-7610,-46.44775390625
61,5,15,94152,32768,61384,187.3291015625
61,6,1,0,2,-2,-100.0
61,6,2,1,4,-3,-75.0
61,6,3,2,8,-6,-75.0
61,6,4,8,16,-8,-50.0
61,6,5,17,32,-15,-46.875
61,6,6,44,64,-20,-31.25
61,6,7,210,128,82,64.0625
61,6,8,295,256,39,15.234375
61,6,9,1053,512,541,105.6640625
61,6,10,2262,1024,1238,120.8984375
61,6,11,4285,2048,2237,109.228515625
61,6,12,1008,4096,-3088,-75.390625
61,6,13,5177,8192,-3015,-36.80419921875
61,6,14,863,16384,-15521,-94.732666015625
61,6,15,21316,32768,-11452,-34.94873046875
61,7,1,0,2,-2,-100.0
61,7,2,1,4,-3,-75.0
61,7,3,4,8,-4,-50.0
61,7,4,12,16,-4,-25.0
61,7,5,48,32,16,50.0
61,7,6,17,64,-47,-73.4375
61,7,7,296,128,168,131.25
61,7,8,20,256,-236,-92.1875
61,7,9,2080,512,1568,306.25
61,7,10,2035,1024,1011,98.73046875
61,7,11,1725,2048,-323,-15.771484375
61,7,12,5619,4096,1523,37.1826171875
61,7,13,3917,8192,-4275,-52.18505859375
61,7,14,3960,16384,-12424,-75.830078125
61,7,15,42985,32768,10217,31.1798095703125
61,8,1,0,2,-2,-100.0
61,8,2,2,4,-2,-50.0
61,8,3,8,8,0,0.0
61,8,4,4,16,-12,-75.0
61,8,5,57,32,25,78.125
61,8,6,53,64,-11,-17.1875
61,8,7,31,128,-97,-75.78125
61,8,8,158,256,-98,-38.28125
61,8,9,274,512,-238,-46.484375
61,8,10,597,1024,-427,-41.69921875
61,8,11,4038,2048,1990,97.16796875
61,8,12,7402,4096,3306,80.712890625
61,8,13,24264,8192,16072,196.19140625
61,8,14,3889,16384,-12495,-76.263427734375
61,8,15,59473,32768,26705,81.4971923828125
61,9,1,0,2,-2,-100.0
61,9,2,3,4,-1,-25.0
61,9,3,4,8,-4,-50.0
61,9,4,27,16,11,68.75
61,9,5,82,32,50,156.25
61,9,6,44,64,-20,-31.25
61,9,7,191,128,63,49.21875
61,9,8,352,256,96,37.5
61,9,9,993,512,481,93.9453125
61,9,10,1600,1024,576,56.25
61,9,11,329,2048,-1719,-83.935546875
61,9,12,5038,4096,942,22.998046875
61,9,13,13190,8192,4998,61.0107421875
61,9,14,4307,16384,-12077,-73.712158203125
61,9,15,3935,32768,-28833,-87.9913330078125
61,10,1,0,2,-2,-100.0
61,10,2,2,4,-2,-50.0
61,10,3,2,8,-6,-75.0
61,10,4,20,16,4,25.0
61,10,5,8,32,-24,-75.0
61,10,6,15,64,-49,-76.5625
61,10,7,65,128,-63,-49.21875
61,10,8,186,256,-70,-27.34375
61,10,9,274,512,-238,-46.484375
61,10,10,748,1024,-276,-26.953125
61,10,11,7585,2048,5537,270.361328125
61,10,12,10531,4096,6435,157.1044921875
61,10,13,614,8192,-7578,-92.5048828125
61,10,14,29058,16384,12674,77.35595703125
61,10,15,93981,32768,61213,186.8072509765625
61,11,1,0,2,-2,-100.0
61,11,2,4,4,0,0.0
61,11,3,3,8,-5,-62.5
61,11,4,16,16,0,0.0
61,11,5,35,32,3,9.375
61,11,6,47,64,-17,-26.5625
61,11,7,131,128,3,2.34375
61,11,8,281,256,25,9.765625
61,11,9,734,512,222,43.359375
61,11,10,425,1024,-599,-58.49609375
61,11,11,2180,2048,132,6.4453125
61,11,12,2914,4096,-1182,-28.857421875
61,11,13,6233,8192,-1959,-23.91357421875
61,11,14,27694,16384,11310,69.03076171875
61,11,15,5147,32768,-27621,-84.2926025390625
61,12,1,0,2,-2,-100.0
61,12,2,1,4,-3,-75.0
61,12,3,11,8,3,37.5
61,12,4,6,16,-10,-62.5
61,12,5,18,32,-14,-43.75
61,12,6,58,64,-6,-9.375
61,12,7,130,128,2,1.5625
61,12,8,209,256,-47,-18.359375
61,12,9,106,512,-406,-79.296875
61,12,10,106,1024,-918,-89.6484375
61,12,11,2576,2048,528,25.78125
61,12,12,7271,4096,3175,77.5146484375
61,12,13,20984,8192,12792,156.15234375
61,12,14,8436,16384,-7948,-48.5107421875
61,12,15,27539,32768,-5229,-15.9576416015625
61,13,1,0,2,-2,-100.0
61,13,2,2,4,-2,-50.0
61,13,3,10,8,2,25.0
61,13,4,3,16,-13,-81.25
61,13,5,20,32,-12,-37.5
61,13,6,127,64,63,98.4375
61,13,7,79,128,-49,-38.28125
61,13,8,62,256,-194,-75.78125
61,13,9,158,512,-354,-69.140625
61,13,10,204,1024,-820,-80.078125
61,13,11,426,2048,-1622,-79.19921875
61,13,12,538,4096,-3558,-86.865234375
61,13,13,440,8192,-7752,-94.62890625
61,13,14,12002,16384,-4382,-26.74560546875
61,13,15,6068,32768,-26700,-81.48193359375
61,14,1,0,2,-2,-100.0
61,14,2,1,4,-3,-75.0
61,14,3,4,8,-4,-50.0
61,14,4,27,16,11,68.75
61,14,5,29,32,-3,-9.375
61,14,6,22,64,-42,-65.625
61,14,7,24,128,-104,-81.25
61,14,8,150,256,-106,-41.40625
61,14,9,599,512,87,16.9921875
61,14,10,2792,1024,1768,172.65625
61,14,11,1458,2048,-590,-28.80859375
61,14,12,3923,4096,-173,-4.2236328125
61,14,13,1364,8192,-6828,-83.349609375
61,14,14,6065,16384,-10319,-62.982177734375
61,14,15,20141,32768,-12627,-38.5345458984375
61,15,1,0,2,-2,-100.0
61,15,2,1,4,-3,-75.0
61,15,3,3,8,-5,-62.5
61,15,4,4,16,-12,-75.0
61,15,5,7,32,-25,-78.125
61,15,6,43,64,-21,-32.8125
61,15,7,141,128,13,10.15625
61,15,8,187,256,-69,-26.953125
61,15,9,22,512,-490,-95.703125
61,15,10,1004,1024,-20,-1.953125
61,15,11,462,2048,-1586,-77.44140625
61,15,12,4260,4096,164,4.00390625
61,15,13,8388,8192,196,2.392578125
61,15,14,16210,16384,-174,-1.06201171875
61,15,15,21619,32768,-11149,-34.0240478515625
61,16,1,0,2,-2,-100.0
61,16,2,2,4,-2,-50.0
61,16,3,2,8,-6,-75.0
61,16,4,5,16,-11,-68.75
61,16,5,11,32,-21,-65.625
61,16,6,19,64,-45,-70.3125
61,16,7,157,128,29,22.65625
61,16,8,582,256,326,127.34375
61,16,9,193,512,-319,-62.3046875
61,16,10,323,1024,-701,-68.45703125
61,16,11,1939,2048,-109,-5.322265625
61,16,12,9211,4096,5115,124.8779296875
61,16,13,1456,8192,-6736,-82.2265625
61,16,14,2369,16384,-14015,-85.540771484375
61,16,15,23889,32768,-8879,-27.0965576171875
61,17,1,0,2,-2,-100.0
61,17,2,2,4,-2,-50.0
61,17,3,11,8,3,37.5
61,17,4,15,16,-1,-6.25
61,17,5,8,32,-24,-75.0
61,17,6,20,64,-44,-68.75
61,17,7,21,128,-107,-83.59375
61,17,8,340,256,84,32.8125
61,17,9,130,512,-382,-74.609375
61,17,10,38,1024,-986,-96.2890625
61,17,11,1076,2048,-972,-47.4609375
61,17,12,2070,4096,-2026,-49.462890625
61,17,13,2871,8192,-5321,-64.95361328125
61,17,14,4663,16384,-11721,-71.539306640625
61,17,15,50089,32768,17321,52.8594970703125
61,18,1,0,2,-2,-100.0
61,18,2,3,4,-1,-25.0
61,18,3,4,8,-4,-50.0
61,18,4,24,16,8,50.0
61,18,5,5,32,-27,-84.375
61,18,6,35,64,-29,-45.3125
61,18,7,188,128,60,46.875
61,18,8,878,256,622,242.96875
61,18,9,110,512,-402,-78.515625
61,18,10,3637,1024,2613,255.17578125
61,18,11,1659,2048,-389,-18.994140625
61,18,12,7505,4096,3409,83.2275390625
61,18,13,1465,8192,-6727,-82.11669921875
61,18,14,5687,16384,-10697,-65.289306640625
61,18,15,93677,32768,60909,185.8795166015625
61,19,1,0,2,-2,-100.0
61,19,2,4,4,0,0.0
61,19,3,5,8,-3,-37.5
61,19,4,12,16,-4,-25.0
61,19,5,23,32,-9,-28.125
61,19,6,68,64,4,6.25
61,19,7,88,128,-40,-31.25
61,19,8,652,256,396,154.6875
61,19,9,188,512,-324,-63.28125
61,19,10,1015,1024,-9,-0.87890625
61,19,11,4222,2048,2174,106.15234375
61,19,12,1780,4096,-2316,-56.54296875
61,19,13,3263,8192,-4929,-60.16845703125
61,19,14,8830,16384,-7554,-46.10595703125
61,19,15,13283,32768,-19485,-59.4635009765625
61,20,1,0,2,-2,-100.0
61,20,2,8,4,4,100.0
61,20,3,4,8,-4,-50.0
61,20,4,6,16,-10,-62.5
61,20,5,4,32,-28,-87.5
61,20,6,174,64,110,171.875
61,20,7,15,128,-113,-88.28125
61,20,8,64,256,-192,-75.0
61,20,9,177,512,-335,-65.4296875
61,20,10,62,1024,-962,-93.9453125
61,20,11,989,2048,-1059,-51.708984375
61,20,12,6185,4096,2089,51.0009765625
61,20,13,3757,8192,-4435,-54.13818359375
61,20,14,16062,16384,-322,-1.96533203125
61,20,15,8537,32768,-24231,-73.9471435546875
61,21,1,0,2,-2,-100.0
61,21,2,4,4,0,0.0
61,21,3,2,8,-6,-75.0
61,21,4,13,16,-3,-18.75
61,21,5,35,32,3,9.375
61,21,6,7,64,-57,-89.0625
61,21,7,220,128,92,71.875
61,21,8,289,256,33,12.890625
61,21,9,173,512,-339,-66.2109375
61,21,10,3002,1024,1978,193.1640625
61,21,11,737,2048,-1311,-64.013671875
61,21,12,8466,4096,4370,106.689453125
61,21,13,14705,8192,6513,79.50439453125
61,21,14,9472,16384,-6912,-42.1875
61,21,15,35605,32768,2837,8.6578369140625
61,22,1,0,2,-2,-100.0
61,22,2,1,4,-3,-75.0
61,22,3,6,8,-2,-25.0
61,22,4,3,16,-13,-81.25
61,22,5,4,32,-28,-87.5
61,22,6,22,64,-42,-65.625
61,22,7,24,128,-104,-81.25
61,22,8,443,256,187,73.046875
61,22,9,124,512,-388,-75.78125
61,22,10,202,1024,-822,-80.2734375
61,22,11,1207,2048,-841,-41.064453125
61,22,12,8645,4096,4549,111.0595703125
61,22,13,4666,8192,-3526,-43.0419921875
61,22,14,256,16384,-16128,-98.4375
61,22,15,13949,32768,-18819,-57.4310302734375
61,23,1,0,2,-2,-100.0
61,23,2,2,4,-2,-50.0
61,23,3,14,8,6,75.0
61,23,4,5,16,-11,-68.75
61,23,5,33,32,1,3.125
61,23,6,49,64,-15,-23.4375
61,23,7,42,128,-86,-67.1875
61,23,8,49,256,-207,-80.859375
61,23,9,559,512,47,9.1796875
61,23,10,633,1024,-391,-38.18359375
61,23,11,3859,2048,1811,88.427734375
61,23,12,10301,4096,6205,151.4892578125
61,23,13,5112,8192,-3080,-37.59765625
61,23,14,34847,16384,18463,112.689208984375
61,23,15,4903,32768,-27865,-85.0372314453125
61,24,1,0,2,-2,-100.0
61,24,2,5,4,1,25.0
61,24,3,6,8,-2,-25.0
61,24,4,13,16,-3,-18.75
61,24,5,51,32,19,59.375
61,24,6,54,64,-10,-15.625
61,24,7,123,128,-5,-3.90625
61,24,8,49,256,-207,-80.859375
61,24,9,117,512,-395,-77.1484375
61,24,10,1512,1024,488,47.65625
61,24,11,571,2048,-1477,-72.119140625
61,24,12,6626,4096,2530,61.767578125
61,24,13,6225,8192,-1967,-24.01123046875
61,24,14,88191,16384,71807,438.275146484375
61,24,15,50706,32768,17938,54.742431640625
61,25,1,0,2,-2,-100.0
61,25,2,7,4,3,75.0
61,25,3,2,8,-6,-75.0
61,25,4,3,16,-13,-81.25
61,25,5,21,32,-11,-34.375
61,25,6,30,64,-34,-53.125
61,25,7,48,128,-80,-62.5
61,25,8,808,256,552,215.625
61,25,9,363,512,-149,-29.1015625
61,25,10,1786,1024,762,74.4140625
61,25,11,663,2048,-1385,-67.626953125
61,25,12,2966,4096,-1130,-27.587890625
61,25,13,70,8192,-8122,-99.1455078125
61,25,14,19682,16384,3298,20.12939453125
61,25,15,24215,32768,-8553,-26.1016845703125
61,26,1,0,2,-2,-100.0
61,26,2,4,4,0,0.0
61,26,3,6,8,-2,-25.0
61,26,4,13,16,-3,-18.75
61,26,5,27,32,-5,-15.625
61,26,6,14,64,-50,-78.125
61,26,7,68,128,-60,-46.875
61,26,8,22,256,-234,-91.40625
61,26,9,71,512,-441,-86.1328125
61,26,10,282,1024,-742,-72.4609375
61,26,11,969,2048,-1079,-52.685546875
61,26,12,644,4096,-3452,-84.27734375
61,26,13,2519,8192,-5673,-69.25048828125
61,26,14,5242,16384,-11142,-68.00537109375
61,26,15,91313,32768,58545,178.6651611328125
61,27,1,0,2,-2,-100.0
61,27,2,1,4,-3,-75.0
61,27,3,8,8,0,0.0
61,27,4,4,16,-12,-75.0
61,27,5,30,32,-2,-6.25
61,27,6,67,64,3,4.6875
61,27,7,263,128,135,105.46875
61,27,8,107,256,-149,-58.203125
61,27,9,624,512,112,21.875
61,27,10,1887,1024,863,84.27734375
61,27,11,109,2048,-1939,-94.677734375
61,27,12,8879,4096,4783,116.7724609375
61,27,13,1002,8192,-7190,-87.7685546875
61,27,14,4534,16384,-11850,-72.32666015625
61,27,15,14126,32768,-18642,-56.890869140625
61,28,1,0,2,-2,-100.0
61,28,2,2,4,-2,-50.0
61,28,3,5,8,-3,-37.5
61,28,4,6,16,-10,-62.5
61,28,5,4,32,-28,-87.5
61,28,6,28,64,-36,-56.25
61,28,7,124,128,-4,-3.125
61,28,8,236,256,-20,-7.8125
61,28,9,297,512,-215,-41.9921875
61,28,10,479,1024,-545,-53.22265625
61,28,11,3262,2048,1214,59.27734375
61,28,12,2347,4096,-1749,-42.7001953125
61,28,13,10451,8192,2259,27.57568359375
61,28,14,9937,16384,-6447,-39.349365234375
61,28,15,51876,32768,19108,58.31298828125
61,29,1,0,2,-2,-100.0
61,29,2,1,4,-3,-75.0
61,29,3,4,8,-4,-50.0
61,29,4,17,16,1,6.25
61,29,5,62,32,30,93.75
61,29,6,29,64,-35,-54.6875
61,29,7,208,128,80,62.5
61,29,8,370,256,114,44.53125
61,29,9,313,512,-199,-38.8671875
61,29,10,870,1024,-154,-15.0390625
61,29,11,450,2048,-1598,-78.02734375
61,29,12,3914,4096,-182,-4.443359375
61,29,13,223,8192,-7969,-97.27783203125
61,29,14,3978,16384,-12406,-75.72021484375
61,29,15,71863,32768,39095,119.3084716796875
61,30,1,0,2,-2,-100.0
61,30,2,1,4,-3,-75.0
61,30,3,3,8,-5,-62.5
61,30,4,5,16,-11,-68.75
61,30,5,11,32,-21,-65.625
61,30,6,16,64,-48,-75.0
61,30,7,74,128,-54,-42.1875
61,30,8,699,256,443,173.046875
61,30,9,841,512,329,64.2578125
61,30,10,1545,1024,521,50.87890625
61,30,11,751,2048,-1297,-63.330078125
61,30,12,2769,4096,-1327,-32.3974609375
61,30,13,20895,8192,12703,155.06591796875
61,30,14,7355,16384,-9029,-55.108642578125
61,30,15,41661,32768,8893,27.1392822265625
61,31,1,0,2,-2,-100.0
61,31,2,1,4,-3,-75.0
61,31,3,4,8,-4,-50.0
61,31,4,5,16,-11,-68.75
61,31,5,13,32,-19,-59.375
61,31,6,105,64,41,64.0625
61,31,7,29,128,-99,-77.34375
61,31,8,112,256,-144,-56.25
61,31,9,204,512,-308,-60.15625
61,31,10,265,1024,-759,-74.12109375
61,31,11,2759,2048,711,34.716796875
61,31,12,867,4096,-3229,-78.8330078125
61,31,13,13606,8192,5414,66.0888671875
61,31,14,5199,16384,-11185,-68.267822265625
61,31,15,21123,32768,-11645,-35.5377197265625
61,32,1,0,2,-2,-100.0
61,32,2,2,4,-2,-50.0
61,32,3,12,8,4,50.0
61,32,4,12,16,-4,-25.0
61,32,5,26,32,-6,-18.75
61,32,6,34,64,-30,-46.875
61,32,7,135,128,7,5.46875
61,32,8,90,256,-166,-64.84375
61,32,9,647,512,135,26.3671875
61,32,10,807,1024,-217,-21.19140625
61,32,11,472,2048,-1576,-76.953125
61,32,12,1259,4096,-2837,-69.2626953125
61,32,13,7554,8192,-638,-7.7880859375
61,32,14,17086,16384,702,4.28466796875
61,32,15,9901,32768,-22867,-69.7845458984375
61,33,1,0,2,-2,-100.0
61,33,2,2,4,-2,-50.0
61,33,3,12,8,4,50.0
61,33,4,44,16,28,175.0
61,33,5,96,32,64,200.0
61,33,6,10,64,-54,-84.375
61,33,7,10,128,-118,-92.1875
61,33,8,7,256,-249,-97.265625
61,33,9,1225,512,713,139.2578125
61,33,10,308,1024,-716,-69.921875
61,33,11,693,2048,-1355,-66.162109375
61,33,12,733,4096,-3363,-82.1044921875
61,33,13,25627,8192,17435,212.82958984375
61,33,14,30500,16384,14116,86.1572265625
61,33,15,33675,32768,907,2.7679443359375
61,34,1,0,2,-2,-100.0
61,34,2,1,4,-3,-75.0
61,34,3,2,8,-6,-75.0
61,34,4,5,16,-11,-68.75
61,34,5,9,32,-23,-71.875
61,34,6,8,64,-56,-87.5
61,34,7,28,128,-100,-78.125
61,34,8,170,256,-86,-33.59375
61,34,9,182,512,-330,-64.453125
61,34,10,407,1024,-617,-60.25390625
61,34,11,3560,2048,1512,73.828125
61,34,12,613,4096,-3483,-85.0341796875
61,34,13,10559,8192,2367,28.89404296875
61,34,14,6171,16384,-10213,-62.335205078125
61,34,15,40643,32768,7875,24.0325927734375
61,35,1,0,2,-2,-100.0
61,35,2,1,4,-3,-75.0
61,35,3,13,8,5,62.5
61,35,4,3,16,-13,-81.25
61,35,5,39,32,7,21.875
61,35,6,115,64,51,79.6875
61,35,7,453,128,325,253.90625
61,35,8,324,256,68,26.5625
61,35,9,120,512,-392,-76.5625
61,35,10,16,1024,-1008,-98.4375
61,35,11,1009,2048,-1039,-50.732421875
61,35,12,6102,4096,2006,48.974609375
61,35,13,3266,8192,-4926,-60.1318359375
61,35,14,8618,16384,-7766,-47.39990234375
61,35,15,33326,32768,558,1.702880859375
61,36,1,0,2,-2,-100.0
61,36,2,3,4,-1,-25.0
61,36,3,14,8,6,75.0
61,36,4,17,16,1,6.25
61,36,5,33,32,1,3.125
61,36,6,15,64,-49,-76.5625
61,36,7,19,128,-109,-85.15625
61,36,8,219,256,-37,-14.453125
61,36,9,54,512,-458,-89.453125
61,36,10,2934,1024,1910,186.5234375
61,36,11,602,2048,-1446,-70.60546875
61,36,12,6515,4096,2419,59.0576171875
61,36,13,2623,8192,-5569,-67.98095703125
61,36,14,15396,16384,-988,-6.0302734375
61,36,15,2881,32768,-29887,-91.2078857421875
61,37,1,0,2,-2,-100.0
61,37,2,2,4,-2,-50.0
61,37,3,2,8,-6,-75.0
61,37,4,3,16,-13,-81.25
61,37,5,8,32,-24,-75.0
61,37,6,74,64,10,15.625
61,37,7,34,128,-94,-73.4375
61,37,8,110,256,-146,-57.03125
61,37,9,297,512,-215,-41.9921875
61,37,10,54,1024,-970,-94.7265625
61,37,11,1795,2048,-253,-12.353515625
61,37,12,13113,4096,9017,220.1416015625
61,37,13,8858,8192,666,8.1298828125
61,37,14,6507,16384,-9877,-60.284423828125
61,37,15,22292,32768,-10476,-31.97021484375
61,38,1,0,2,-2,-100.0
61,38,2,1,4,-3,-75.0
61,38,3,2,8,-6,-75.0
61,38,4,14,16,-2,-12.5
61,38,5,56,32,24,75.0
61,38,6,10,64,-54,-84.375
61,38,7,107,128,-21,-16.40625
61,38,8,28,256,-228,-89.0625
61,38,9,54,512,-458,-89.453125
61,38,10,875,1024,-149,-14.55078125
61,38,11,1576,2048,-472,-23.046875
61,38,12,3983,4096,-113,-2.7587890625
61,38,13,1680,8192,-6512,-79.4921875
61,38,14,34980,16384,18596,113.5009765625
61,38,15,71087,32768,38319,116.9403076171875
61,39,1,0,2,-2,-100.0
61,39,2,1,4,-3,-75.0
61,39,3,16,8,8,100.0
61,39,4,36,16,20,125.0
61,39,5,6,32,-26,-81.25
61,39,6,48,64,-16,-25.0
61,39,7,187,128,59,46.09375
61,39,8,36,256,-220,-85.9375
61,39,9,667,512,155,30.2734375
61,39,10,903,1024,-121,-11.81640625
61,39,11,2638,2048,590,28.80859375
61,39,12,8030,4096,3934,96.044921875
61,39,13,25159,8192,16967,207.11669921875
61,39,14,46443,16384,30059,183.465576171875
61,39,15,120002,32768,87234,266.217041015625
61,40,1,0,2,-2,-100.0
61,40,2,1,4,-3,-75.0
61,40,3,15,8,7,87.5
61,40,4,45,16,29,181.25
61,40,5,4,32,-28,-87.5
61,40,6,109,64,45,70.3125
61,40,7,35,128,-93,-72.65625
61,40,8,135,256,-121,-47.265625
61,40,9,27,512,-485,-94.7265625
61,40,10,549,1024,-475,-46.38671875
61,40,11,1409,2048,-639,-31.201171875
61,40,12,1133,4096,-2963,-72.3388671875
61,40,13,4250,8192,-3942,-48.1201171875
61,40,14,5372,16384,-11012,-67.2119140625
61,40,15,23561,32768,-9207,-28.0975341796875
61,41,1,0,2,-2,-100.0
61,41,2,1,4,-3,-75.0
61,41,3,4,8,-4,-50.0
61,41,4,28,16,12,75.0
61,41,5,24,32,-8,-25.0
61,41,6,211,64,147,229.6875
61,41,7,244,128,116,90.625
61,41,8,28,256,-228,-89.0625
61,41,9,228,512,-284,-55.46875
61,41,10,484,1024,-540,-52.734375
61,41,11,3772,2048,1724,84.1796875
61,41,12,3851,4096,-245,-5.9814453125
61,41,13,1413,8192,-6779,-82.75146484375
61,41,14,599,16384,-15785,-96.343994140625
61,41,15,12293,32768,-20475,-62.4847412109375
61,42,1,0,2,-2,-100.0
61,42,2,1,4,-3,-75.0
61,42,3,3,8,-5,-62.5
61,42,4,12,16,-4,-25.0
61,42,5,38,32,6,18.75
61,42,6,16,64,-48,-75.0
61,42,7,98,128,-30,-23.4375
61,42,8,1269,256,1013,395.703125
61,42,9,355,512,-157,-30.6640625
61,42,10,1065,1024,41,4.00390625
61,42,11,10454,2048,8406,410.44921875
61,42,12,568,4096,-3528,-86.1328125
61,42,13,27067,8192,18875,230.40771484375
61,42,14,8096,16384,-8288,-50.5859375
61,42,15,4516,32768,-28252,-86.21826171875
61,43,1,0,2,-2,-100.0
61,43,2,2,4,-2,-50.0
61,43,3,7,8,-1,-12.5
61,43,4,5,16,-11,-68.75
61,43,5,4,32,-28,-87.5
61,43,6,172,64,108,168.75
61,43,7,14,128,-114,-89.0625
61,43,8,106,256,-150,-58.59375
61,43,9,180,512,-332,-64.84375
61,43,10,318,1024,-706,-68.9453125
61,43,11,2942,2048,894,43.65234375
61,43,12,1580,4096,-2516,-61.42578125
61,43,13,225,8192,-7967,-97.25341796875
61,43,14,5132,16384,-11252,-68.6767578125
61,43,15,64444,32768,31676,96.66748046875
61,44,1,0,2,-2,-100.0
61,44,2,2,4,-2,-50.0
61,44,3,21,8,13,162.5
61,44,4,11,16,-5,-31.25
61,44,5,29,32,-3,-9.375
61,44,6,159,64,95,148.4375
61,44,7,390,128,262,204.6875
61,44,8,44,256,-212,-82.8125
61,44,9,162,512,-350,-68.359375
61,44,10,398,1024,-626,-61.1328125
61,44,11,575,2048,-1473,-71.923828125
61,44,12,2682,4096,-1414,-34.521484375
61,44,13,5077,8192,-3115,-38.02490234375
61,44,14,3424,16384,-12960,-79.1015625
61,44,15,8227,32768,-24541,-74.8931884765625
61,45,1,0,2,-2,-100.0
61,45,2,1,4,-3,-75.0
61,45,3,4,8,-4,-50.0
61,45,4,8,16,-8,-50.0
61,45,5,5,32,-27,-84.375
61,45,6,25,64,-39,-60.9375
61,45,7,165,128,37,28.90625
61,45,8,319,256,63,24.609375
61,45,9,93,512,-419,-81.8359375
61,45,10,165,1024,-859,-83.88671875
61,45,11,1907,2048,-141,-6.884765625
61,45,12,2821,4096,-1275,-31.1279296875
61,45,13,30766,8192,22574,275.5615234375
61,45,14,51698,16384,35314,215.53955078125
61,45,15,11054,32768,-21714,-66.265869140625
61,46,1,0,2,-2,-100.0
61,46,2,2,4,-2,-50.0
61,46,3,3,8,-5,-62.5
61,46,4,10,16,-6,-37.5
61,46,5,28,32,-4,-12.5
61,46,6,40,64,-24,-37.5
61,46,7,134,128,6,4.6875
61,46,8,520,256,264,103.125
61,46,9,52,512,-460,-89.84375
61,46,10,1216,1024,192,18.75
61,46,11,892,2048,-1156,-56.4453125
61,46,12,18247,4096,14151,345.4833984375
61,46,13,9510,8192,1318,16.0888671875
61,46,14,4638,16384,-11746,-71.69189453125
61,46,15,75340,32768,42572,129.91943359375
61,47,1,0,2,-2,-100.0
61,47,2,1,4,-3,-75.0
61,47,3,4,8,-4,-50.0
61,47,4,10,16,-6,-37.5
61,47,5,48,32,16,50.0
61,47,6,152,64,88,137.5
61,47,7,231,128,103,80.46875
61,47,8,42,256,-214,-83.59375
61,47,9,511,512,-1,-0.1953125
61,47,10,382,1024,-642,-62.6953125
61,47,11,2364,2048,316,15.4296875
61,47,12,515,4096,-3581,-87.4267578125
61,47,13,2756,8192,-5436,-66.357421875
61,47,14,6916,16384,-9468,-57.7880859375
61,47,15,203366,32768,170598,520.623779296875
61,48,1,0,2,-2,-100.0
61,48,2,3,4,-1,-25.0
61,48,3,6,8,-2,-25.0
61,48,4,22,16,6,37.5
61,48,5,45,32,13,40.625
61,48,6,9,64,-55,-85.9375
61,48,7,63,128,-65,-50.78125
61,48,8,10,256,-246,-96.09375
61,48,9,242,512,-270,-52.734375
61,48,10,1176,1024,152,14.84375
61,48,11,1635,2048,-413,-20.166015625
61,48,12,745,4096,-3351,-81.8115234375
61,48,13,2597,8192,-5595,-68.29833984375
61,48,14,1015,16384,-15369,-93.804931640625
61,48,15,29757,32768,-3011,-9.1888427734375
61,49,1,0,2,-2,-100.0
61,49,2,1,4,-3,-75.0
61,49,3,8,8,0,0.0
61,49,4,8,16,-8,-50.0
61,49,5,23,32,-9,-28.125
61,49,6,20,64,-44,-68.75
61,49,7,148,128,20,15.625
61,49,8,544,256,288,112.5
61,49,9,535,512,23,4.4921875
61,49,10,1597,1024,573,55.95703125
61,49,11,6465,2048,4417,215.673828125
61,49,12,4817,4096,721,17.6025390625
61,49,13,7853,8192,-339,-4.13818359375
61,49,14,7044,16384,-9340,-57.0068359375
61,49,15,36524,32768,3756,11.46240234375
61,50,1,0,2,-2,-100.0
61,50,2,2,4,-2,-50.0
61,50,3,10,8,2,25.0
61,50,4,24,16,8,50.0
61,50,5,7,32,-25,-78.125
61,50,6,19,64,-45,-70.3125
61,50,7,35,128,-93,-72.65625
61,50,8,94,256,-162,-63.28125
61,50,9,641,512,129,25.1953125
61,50,10,945,1024,-79,-7.71484375
61,50,11,646,2048,-1402,-68.45703125
61,50,12,1529,4096,-2567,-62.6708984375
61,50,13,20498,8192,12306,150.2197265625
61,50,14,2021,16384,-14363,-87.664794921875
61,50,15,5419,32768,-27349,-83.4625244140625
61,51,1,0,2,-2,-100.0
61,51,2,1,4,-3,-75.0
61,51,3,2,8,-6,-75.0
61,51,4,8,16,-8,-50.0
61,51,5,24,32,-8,-25.0
61,51,6,53,64,-11,-17.1875
61,51,7,245,128,117,91.40625
61,51,8,191,256,-65,-25.390625
61,51,9,139,512,-373,-72.8515625
61,51,10,1867,1024,843,82.32421875
61,51,11,138,2048,-1910,-93.26171875
61,51,12,6814,4096,2718,66.357421875
61,51,13,5834,8192,-2358,-28.7841796875
61,51,14,16972,16384,588,3.5888671875
61,51,15,14647,32768,-18121,-55.3009033203125
61,52,1,0,2,-2,-100.0
61,52,2,1,4,-3,-75.0
61,52,3,3,8,-5,-62.5
61,52,4,11,16,-5,-31.25
61,52,5,7,32,-25,-78.125
61,52,6,12,64,-52,-81.25
61,52,7,194,128,66,51.5625
61,52,8,764,256,508,198.4375
61,52,9,430,512,-82,-16.015625
61,52,10,1872,1024,848,82.8125
61,52,11,2579,2048,531,25.927734375
61,52,12,2989,4096,-1107,-27.0263671875
61,52,13,22963,8192,14771,180.31005859375
61,52,14,35199,16384,18815,114.837646484375
61,52,15,13907,32768,-18861,-57.5592041015625
61,53,1,0,2,-2,-100.0
61,53,2,2,4,-2,-50.0
61,53,3,5,8,-3,-37.5
61,53,4,5,16,-11,-68.75
61,53,5,27,32,-5,-15.625
61,53,6,156,64,92,143.75
61,53,7,89,128,-39,-30.46875
61,53,8,298,256,42,16.40625
61,53,9,1111,512,599,116.9921875
61,53,10,367,1024,-657,-64.16015625
61,53,11,537,2048,-1511,-73.779296875
61,53,12,985,4096,-3111,-75.9521484375
61,53,13,3860,8192,-4332,-52.880859375
61,53,14,33175,16384,16791,102.484130859375
61,53,15,24726,32768,-8042,-24.542236328125
61,54,1,0,2,-2,-100.0
61,54,2,2,4,-2,-50.0
61,54,3,8,8,0,0.0
61,54,4,6,16,-10,-62.5
61,54,5,71,32,39,121.875
61,54,6,40,64,-24,-37.5
61,54,7,94,128,-34,-26.5625
61,54,8,325,256,69,26.953125
61,54,9,1448,512,936,182.8125
61,54,10,3041,1024,2017,196.97265625
61,54,11,364,2048,-1684,-82.2265625
61,54,12,1577,4096,-2519,-61.4990234375
61,54,13,5126,8192,-3066,-37.4267578125
61,54,14,3062,16384,-13322,-81.31103515625
61,54,15,21518,32768,-11250,-34.332275390625
61,55,1,0,2,-2,-100.0
61,55,2,1,4,-3,-75.0
61,55,3,11,8,3,37.5
61,55,4,8,16,-8,-50.0
61,55,5,21,32,-11,-34.375
61,55,6,15,64,-49,-76.5625
61,55,7,67,128,-61,-47.65625
61,55,8,268,256,12,4.6875
61,55,9,979,512,467,91.2109375
61,55,10,1063,1024,39,3.80859375
61,55,11,647,2048,-1401,-68.408203125
61,55,12,4719,4096,623,15.2099609375
61,55,13,1810,8192,-6382,-77.9052734375
61,55,14,24462,16384,8078,49.30419921875
61,55,15,18864,32768,-13904,-42.431640625
61,56,1,0,2,-2,-100.0
61,56,2,2,4,-2,-50.0
61,56,3,5,8,-3,-37.5
61,56,4,9,16,-7,-43.75
61,56,5,23,32,-9,-28.125
61,56,6,5,64,-59,-92.1875
61,56,7,120,128,-8,-6.25
61,56,8,1364,256,1108,432.8125
61,56,9,31,512,-481,-93.9453125
61,56,10,1161,1024,137,13.37890625
61,56,11,66,2048,-1982,-96.77734375
61,56,12,1283,4096,-2813,-68.6767578125
61,56,13,409,8192,-7783,-95.00732421875
61,56,14,4970,16384,-11414,-69.66552734375
61,56,15,16404,32768,-16364,-49.93896484375
61,57,1,0,2,-2,-100.0
61,57,2,3,4,-1,-25.0
61,57,3,3,8,-5,-62.5
61,57,4,10,16,-6,-37.5
61,57,5,36,32,4,12.5
61,57,6,162,64,98,153.125
61,57,7,82,128,-46,-35.9375
61,57,8,356,256,100,39.0625
61,57,9,740,512,228,44.53125
61,57,10,521,1024,-503,-49.12109375
61,57,11,546,2048,-1502,-73.33984375
61,57,12,4504,4096,408,9.9609375
61,57,13,170,8192,-8022,-97.9248046875
61,57,14,6878,16384,-9506,-58.02001953125
61,57,15,71752,32768,38984,118.9697265625
61,58,1,0,2,-2,-100.0
61,58,2,1,4,-3,-75.0
61,58,3,11,8,3,37.5
61,58,4,16,16,0,0.0
61,58,5,14,32,-18,-56.25
61,58,6,44,64,-20,-31.25
61,58,7,86,128,-42,-32.8125
61,58,8,452,256,196,76.5625
61,58,9,1715,512,1203,234.9609375
61,58,10,743,1024,-281,-27.44140625
61,58,11,5126,2048,3078,150.29296875
61,58,12,1549,4096,-2547,-62.1826171875
61,58,13,27875,8192,19683,240.27099609375
61,58,14,13624,16384,-2760,-16.845703125
61,58,15,40426,32768,7658,23.370361328125
61,59,1,0,2,-2,-100.0
61,59,2,2,4,-2,-50.0
61,59,3,7,8,-1,-12.5
61,59,4,25,16,9,56.25
61,59,5,32,32,0,0.0
61,59,6,7,64,-57,-89.0625
61,59,7,88,128,-40,-31.25
61,59,8,842,256,586,228.90625
61,59,9,480,512,-32,-6.25
61,59,10,3309,1024,2285,223.14453125
61,59,11,3785,2048,1737,84.814453125
61,59,12,10368,4096,6272,153.125
61,59,13,11715,8192,3523,43.00537109375
61,59,14,14150,16384,-2234,-13.63525390625
61,59,15,3152,32768,-29616,-90.380859375
61,60,1,0,2,-2,-100.0
61,60,2,1,4,-3,-75.0
61,60,3,7,8,-1,-12.5
61,60,4,9,16,-7,-43.75
61,60,5,21,32,-11,-34.375
61,60,6,8,64,-56,-87.5
61,60,7,53,128,-75,-58.59375
61,60,8,465,256,209,81.640625
61,60,9,736,512,224,43.75
61,60,10,594,1024,-430,-41.9921875
61,60,11,5339,2048,3291,160.693359375
61,60,12,167,4096,-3929,-95.9228515625
61,60,13,32017,8192,23825,290.83251953125
61,60,14,15021,16384,-1363,-8.319091796875
61,60,15,80344,32768,47576,145.1904296875
61,61,1,0,2,-2,-100.0
61,61,2,9,4,5,125.0
61,61,3,5,8,-3,-37.5
61,61,4,17,16,1,6.25
61,61,5,18,32,-14,-43.75
61,61,6,46,64,-18,-28.125
61,61,7,73,128,-55,-42.96875
61,61,8,515,256,259,101.171875
61,61,9,450,512,-62,-12.109375
61,61,10,1299,1024,275,26.85546875
61,61,11,771,2048,-1277,-62.353515625
61,61,12,817,4096,-3279,-80.0537109375
61,61,13,3671,8192,-4521,-55.18798828125
61,61,14,10706,16384,-5678,-34.65576171875
61,61,15,79124,32768,46356,141.46728515625
62,1,1,0,2,-2,-100.0
62,1,2,3,4,-1,-25.0
62,1,3,23,8,15,187.5
62,1,4,23,16,7,43.75
62,1,5,28,32,-4,-12.5
62,1,6,43,64,-21,-32.8125
62,1,7,71,128,-57,-44.53125
62,1,8,423,256,167,65.234375
62,1,9,3656,512,3144,614.0625
62,1,10,805,1024,-219,-21.38671875
62,1,11,3017,2048,969,47.314453125
62,1,12,2422,4096,-1674,-40.869140625
62,1,13,3704,8192,-4488,-54.78515625
62,1,14,748,16384,-15636,-95.4345703125
62,1,15,21201,32768,-11567,-35.2996826171875
62,2,1,0,2,-2,-100.0
62,2,2,1,4,-3,-75.0
62,2,3,23,8,15,187.5
62,2,4,14,16,-2,-12.5
62,2,5,10,32,-22,-68.75
62,2,6,26,64,-38,-59.375
62,2,7,117,128,-11,-8.59375
62,2,8,75,256,-181,-70.703125
62,2,9,359,512,-153,-29.8828125
62,2,10,1247,1024,223,21.77734375
62,2,11,3943,2048,1895,92.529296875
62,2,12,3572,4096,-524,-12.79296875
62,2,13,435,8192,-7757,-94.68994140625
62,2,14,11787,16384,-4597,-28.057861328125
62,2,15,65875,32768,33107,101.0345458984375
62,3,1,0,2,-2,-100.0
62,3,2,1,4,-3,-75.0
62,3,3,3,8,-5,-62.5
62,3,4,18,16,2,12.5
62,3,5,42,32,10,31.25
62,3,6,81,64,17,26.5625
62,3,7,128,128,0,0.0
62,3,8,517,256,261,101.953125
62,3,9,177,512,-335,-65.4296875
62,3,10,29,1024,-995,-97.16796875
62,3,11,3299,2048,1251,61.083984375
62,3,12,1659,4096,-2437,-59.4970703125
62,3,13,18891,8192,10699,130.60302734375
62,3,14,21549,16384,5165,31.524658203125
62,3,15,23261,32768,-9507,-29.0130615234375
62,4,1,0,2,-2,-100.0
62,4,2,4,4,0,0.0
62,4,3,3,8,-5,-62.5
62,4,4,58,16,42,262.5
62,4,5,6,32,-26,-81.25
62,4,6,79,64,15,23.4375
62,4,7,178,128,50,39.0625
62,4,8,62,256,-194,-75.78125
62,4,9,401,512,-111,-21.6796875
62,4,10,1117,1024,93,9.08203125
62,4,11,3693,2048,1645,80.322265625
62,4,12,8086,4096,3990,97.412109375
62,4,13,3916,8192,-4276,-52.197265625
62,4,14,1110,16384,-15274,-93.22509765625
62,4,15,39409,32768,6641,20.2667236328125
62,5,1,0,2,-2,-100.0
62,5,2,1,4,-3,-75.0
62,5,3,4,8,-4,-50.0
62,5,4,15,16,-1,-6.25
62,5,5,48,32,16,50.0
62,5,6,99,64,35,54.6875
62,5,7,190,128,62,48.4375
62,5,8,483,256,227,88.671875
62,5,9,248,512,-264,-51.5625
62,5,10,55,1024,-969,-94.62890625
62,5,11,7827,2048,5779,282.177734375
62,5,12,6719,4096,2623,64.0380859375
62,5,13,12125,8192,3933,48.01025390625
62,5,14,7607,16384,-8777,-53.570556640625
62,5,15,55188,32768,22420,68.42041015625
62,6,1,0,2,-2,-100.0
62,6,2,4,4,0,0.0
62,6,3,8,8,0,0.0
62,6,4,8,16,-8,-50.0
62,6,5,27,32,-5,-15.625
62,6,6,100,64,36,56.25
62,6,7,105,128,-23,-17.96875
62,6,8,86,256,-170,-66.40625
62,6,9,440,512,-72,-14.0625
62,6,10,1998,1024,974,95.1171875
62,6,11,3587,2048,1539,75.146484375
62,6,12,7432,4096,3336,81.4453125
62,6,13,1516,8192,-6676,-81.494140625
62,6,14,22618,16384,6234,38.04931640625
62,6,15,2367,32768,-30401,-92.7764892578125
62,7,1,0,2,-2,-100.0
62,7,2,6,4,2,50.0
62,7,3,2,8,-6,-75.0
62,7,4,21,16,5,31.25
62,7,5,34,32,2,6.25
62,7,6,33,64,-31,-48.4375
62,7,7,288,128,160,125.0
62,7,8,52,256,-204,-79.6875
62,7,9,259,512,-253,-49.4140625
62,7,10,1403,1024,379,37.01171875
62,7,11,5097,2048,3049,148.876953125
62,7,12,1019,4096,-3077,-75.1220703125
62,7,13,3643,8192,-4549,-55.52978515625
62,7,14,17155,16384,771,4.705810546875
62,7,15,4452,32768,-28316,-86.41357421875
62,8,1,0,2,-2,-100.0
62,8,2,1,4,-3,-75.0
62,8,3,7,8,-1,-12.5
62,8,4,19,16,3,18.75
62,8,5,4,32,-28,-87.5
62,8,6,12,64,-52,-81.25
62,8,7,45,128,-83,-64.84375
62,8,8,9,256,-247,-96.484375
62,8,9,594,512,82,16.015625
62,8,10,73,1024,-951,-92.87109375
62,8,11,677,2048,-1371,-66.943359375
62,8,12,1511,4096,-2585,-63.1103515625
62,8,13,3383,8192,-4809,-58.70361328125
62,8,14,9980,16384,-6404,-39.0869140625
62,8,15,8821,32768,-23947,-73.0804443359375
62,9,1,0,2,-2,-100.0
62,9,2,1,4,-3,-75.0
62,9,3,5,8,-3,-37.5
62,9,4,36,16,20,125.0
62,9,5,49,32,17,53.125
62,9,6,31,64,-33,-51.5625
62,9,7,92,128,-36,-28.125
62,9,8,97,256,-159,-62.109375
62,9,9,177,512,-335,-65.4296875
62,9,10,235,1024,-789,-77.05078125
62,9,11,3772,2048,1724,84.1796875
62,9,12,3850,4096,-246,-6.005859375
62,9,13,13069,8192,4877,59.53369140625
62,9,14,13697,16384,-2687,-16.400146484375
62,9,15,4261,32768,-28507,-86.9964599609375
62,10,1,0,2,-2,-100.0
62,10,2,1,4,-3,-75.0
62,10,3,2,8,-6,-75.0
62,10,4,8,16,-8,-50.0
62,10,5,17,32,-15,-46.875
62,10,6,90,64,26,40.625
62,10,7,335,128,207,161.71875
62,10,8,315,256,59,23.046875
62,10,9,805,512,293,57.2265625
62,10,10,169,1024,-855,-83.49609375
62,10,11,851,2048,-1197,-58.447265625
62,10,12,1327,4096,-2769,-67.6025390625
62,10,13,31089,8192,22897,279.50439453125
62,10,14,15204,16384,-1180,-7.2021484375
62,10,15,23663,32768,-9105,-27.7862548828125
62,11,1,0,2,-2,-100.0
62,11,2,1,4,-3,-75.0
62,11,3,4,8,-4,-50.0
62,11,4,26,16,10,62.5
62,11,5,16,32,-16,-50.0
62,11,6,66,64,2,3.125
62,11,7,57,128,-71,-55.46875
62,11,8,189,256,-67,-26.171875
62,11,9,1702,512,1190,232.421875
62,11,10,1104,1024,80,7.8125
62,11,11,2152,2048,104,5.078125
62,11,12,2499,4096,-1597,-38.9892578125
62,11,13,13202,8192,5010,61.1572265625
62,11,14,17285,16384,901,5.499267578125
62,11,15,75395,32768,42627,130.0872802734375
62,12,1,0,2,-2,-100.0
62,12,2,7,4,3,75.0
62,12,3,5,8,-3,-37.5
62,12,4,10,16,-6,-37.5
62,12,5,74,32,42,131.25
62,12,6,60,64,-4,-6.25
62,12,7,140,128,12,9.375
62,12,8,437,256,181,70.703125
62,12,9,232,512,-280,-54.6875
62,12,10,2108,1024,1084,105.859375
62,12,11,7356,2048,5308,259.1796875
62,12,12,416,4096,-3680,-89.84375
62,12,13,11550,8192,3358,40.9912109375
62,12,14,10813,16384,-5571,-34.002685546875
62,12,15,2414,32768,-30354,-92.633056640625
62,13,1,0,2,-2,-100.0
62,13,2,1,4,-3,-75.0
62,13,3,4,8,-4,-50.0
62,13,4,31,16,15,93.75
62,13,5,14,32,-18,-56.25
62,13,6,49,64,-15,-23.4375
62,13,7,362,128,234,182.8125
62,13,8,198,256,-58,-22.65625
62,13,9,390,512,-122,-23.828125
62,13,10,2871,1024,1847,180.37109375
62,13,11,3802,2048,1754,85.64453125
62,13,12,4532,4096,436,10.64453125
62,13,13,14455,8192,6263,76.45263671875
62,13,14,20944,16384,4560,27.83203125
62,13,15,10655,32768,-22113,-67.4835205078125
62,14,1,0,2,-2,-100.0
62,14,2,3,4,-1,-25.0
62,14,3,2,8,-6,-75.0
62,14,4,3,16,-13,-81.25
62,14,5,7,32,-25,-78.125
62,14,6,25,64,-39,-60.9375
62,14,7,18,128,-110,-85.9375
62,14,8,216,256,-40,-15.625
62,14,9,1810,512,1298,253.515625
62,14,10,8600,1024,7576,739.84375
62,14,11,1102,2048,-946,-46.19140625
62,14,12,4076,4096,-20,-0.48828125
62,14,13,1923,8192,-6269,-76.52587890625
62,14,14,8824,16384,-7560,-46.142578125
62,14,15,77754,32768,44986,137.286376953125
62,15,1,0,2,-2,-100.0
62,15,2,1,4,-3,-75.0
62,15,3,2,8,-6,-75.0
62,15,4,3,16,-13,-81.25
62,15,5,13,32,-19,-59.375
62,15,6,118,64,54,84.375
62,15,7,160,128,32,25.0
62,15,8,69,256,-187,-73.046875
62,15,9,949,512,437,85.3515625
62,15,10,228,1024,-796,-77.734375
62,15,11,6701,2048,4653,227.197265625
62,15,12,5644,4096,1548,37.79296875
62,15,13,13793,8192,5601,68.37158203125
62,15,14,982,16384,-15402,-94.00634765625
62,15,15,93,32768,-32675,-99.7161865234375
62,16,1,0,2,-2,-100.0
62,16,2,2,4,-2,-50.0
62,16,3,14,8,6,75.0
62,16,4,11,16,-5,-31.25
62,16,5,7,32,-25,-78.125
62,16,6,94,64,30,46.875
62,16,7,66,128,-62,-48.4375
62,16,8,282,256,26,10.15625
62,16,9,1195,512,683,133.3984375
62,16,10,1851,1024,827,80.76171875
62,16,11,1320,2048,-728,-35.546875
62,16,12,1898,4096,-2198,-53.662109375
62,16,13,18250,8192,10058,122.7783203125
62,16,14,12952,16384,-3432,-20.947265625
62,16,15,16809,32768,-15959,-48.7030029296875
62,17,1,0,2,-2,-100.0
62,17,2,1,4,-3,-75.0
62,17,3,26,8,18,225.0
62,17,4,13,16,-3,-18.75
62,17,5,36,32,4,12.5
62,17,6,132,64,68,106.25
62,17,7,39,128,-89,-69.53125
62,17,8,353,256,97,37.890625
62,17,9,306,512,-206,-40.234375
62,17,10,3073,1024,2049,200.09765625
62,17,11,2196,2048,148,7.2265625
62,17,12,4741,4096,645,15.7470703125
62,17,13,5667,8192,-2525,-30.82275390625
62,17,14,24176,16384,7792,47.55859375
62,17,15,23592,32768,-9176,-28.0029296875
62,18,1,0,2,-2,-100.0
62,18,2,1,4,-3,-75.0
62,18,3,6,8,-2,-25.0
62,18,4,11,16,-5,-31.25
62,18,5,57,32,25,78.125
62,18,6,7,64,-57,-89.0625
62,18,7,161,128,33,25.78125
62,18,8,38,256,-218,-85.15625
62,18,9,508,512,-4,-0.78125
62,18,10,810,1024,-214,-20.8984375
62,18,11,730,2048,-1318,-64.35546875
62,18,12,1995,4096,-2101,-51.2939453125
62,18,13,3825,8192,-4367,-53.30810546875
62,18,14,9496,16384,-6888,-42.041015625
62,18,15,62088,32768,29320,89.4775390625
62,19,1,0,2,-2,-100.0
62,19,2,1,4,-3,-75.0
62,19,3,4,8,-4,-50.0
62,19,4,46,16,30,187.5
62,19,5,44,32,12,37.5
62,19,6,10,64,-54,-84.375
62,19,7,29,128,-99,-77.34375
62,19,8,66,256,-190,-74.21875
62,19,9,944,512,432,84.375
62,19,10,1971,1024,947,92.48046875
62,19,11,1211,2048,-837,-40.869140625
62,19,12,18383,4096,14287,348.8037109375
62,19,13,741,8192,-7451,-90.95458984375
62,19,14,9099,16384,-7285,-44.464111328125
62,19,15,19514,32768,-13254,-40.447998046875
62,20,1,0,2,-2,-100.0
62,20,2,8,4,4,100.0
62,20,3,2,8,-6,-75.0
62,20,4,22,16,6,37.5
62,20,5,47,32,15,46.875
62,20,6,69,64,5,7.8125
62,20,7,36,128,-92,-71.875
62,20,8,170,256,-86,-33.59375
62,20,9,55,512,-457,-89.2578125
62,20,10,1170,1024,146,14.2578125
62,20,11,946,2048,-1102,-53.80859375
62,20,12,3747,4096,-349,-8.5205078125
62,20,13,2004,8192,-6188,-75.537109375
62,20,14,12059,16384,-4325,-26.397705078125
62,20,15,64602,32768,31834,97.149658203125
62,21,1,0,2,-2,-100.0
62,21,2,1,4,-3,-75.0
62,21,3,8,8,0,0.0
62,21,4,4,16,-12,-75.0
62,21,5,93,32,61,190.625
62,21,6,22,64,-42,-65.625
62,21,7,28,128,-100,-78.125
62,21,8,610,256,354,138.28125
62,21,9,223,512,-289,-56.4453125
62,21,10,1051,1024,27,2.63671875
62,21,11,359,2048,-1689,-82.470703125
62,21,12,3461,4096,-635,-15.5029296875
62,21,13,44607,8192,36415,444.51904296875
62,21,14,11438,16384,-4946,-30.18798828125
62,21,15,11183,32768,-21585,-65.8721923828125
62,22,1,0,2,-2,-100.0
62,22,2,3,4,-1,-25.0
62,22,3,6,8,-2,-25.0
62,22,4,8,16,-8,-50.0
62,22,5,36,32,4,12.5
62,22,6,59,64,-5,-7.8125
62,22,7,61,128,-67,-52.34375
62,22,8,44,256,-212,-82.8125
62,22,9,30,512,-482,-94.140625
62,22,10,433,1024,-591,-57.71484375
62,22,11,204,2048,-1844,-90.0390625
62,22,12,5447,4096,1351,32.9833984375
62,22,13,8126,8192,-66,-0.8056640625
62,22,14,851,16384,-15533,-94.805908203125
62,22,15,3436,32768,-29332,-89.51416015625
62,23,1,0,2,-2,-100.0
62,23,2,1,4,-3,-75.0
62,23,3,9,8,1,12.5
62,23,4,11,16,-5,-31.25
62,23,5,69,32,37,115.625
62,23,6,26,64,-38,-59.375
62,23,7,37,128,-91,-71.09375
62,23,8,919,256,663,258.984375
62,23,9,207,512,-305,-59.5703125
62,23,10,1280,1024,256,25.0
62,23,11,560,2048,-1488,-72.65625
62,23,12,15960,4096,11864,289.6484375
62,23,13,3603,8192,-4589,-56.01806640625
62,23,14,3603,16384,-12781,-78.009033203125
62,23,15,13988,32768,-18780,-57.31201171875
62,24,1,0,2,-2,-100.0
62,24,2,1,4,-3,-75.0
62,24,3,2,8,-6,-75.0
62,24,4,6,16,-10,-62.5
62,24,5,111,32,79,246.875
62,24,6,35,64,-29,-45.3125
62,24,7,342,128,214,167.1875
62,24,8,132,256,-124,-48.4375
62,24,9,2445,512,1933,377.5390625
62,24,10,233,1024,-791,-77.24609375
62,24,11,4747,2048,2699,131.787109375
62,24,12,10739,4096,6643,162.1826171875
62,24,13,12671,8192,4479,54.67529296875
62,24,14,27264,16384,10880,66.40625
62,24,15,51028,32768,18260,55.72509765625
62,25,1,0,2,-2,-100.0
62,25,2,3,4,-1,-25.0
62,25,3,3,8,-5,-62.5
62,25,4,8,16,-8,-50.0
62,25,5,70,32,38,118.75
62,25,6,122,64,58,90.625
62,25,7,77,128,-51,-39.84375
62,25,8,112,256,-144,-56.25
62,25,9,102,512,-410,-80.078125
62,25,10,617,1024,-407,-39.74609375
62,25,11,1758,2048,-290,-14.16015625
62,25,12,4479,4096,383,9.3505859375
62,25,13,3714,8192,-4478,-54.6630859375
62,25,14,20844,16384,4460,27.2216796875
62,25,15,3235,32768,-29533,-90.1275634765625
62,26,1,0,2,-2,-100.0
62,26,2,2,4,-2,-50.0
62,26,3,5,8,-3,-37.5
62,26,4,3,16,-13,-81.25
62,26,5,53,32,21,65.625
62,26,6,158,64,94,146.875
62,26,7,67,128,-61,-47.65625
62,26,8,155,256,-101,-39.453125
62,26,9,155,512,-357,-69.7265625
62,26,10,373,1024,-651,-63.57421875
62,26,11,338,2048,-1710,-83.49609375
62,26,12,1746,4096,-2350,-57.373046875
62,26,13,9102,8192,910,11.1083984375
62,26,14,1012,16384,-15372,-93.8232421875
62,26,15,119583,32768,86815,264.9383544921875
62,27,1,0,2,-2,-100.0
62,27,2,1,4,-3,-75.0
62,27,3,6,8,-2,-25.0
62,27,4,10,16,-6,-37.5
62,27,5,5,32,-27,-84.375
62,27,6,13,64,-51,-79.6875
62,27,7,67,128,-61,-47.65625
62,27,8,441,256,185,72.265625
62,27,9,587,512,75,14.6484375
62,27,10,859,1024,-165,-16.11328125
62,27,11,1619,2048,-429,-20.947265625
62,27,12,3760,4096,-336,-8.203125
62,27,13,2230,8192,-5962,-72.7783203125
62,27,14,30389,16384,14005,85.479736328125
62,27,15,20295,32768,-12473,-38.0645751953125
62,28,1,0,2,-2,-100.0
62,28,2,4,4,0,0.0
62,28,3,8,8,0,0.0
62,28,4,10,16,-6,-37.5
62,28,5,5,32,-27,-84.375
62,28,6,17,64,-47,-73.4375
62,28,7,222,128,94,73.4375
62,28,8,13,256,-243,-94.921875
62,28,9,200,512,-312,-60.9375
62,28,10,125,1024,-899,-87.79296875
62,28,11,573,2048,-1475,-72.021484375
62,28,12,1677,4096,-2419,-59.0576171875
62,28,13,6869,8192,-1323,-16.14990234375
62,28,14,5906,16384,-10478,-63.95263671875
62,28,15,18741,32768,-14027,-42.8070068359375
62,29,1,0,2,-2,-100.0
62,29,2,1,4,-3,-75.0
62,29,3,14,8,6,75.0
62,29,4,21,16,5,31.25
62,29,5,13,32,-19,-59.375
62,29,6,18,64,-46,-71.875
62,29,7,148,128,20,15.625
62,29,8,101,256,-155,-60.546875
62,29,9,201,512,-311,-60.7421875
62,29,10,1155,1024,131,12.79296875
62,29,11,233,2048,-1815,-88.623046875
62,29,12,4141,4096,45,1.0986328125
62,29,13,2753,8192,-5439,-66.39404296875
62,29,14,16723,16384,339,2.069091796875
62,29,15,45529,32768,12761,38.9434814453125
62,30,1,0,2,-2,-100.0
62,30,2,1,4,-3,-75.0
62,30,3,2,8,-6,-75.0
62,30,4,5,16,-11,-68.75
62,30,5,17,32,-15,-46.875
62,30,6,8,64,-56,-87.5
62,30,7,22,128,-106,-82.8125
62,30,8,46,256,-210,-82.03125
62,30,9,211,512,-301,-58.7890625
62,30,10,74,1024,-950,-92.7734375
62,30,11,175,2048,-1873,-91.455078125
62,30,12,14456,4096,10360,252.9296875
62,30,13,235,8192,-7957,-97.13134765625
62,30,14,23047,16384,6663,40.667724609375
62,30,15,21139,32768,-11629,-35.4888916015625
62,31,1,0,2,-2,-100.0
62,31,2,4,4,0,0.0
62,31,3,32,8,24,300.0
62,31,4,4,16,-12,-75.0
62,31,5,14,32,-18,-56.25
62,31,6,8,64,-56,-87.5
62,31,7,20,128,-108,-84.375
62,31,8,479,256,223,87.109375
62,31,9,526,512,14,2.734375
62,31,10,305,1024,-719,-70.21484375
62,31,11,3793,2048,1745,85.205078125
62,31,12,2297,4096,-1799,-43.9208984375
62,31,13,22516,8192,14324,174.853515625
62,31,14,3935,16384,-12449,-75.982666015625
62,31,15,6048,32768,-26720,-81.54296875
62,32,1,0,2,-2,-100.0
62,32,2,1,4,-3,-75.0
62,32,3,5,8,-3,-37.5
62,32,4,13,16,-3,-18.75
62,32,5,54,32,22,68.75
62,32,6,48,64,-16,-25.0
62,32,7,126,128,-2,-1.5625
62,32,8,24,256,-232,-90.625
62,32,9,1124,512,612,119.53125
62,32,10,5830,1024,4806,469.3359375
62,32,11,327,2048,-1721,-84.033203125
62,32,12,1724,4096,-2372,-57.91015625
62,32,13,22907,8192,14715,179.62646484375
62,32,14,11261,16384,-5123,-31.268310546875
62,32,15,81952,32768,49184,150.09765625
62,33,1,0,2,-2,-100.0
62,33,2,2,4,-2,-50.0
62,33,3,11,8,3,37.5
62,33,4,19,16,3,18.75
62,33,5,5,32,-27,-84.375
62,33,6,6,64,-58,-90.625
62,33,7,48,128,-80,-62.5
62,33,8,318,256,62,24.21875
62,33,9,581,512,69,13.4765625
62,33,10,810,1024,-214,-20.8984375
62,33,11,2167,2048,119,5.810546875
62,33,12,3391,4096,-705,-17.2119140625
62,33,13,9920,8192,1728,21.09375
62,33,14,8922,16384,-7462,-45.54443359375
62,33,15,2949,32768,-29819,-91.0003662109375
62,34,1,0,2,-2,-100.0
62,34,2,2,4,-2,-50.0
62,34,3,5,8,-3,-37.5
62,34,4,46,16,30,187.5
62,34,5,17,32,-15,-46.875
62,34,6,64,64,0,0.0
62,34,7,160,128,32,25.0
62,34,8,85,256,-171,-66.796875
62,34,9,105,512,-407,-79.4921875
62,34,10,789,1024,-235,-22.94921875
62,34,11,2377,2048,329,16.064453125
62,34,12,2420,4096,-1676,-40.91796875
62,34,13,6410,8192,-1782,-21.7529296875
62,34,14,6561,16384,-9823,-59.954833984375
62,34,15,59959,32768,27191,82.9803466796875
62,35,1,0,2,-2,-100.0
62,35,2,1,4,-3,-75.0
62,35,3,7,8,-1,-12.5
62,35,4,14,16,-2,-12.5
62,35,5,38,32,6,18.75
62,35,6,83,64,19,29.6875
62,35,7,192,128,64,50.0
62,35,8,157,256,-99,-38.671875
62,35,9,523,512,11,2.1484375
62,35,10,1222,1024,198,19.3359375
62,35,11,1606,2048,-442,-21.58203125
62,35,12,269,4096,-3827,-93.4326171875
62,35,13,9941,8192,1749,21.35009765625
62,35,14,26296,16384,9912,60.498046875
62,35,15,22504,32768,-10264,-31.3232421875
62,36,1,0,2,-2,-100.0
62,36,2,1,4,-3,-75.0
62,36,3,2,8,-6,-75.0
62,36,4,10,16,-6,-37.5
62,36,5,11,32,-21,-65.625
62,36,6,147,64,83,129.6875
62,36,7,72,128,-56,-43.75
62,36,8,572,256,316,123.4375
62,36,9,624,512,112,21.875
62,36,10,15,1024,-1009,-98.53515625
62,36,11,498,2048,-1550,-75.68359375
62,36,12,3114,4096,-982,-23.974609375
62,36,13,14441,8192,6249,76.28173828125
62,36,14,1787,16384,-14597,-89.093017578125
62,36,15,13975,32768,-18793,-57.3516845703125
62,37,1,0,2,-2,-100.0
62,37,2,1,4,-3,-75.0
62,37,3,5,8,-3,-37.5
62,37,4,54,16,38,237.5
62,37,5,126,32,94,293.75
62,37,6,28,64,-36,-56.25
62,37,7,185,128,57,44.53125
62,37,8,287,256,31,12.109375
62,37,9,245,512,-267,-52.1484375
62,37,10,1425,1024,401,39.16015625
62,37,11,851,2048,-1197,-58.447265625
62,37,12,121,4096,-3975,-97.0458984375
62,37,13,7330,8192,-862,-10.5224609375
62,37,14,18713,16384,2329,14.215087890625
62,37,15,1786,32768,-30982,-94.549560546875
62,38,1,0,2,-2,-100.0
62,38,2,1,4,-3,-75.0
62,38,3,6,8,-2,-25.0
62,38,4,6,16,-10,-62.5
62,38,5,12,32,-20,-62.5
62,38,6,14,64,-50,-78.125
62,38,7,29,128,-99,-77.34375
62,38,8,35,256,-221,-86.328125
62,38,9,606,512,94,18.359375
62,38,10,318,1024,-706,-68.9453125
62,38,11,290,2048,-1758,-85.83984375
62,38,12,976,4096,-3120,-76.171875
62,38,13,25021,8192,16829,205.43212890625
62,38,14,11303,16384,-5081,-31.011962890625
62,38,15,5265,32768,-27503,-83.9324951171875
62,39,1,0,2,-2,-100.0
62,39,2,2,4,-2,-50.0
62,39,3,4,8,-4,-50.0
62,39,4,19,16,3,18.75
62,39,5,11,32,-21,-65.625
62,39,6,74,64,10,15.625
62,39,7,185,128,57,44.53125
62,39,8,35,256,-221,-86.328125
62,39,9,224,512,-288,-56.25
62,39,10,285,1024,-739,-72.16796875
62,39,11,717,2048,-1331,-64.990234375
62,39,12,416,4096,-3680,-89.84375
62,39,13,14970,8192,6778,82.7392578125
62,39,14,36364,16384,19980,121.9482421875
62,39,15,41349,32768,8581,26.1871337890625
62,40,1,0,2,-2,-100.0
62,40,2,1,4,-3,-75.0
62,40,3,9,8,1,12.5
62,40,4,7,16,-9,-56.25
62,40,5,44,32,12,37.5
62,40,6,49,64,-15,-23.4375
62,40,7,107,128,-21,-16.40625
62,40,8,536,256,280,109.375
62,40,9,962,512,450,87.890625
62,40,10,637,1024,-387,-37.79296875
62,40,11,2236,2048,188,9.1796875
62,40,12,6408,4096,2312,56.4453125
62,40,13,16878,8192,8686,106.0302734375
62,40,14,53503,16384,37119,226.556396484375
62,40,15,176,32768,-32592,-99.462890625
62,41,1,0,2,-2,-100.0
62,41,2,1,4,-3,-75.0
62,41,3,3,8,-5,-62.5
62,41,4,3,16,-13,-81.25
62,41,5,22,32,-10,-31.25
62,41,6,44,64,-20,-31.25
62,41,7,24,128,-104,-81.25
62,41,8,120,256,-136,-53.125
62,41,9,2086,512,1574,307.421875
62,41,10,529,1024,-495,-48.33984375
62,41,11,1119,2048,-929,-45.361328125
62,41,12,28304,4096,24208,591.015625
62,41,13,3412,8192,-4780,-58.349609375
62,41,14,22310,16384,5926,36.16943359375
62,41,15,274,32768,-32494,-99.163818359375
62,42,1,0,2,-2,-100.0
62,42,2,3,4,-1,-25.0
62,42,3,2,8,-6,-75.0
62,42,4,12,16,-4,-25.0
62,42,5,34,32,2,6.25
62,42,6,142,64,78,121.875
62,42,7,47,128,-81,-63.28125
62,42,8,26,256,-230,-89.84375
62,42,9,446,512,-66,-12.890625
62,42,10,518,1024,-506,-49.4140625
62,42,11,1622,2048,-426,-20.80078125
62,42,12,5720,4096,1624,39.6484375
62,42,13,821,8192,-7371,-89.97802734375
62,42,14,6595,16384,-9789,-59.747314453125
62,42,15,14377,32768,-18391,-56.1248779296875
62,43,1,0,2,-2,-100.0
62,43,2,1,4,-3,-75.0
62,43,3,2,8,-6,-75.0
62,43,4,22,16,6,37.5
62,43,5,21,32,-11,-34.375
62,43,6,168,64,104,162.5
62,43,7,345,128,217,169.53125
62,43,8,597,256,341,133.203125
62,43,9,56,512,-456,-89.0625
62,43,10,551,1024,-473,-46.19140625
62,43,11,306,2048,-1742,-85.05859375
62,43,12,9925,4096,5829,142.3095703125
62,43,13,11316,8192,3124,38.134765625
62,43,14,43122,16384,26738,163.19580078125
62,43,15,46938,32768,14170,43.243408203125
62,44,1,0,2,-2,-100.0
62,44,2,1,4,-3,-75.0
62,44,3,3,8,-5,-62.5
62,44,4,14,16,-2,-12.5
62,44,5,13,32,-19,-59.375
62,44,6,22,64,-42,-65.625
62,44,7,97,128,-31,-24.21875
62,44,8,43,256,-213,-83.203125
62,44,9,441,512,-71,-13.8671875
62,44,10,2601,1024,1577,154.00390625
62,44,11,2156,2048,108,5.2734375
62,44,12,3413,4096,-683,-16.6748046875
62,44,13,14542,8192,6350,77.5146484375
62,44,14,33931,16384,17547,107.098388671875
62,44,15,1930,32768,-30838,-94.110107421875
62,45,1,0,2,-2,-100.0
62,45,2,2,4,-2,-50.0
62,45,3,3,8,-5,-62.5
62,45,4,5,16,-11,-68.75
62,45,5,9,32,-23,-71.875
62,45,6,28,64,-36,-56.25
62,45,7,180,128,52,40.625
62,45,8,79,256,-177,-69.140625
62,45,9,1337,512,825,161.1328125
62,45,10,2230,1024,1206,117.7734375
62,45,11,2123,2048,75,3.662109375
62,45,12,17,4096,-4079,-99.5849609375
62,45,13,16768,8192,8576,104.6875
62,45,14,23525,16384,7141,43.585205078125
62,45,15,55366,32768,22598,68.963623046875
62,46,1,0,2,-2,-100.0
62,46,2,1,4,-3,-75.0
62,46,3,2,8,-6,-75.0
62,46,4,7,16,-9,-56.25
62,46,5,5,32,-27,-84.375
62,46,6,328,64,264,412.5
62,46,7,159,128,31,24.21875
62,46,8,10,256,-246,-96.09375
62,46,9,411,512,-101,-19.7265625
62,46,10,2008,1024,984,96.09375
62,46,11,409,2048,-1639,-80.029296875
62,46,12,1272,4096,-2824,-68.9453125
62,46,13,9160,8192,968,11.81640625
62,46,14,231,16384,-16153,-98.590087890625
62,46,15,10136,32768,-22632,-69.0673828125
62,47,1,0,2,-2,-100.0
62,47,2,1,4,-3,-75.0
62,47,3,3,8,-5,-62.5
62,47,4,7,16,-9,-56.25
62,47,5,5,32,-27,-84.375
62,47,6,18,64,-46,-71.875
62,47,7,107,128,-21,-16.40625
62,47,8,750,256,494,192.96875
62,47,9,609,512,97,18.9453125
62,47,10,1810,1024,786,76.7578125
62,47,11,3574,2048,1526,74.51171875
62,47,12,18179,4096,14083,343.8232421875
62,47,13,4867,8192,-3325,-40.58837890625
62,47,14,7825,16384,-8559,-52.239990234375
62,47,15,3364,32768,-29404,-89.73388671875
62,48,1,0,2,-2,-100.0
62,48,2,2,4,-2,-50.0
62,48,3,9,8,1,12.5
62,48,4,11,16,-5,-31.25
62,48,5,33,32,1,3.125
62,48,6,13,64,-51,-79.6875
62,48,7,60,128,-68,-53.125
62,48,8,751,256,495,193.359375
62,48,9,1674,512,1162,226.953125
62,48,10,346,1024,-678,-66.2109375
62,48,11,1981,2048,-67,-3.271484375
62,48,12,3822,4096,-274,-6.689453125
62,48,13,16809,8192,8617,105.18798828125
62,48,14,3143,16384,-13241,-80.816650390625
62,48,15,21135,32768,-11633,-35.5010986328125
62,49,1,0,2,-2,-100.0
62,49,2,3,4,-1,-25.0
62,49,3,4,8,-4,-50.0
62,49,4,5,16,-11,-68.75
62,49,5,9,32,-23,-71.875
62,49,6,40,64,-24,-37.5
62,49,7,40,128,-88,-68.75
62,49,8,158,256,-98,-38.28125
62,49,9,396,512,-116,-22.65625
62,49,10,2407,1024,1383,135.05859375
62,49,11,2999,2048,951,46.435546875
62,49,12,2808,4096,-1288,-31.4453125
62,49,13,7149,8192,-1043,-12.73193359375
62,49,14,22422,16384,6038,36.85302734375
62,49,15,91301,32768,58533,178.6285400390625
62,50,1,0,2,-2,-100.0
62,50,2,2,4,-2,-50.0
62,50,3,5,8,-3,-37.5
62,50,4,15,16,-1,-6.25
62,50,5,37,32,5,15.625
62,50,6,31,64,-33,-51.5625
62,50,7,123,128,-5,-3.90625
62,50,8,115,256,-141,-55.078125
62,50,9,270,512,-242,-47.265625
62,50,10,278,1024,-746,-72.8515625
62,50,11,2847,2048,799,39.013671875
62,50,12,8159,4096,4063,99.1943359375
62,50,13,27464,8192,19272,235.25390625
62,50,14,30247,16384,13863,84.613037109375
62,50,15,1326,32768,-31442,-95.953369140625
62,51,1,0,2,-2,-100.0
62,51,2,3,4,-1,-25.0
62,51,3,2,8,-6,-75.0
62,51,4,10,16,-6,-37.5
62,51,5,34,32,2,6.25
62,51,6,89,64,25,39.0625
62,51,7,102,128,-26,-20.3125
62,51,8,208,256,-48,-18.75
62,51,9,1315,512,803,156.8359375
62,51,10,636,1024,-388,-37.890625
62,51,11,5966,2048,3918,191.30859375
62,51,12,4334,4096,238,5.810546875
62,51,13,2376,8192,-5816,-70.99609375
62,51,14,9043,16384,-7341,-44.805908203125
62,51,15,70314,32768,37546,114.581298828125
62,52,1,0,2,-2,-100.0
62,52,2,1,4,-3,-75.0
62,52,3,6,8,-2,-25.0
62,52,4,3,16,-13,-81.25
62,52,5,21,32,-11,-34.375
62,52,6,10,64,-54,-84.375
62,52,7,105,128,-23,-17.96875
62,52,8,152,256,-104,-40.625
62,52,9,80,512,-432,-84.375
62,52,10,23,1024,-1001,-97.75390625
62,52,11,453,2048,-1595,-77.880859375
62,52,12,751,4096,-3345,-81.6650390625
62,52,13,2868,8192,-5324,-64.990234375
62,52,14,40827,16384,24443,149.188232421875
62,52,15,16648,32768,-16120,-49.1943359375
62,53,1,0,2,-2,-100.0
62,53,2,2,4,-2,-50.0
62,53,3,3,8,-5,-62.5
62,53,4,5,16,-11,-68.75
62,53,5,9,32,-23,-71.875
62,53,6,104,64,40,62.5
62,53,7,51,128,-77,-60.15625
62,53,8,713,256,457,178.515625
62,53,9,368,512,-144,-28.125
62,53,10,905,1024,-119,-11.62109375
62,53,11,6933,2048,4885,238.525390625
62,53,12,3686,4096,-410,-10.009765625
62,53,13,23898,8192,15706,191.7236328125
62,53,14,3120,16384,-13264,-80.95703125
62,53,15,43271,32768,10503,32.0526123046875
62,54,1,0,2,-2,-100.0
62,54,2,1,4,-3,-75.0
62,54,3,7,8,-1,-12.5
62,54,4,7,16,-9,-56.25
62,54,5,52,32,20,62.5
62,54,6,75,64,11,17.1875
62,54,7,51,128,-77,-60.15625
62,54,8,973,256,717,280.078125
62,54,9,239,512,-273,-53.3203125
62,54,10,872,1024,-152,-14.84375
62,54,11,508,2048,-1540,-75.1953125
62,54,12,742,4096,-3354,-81.884765625
62,54,13,5850,8192,-2342,-28.5888671875
62,54,14,17967,16384,1583,9.661865234375
62,54,15,3965,32768,-28803,-87.8997802734375
62,55,1,0,2,-2,-100.0
62,55,2,2,4,-2,-50.0
62,55,3,15,8,7,87.5
62,55,4,7,16,-9,-56.25
62,55,5,10,32,-22,-68.75
62,55,6,39,64,-25,-39.0625
62,55,7,42,128,-86,-67.1875
62,55,8,120,256,-136,-53.125
62,55,9,362,512,-150,-29.296875
62,55,10,72,1024,-952,-92.96875
62,55,11,4683,2048,2635,128.662109375
62,55,12,1372,4096,-2724,-66.50390625
62,55,13,746,8192,-7446,-90.8935546875
62,55,14,20236,16384,3852,23.5107421875
62,55,15,28324,32768,-4444,-13.56201171875
62,56,1,0,2,-2,-100.0
62,56,2,2,4,-2,-50.0
62,56,3,2,8,-6,-75.0
62,56,4,6,16,-10,-62.5
62,56,5,4,32,-28,-87.5
62,56,6,46,64,-18,-28.125
62,56,7,94,128,-34,-26.5625
62,56,8,116,256,-140,-54.6875
62,56,9,1410,512,898,175.390625
62,56,10,3821,1024,2797,273.14453125
62,56,11,265,2048,-1783,-87.060546875
62,56,12,491,4096,-3605,-88.0126953125
62,56,13,3189,8192,-5003,-61.07177734375
62,56,14,7217,16384,-9167,-55.950927734375
62,56,15,3552,32768,-29216,-89.16015625
62,57,1,0,2,-2,-100.0
62,57,2,2,4,-2,-50.0
62,57,3,2,8,-6,-75.0
62,57,4,4,16,-12,-75.0
62,57,5,15,32,-17,-53.125
62,57,6,267,64,203,317.1875
62,57,7,70,128,-58,-45.3125
62,57,8,311,256,55,21.484375
62,57,9,848,512,336,65.625
62,57,10,2557,1024,1533,149.70703125
62,57,11,723,2048,-1325,-64.697265625
62,57,12,423,4096,-3673,-89.6728515625
62,57,13,83,8192,-8109,-98.98681640625
62,57,14,31541,16384,15157,92.510986328125
62,57,15,50738,32768,17970,54.840087890625
62,58,1,0,2,-2,-100.0
62,58,2,1,4,-3,-75.0
62,58,3,6,8,-2,-25.0
62,58,4,6,16,-10,-62.5
62,58,5,25,32,-7,-21.875
62,58,6,25,64,-39,-60.9375
62,58,7,288,128,160,125.0
62,58,8,25,256,-231,-90.234375
62,58,9,762,512,250,48.828125
62,58,10,1696,1024,672,65.625
62,58,11,38,2048,-2010,-98.14453125
62,58,12,1370,4096,-2726,-66.552734375
62,58,13,6387,8192,-1805,-22.03369140625
62,58,14,42237,16384,25853,157.794189453125
62,58,15,21653,32768,-11115,-33.9202880859375
62,59,1,0,2,-2,-100.0
62,59,2,1,4,-3,-75.0
62,59,3,6,8,-2,-25.0
62,59,4,15,16,-1,-6.25
62,59,5,98,32,66,206.25
62,59,6,88,64,24,37.5
62,59,7,320,128,192,150.0
62,59,8,16,256,-240,-93.75
62,59,9,153,512,-359,-70.1171875
62,59,10,155,1024,-869,-84.86328125
62,59,11,3804,2048,1756,85.7421875
62,59,12,3985,4096,-111,-2.7099609375
62,59,13,5452,8192,-2740,-33.447265625
62,59,14,5893,16384,-10491,-64.031982421875
62,59,15,5715,32768,-27053,-82.5592041015625
62,60,1,0,2,-2,-100.0
62,60,2,1,4,-3,-75.0
62,60,3,4,8,-4,-50.0
62,60,4,10,16,-6,-37.5
62,60,5,53,32,21,65.625
62,60,6,103,64,39,60.9375
62,60,7,28,128,-100,-78.125
62,60,8,290,256,34,13.28125
62,60,9,502,512,-10,-1.953125
62,60,10,344,1024,-680,-66.40625
62,60,11,4421,2048,2373,115.869140625
62,60,12,877,4096,-3219,-78.5888671875
62,60,13,19311,8192,11119,135.72998046875
62,60,14,10337,16384,-6047,-36.907958984375
62,60,15,20916,32768,-11852,-36.16943359375
62,61,1,0,2,-2,-100.0
62,61,2,1,4,-3,-75.0
62,61,3,3,8,-5,-62.5
62,61,4,18,16,2,12.5
62,61,5,49,32,17,53.125
62,61,6,42,64,-22,-34.375
62,61,7,36,128,-92,-71.875
62,61,8,36,256,-220,-85.9375
62,61,9,762,512,250,48.828125
62,61,10,3414,1024,2390,233.3984375
62,61,11,1694,2048,-354,-17.28515625
62,61,12,1737,4096,-2359,-57.5927734375
62,61,13,5384,8192,-2808,-34.27734375
62,61,14,32941,16384,16557,101.055908203125
62,61,15,71898,32768,39130,119.415283203125
62,62,1,0,2,-2,-100.0
62,62,2,1,4,-3,-75.0
62,62,3,4,8,-4,-50.0
62,62,4,4,16,-12,-75.0
62,62,5,19,32,-13,-40.625
62,62,6,15,64,-49,-76.5625
62,62,7,83,128,-45,-35.15625
62,62,8,877,256,621,242.578125
62,62,9,134,512,-378,-73.828125
62,62,10,59,1024,-965,-94.23828125
62,62,11,1706,2048,-342,-16.69921875
62,62,12,1600,4096,-2496,-60.9375
62,62,13,13830,8192,5638,68.8232421875
62,62,14,37172,16384,20788,126.8798828125
62,62,15,28064,32768,-4704,-14.35546875
63,1,1,0,2,-2,-100.0
63,1,2,3,4,-1,-25.0
63,1,3,22,8,14,175.0
63,1,4,3,16,-13,-81.25
63,1,5,25,32,-7,-21.875
63,1,6,236,64,172,268.75
63,1,7,113,128,-15,-11.71875
63,1,8,355,256,99,38.671875
63,1,9,24,512,-488,-95.3125
63,1,10,171,1024,-853,-83.30078125
63,1,11,2472,2048,424,20.703125
63,1,12,3215,4096,-881,-21.5087890625
63,1,13,2709,8192,-5483,-66.93115234375
63,1,14,6527,16384,-9857,-60.162353515625
63,1,15,94981,32768,62213,189.8590087890625
63,2,1,0,2,-2,-100.0
63,2,2,1,4,-3,-75.0
63,2,3,16,8,8,100.0
63,2,4,16,16,0,0.0
63,2,5,23,32,-9,-28.125
63,2,6,80,64,16,25.0
63,2,7,67,128,-61,-47.65625
63,2,8,593,256,337,131.640625
63,2,9,159,512,-353,-68.9453125
63,2,10,314,1024,-710,-69.3359375
63,2,11,503,2048,-1545,-75.439453125
63,2,12,9045,4096,4949,120.8251953125
63,2,13,59,8192,-8133,-99.27978515625
63,2,14,6839,16384,-9545,-58.258056640625
63,2,15,73483,32768,40715,124.2523193359375
63,3,1,0,2,-2,-100.0
63,3,2,1,4,-3,-75.0
63,3,3,2,8,-6,-75.0
63,3,4,11,16,-5,-31.25
63,3,5,12,32,-20,-62.5
63,3,6,36,64,-28,-43.75
63,3,7,34,128,-94,-73.4375
63,3,8,453,256,197,76.953125
63,3,9,188,512,-324,-63.28125
63,3,10,889,1024,-135,-13.18359375
63,3,11,1449,2048,-599,-29.248046875
63,3,12,3518,4096,-578,-14.111328125
63,3,13,5747,8192,-2445,-29.84619140625
63,3,14,20822,16384,4438,27.08740234375
63,3,15,13213,32768,-19555,-59.6771240234375
63,4,1,0,2,-2,-100.0
63,4,2,4,4,0,0.0
63,4,3,3,8,-5,-62.5
63,4,4,4,16,-12,-75.0
63,4,5,7,32,-25,-78.125
63,4,6,18,64,-46,-71.875
63,4,7,234,128,106,82.8125
63,4,8,76,256,-180,-70.3125
63,4,9,976,512,464,90.625
63,4,10,201,1024,-823,-80.37109375
63,4,11,570,2048,-1478,-72.16796875
63,4,12,268,4096,-3828,-93.45703125
63,4,13,15015,8192,6823,83.28857421875
63,4,14,23047,16384,6663,40.667724609375
63,4,15,23283,32768,-9485,-28.9459228515625
63,5,1,0,2,-2,-100.0
63,5,2,4,4,0,0.0
63,5,3,6,8,-2,-25.0
63,5,4,19,16,3,18.75
63,5,5,4,32,-28,-87.5
63,5,6,27,64,-37,-57.8125
63,5,7,102,128,-26,-20.3125
63,5,8,860,256,604,235.9375
63,5,9,106,512,-406,-79.296875
63,5,10,490,1024,-534,-52.1484375
63,5,11,1391,2048,-657,-32.080078125
63,5,12,3986,4096,-110,-2.685546875
63,5,13,19565,8192,11373,138.83056640625
63,5,14,19913,16384,3529,21.539306640625
63,5,15,11267,32768,-21501,-65.6158447265625
63,6,1,0,2,-2,-100.0
63,6,2,4,4,0,0.0
63,6,3,2,8,-6,-75.0
63,6,4,25,16,9,56.25
63,6,5,66,32,34,106.25
63,6,6,12,64,-52,-81.25
63,6,7,22,128,-106,-82.8125
63,6,8,404,256,148,57.8125
63,6,9,893,512,381,74.4140625
63,6,10,986,1024,-38,-3.7109375
63,6,11,1989,2048,-59,-2.880859375
63,6,12,5292,4096,1196,29.19921875
63,6,13,6783,8192,-1409,-17.19970703125
63,6,14,6193,16384,-10191,-62.200927734375
63,6,15,98026,32768,65258,199.151611328125
63,7,1,0,2,-2,-100.0
63,7,2,5,4,1,25.0
63,7,3,3,8,-5,-62.5
63,7,4,19,16,3,18.75
63,7,5,20,32,-12,-37.5
63,7,6,12,64,-52,-81.25
63,7,7,165,128,37,28.90625
63,7,8,23,256,-233,-91.015625
63,7,9,38,512,-474,-92.578125
63,7,10,1006,1024,-18,-1.7578125
63,7,11,1509,2048,-539,-26.318359375
63,7,12,11340,4096,7244,176.85546875
63,7,13,5339,8192,-2853,-34.82666015625
63,7,14,32389,16384,16005,97.686767578125
63,7,15,9804,32768,-22964,-70.08056640625
63,8,1,0,2,-2,-100.0
63,8,2,2,4,-2,-50.0
63,8,3,3,8,-5,-62.5
63,8,4,12,16,-4,-25.0
63,8,5,10,32,-22,-68.75
63,8,6,69,64,5,7.8125
63,8,7,71,128,-57,-44.53125
63,8,8,41,256,-215,-83.984375
63,8,9,54,512,-458,-89.453125
63,8,10,1082,1024,58,5.6640625
63,8,11,152,2048,-1896,-92.578125
63,8,12,1825,4096,-2271,-55.4443359375
63,8,13,7048,8192,-1144,-13.96484375
63,8,14,13617,16384,-2767,-16.888427734375
63,8,15,2376,32768,-30392,-92.7490234375
63,9,1,0,2,-2,-100.0
63,9,2,1,4,-3,-75.0
63,9,3,8,8,0,0.0
63,9,4,3,16,-13,-81.25
63,9,5,95,32,63,196.875
63,9,6,204,64,140,218.75
63,9,7,118,128,-10,-7.8125
63,9,8,85,256,-171,-66.796875
63,9,9,255,512,-257,-50.1953125
63,9,10,1928,1024,904,88.28125
63,9,11,5476,2048,3428,167.3828125
63,9,12,3366,4096,-730,-17.822265625
63,9,13,4114,8192,-4078,-49.7802734375
63,9,14,5170,16384,-11214,-68.44482421875
63,9,15,16760,32768,-16008,-48.8525390625
63,10,1,0,2,-2,-100.0
63,10,2,2,4,-2,-50.0
63,10,3,2,8,-6,-75.0
63,10,4,6,16,-10,-62.5
63,10,5,24,32,-8,-25.0
63,10,6,28,64,-36,-56.25
63,10,7,379,128,251,196.09375
63,10,8,115,256,-141,-55.078125
63,10,9,2224,512,1712,334.375
63,10,10,863,1024,-161,-15.72265625
63,10,11,3119,2048,1071,52.294921875
63,10,12,240,4096,-3856,-94.140625
63,10,13,182,8192,-8010,-97.7783203125
63,10,14,18319,16384,1935,11.810302734375
63,10,15,30131,32768,-2637,-8.0474853515625
63,11,1,0,2,-2,-100.0
63,11,2,2,4,-2,-50.0
63,11,3,3,8,-5,-62.5
63,11,4,3,16,-13,-81.25
63,11,5,7,32,-25,-78.125
63,11,6,49,64,-15,-23.4375
63,11,7,195,128,67,52.34375
63,11,8,211,256,-45,-17.578125
63,11,9,12,512,-500,-97.65625
63,11,10,778,1024,-246,-24.0234375
63,11,11,492,2048,-1556,-75.9765625
63,11,12,8477,4096,4381,106.9580078125
63,11,13,886,8192,-7306,-89.1845703125
63,11,14,42241,16384,25857,157.818603515625
63,11,15,18716,32768,-14052,-42.88330078125
63,12,1,0,2,-2,-100.0
63,12,2,1,4,-3,-75.0
63,12,3,23,8,15,187.5
63,12,4,21,16,5,31.25
63,12,5,4,32,-28,-87.5
63,12,6,75,64,11,17.1875
63,12,7,70,128,-58,-45.3125
63,12,8,59,256,-197,-76.953125
63,12,9,375,512,-137,-26.7578125
63,12,10,1343,1024,319,31.15234375
63,12,11,835,2048,-1213,-59.228515625
63,12,12,6285,4096,2189,53.4423828125
63,12,13,2309,8192,-5883,-71.81396484375
63,12,14,20319,16384,3935,24.017333984375
63,12,15,102974,32768,70206,214.251708984375
63,13,1,0,2,-2,-100.0
63,13,2,4,4,0,0.0
63,13,3,2,8,-6,-75.0
63,13,4,31,16,15,93.75
63,13,5,20,32,-12,-37.5
63,13,6,84,64,20,31.25
63,13,7,44,128,-84,-65.625
63,13,8,16,256,-240,-93.75
63,13,9,1421,512,909,177.5390625
63,13,10,594,1024,-430,-41.9921875
63,13,11,2626,2048,578,28.22265625
63,13,12,268,4096,-3828,-93.45703125
63,13,13,409,8192,-7783,-95.00732421875
63,13,14,70528,16384,54144,330.46875
63,13,15,3917,32768,-28851,-88.0462646484375
63,14,1,0,2,-2,-100.0
63,14,2,5,4,1,25.0
63,14,3,2,8,-6,-75.0
63,14,4,19,16,3,18.75
63,14,5,6,32,-26,-81.25
63,14,6,120,64,56,87.5
63,14,7,44,128,-84,-65.625
63,14,8,69,256,-187,-73.046875
63,14,9,153,512,-359,-70.1171875
63,14,10,137,1024,-887,-86.62109375
63,14,11,1689,2048,-359,-17.529296875
63,14,12,3269,4096,-827,-20.1904296875
63,14,13,10832,8192,2640,32.2265625
63,14,14,8096,16384,-8288,-50.5859375
63,14,15,9734,32768,-23034,-70.294189453125
63,15,1,0,2,-2,-100.0
63,15,2,1,4,-3,-75.0
63,15,3,5,8,-3,-37.5
63,15,4,4,16,-12,-75.0
63,15,5,11,32,-21,-65.625
63,15,6,71,64,7,10.9375
63,15,7,114,128,-14,-10.9375
63,15,8,386,256,130,50.78125
63,15,9,363,512,-149,-29.1015625
63,15,10,789,1024,-235,-22.94921875
63,15,11,535,2048,-1513,-73.876953125
63,15,12,4253,4096,157,3.8330078125
63,15,13,450,8192,-7742,-94.5068359375
63,15,14,1060,16384,-15324,-93.5302734375
63,15,15,2382,32768,-30386,-92.730712890625
63,16,1,0,2,-2,-100.0
63,16,2,2,4,-2,-50.0
63,16,3,2,8,-6,-75.0
63,16,4,15,16,-1,-6.25
63,16,5,14,32,-18,-56.25
63,16,6,184,64,120,187.5
63,16,7,50,128,-78,-60.9375
63,16,8,80,256,-176,-68.75
63,16,9,307,512,-205,-40.0390625
63,16,10,425,1024,-599,-58.49609375
63,16,11,53,2048,-1995,-97.412109375
63,16,12,16781,4096,12685,309.6923828125
63,16,13,14837,8192,6645,81.11572265625
63,16,14,27336,16384,10952,66.845703125
63,16,15,14338,32768,-18430,-56.243896484375
63,17,1,0,2,-2,-100.0
63,17,2,3,4,-1,-25.0
63,17,3,3,8,-5,-62.5
63,17,4,11,16,-5,-31.25
63,17,5,12,32,-20,-62.5
63,17,6,19,64,-45,-70.3125
63,17,7,27,128,-101,-78.90625
63,17,8,113,256,-143,-55.859375
63,17,9,91,512,-421,-82.2265625
63,17,10,211,1024,-813,-79.39453125
63,17,11,3431,2048,1383,67.529296875
63,17,12,3331,4096,-765,-18.6767578125
63,17,13,9276,8192,1084,13.232421875
63,17,14,44031,16384,27647,168.743896484375
63,17,15,19000,32768,-13768,-42.0166015625
63,18,1,0,2,-2,-100.0
63,18,2,2,4,-2,-50.0
63,18,3,6,8,-2,-25.0
63,18,4,15,16,-1,-6.25
63,18,5,64,32,32,100.0
63,18,6,31,64,-33,-51.5625
63,18,7,88,128,-40,-31.25
63,18,8,21,256,-235,-91.796875
63,18,9,544,512,32,6.25
63,18,10,442,1024,-582,-56.8359375
63,18,11,321,2048,-1727,-84.326171875
63,18,12,6062,4096,1966,47.998046875
63,18,13,8744,8192,552,6.73828125
63,18,14,3092,16384,-13292,-81.1279296875
63,18,15,202522,32768,169754,518.048095703125
63,19,1,0,2,-2,-100.0
63,19,2,2,4,-2,-50.0
63,19,3,7,8,-1,-12.5
63,19,4,16,16,0,0.0
63,19,5,8,32,-24,-75.0
63,19,6,77,64,13,20.3125
63,19,7,143,128,15,11.71875
63,19,8,109,256,-147,-57.421875
63,19,9,163,512,-349,-68.1640625
63,19,10,1208,1024,184,17.96875
63,19,11,169,2048,-1879,-91.748046875
63,19,12,932,4096,-3164,-77.24609375
63,19,13,5149,8192,-3043,-37.14599609375
63,19,14,9584,16384,-6800,-41.50390625
63,19,15,50181,32768,17413,53.1402587890625
63,20,1,0,2,-2,-100.0
63,20,2,1,4,-3,-75.0
63,20,3,9,8,1,12.5
63,20,4,13,16,-3,-18.75
63,20,5,70,32,38,118.75
63,20,6,240,64,176,275.0
63,20,7,135,128,7,5.46875
63,20,8,163,256,-93,-36.328125
63,20,9,15,512,-497,-97.0703125
63,20,10,66,1024,-958,-93.5546875
63,20,11,1173,2048,-875,-42.724609375
63,20,12,3076,4096,-1020,-24.90234375
63,20,13,8340,8192,148,1.806640625
63,20,14,2832,16384,-13552,-82.71484375
63,20,15,73708,32768,40940,124.93896484375
63,21,1,0,2,-2,-100.0
63,21,2,2,4,-2,-50.0
63,21,3,10,8,2,25.0
63,21,4,4,16,-12,-75.0
63,21,5,8,32,-24,-75.0
63,21,6,49,64,-15,-23.4375
63,21,7,25,128,-103,-80.46875
63,21,8,833,256,577,225.390625
63,21,9,234,512,-278,-54.296875
63,21,10,47,1024,-977,-95.41015625
63,21,11,627,2048,-1421,-69.384765625
63,21,12,7014,4096,2918,71.240234375
63,21,13,2447,8192,-5745,-70.12939453125
63,21,14,280,16384,-16104,-98.291015625
63,21,15,8247,32768,-24521,-74.8321533203125
63,22,1,0,2,-2,-100.0
63,22,2,2,4,-2,-50.0
63,22,3,6,8,-2,-25.0
63,22,4,33,16,17,106.25
63,22,5,6,32,-26,-81.25
63,22,6,19,64,-45,-70.3125
63,22,7,37,128,-91,-71.09375
63,22,8,30,256,-226,-88.28125
63,22,9,228,512,-284,-55.46875
63,22,10,977,1024,-47,-4.58984375
63,22,11,1739,2048,-309,-15.087890625
63,22,12,6975,4096,2879,70.2880859375
63,22,13,14096,8192,5904,72.0703125
63,22,14,2660,16384,-13724,-83.7646484375
63,22,15,29894,32768,-2874,-8.770751953125
63,23,1,0,2,-2,-100.0
63,23,2,1,4,-3,-75.0
63,23,3,4,8,-4,-50.0
63,23,4,14,16,-2,-12.5
63,23,5,8,32,-24,-75.0
63,23,6,43,64,-21,-32.8125
63,23,7,16,128,-112,-87.5
63,23,8,307,256,51,19.921875
63,23,9,193,512,-319,-62.3046875
63,23,10,2379,1024,1355,132.32421875
63,23,11,2010,2048,-38,-1.85546875
63,23,12,5994,4096,1898,46.337890625
63,23,13,2316,8192,-5876,-71.728515625
63,23,14,11945,16384,-4439,-27.093505859375
63,23,15,10801,32768,-21967,-67.0379638671875
63,24,1,0,2,-2,-100.0
63,24,2,2,4,-2,-50.0
63,24,3,6,8,-2,-25.0
63,24,4,14,16,-2,-12.5
63,24,5,40,32,8,25.0
63,24,6,21,64,-43,-67.1875
63,24,7,263,128,135,105.46875
63,24,8,532,256,276,107.8125
63,24,9,944,512,432,84.375
63,24,10,317,1024,-707,-69.04296875
63,24,11,1475,2048,-573,-27.978515625
63,24,12,423,4096,-3673,-89.6728515625
63,24,13,5403,8192,-2789,-34.04541015625
63,24,14,4003,16384,-12381,-75.567626953125
63,24,15,54325,32768,21557,65.7867431640625
63,25,1,0,2,-2,-100.0
63,25,2,3,4,-1,-25.0
63,25,3,5,8,-3,-37.5
63,25,4,22,16,6,37.5
63,25,5,23,32,-9,-28.125
63,25,6,57,64,-7,-10.9375
63,25,7,157,128,29,22.65625
63,25,8,359,256,103,40.234375
63,25,9,160,512,-352,-68.75
63,25,10,1036,1024,12,1.171875
63,25,11,164,2048,-1884,-91.9921875
63,25,12,49,4096,-4047,-98.8037109375
63,25,13,1778,8192,-6414,-78.2958984375
63,25,14,444,16384,-15940,-97.2900390625
63,25,15,60028,32768,27260,83.19091796875
63,26,1,0,2,-2,-100.0
63,26,2,1,4,-3,-75.0
63,26,3,7,8,-1,-12.5
63,26,4,17,16,1,6.25
63,26,5,4,32,-28,-87.5
63,26,6,17,64,-47,-73.4375
63,26,7,101,128,-27,-21.09375
63,26,8,340,256,84,32.8125
63,26,9,357,512,-155,-30.2734375
63,26,10,44,1024,-980,-95.703125
63,26,11,1757,2048,-291,-14.208984375
63,26,12,220,4096,-3876,-94.62890625
63,26,13,10185,8192,1993,24.32861328125
63,26,14,893,16384,-15491,-94.549560546875
63,26,15,47578,32768,14810,45.196533203125
63,27,1,0,2,-2,-100.0
63,27,2,1,4,-3,-75.0
63,27,3,6,8,-2,-25.0
63,27,4,14,16,-2,-12.5
63,27,5,32,32,0,0.0
63,27,6,205,64,141,220.3125
63,27,7,86,128,-42,-32.8125
63,27,8,18,256,-238,-92.96875
63,27,9,349,512,-163,-31.8359375
63,27,10,2613,1024,1589,155.17578125
63,27,11,1057,2048,-991,-48.388671875
63,27,12,4213,4096,117,2.8564453125
63,27,13,4940,8192,-3252,-39.697265625
63,27,14,23677,16384,7293,44.512939453125
63,27,15,86956,32768,54188,165.36865234375
63,28,1,0,2,-2,-100.0
63,28,2,1,4,-3,-75.0
63,28,3,8,8,0,0.0
63,28,4,5,16,-11,-68.75
63,28,5,9,32,-23,-71.875
63,28,6,93,64,29,45.3125
63,28,7,19,128,-109,-85.15625
63,28,8,274,256,18,7.03125
63,28,9,860,512,348,67.96875
63,28,10,1871,1024,847,82.71484375
63,28,11,4329,2048,2281,111.376953125
63,28,12,634,4096,-3462,-84.521484375
63,28,13,6203,8192,-1989,-24.27978515625
63,28,14,38451,16384,22067,134.686279296875
63,28,15,11202,32768,-21566,-65.814208984375
63,29,1,0,2,-2,-100.0
63,29,2,1,4,-3,-75.0
63,29,3,3,8,-5,-62.5
63,29,4,3,16,-13,-81.25
63,29,5,30,32,-2,-6.25
63,29,6,218,64,154,240.625
63,29,7,134,128,6,4.6875
63,29,8,71,256,-185,-72.265625
63,29,9,191,512,-321,-62.6953125
63,29,10,90,1024,-934,-91.2109375
63,29,11,481,2048,-1567,-76.513671875
63,29,12,2397,4096,-1699,-41.4794921875
63,29,13,5270,8192,-2922,-35.6689453125
63,29,14,37129,16384,20745,126.617431640625
63,29,15,15557,32768,-17211,-52.5238037109375
63,30,1,0,2,-2,-100.0
63,30,2,2,4,-2,-50.0
63,30,3,2,8,-6,-75.0
63,30,4,11,16,-5,-31.25
63,30,5,44,32,12,37.5
63,30,6,19,64,-45,-70.3125
63,30,7,54,128,-74,-57.8125
63,30,8,166,256,-90,-35.15625
63,30,9,1023,512,511,99.8046875
63,30,10,896,1024,-128,-12.5
63,30,11,7483,2048,5435,265.380859375
63,30,12,3362,4096,-734,-17.919921875
63,30,13,27112,8192,18920,230.95703125
63,30,14,17360,16384,976,5.95703125
63,30,15,78763,32768,45995,140.3656005859375
63,31,1,0,2,-2,-100.0
63,31,2,1,4,-3,-75.0
63,31,3,10,8,2,25.0
63,31,4,8,16,-8,-50.0
63,31,5,9,32,-23,-71.875
63,31,6,40,64,-24,-37.5
63,31,7,119,128,-9,-7.03125
63,31,8,54,256,-202,-78.90625
63,31,9,72,512,-440,-85.9375
63,31,10,3211,1024,2187,213.57421875
63,31,11,7112,2048,5064,247.265625
63,31,12,1048,4096,-3048,-74.4140625
63,31,13,9823,8192,1631,19.90966796875
63,31,14,37082,16384,20698,126.33056640625
63,31,15,17842,32768,-14926,-45.550537109375
63,32,1,0,2,-2,-100.0
63,32,2,1,4,-3,-75.0
63,32,3,12,8,4,50.0
63,32,4,13,16,-3,-18.75
63,32,5,55,32,23,71.875
63,32,6,60,64,-4,-6.25
63,32,7,97,128,-31,-24.21875
63,32,8,266,256,10,3.90625
63,32,9,36,512,-476,-92.96875
63,32,10,300,1024,-724,-70.703125
63,32,11,3188,2048,1140,55.6640625
63,32,12,1358,4096,-2738,-66.845703125
63,32,13,627,8192,-7565,-92.34619140625
63,32,14,19786,16384,3402,20.76416015625
63,32,15,41185,32768,8417,25.6866455078125
63,33,1,0,2,-2,-100.0
63,33,2,2,4,-2,-50.0
63,33,3,2,8,-6,-75.0
63,33,4,33,16,17,106.25
63,33,5,32,32,0,0.0
63,33,6,13,64,-51,-79.6875
63,33,7,69,128,-59,-46.09375
63,33,8,95,256,-161,-62.890625
63,33,9,768,512,256,50.0
63,33,10,3914,1024,2890,282.2265625
63,33,11,684,2048,-1364,-66.6015625
63,33,12,2282,4096,-1814,-44.287109375
63,33,13,3838,8192,-4354,-53.1494140625
63,33,14,112665,16384,96281,587.652587890625
63,33,15,60073,32768,27305,83.3282470703125
63,34,1,0,2,-2,-100.0
63,34,2,1,4,-3,-75.0
63,34,3,4,8,-4,-50.0
63,34,4,3,16,-13,-81.25
63,34,5,33,32,1,3.125
63,34,6,6,64,-58,-90.625
63,34,7,99,128,-29,-22.65625
63,34,8,295,256,39,15.234375
63,34,9,92,512,-420,-82.03125
63,34,10,545,1024,-479,-46.77734375
63,34,11,243,2048,-1805,-88.134765625
63,34,12,3576,4096,-520,-12.6953125
63,34,13,4829,8192,-3363,-41.05224609375
63,34,14,5375,16384,-11009,-67.193603515625
63,34,15,8349,32768,-24419,-74.5208740234375
63,35,1,0,2,-2,-100.0
63,35,2,2,4,-2,-50.0
63,35,3,5,8,-3,-37.5
63,35,4,24,16,8,50.0
63,35,5,6,32,-26,-81.25
63,35,6,25,64,-39,-60.9375
63,35,7,136,128,8,6.25
63,35,8,98,256,-158,-61.71875
63,35,9,716,512,204,39.84375
63,35,10,176,1024,-848,-82.8125
63,35,11,2804,2048,756,36.9140625
63,35,12,1243,4096,-2853,-69.6533203125
63,35,13,6722,8192,-1470,-17.9443359375
63,35,14,23015,16384,6631,40.472412109375
63,35,15,65610,32768,32842,100.225830078125
63,36,1,0,2,-2,-100.0
63,36,2,1,4,-3,-75.0
63,36,3,3,8,-5,-62.5
63,36,4,17,16,1,6.25
63,36,5,57,32,25,78.125
63,36,6,107,64,43,67.1875
63,36,7,162,128,34,26.5625
63,36,8,356,256,100,39.0625
63,36,9,28,512,-484,-94.53125
63,36,10,2676,1024,1652,161.328125
63,36,11,982,2048,-1066,-52.05078125
63,36,12,679,4096,-3417,-83.4228515625
63,36,13,12368,8192,4176,50.9765625
63,36,14,54602,16384,38218,233.26416015625
63,36,15,31557,32768,-1211,-3.6956787109375
63,37,1,0,2,-2,-100.0
63,37,2,9,4,5,125.0
63,37,3,8,8,0,0.0
63,37,4,29,16,13,81.25
63,37,5,41,32,9,28.125
63,37,6,21,64,-43,-67.1875
63,37,7,60,128,-68,-53.125
63,37,8,513,256,257,100.390625
63,37,9,270,512,-242,-47.265625
63,37,10,1006,1024,-18,-1.7578125
63,37,11,642,2048,-1406,-68.65234375
63,37,12,10018,4096,5922,144.580078125
63,37,13,2072,8192,-6120,-74.70703125
63,37,14,6301,16384,-10083,-61.541748046875
63,37,15,22689,32768,-10079,-30.7586669921875
63,38,1,0,2,-2,-100.0
63,38,2,1,4,-3,-75.0
63,38,3,2,8,-6,-75.0
63,38,4,20,16,4,25.0
63,38,5,29,32,-3,-9.375
63,38,6,18,64,-46,-71.875
63,38,7,114,128,-14,-10.9375
63,38,8,97,256,-159,-62.109375
63,38,9,557,512,45,8.7890625
63,38,10,632,1024,-392,-38.28125
63,38,11,1558,2048,-490,-23.92578125
63,38,12,6099,4096,2003,48.9013671875
63,38,13,650,8192,-7542,-92.0654296875
63,38,14,19926,16384,3542,21.61865234375
63,38,15,13440,32768,-19328,-58.984375
63,39,1,0,2,-2,-100.0
63,39,2,1,4,-3,-75.0
63,39,3,3,8,-5,-62.5
63,39,4,9,16,-7,-43.75
63,39,5,21,32,-11,-34.375
63,39,6,152,64,88,137.5
63,39,7,11,128,-117,-91.40625
63,39,8,236,256,-20,-7.8125
63,39,9,73,512,-439,-85.7421875
63,39,10,876,1024,-148,-14.453125
63,39,11,8245,2048,6197,302.587890625
63,39,12,192,4096,-3904,-95.3125
63,39,13,1826,8192,-6366,-77.7099609375
63,39,14,29461,16384,13077,79.815673828125
63,39,15,36269,32768,3501,10.6842041015625
63,40,1,0,2,-2,-100.0
63,40,2,1,4,-3,-75.0
63,40,3,3,8,-5,-62.5
63,40,4,4,16,-12,-75.0
63,40,5,81,32,49,153.125
63,40,6,71,64,7,10.9375
63,40,7,99,128,-29,-22.65625
63,40,8,139,256,-117,-45.703125
63,40,9,622,512,110,21.484375
63,40,10,379,1024,-645,-62.98828125
63,40,11,11,2048,-2037,-99.462890625
63,40,12,3805,4096,-291,-7.1044921875
63,40,13,6397,8192,-1795,-21.91162109375
63,40,14,1616,16384,-14768,-90.13671875
63,40,15,12377,32768,-20391,-62.2283935546875
63,41,1,0,2,-2,-100.0
63,41,2,1,4,-3,-75.0
63,41,3,8,8,0,0.0
63,41,4,34,16,18,112.5
63,41,5,69,32,37,115.625
63,41,6,32,64,-32,-50.0
63,41,7,15,128,-113,-88.28125
63,41,8,131,256,-125,-48.828125
63,41,9,320,512,-192,-37.5
63,41,10,2664,1024,1640,160.15625
63,41,11,8190,2048,6142,299.90234375
63,41,12,931,4096,-3165,-77.2705078125
63,41,13,5323,8192,-2869,-35.02197265625
63,41,14,11314,16384,-5070,-30.94482421875
63,41,15,115513,32768,82745,252.5177001953125
63,42,1,0,2,-2,-100.0
63,42,2,1,4,-3,-75.0
63,42,3,2,8,-6,-75.0
63,42,4,3,16,-13,-81.25
63,42,5,33,32,1,3.125
63,42,6,153,64,89,139.0625
63,42,7,303,128,175,136.71875
63,42,8,428,256,172,67.1875
63,42,9,203,512,-309,-60.3515625
63,42,10,431,1024,-593,-57.91015625
63,42,11,474,2048,-1574,-76.85546875
63,42,12,1949,4096,-2147,-52.4169921875
63,42,13,640,8192,-7552,-92.1875
63,42,14,22249,16384,5865,35.797119140625
63,42,15,4054,32768,-28714,-87.628173828125
63,43,1,0,2,-2,-100.0
63,43,2,1,4,-3,-75.0
63,43,3,2,8,-6,-75.0
63,43,4,80,16,64,400.0
63,43,5,38,32,6,18.75
63,43,6,19,64,-45,-70.3125
63,43,7,315,128,187,146.09375
63,43,8,400,256,144,56.25
63,43,9,951,512,439,85.7421875
63,43,10,145,1024,-879,-85.83984375
63,43,11,3602,2048,1554,75.87890625
63,43,12,413,4096,-3683,-89.9169921875
63,43,13,556,8192,-7636,-93.212890625
63,43,14,22582,16384,6198,37.82958984375
63,43,15,3070,32768,-29698,-90.631103515625
63,44,1,0,2,-2,-100.0
63,44,2,1,4,-3,-75.0
63,44,3,5,8,-3,-37.5
63,44,4,58,16,42,262.5
63,44,5,9,32,-23,-71.875
63,44,6,95,64,31,48.4375
63,44,7,67,128,-61,-47.65625
63,44,8,176,256,-80,-31.25
63,44,9,178,512,-334,-65.234375
63,44,10,3052,1024,2028,198.046875
63,44,11,866,2048,-1182,-57.71484375
63,44,12,3894,4096,-202,-4.931640625
63,44,13,90,8192,-8102,-98.9013671875
63,44,14,11173,16384,-5211,-31.805419921875
63,44,15,20382,32768,-12386,-37.799072265625
63,45,1,0,2,-2,-100.0
63,45,2,2,4,-2,-50.0
63,45,3,5,8,-3,-37.5
63,45,4,19,16,3,18.75
63,45,5,4,32,-28,-87.5
63,45,6,12,64,-52,-81.25
63,45,7,23,128,-105,-82.03125
63,45,8,223,256,-33,-12.890625
63,45,9,424,512,-88,-17.1875
63,45,10,286,1024,-738,-72.0703125
63,45,11,1537,2048,-511,-24.951171875
63,45,12,15629,4096,11533,281.5673828125
63,45,13,2454,8192,-5738,-70.0439453125
63,45,14,4746,16384,-11638,-71.03271484375
63,45,15,67304,32768,34536,105.3955078125
63,46,1,0,2,-2,-100.0
63,46,2,1,4,-3,-75.0
63,46,3,5,8,-3,-37.5
63,46,4,37,16,21,131.25
63,46,5,58,32,26,81.25
63,46,6,6,64,-58,-90.625
63,46,7,155,128,27,21.09375
63,46,8,733,256,477,186.328125
63,46,9,50,512,-462,-90.234375
63,46,10,1378,1024,354,34.5703125
63,46,11,35,2048,-2013,-98.291015625
63,46,12,495,4096,-3601,-87.9150390625
63,46,13,4234,8192,-3958,-48.3154296875
63,46,14,45105,16384,28721,175.299072265625
63,46,15,10838,32768,-21930,-66.925048828125
63,47,1,0,2,-2,-100.0
63,47,2,1,4,-3,-75.0
63,47,3,2,8,-6,-75.0
63,47,4,16,16,0,0.0
63,47,5,52,32,20,62.5
63,47,6,90,64,26,40.625
63,47,7,268,128,140,109.375
63,47,8,146,256,-110,-42.96875
63,47,9,439,512,-73,-14.2578125
63,47,10,4448,1024,3424,334.375
63,47,11,238,2048,-1810,-88.37890625
63,47,12,18596,4096,14500,354.00390625
63,47,13,7910,8192,-282,-3.4423828125
63,47,14,81739,16384,65355,398.895263671875
63,47,15,37114,32768,4346,13.262939453125
63,48,1,0,2,-2,-100.0
63,48,2,1,4,-3,-75.0
63,48,3,6,8,-2,-25.0
63,48,4,37,16,21,131.25
63,48,5,62,32,30,93.75
63,48,6,5,64,-59,-92.1875
63,48,7,89,128,-39,-30.46875
63,48,8,22,256,-234,-91.40625
63,48,9,743,512,231,45.1171875
63,48,10,658,1024,-366,-35.7421875
63,48,11,3009,2048,961,46.923828125
63,48,12,4893,4096,797,19.4580078125
63,48,13,2626,8192,-5566,-67.9443359375
63,48,14,5515,16384,-10869,-66.339111328125
63,48,15,48282,32768,15514,47.344970703125
63,49,1,0,2,-2,-100.0
63,49,2,3,4,-1,-25.0
63,49,3,7,8,-1,-12.5
63,49,4,29,16,13,81.25
63,49,5,49,32,17,53.125
63,49,6,129,64,65,101.5625
63,49,7,529,128,401,313.28125
63,49,8,284,256,28,10.9375
63,49,9,229,512,-283,-55.2734375
63,49,10,695,1024,-329,-32.12890625
63,49,11,992,2048,-1056,-51.5625
63,49,12,1160,4096,-2936,-71.6796875
63,49,13,13577,8192,5385,65.73486328125
63,49,14,4936,16384,-11448,-69.873046875
63,49,15,114574,32768,81806,249.652099609375
63,50,1,0,2,-2,-100.0
63,50,2,1,4,-3,-75.0
63,50,3,2,8,-6,-75.0
63,50,4,3,16,-13,-81.25
63,50,5,25,32,-7,-21.875
63,50,6,95,64,31,48.4375
63,50,7,109,128,-19,-14.84375
63,50,8,329,256,73,28.515625
63,50,9,484,512,-28,-5.46875
63,50,10,669,1024,-355,-34.66796875
63,50,11,1599,2048,-449,-21.923828125
63,50,12,390,4096,-3706,-90.478515625
63,50,13,6982,8192,-1210,-14.7705078125
63,50,14,2252,16384,-14132,-86.2548828125
63,50,15,48193,32768,15425,47.0733642578125
63,51,1,0,2,-2,-100.0
63,51,2,1,4,-3,-75.0
63,51,3,2,8,-6,-75.0
63,51,4,11,16,-5,-31.25
63,51,5,4,32,-28,-87.5
63,51,6,35,64,-29,-45.3125
63,51,7,20,128,-108,-84.375
63,51,8,309,256,53,20.703125
63,51,9,661,512,149,29.1015625
63,51,10,146,1024,-878,-85.7421875
63,51,11,10179,2048,8131,397.021484375
63,51,12,1773,4096,-2323,-56.7138671875
63,51,13,487,8192,-7705,-94.05517578125
63,51,14,5469,16384,-10915,-66.619873046875
63,51,15,17175,32768,-15593,-47.5860595703125
63,52,1,0,2,-2,-100.0
63,52,2,1,4,-3,-75.0
63,52,3,6,8,-2,-25.0
63,52,4,4,16,-12,-75.0
63,52,5,13,32,-19,-59.375
63,52,6,59,64,-5,-7.8125
63,52,7,6,128,-122,-95.3125
63,52,8,257,256,1,0.390625
63,52,9,712,512,200,39.0625
63,52,10,436,1024,-588,-57.421875
63,52,11,2437,2048,389,18.994140625
63,52,12,300,4096,-3796,-92.67578125
63,52,13,3425,8192,-4767,-58.19091796875
63,52,14,17352,16384,968,5.908203125
63,52,15,16158,32768,-16610,-50.689697265625
63,53,1,0,2,-2,-100.0
63,53,2,2,4,-2,-50.0
63,53,3,5,8,-3,-37.5
63,53,4,14,16,-2,-12.5
63,53,5,26,32,-6,-18.75
63,53,6,63,64,-1,-1.5625
63,53,7,87,128,-41,-32.03125
63,53,8,220,256,-36,-14.0625
63,53,9,18,512,-494,-96.484375
63,53,10,63,1024,-961,-93.84765625
63,53,11,213,2048,-1835,-89.599609375
63,53,12,35,4096,-4061,-99.1455078125
63,53,13,1335,8192,-6857,-83.70361328125
63,53,14,2769,16384,-13615,-83.099365234375
63,53,15,83375,32768,50607,154.4403076171875
63,54,1,0,2,-2,-100.0
63,54,2,1,4,-3,-75.0
63,54,3,5,8,-3,-37.5
63,54,4,5,16,-11,-68.75
63,54,5,5,32,-27,-84.375
63,54,6,69,64,5,7.8125
63,54,7,227,128,99,77.34375
63,54,8,180,256,-76,-29.6875
63,54,9,85,512,-427,-83.3984375
63,54,10,176,1024,-848,-82.8125
63,54,11,1821,2048,-227,-11.083984375
63,54,12,1654,4096,-2442,-59.619140625
63,54,13,8574,8192,382,4.6630859375
63,54,14,114,16384,-16270,-99.30419921875
63,54,15,1847,32768,-30921,-94.3634033203125
63,55,1,0,2,-2,-100.0
63,55,2,2,4,-2,-50.0
63,55,3,3,8,-5,-62.5
63,55,4,4,16,-12,-75.0
63,55,5,34,32,2,6.25
63,55,6,53,64,-11,-17.1875
63,55,7,89,128,-39,-30.46875
63,55,8,155,256,-101,-39.453125
63,55,9,436,512,-76,-14.84375
63,55,10,490,1024,-534,-52.1484375
63,55,11,1728,2048,-320,-15.625
63,55,12,54,4096,-4042,-98.681640625
63,55,13,11844,8192,3652,44.580078125
63,55,14,660,16384,-15724,-95.9716796875
63,55,15,36130,32768,3362,10.260009765625
63,56,1,0,2,-2,-100.0
63,56,2,2,4,-2,-50.0
63,56,3,7,8,-1,-12.5
63,56,4,19,16,3,18.75
63,56,5,22,32,-10,-31.25
63,56,6,112,64,48,75.0
63,56,7,277,128,149,116.40625
63,56,8,397,256,141,55.078125
63,56,9,336,512,-176,-34.375
63,56,10,36,1024,-988,-96.484375
63,56,11,1701,2048,-347,-16.943359375
63,56,12,164,4096,-3932,-95.99609375
63,56,13,9274,8192,1082,13.2080078125
63,56,14,20728,16384,4344,26.513671875
63,56,15,20359,32768,-12409,-37.8692626953125
63,57,1,0,2,-2,-100.0
63,57,2,5,4,1,25.0
63,57,3,2,8,-6,-75.0
63,57,4,3,16,-13,-81.25
63,57,5,10,32,-22,-68.75
63,57,6,42,64,-22,-34.375
63,57,7,237,128,109,85.15625
63,57,8,186,256,-70,-27.34375
63,57,9,587,512,75,14.6484375
63,57,10,2581,1024,1557,152.05078125
63,57,11,3012,2048,964,47.0703125
63,57,12,2191,4096,-1905,-46.5087890625
63,57,13,24331,8192,16139,197.00927734375
63,57,14,21105,16384,4721,28.814697265625
63,57,15,23428,32768,-9340,-28.50341796875
63,58,1,0,2,-2,-100.0
63,58,2,3,4,-1,-25.0
63,58,3,14,8,6,75.0
63,58,4,19,16,3,18.75
63,58,5,14,32,-18,-56.25
63,58,6,143,64,79,123.4375
63,58,7,27,128,-101,-78.90625
63,58,8,213,256,-43,-16.796875
63,58,9,489,512,-23,-4.4921875
63,58,10,906,1024,-118,-11.5234375
63,58,11,3404,2048,1356,66.2109375
63,58,12,11835,4096,7739,188.9404296875
63,58,13,1903,8192,-6289,-76.77001953125
63,58,14,75915,16384,59531,363.348388671875
63,58,15,49373,32768,16605,50.6744384765625
63,59,1,0,2,-2,-100.0
63,59,2,3,4,-1,-25.0
63,59,3,17,8,9,112.5
63,59,4,12,16,-4,-25.0
63,59,5,17,32,-15,-46.875
63,59,6,36,64,-28,-43.75
63,59,7,13,128,-115,-89.84375
63,59,8,377,256,121,47.265625
63,59,9,256,512,-256,-50.0
63,59,10,932,1024,-92,-8.984375
63,59,11,1775,2048,-273,-13.330078125
63,59,12,3292,4096,-804,-19.62890625
63,59,13,2552,8192,-5640,-68.84765625
63,59,14,1624,16384,-14760,-90.087890625
63,59,15,13095,32768,-19673,-60.0372314453125
63,60,1,0,2,-2,-100.0
63,60,2,2,4,-2,-50.0
63,60,3,6,8,-2,-25.0
63,60,4,12,16,-4,-25.0
63,60,5,5,32,-27,-84.375
63,60,6,9,64,-55,-85.9375
63,60,7,219,128,91,71.09375
63,60,8,369,256,113,44.140625
63,60,9,967,512,455,88.8671875
63,60,10,1957,1024,933,91.11328125
63,60,11,588,2048,-1460,-71.2890625
63,60,12,5938,4096,1842,44.970703125
63,60,13,6945,8192,-1247,-15.22216796875
63,60,14,6558,16384,-9826,-59.97314453125
63,60,15,61139,32768,28371,86.5814208984375
63,61,1,0,2,-2,-100.0
63,61,2,3,4,-1,-25.0
63,61,3,7,8,-1,-12.5
63,61,4,3,16,-13,-81.25
63,61,5,17,32,-15,-46.875
63,61,6,45,64,-19,-29.6875
63,61,7,115,128,-13,-10.15625
63,61,8,156,256,-100,-39.0625
63,61,9,105,512,-407,-79.4921875
63,61,10,744,1024,-280,-27.34375
63,61,11,7097,2048,5049,246.533203125
63,61,12,4997,4096,901,21.9970703125
63,61,13,2469,8192,-5723,-69.86083984375
63,61,14,3485,16384,-12899,-78.729248046875
63,61,15,5469,32768,-27299,-83.3099365234375
63,62,1,0,2,-2,-100.0
63,62,2,1,4,-3,-75.0
63,62,3,2,8,-6,-75.0
63,62,4,6,16,-10,-62.5
63,62,5,69,32,37,115.625
63,62,6,36,64,-28,-43.75
63,62,7,151,128,23,17.96875
63,62,8,834,256,578,225.78125
63,62,9,558,512,46,8.984375
63,62,10,2230,1024,1206,117.7734375
63,62,11,1616,2048,-432,-21.09375
63,62,12,746,4096,-3350,-81.787109375
63,62,13,381,8192,-7811,-95.34912109375
63,62,14,9941,16384,-6443,-39.324951171875
63,62,15,24571,32768,-8197,-25.0152587890625
63,63,1,0,2,-2,-100.0
63,63,2,2,4,-2,-50.0
63,63,3,3,8,-5,-62.5
63,63,4,20,16,4,25.0
63,63,5,15,32,-17,-53.125
63,63,6,92,64,28,43.75
63,63,7,80,128,-48,-37.5
63,63,8,119,256,-137,-53.515625
63,63,9,713,512,201,39.2578125
63,63,10,290,1024,-734,-71.6796875
63,63,11,3026,2048,978,47.75390625
63,63,12,7395,4096,3299,80.5419921875
63,63,13,7973,8192,-219,-2.67333984375
63,63,14,1822,16384,-14562,-88.87939453125
63,63,15,13477,32768,-19291,-58.8714599609375
64,1,1,0,2,-2,-100.0
64,1,2,4,4,0,0.0
64,1,3,5,8,-3,-37.5
64,1,4,3,16,-13,-81.25
64,1,5,57,32,25,78.125
64,1,6,15,64,-49,-76.5625
64,1,7,63,128,-65,-50.78125
64,1,8,164,256,-92,-35.9375
64,1,9,746,512,234,45.703125
64,1,10,442,1024,-582,-56.8359375
64,1,11,200,2048,-1848,-90.234375
64,1,12,4932,4096,836,20.41015625
64,1,13,17975,8192,9783,119.42138671875
64,1,14,10564,16384,-5820,-35.5224609375
64,1,15,7279,32768,-25489,-77.7862548828125
64,2,1,0,2,-2,-100.0
64,2,2,1,4,-3,-75.0
64,2,3,7,8,-1,-12.5
64,2,4,3,16,-13,-81.25
64,2,5,23,32,-9,-28.125
64,2,6,44,64,-20,-31.25
64,2,7,127,128,-1,-0.78125
64,2,8,61,256,-195,-76.171875
64,2,9,1209,512,697,136.1328125
64,2,10,1209,1024,185,18.06640625
64,2,11,1125,2048,-923,-45.068359375
64,2,12,411,4096,-3685,-89.9658203125
64,2,13,22620,8192,14428,176.123046875
64,2,14,7976,16384,-8408,-51.318359375
64,2,15,59931,32768,27163,82.8948974609375
64,3,1,0,2,-2,-100.0
64,3,2,1,4,-3,-75.0
64,3,3,3,8,-5,-62.5
64,3,4,12,16,-4,-25.0
64,3,5,69,32,37,115.625
64,3,6,96,64,32,50.0
64,3,7,91,128,-37,-28.90625
64,3,8,406,256,150,58.59375
64,3,9,180,512,-332,-64.84375
64,3,10,711,1024,-313,-30.56640625
64,3,11,400,2048,-1648,-80.46875
64,3,12,5484,4096,1388,33.88671875
64,3,13,436,8192,-7756,-94.677734375
64,3,14,3071,16384,-13313,-81.256103515625
64,3,15,124234,32768,91466,279.132080078125
64,4,1,0,2,-2,-100.0
64,4,2,3,4,-1,-25.0
64,4,3,5,8,-3,-37.5
64,4,4,6,16,-10,-62.5
64,4,5,33,32,1,3.125
64,4,6,28,64,-36,-56.25
64,4,7,245,128,117,91.40625
64,4,8,609,256,353,137.890625
64,4,9,669,512,157,30.6640625
64,4,10,92,1024,-932,-91.015625
64,4,11,2866,2048,818,39.94140625
64,4,12,167,4096,-3929,-95.9228515625
64,4,13,7078,8192,-1114,-13.5986328125
64,4,14,31477,16384,15093,92.120361328125
64,4,15,29430,32768,-3338,-10.186767578125
64,5,1,0,2,-2,-100.0
64,5,2,1,4,-3,-75.0
64,5,3,11,8,3,37.5
64,5,4,14,16,-2,-12.5
64,5,5,77,32,45,140.625
64,5,6,13,64,-51,-79.6875
64,5,7,351,128,223,174.21875
64,5,8,71,256,-185,-72.265625
64,5,9,407,512,-105,-20.5078125
64,5,10,3255,1024,2231,217.87109375
64,5,11,5328,2048,3280,160.15625
64,5,12,5886,4096,1790,43.701171875
64,5,13,7387,8192,-805,-9.82666015625
64,5,14,9775,16384,-6609,-40.338134765625
64,5,15,96972,32768,64204,195.93505859375
64,6,1,0,2,-2,-100.0
64,6,2,1,4,-3,-75.0
64,6,3,3,8,-5,-62.5
64,6,4,18,16,2,12.5
64,6,5,20,32,-12,-37.5
64,6,6,5,64,-59,-92.1875
64,6,7,311,128,183,142.96875
64,6,8,21,256,-235,-91.796875
64,6,9,329,512,-183,-35.7421875
64,6,10,2215,1024,1191,116.30859375
64,6,11,4686,2048,2638,128.80859375
64,6,12,8234,4096,4138,101.025390625
64,6,13,1164,8192,-7028,-85.791015625
64,6,14,3156,16384,-13228,-80.7373046875
64,6,15,12677,32768,-20091,-61.3128662109375
64,7,1,0,2,-2,-100.0
64,7,2,1,4,-3,-75.0
64,7,3,3,8,-5,-62.5
64,7,4,17,16,1,6.25
64,7,5,12,32,-20,-62.5
64,7,6,120,64,56,87.5
64,7,7,45,128,-83,-64.84375
64,7,8,279,256,23,8.984375
64,7,9,2686,512,2174,424.609375
64,7,10,723,1024,-301,-29.39453125
64,7,11,1438,2048,-610,-29.78515625
64,7,12,891,4096,-3205,-78.2470703125
64,7,13,5006,8192,-3186,-38.8916015625
64,7,14,454,16384,-15930,-97.22900390625
64,7,15,703,32768,-32065,-97.8546142578125
64,8,1,0,2,-2,-100.0
64,8,2,1,4,-3,-75.0
64,8,3,3,8,-5,-62.5
64,8,4,4,16,-12,-75.0
64,8,5,91,32,59,184.375
64,8,6,226,64,162,253.125
64,8,7,83,128,-45,-35.15625
64,8,8,171,256,-85,-33.203125
64,8,9,248,512,-264,-51.5625
64,8,10,88,1024,-936,-91.40625
64,8,11,1437,2048,-611,-29.833984375
64,8,12,3288,4096,-808,-19.7265625
64,8,13,2001,8192,-6191,-75.57373046875
64,8,14,1791,16384,-14593,-89.068603515625
64,8,15,10991,32768,-21777,-66.4581298828125
64,9,1,0,2,-2,-100.0
64,9,2,1,4,-3,-75.0
64,9,3,6,8,-2,-25.0
64,9,4,18,16,2,12.5
64,9,5,6,32,-26,-81.25
64,9,6,29,64,-35,-54.6875
64,9,7,33,128,-95,-74.21875
64,9,8,336,256,80,31.25
64,9,9,1290,512,778,151.953125
64,9,10,315,1024,-709,-69.23828125
64,9,11,1373,2048,-675,-32.958984375
64,9,12,8000,4096,3904,95.3125
64,9,13,52314,8192,44122,538.5986328125
64,9,14,2367,16384,-14017,-85.552978515625
64,9,15,6164,32768,-26604,-81.18896484375
64,10,1,0,2,-2,-100.0
64,10,2,1,4,-3,-75.0
64,10,3,5,8,-3,-37.5
64,10,4,12,16,-4,-25.0
64,10,5,96,32,64,200.0
64,10,6,21,64,-43,-67.1875
64,10,7,27,128,-101,-78.90625
64,10,8,712,256,456,178.125
64,10,9,267,512,-245,-47.8515625
64,10,10,48,1024,-976,-95.3125
64,10,11,4834,2048,2786,136.03515625
64,10,12,1637,4096,-2459,-60.0341796875
64,10,13,2429,8192,-5763,-70.34912109375
64,10,14,27383,16384,10999,67.132568359375
64,10,15,25022,32768,-7746,-23.638916015625
64,11,1,0,2,-2,-100.0
64,11,2,5,4,1,25.0
64,11,3,4,8,-4,-50.0
64,11,4,39,16,23,143.75
64,11,5,10,32,-22,-68.75
64,11,6,92,64,28,43.75
64,11,7,286,128,158,123.4375
64,11,8,63,256,-193,-75.390625
64,11,9,538,512,26,5.078125
64,11,10,627,1024,-397,-38.76953125
64,11,11,663,2048,-1385,-67.626953125
64,11,12,495,4096,-3601,-87.9150390625
64,11,13,1045,8192,-7147,-87.24365234375
64,11,14,75566,16384,59182,361.21826171875
64,11,15,667,32768,-32101,-97.9644775390625
64,12,1,0,2,-2,-100.0
64,12,2,1,4,-3,-75.0
64,12,3,6,8,-2,-25.0
64,12,4,7,16,-9,-56.25
64,12,5,68,32,36,112.5
64,12,6,5,64,-59,-92.1875
64,12,7,78,128,-50,-39.0625
64,12,8,167,256,-89,-34.765625
64,12,9,241,512,-271,-52.9296875
64,12,10,157,1024,-867,-84.66796875
64,12,11,11,2048,-2037,-99.462890625
64,12,12,1198,4096,-2898,-70.751953125
64,12,13,27944,8192,19752,241.11328125
64,12,14,5157,16384,-11227,-68.524169921875
64,12,15,27122,32768,-5646,-17.230224609375
64,13,1,0,2,-2,-100.0
64,13,2,5,4,1,25.0
64,13,3,8,8,0,0.0
64,13,4,13,16,-3,-18.75
64,13,5,4,32,-28,-87.5
64,13,6,61,64,-3,-4.6875
64,13,7,22,128,-106,-82.8125
64,13,8,204,256,-52,-20.3125
64,13,9,1802,512,1290,251.953125
64,13,10,518,1024,-506,-49.4140625
64,13,11,4195,2048,2147,104.833984375
64,13,12,4780,4096,684,16.69921875
64,13,13,16044,8192,7852,95.849609375
64,13,14,20619,16384,4235,25.848388671875
64,13,15,7507,32768,-25261,-77.0904541015625
64,14,1,0,2,-2,-100.0
64,14,2,2,4,-2,-50.0
64,14,3,5,8,-3,-37.5
64,14,4,14,16,-2,-12.5
64,14,5,39,32,7,21.875
64,14,6,154,64,90,140.625
64,14,7,62,128,-66,-51.5625
64,14,8,367,256,111,43.359375
64,14,9,62,512,-450,-87.890625
64,14,10,2748,1024,1724,168.359375
64,14,11,869,2048,-1179,-57.568359375
64,14,12,10909,4096,6813,166.3330078125
64,14,13,7174,8192,-1018,-12.4267578125
64,14,14,6292,16384,-10092,-61.5966796875
64,14,15,15718,32768,-17050,-52.032470703125
64,15,1,0,2,-2,-100.0
64,15,2,1,4,-3,-75.0
64,15,3,3,8,-5,-62.5
64,15,4,25,16,9,56.25
64,15,5,14,32,-18,-56.25
64,15,6,29,64,-35,-54.6875
64,15,7,41,128,-87,-67.96875
64,15,8,211,256,-45,-17.578125
64,15,9,669,512,157,30.6640625
64,15,10,833,1024,-191,-18.65234375
64,15,11,41,2048,-2007,-97.998046875
64,15,12,2801,4096,-1295,-31.6162109375
64,15,13,3378,8192,-4814,-58.7646484375
64,15,14,1018,16384,-15366,-93.78662109375
64,15,15,1941,32768,-30827,-94.0765380859375
64,16,1,0,2,-2,-100.0
64,16,2,7,4,3,75.0
64,16,3,2,8,-6,-75.0
64,16,4,20,16,4,25.0
64,16,5,14,32,-18,-56.25
64,16,6,137,64,73,114.0625
64,16,7,34,128,-94,-73.4375
64,16,8,49,256,-207,-80.859375
64,16,9,136,512,-376,-73.4375
64,16,10,327,1024,-697,-68.06640625
64,16,11,671,2048,-1377,-67.236328125
64,16,12,1633,4096,-2463,-60.1318359375
64,16,13,3865,8192,-4327,-52.81982421875
64,16,14,19678,16384,3294,20.10498046875
64,16,15,58892,32768,26124,79.72412109375
64,17,1,0,2,-2,-100.0
64,17,2,1,4,-3,-75.0
64,17,3,6,8,-2,-25.0
64,17,4,8,16,-8,-50.0
64,17,5,17,32,-15,-46.875
64,17,6,5,64,-59,-92.1875
64,17,7,204,128,76,59.375
64,17,8,332,256,76,29.6875
64,17,9,577,512,65,12.6953125
64,17,10,583,1024,-441,-43.06640625
64,17,11,7439,2048,5391,263.232421875
64,17,12,750,4096,-3346,-81.689453125
64,17,13,10445,8192,2253,27.50244140625
64,17,14,2008,16384,-14376,-87.744140625
64,17,15,117020,32768,84252,257.11669921875
64,18,1,0,2,-2,-100.0
64,18,2,1,4,-3,-75.0
64,18,3,10,8,2,25.0
64,18,4,10,16,-6,-37.5
64,18,5,44,32,12,37.5
64,18,6,22,64,-42,-65.625
64,18,7,73,128,-55,-42.96875
64,18,8,258,256,2,0.78125
64,18,9,42,512,-470,-91.796875
64,18,10,2628,1024,1604,156.640625
64,18,11,4546,2048,2498,121.97265625
64,18,12,5798,4096,1702,41.552734375
64,18,13,3437,8192,-4755,-58.04443359375
64,18,14,45272,16384,28888,176.318359375
64,18,15,121014,32768,88246,269.305419921875
64,19,1,0,2,-2,-100.0
64,19,2,3,4,-1,-25.0
64,19,3,6,8,-2,-25.0
64,19,4,4,16,-12,-75.0
64,19,5,106,32,74,231.25
64,19,6,135,64,71,110.9375
64,19,7,7,128,-121,-94.53125
64,19,8,376,256,120,46.875
64,19,9,19,512,-493,-96.2890625
64,19,10,1870,1024,846,82.6171875
64,19,11,791,2048,-1257,-61.376953125
64,19,12,1534,4096,-2562,-62.548828125
64,19,13,5607,8192,-2585,-31.55517578125
64,19,14,2548,16384,-13836,-84.4482421875
64,19,15,10011,32768,-22757,-69.4488525390625
64,20,1,0,2,-2,-100.0
64,20,2,1,4,-3,-75.0
64,20,3,3,8,-5,-62.5
64,20,4,9,16,-7,-43.75
64,20,5,55,32,23,71.875
64,20,6,76,64,12,18.75
64,20,7,133,128,5,3.90625
64,20,8,77,256,-179,-69.921875
64,20,9,264,512,-248,-48.4375
64,20,10,247,1024,-777,-75.87890625
64,20,11,6494,2048,4446,217.08984375
64,20,12,5755,4096,1659,40.5029296875
64,20,13,1361,8192,-6831,-83.38623046875
64,20,14,1461,16384,-14923,-91.082763671875
64,20,15,28424,32768,-4344,-13.2568359375
64,21,1,0,2,-2,-100.0
64,21,2,1,4,-3,-75.0
64,21,3,3,8,-5,-62.5
64,21,4,15,16,-1,-6.25
64,21,5,11,32,-21,-65.625
64,21,6,68,64,4,6.25
64,21,7,278,128,150,117.1875
64,21,8,839,256,583,227.734375
64,21,9,239,512,-273,-53.3203125
64,21,10,151,1024,-873,-85.25390625
64,21,11,6104,2048,4056,198.046875
64,21,12,30,4096,-4066,-99.267578125
64,21,13,183,8192,-8009,-97.76611328125
64,21,14,18114,16384,1730,10.55908203125
64,21,15,40986,32768,8218,25.079345703125
64,22,1,0,2,-2,-100.0
64,22,2,2,4,-2,-50.0
64,22,3,15,8,7,87.5
64,22,4,13,16,-3,-18.75
64,22,5,10,32,-22,-68.75
64,22,6,24,64,-40,-62.5
64,22,7,170,128,42,32.8125
64,22,8,506,256,250,97.65625
64,22,9,81,512,-431,-84.1796875
64,22,10,150,1024,-874,-85.3515625
64,22,11,4935,2048,2887,140.966796875
64,22,12,5514,4096,1418,34.619140625
64,22,13,1122,8192,-7070,-86.3037109375
64,22,14,11141,16384,-5243,-32.000732421875
64,22,15,10302,32768,-22466,-68.560791015625
64,23,1,0,2,-2,-100.0
64,23,2,1,4,-3,-75.0
64,23,3,5,8,-3,-37.5
64,23,4,15,16,-1,-6.25
64,23,5,42,32,10,31.25
64,23,6,20,64,-44,-68.75
64,23,7,155,128,27,21.09375
64,23,8,98,256,-158,-61.71875
64,23,9,1100,512,588,114.84375
64,23,10,699,1024,-325,-31.73828125
64,23,11,2239,2048,191,9.326171875
64,23,12,3992,4096,-104,-2.5390625
64,23,13,22104,8192,13912,169.82421875
64,23,14,3289,16384,-13095,-79.925537109375
64,23,15,8061,32768,-24707,-75.3997802734375
64,24,1,0,2,-2,-100.0
64,24,2,1,4,-3,-75.0
64,24,3,3,8,-5,-62.5
64,24,4,5,16,-11,-68.75
64,24,5,25,32,-7,-21.875
64,24,6,21,64,-43,-67.1875
64,24,7,439,128,311,242.96875
64,24,8,30,256,-226,-88.28125
64,24,9,209,512,-303,-59.1796875
64,24,10,1511,1024,487,47.55859375
64,24,11,1779,2048,-269,-13.134765625
64,24,12,2215,4096,-1881,-45.9228515625
64,24,13,11005,8192,2813,34.33837890625
64,24,14,6763,16384,-9621,-58.721923828125
64,24,15,37572,32768,4804,14.66064453125
64,25,1,0,2,-2,-100.0
64,25,2,4,4,0,0.0
64,25,3,2,8,-6,-75.0
64,25,4,7,16,-9,-56.25
64,25,5,19,32,-13,-40.625
64,25,6,7,64,-57,-89.0625
64,25,7,146,128,18,14.0625
64,25,8,433,256,177,69.140625
64,25,9,94,512,-418,-81.640625
64,25,10,1126,1024,102,9.9609375
64,25,11,20,2048,-2028,-99.0234375
64,25,12,7529,4096,3433,83.8134765625
64,25,13,522,8192,-7670,-93.6279296875
64,25,14,10957,16384,-5427,-33.123779296875
64,25,15,34414,32768,1646,5.023193359375
64,26,1,0,2,-2,-100.0
64,26,2,1,4,-3,-75.0
64,26,3,9,8,1,12.5
64,26,4,21,16,5,31.25
64,26,5,38,32,6,18.75
64,26,6,48,64,-16,-25.0
64,26,7,24,128,-104,-81.25
64,26,8,195,256,-61,-23.828125
64,26,9,870,512,358,69.921875
64,26,10,1474,1024,450,43.9453125
64,26,11,1655,2048,-393,-19.189453125
64,26,12,4506,4096,410,10.009765625
64,26,13,318,8192,-7874,-96.1181640625
64,26,14,2770,16384,-13614,-83.09326171875
64,26,15,15847,32768,-16921,-51.6387939453125
64,27,1,0,2,-2,-100.0
64,27,2,1,4,-3,-75.0
64,27,3,2,8,-6,-75.0
64,27,4,4,16,-12,-75.0
64,27,5,60,32,28,87.5
64,27,6,21,64,-43,-67.1875
64,27,7,62,128,-66,-51.5625
64,27,8,664,256,408,159.375
64,27,9,122,512,-390,-76.171875
64,27,10,1148,1024,124,12.109375
64,27,11,4215,2048,2167,105.810546875
64,27,12,4077,4096,-19,-0.4638671875
64,27,13,7193,8192,-999,-12.19482421875
64,27,14,17795,16384,1411,8.612060546875
64,27,15,47717,32768,14949,45.6207275390625
64,28,1,0,2,-2,-100.0
64,28,2,4,4,0,0.0
64,28,3,22,8,14,175.0
64,28,4,6,16,-10,-62.5
64,28,5,7,32,-25,-78.125
64,28,6,165,64,101,157.8125
64,28,7,63,128,-65,-50.78125
64,28,8,182,256,-74,-28.90625
64,28,9,52,512,-460,-89.84375
64,28,10,828,1024,-196,-19.140625
64,28,11,221,2048,-1827,-89.208984375
64,28,12,924,4096,-3172,-77.44140625
64,28,13,9478,8192,1286,15.6982421875
64,28,14,1249,16384,-15135,-92.376708984375
64,28,15,2979,32768,-29789,-90.9088134765625
64,29,1,0,2,-2,-100.0
64,29,2,1,4,-3,-75.0
64,29,3,2,8,-6,-75.0
64,29,4,14,16,-2,-12.5
64,29,5,42,32,10,31.25
64,29,6,63,64,-1,-1.5625
64,29,7,31,128,-97,-75.78125
64,29,8,230,256,-26,-10.15625
64,29,9,37,512,-475,-92.7734375
64,29,10,1612,1024,588,57.421875
64,29,11,4187,2048,2139,104.443359375
64,29,12,6942,4096,2846,69.482421875
64,29,13,5632,8192,-2560,-31.25
64,29,14,12237,16384,-4147,-25.311279296875
64,29,15,44661,32768,11893,36.2945556640625
64,30,1,0,2,-2,-100.0
64,30,2,2,4,-2,-50.0
64,30,3,3,8,-5,-62.5
64,30,4,13,16,-3,-18.75
64,30,5,18,32,-14,-43.75
64,30,6,8,64,-56,-87.5
64,30,7,62,128,-66,-51.5625
64,30,8,233,256,-23,-8.984375
64,30,9,374,512,-138,-26.953125
64,30,10,336,1024,-688,-67.1875
64,30,11,3523,2048,1475,72.021484375
64,30,12,5071,4096,975,23.8037109375
64,30,13,6372,8192,-1820,-22.216796875
64,30,14,19573,16384,3189,19.464111328125
64,30,15,72165,32768,39397,120.2301025390625
64,31,1,0,2,-2,-100.0
64,31,2,2,4,-2,-50.0
64,31,3,2,8,-6,-75.0
64,31,4,26,16,10,62.5
64,31,5,6,32,-26,-81.25
64,31,6,17,64,-47,-73.4375
64,31,7,164,128,36,28.125
64,31,8,28,256,-228,-89.0625
64,31,9,121,512,-391,-76.3671875
64,31,10,1730,1024,706,68.9453125
64,31,11,2858,2048,810,39.55078125
64,31,12,8566,4096,4470,109.130859375
64,31,13,12324,8192,4132,50.439453125
64,31,14,5401,16384,-10983,-67.034912109375
64,31,15,39477,32768,6709,20.4742431640625
64,32,1,0,2,-2,-100.0
64,32,2,1,4,-3,-75.0
64,32,3,3,8,-5,-62.5
64,32,4,17,16,1,6.25
64,32,5,32,32,0,0.0
64,32,6,81,64,17,26.5625
64,32,7,609,128,481,375.78125
64,32,8,999,256,743,290.234375
64,32,9,299,512,-213,-41.6015625
64,32,10,1806,1024,782,76.3671875
64,32,11,1822,2048,-226,-11.03515625
64,32,12,6314,4096,2218,54.150390625
64,32,13,3917,8192,-4275,-52.18505859375
64,32,14,26321,16384,9937,60.650634765625
64,32,15,59867,32768,27099,82.6995849609375
64,33,1,0,2,-2,-100.0
64,33,2,5,4,1,25.0
64,33,3,2,8,-6,-75.0
64,33,4,14,16,-2,-12.5
64,33,5,36,32,4,12.5
64,33,6,101,64,37,57.8125
64,33,7,216,128,88,68.75
64,33,8,187,256,-69,-26.953125
64,33,9,347,512,-165,-32.2265625
64,33,10,567,1024,-457,-44.62890625
64,33,11,421,2048,-1627,-79.443359375
64,33,12,1099,4096,-2997,-73.1689453125
64,33,13,1616,8192,-6576,-80.2734375
64,33,14,18127,16384,1743,10.638427734375
64,33,15,41999,32768,9231,28.1707763671875
64,34,1,0,2,-2,-100.0
64,34,2,2,4,-2,-50.0
64,34,3,10,8,2,25.0
64,34,4,3,16,-13,-81.25
64,34,5,27,32,-5,-15.625
64,34,6,105,64,41,64.0625
64,34,7,117,128,-11,-8.59375
64,34,8,1009,256,753,294.140625
64,34,9,1712,512,1200,234.375
64,34,10,714,1024,-310,-30.2734375
64,34,11,1419,2048,-629,-30.712890625
64,34,12,1880,4096,-2216,-54.1015625
64,34,13,460,8192,-7732,-94.384765625
64,34,14,25367,16384,8983,54.827880859375
64,34,15,435,32768,-32333,-98.6724853515625
64,35,1,0,2,-2,-100.0
64,35,2,4,4,0,0.0
64,35,3,5,8,-3,-37.5
64,35,4,17,16,1,6.25
64,35,5,21,32,-11,-34.375
64,35,6,26,64,-38,-59.375
64,35,7,312,128,184,143.75
64,35,8,295,256,39,15.234375
64,35,9,36,512,-476,-92.96875
64,35,10,452,1024,-572,-55.859375
64,35,11,820,2048,-1228,-59.9609375
64,35,12,2630,4096,-1466,-35.791015625
64,35,13,735,8192,-7457,-91.02783203125
64,35,14,14520,16384,-1864,-11.376953125
64,35,15,7068,32768,-25700,-78.43017578125
64,36,1,0,2,-2,-100.0
64,36,2,1,4,-3,-75.0
64,36,3,7,8,-1,-12.5
64,36,4,11,16,-5,-31.25
64,36,5,27,32,-5,-15.625
64,36,6,134,64,70,109.375
64,36,7,103,128,-25,-19.53125
64,36,8,12,256,-244,-95.3125
64,36,9,112,512,-400,-78.125
64,36,10,747,1024,-277,-27.05078125
64,36,11,2966,2048,918,44.82421875
64,36,12,924,4096,-3172,-77.44140625
64,36,13,9179,8192,987,12.04833984375
64,36,14,13016,16384,-3368,-20.556640625
64,36,15,3782,32768,-28986,-88.458251953125
64,37,1,0,2,-2,-100.0
64,37,2,4,4,0,0.0
64,37,3,7,8,-1,-12.5
64,37,4,19,16,3,18.75
64,37,5,74,32,42,131.25
64,37,6,39,64,-25,-39.0625
64,37,7,115,128,-13,-10.15625
64,37,8,359,256,103,40.234375
64,37,9,709,512,197,38.4765625
64,37,10,620,1024,-404,-39.453125
64,37,11,3756,2048,1708,83.3984375
64,37,12,7782,4096,3686,89.990234375
64,37,13,19814,8192,11622,141.8701171875
64,37,14,2383,16384,-14001,-85.455322265625
64,37,15,16022,32768,-16746,-51.104736328125
64,38,1,0,2,-2,-100.0
64,38,2,2,4,-2,-50.0
64,38,3,11,8,3,37.5
64,38,4,21,16,5,31.25
64,38,5,10,32,-22,-68.75
64,38,6,169,64,105,164.0625
64,38,7,278,128,150,117.1875
64,38,8,112,256,-144,-56.25
64,38,9,66,512,-446,-87.109375
64,38,10,543,1024,-481,-46.97265625
64,38,11,1007,2048,-1041,-50.830078125
64,38,12,3674,4096,-422,-10.302734375
64,38,13,7597,8192,-595,-7.26318359375
64,38,14,1949,16384,-14435,-88.104248046875
64,38,15,41843,32768,9075,27.6947021484375
64,39,1,0,2,-2,-100.0
64,39,2,2,4,-2,-50.0
64,39,3,3,8,-5,-62.5
64,39,4,4,16,-12,-75.0
64,39,5,47,32,15,46.875
64,39,6,10,64,-54,-84.375
64,39,7,23,128,-105,-82.03125
64,39,8,156,256,-100,-39.0625
64,39,9,487,512,-25,-4.8828125
64,39,10,449,1024,-575,-56.15234375
64,39,11,2704,2048,656,32.03125
64,39,12,1727,4096,-2369,-57.8369140625
64,39,13,5312,8192,-2880,-35.15625
64,39,14,13262,16384,-3122,-19.05517578125
64,39,15,39036,32768,6268,19.12841796875
64,40,1,0,2,-2,-100.0
64,40,2,1,4,-3,-75.0
64,40,3,9,8,1,12.5
64,40,4,33,16,17,106.25
64,40,5,34,32,2,6.25
64,40,6,5,64,-59,-92.1875
64,40,7,53,128,-75,-58.59375
64,40,8,38,256,-218,-85.15625
64,40,9,282,512,-230,-44.921875
64,40,10,1017,1024,-7,-0.68359375
64,40,11,109,2048,-1939,-94.677734375
64,40,12,4089,4096,-7,-0.1708984375
64,40,13,7569,8192,-623,-7.60498046875
64,40,14,8603,16384,-7781,-47.491455078125
64,40,15,44874,32768,12106,36.944580078125
64,41,1,0,2,-2,-100.0
64,41,2,1,4,-3,-75.0
64,41,3,2,8,-6,-75.0
64,41,4,15,16,-1,-6.25
64,41,5,57,32,25,78.125
64,41,6,153,64,89,139.0625
64,41,7,68,128,-60,-46.875
64,41,8,74,256,-182,-71.09375
64,41,9,298,512,-214,-41.796875
64,41,10,50,1024,-974,-95.1171875
64,41,11,189,2048,-1859,-90.771484375
64,41,12,2413,4096,-1683,-41.0888671875
64,41,13,12265,8192,4073,49.71923828125
64,41,14,1556,16384,-14828,-90.5029296875
64,41,15,1632,32768,-31136,-95.01953125
64,42,1,0,2,-2,-100.0
64,42,2,1,4,-3,-75.0
64,42,3,4,8,-4,-50.0
64,42,4,3,16,-13,-81.25
64,42,5,39,32,7,21.875
64,42,6,186,64,122,190.625
64,42,7,78,128,-50,-39.0625
64,42,8,100,256,-156,-60.9375
64,42,9,161,512,-351,-68.5546875
64,42,10,147,1024,-877,-85.64453125
64,42,11,1875,2048,-173,-8.447265625
64,42,12,4837,4096,741,18.0908203125
64,42,13,13492,8192,5300,64.697265625
64,42,14,4281,16384,-12103,-73.870849609375
64,42,15,8481,32768,-24287,-74.1180419921875
64,43,1,0,2,-2,-100.0
64,43,2,1,4,-3,-75.0
64,43,3,5,8,-3,-37.5
64,43,4,3,16,-13,-81.25
64,43,5,10,32,-22,-68.75
64,43,6,65,64,1,1.5625
64,43,7,303,128,175,136.71875
64,43,8,316,256,60,23.4375
64,43,9,580,512,68,13.28125
64,43,10,3852,1024,2828,276.171875
64,43,11,21,2048,-2027,-98.974609375
64,43,12,10821,4096,6725,164.1845703125
64,43,13,10243,8192,2051,25.03662109375
64,43,14,3368,16384,-13016,-79.443359375
64,43,15,9829,32768,-22939,-70.0042724609375
64,44,1,0,2,-2,-100.0
64,44,2,1,4,-3,-75.0
64,44,3,5,8,-3,-37.5
64,44,4,8,16,-8,-50.0
64,44,5,4,32,-28,-87.5
64,44,6,106,64,42,65.625
64,44,7,260,128,132,103.125
64,44,8,180,256,-76,-29.6875
64,44,9,128,512,-384,-75.0
64,44,10,3263,1024,2239,218.65234375
64,44,11,5031,2048,2983,145.654296875
64,44,12,3721,4096,-375,-9.1552734375
64,44,13,119,8192,-8073,-98.54736328125
64,44,14,2906,16384,-13478,-82.26318359375
64,44,15,23228,32768,-9540,-29.11376953125
64,45,1,0,2,-2,-100.0
64,45,2,4,4,0,0.0
64,45,3,2,8,-6,-75.0
64,45,4,24,16,8,50.0
64,45,5,12,32,-20,-62.5
64,45,6,38,64,-26,-40.625
64,45,7,221,128,93,72.65625
64,45,8,105,256,-151,-58.984375
64,45,9,105,512,-407,-79.4921875
64,45,10,2596,1024,1572,153.515625
64,45,11,2018,2048,-30,-1.46484375
64,45,12,327,4096,-3769,-92.0166015625
64,45,13,12616,8192,4424,54.00390625
64,45,14,7740,16384,-8644,-52.7587890625
64,45,15,72809,32768,40041,122.1954345703125
64,46,1,0,2,-2,-100.0
64,46,2,6,4,2,50.0
64,46,3,8,8,0,0.0
64,46,4,17,16,1,6.25
64,46,5,22,32,-10,-31.25
64,46,6,9,64,-55,-85.9375
64,46,7,20,128,-108,-84.375
64,46,8,723,256,467,182.421875
64,46,9,2197,512,1685,329.1015625
64,46,10,1007,1024,-17,-1.66015625
64,46,11,485,2048,-1563,-76.318359375
64,46,12,1617,4096,-2479,-60.5224609375
64,46,13,16501,8192,8309,101.42822265625
64,46,14,23676,16384,7292,44.5068359375
64,46,15,6407,32768,-26361,-80.4473876953125
64,47,1,0,2,-2,-100.0
64,47,2,1,4,-3,-75.0
64,47,3,13,8,5,62.5
64,47,4,29,16,13,81.25
64,47,5,8,32,-24,-75.0
64,47,6,85,64,21,32.8125
64,47,7,83,128,-45,-35.15625
64,47,8,88,256,-168,-65.625
64,47,9,542,512,30,5.859375
64,47,10,1145,1024,121,11.81640625
64,47,11,3441,2048,1393,68.017578125
64,47,12,3360,4096,-736,-17.96875
64,47,13,4774,8192,-3418,-41.7236328125
64,47,14,42494,16384,26110,159.36279296875
64,47,15,222951,32768,190183,580.3924560546875
64,48,1,0,2,-2,-100.0
64,48,2,3,4,-1,-25.0
64,48,3,5,8,-3,-37.5
64,48,4,15,16,-1,-6.25
64,48,5,16,32,-16,-50.0
64,48,6,50,64,-14,-21.875
64,48,7,144,128,16,12.5
64,48,8,367,256,111,43.359375
64,48,9,470,512,-42,-8.203125
64,48,10,441,1024,-583,-56.93359375
64,48,11,1433,2048,-615,-30.029296875
64,48,12,2590,4096,-1506,-36.767578125
64,48,13,10892,8192,2700,32.958984375
64,48,14,28484,16384,12100,73.8525390625
64,48,15,47822,32768,15054,45.941162109375
64,49,1,0,2,-2,-100.0
64,49,2,1,4,-3,-75.0
64,49,3,5,8,-3,-37.5
64,49,4,3,16,-13,-81.25
64,49,5,10,32,-22,-68.75
64,49,6,37,64,-27,-42.1875
64,49,7,155,128,27,21.09375
64,49,8,537,256,281,109.765625
64,49,9,1195,512,683,133.3984375
64,49,10,11,1024,-1013,-98.92578125
64,49,11,1433,2048,-615,-30.029296875
64,49,12,1397,4096,-2699,-65.8935546875
64,49,13,7436,8192,-756,-9.228515625
64,49,14,24891,16384,8507,51.922607421875
64,49,15,35569,32768,2801,8.5479736328125
64,50,1,0,2,-2,-100.0
64,50,2,3,4,-1,-25.0
64,50,3,2,8,-6,-75.0
64,50,4,17,16,1,6.25
64,50,5,4,32,-28,-87.5
64,50,6,66,64,2,3.125
64,50,7,389,128,261,203.90625
64,50,8,11,256,-245,-95.703125
64,50,9,1237,512,725,141.6015625
64,50,10,423,1024,-601,-58.69140625
64,50,11,454,2048,-1594,-77.83203125
64,50,12,4979,4096,883,21.5576171875
64,50,13,1961,8192,-6231,-76.06201171875
64,50,14,48436,16384,32052,195.6298828125
64,50,15,17848,32768,-14920,-45.5322265625
64,51,1,0,2,-2,-100.0
64,51,2,1,4,-3,-75.0
64,51,3,8,8,0,0.0
64,51,4,20,16,4,25.0
64,51,5,17,32,-15,-46.875
64,51,6,29,64,-35,-54.6875
64,51,7,34,128,-94,-73.4375
64,51,8,256,256,0,0.0
64,51,9,224,512,-288,-56.25
64,51,10,373,1024,-651,-63.57421875
64,51,11,1178,2048,-870,-42.48046875
64,51,12,2462,4096,-1634,-39.892578125
64,51,13,14985,8192,6793,82.92236328125
64,51,14,546,16384,-15838,-96.66748046875
64,51,15,3718,32768,-29050,-88.653564453125
64,52,1,0,2,-2,-100.0
64,52,2,1,4,-3,-75.0
64,52,3,2,8,-6,-75.0
64,52,4,6,16,-10,-62.5
64,52,5,23,32,-9,-28.125
64,52,6,18,64,-46,-71.875
64,52,7,47,128,-81,-63.28125
64,52,8,210,256,-46,-17.96875
64,52,9,543,512,31,6.0546875
64,52,10,11,1024,-1013,-98.92578125
64,52,11,4286,2048,2238,109.27734375
64,52,12,5823,4096,1727,42.1630859375
64,52,13,1430,8192,-6762,-82.5439453125
64,52,14,23490,16384,7106,43.37158203125
64,52,15,7593,32768,-25175,-76.8280029296875
64,53,1,0,2,-2,-100.0
64,53,2,1,4,-3,-75.0
64,53,3,3,8,-5,-62.5
64,53,4,13,16,-3,-18.75
64,53,5,8,32,-24,-75.0
64,53,6,84,64,20,31.25
64,53,7,23,128,-105,-82.03125
64,53,8,397,256,141,55.078125
64,53,9,38,512,-474,-92.578125
64,53,10,1193,1024,169,16.50390625
64,53,11,1767,2048,-281,-13.720703125
64,53,12,5895,4096,1799,43.9208984375
64,53,13,6337,8192,-1855,-22.64404296875
64,53,14,7477,16384,-8907,-54.364013671875
64,53,15,19831,32768,-12937,-39.4805908203125
64,54,1,0,2,-2,-100.0
64,54,2,1,4,-3,-75.0
64,54,3,21,8,13,162.5
64,54,4,4,16,-12,-75.0
64,54,5,14,32,-18,-56.25
64,54,6,47,64,-17,-26.5625
64,54,7,22,128,-106,-82.8125
64,54,8,72,256,-184,-71.875
64,54,9,79,512,-433,-84.5703125
64,54,10,77,1024,-947,-92.48046875
64,54,11,3405,2048,1357,66.259765625
64,54,12,8845,4096,4749,115.9423828125
64,54,13,2035,8192,-6157,-75.15869140625
64,54,14,35213,16384,18829,114.923095703125
64,54,15,14695,32768,-18073,-55.1544189453125
64,55,1,0,2,-2,-100.0
64,55,2,6,4,2,50.0
64,55,3,2,8,-6,-75.0
64,55,4,16,16,0,0.0
64,55,5,10,32,-22,-68.75
64,55,6,57,64,-7,-10.9375
64,55,7,50,128,-78,-60.9375
64,55,8,129,256,-127,-49.609375
64,55,9,271,512,-241,-47.0703125
64,55,10,376,1024,-648,-63.28125
64,55,11,2144,2048,96,4.6875
64,55,12,865,4096,-3231,-78.8818359375
64,55,13,8902,8192,710,8.6669921875
64,55,14,9712,16384,-6672,-40.72265625
64,55,15,43384,32768,10616,32.3974609375
64,56,1,0,2,-2,-100.0
64,56,2,1,4,-3,-75.0
64,56,3,6,8,-2,-25.0
64,56,4,14,16,-2,-12.5
64,56,5,18,32,-14,-43.75
64,56,6,35,64,-29,-45.3125
64,56,7,22,128,-106,-82.8125
64,56,8,732,256,476,185.9375
64,56,9,1008,512,496,96.875
64,56,10,1094,1024,70,6.8359375
64,56,11,1148,2048,-900,-43.9453125
64,56,12,8475,4096,4379,106.9091796875
64,56,13,43000,8192,34808,424.90234375
64,56,14,382,16384,-16002,-97.66845703125
64,56,15,47475,32768,14707,44.8822021484375
64,57,1,0,2,-2,-100.0
64,57,2,1,4,-3,-75.0
64,57,3,7,8,-1,-12.5
64,57,4,24,16,8,50.0
64,57,5,18,32,-14,-43.75
64,57,6,72,64,8,12.5
64,57,7,56,128,-72,-56.25
64,57,8,920,256,664,259.375
64,57,9,80,512,-432,-84.375
64,57,10,1316,1024,292,28.515625
64,57,11,1404,2048,-644,-31.4453125
64,57,12,772,4096,-3324,-81.15234375
64,57,13,568,8192,-7624,-93.06640625
64,57,14,13461,16384,-2923,-17.840576171875
64,57,15,24654,32768,-8114,-24.761962890625
64,58,1,0,2,-2,-100.0
64,58,2,1,4,-3,-75.0
64,58,3,5,8,-3,-37.5
64,58,4,10,16,-6,-37.5
64,58,5,10,32,-22,-68.75
64,58,6,88,64,24,37.5
64,58,7,166,128,38,29.6875
64,58,8,343,256,87,33.984375
64,58,9,171,512,-341,-66.6015625
64,58,10,299,1024,-725,-70.80078125
64,58,11,3533,2048,1485,72.509765625
64,58,12,6538,4096,2442,59.619140625
64,58,13,13360,8192,5168,63.0859375
64,58,14,9395,16384,-6989,-42.657470703125
64,58,15,22861,32768,-9907,-30.2337646484375
64,59,1,0,2,-2,-100.0
64,59,2,1,4,-3,-75.0
64,59,3,6,8,-2,-25.0
64,59,4,28,16,12,75.0
64,59,5,21,32,-11,-34.375
64,59,6,52,64,-12,-18.75
64,59,7,85,128,-43,-33.59375
64,59,8,501,256,245,95.703125
64,59,9,259,512,-253,-49.4140625
64,59,10,658,1024,-366,-35.7421875
64,59,11,2963,2048,915,44.677734375
64,59,12,5748,4096,1652,40.33203125
64,59,13,1498,8192,-6694,-81.7138671875
64,59,14,14032,16384,-2352,-14.35546875
64,59,15,34091,32768,1323,4.0374755859375
64,60,1,0,2,-2,-100.0
64,60,2,1,4,-3,-75.0
64,60,3,17,8,9,112.5
64,60,4,52,16,36,225.0
64,60,5,67,32,35,109.375
64,60,6,51,64,-13,-20.3125
64,60,7,75,128,-53,-41.40625
64,60,8,172,256,-84,-32.8125
64,60,9,250,512,-262,-51.171875
64,60,10,753,1024,-271,-26.46484375
64,60,11,892,2048,-1156,-56.4453125
64,60,12,797,4096,-3299,-80.5419921875
64,60,13,3489,8192,-4703,-57.40966796875
64,60,14,14608,16384,-1776,-10.83984375
64,60,15,65583,32768,32815,100.1434326171875
64,61,1,0,2,-2,-100.0
64,61,2,1,4,-3,-75.0
64,61,3,4,8,-4,-50.0
64,61,4,27,16,11,68.75
64,61,5,51,32,19,59.375
64,61,6,129,64,65,101.5625
64,61,7,156,128,28,21.875
64,61,8,189,256,-67,-26.171875
64,61,9,9,512,-503,-98.2421875
64,61,10,328,1024,-696,-67.96875
64,61,11,1101,2048,-947,-46.240234375
64,61,12,3271,4096,-825,-20.1416015625
64,61,13,9538,8192,1346,16.4306640625
64,61,14,11875,16384,-4509,-27.520751953125
64,61,15,22213,32768,-10555,-32.2113037109375
64,62,1,0,2,-2,-100.0
64,62,2,1,4,-3,-75.0
64,62,3,2,8,-6,-75.0
64,62,4,7,16,-9,-56.25
64,62,5,41,32,9,28.125
64,62,6,9,64,-55,-85.9375
64,62,7,112,128,-16,-12.5
64,62,8,69,256,-187,-73.046875
64,62,9,676,512,164,32.03125
64,62,10,146,1024,-878,-85.7421875
64,62,11,135,2048,-1913,-93.408203125
64,62,12,2844,4096,-1252,-30.56640625
64,62,13,501,8192,-7691,-93.88427734375
64,62,14,33134,16384,16750,102.23388671875
64,62,15,5610,32768,-27158,-82.879638671875
64,63,1,0,2,-2,-100.0
64,63,2,1,4,-3,-75.0
64,63,3,3,8,-5,-62.5
64,63,4,13,16,-3,-18.75
64,63,5,10,32,-22,-68.75
64,63,6,59,64,-5,-7.8125
64,63,7,209,128,81,63.28125
64,63,8,307,256,51,19.921875
64,63,9,385,512,-127,-24.8046875
64,63,10,2862,1024,1838,179.4921875
64,63,11,240,2048,-1808,-88.28125
64,63,12,2571,4096,-1525,-37.2314453125
64,63,13,21950,8192,13758,167.9443359375
64,63,14,21009,16384,4625,28.228759765625
64,63,15,11725,32768,-21043,-64.2181396484375
64,64,1,0,2,-2,-100.0
64,64,2,3,4,-1,-25.0
64,64,3,7,8,-1,-12.5
64,64,4,7,16,-9,-56.25
64,64,5,5,32,-27,-84.375
64,64,6,101,64,37,57.8125
64,64,7,93,128,-35,-27.34375
64,64,8,60,256,-196,-76.5625
64,64,9,31,512,-481,-93.9453125
64,64,10,167,1024,-857,-83.69140625
64,64,11,1808,2048,-240,-11.71875
64,64,12,866,4096,-3230,-78.857421875
64,64,13,2629,8192,-5563,-67.90771484375
64,64,14,15509,16384,-875,-5.340576171875
64,64,15,34974,32768,2206,6.732177734375
65,1,1,0,2,-2,-100.0
65,1,2,2,4,-2,-50.0
65,1,3,5,8,-3,-37.5
65,1,4,4,16,-12,-75.0
65,1,5,4,32,-28,-87.5
65,1,6,76,64,12,18.75
65,1,7,59,128,-69,-53.90625
65,1,8,214,256,-42,-16.40625
65,1,9,54,512,-458,-89.453125
65,1,10,469,1024,-555,-54.19921875
65,1,11,4279,2048,2231,108.935546875
65,1,12,4435,4096,339,8.2763671875
65,1,13,2299,8192,-5893,-71.93603515625
65,1,14,17662,16384,1278,7.80029296875
65,1,15,51073,32768,18305,55.8624267578125
65,2,1,0,2,-2,-100.0
65,2,2,1,4,-3,-75.0
65,2,3,3,8,-5,-62.5
65,2,4,9,16,-7,-43.75
65,2,5,9,32,-23,-71.875
65,2,6,59,64,-5,-7.8125
65,2,7,220,128,92,71.875
65,2,8,107,256,-149,-58.203125
65,2,9,72,512,-440,-85.9375
65,2,10,108,1024,-916,-89.453125
65,2,11,270,2048,-1778,-86.81640625
65,2,12,3054,4096,-1042,-25.439453125
65,2,13,7196,8192,-996,-12.158203125
65,2,14,26420,16384,10036,61.2548828125
65,2,15,102184,32768,69416,211.8408203125
65,3,1,0,2,-2,-100.0
65,3,2,2,4,-2,-50.0
65,3,3,7,8,-1,-12.5
65,3,4,26,16,10,62.5
65,3,5,126,32,94,293.75
65,3,6,22,64,-42,-65.625
65,3,7,32,128,-96,-75.0
65,3,8,843,256,587,229.296875
65,3,9,270,512,-242,-47.265625
65,3,10,638,1024,-386,-37.6953125
65,3,11,561,2048,-1487,-72.607421875
65,3,12,5689,4096,1593,38.8916015625
65,3,13,859,8192,-7333,-89.51416015625
65,3,14,21129,16384,4745,28.961181640625
65,3,15,18271,32768,-14497,-44.2413330078125
65,4,1,0,2,-2,-100.0
65,4,2,3,4,-1,-25.0
65,4,3,2,8,-6,-75.0
65,4,4,3,16,-13,-81.25
65,4,5,28,32,-4,-12.5
65,4,6,19,64,-45,-70.3125
65,4,7,136,128,8,6.25
65,4,8,575,256,319,124.609375
65,4,9,396,512,-116,-22.65625
65,4,10,1861,1024,837,81.73828125
65,4,11,1602,2048,-446,-21.77734375
65,4,12,7297,4096,3201,78.1494140625
65,4,13,12921,8192,4729,57.72705078125
65,4,14,50636,16384,34252,209.0576171875
65,4,15,3664,32768,-29104,-88.818359375
65,5,1,0,2,-2,-100.0
65,5,2,2,4,-2,-50.0
65,5,3,9,8,1,12.5
65,5,4,23,16,7,43.75
65,5,5,12,32,-20,-62.5
65,5,6,52,64,-12,-18.75
65,5,7,50,128,-78,-60.9375
65,5,8,238,256,-18,-7.03125
65,5,9,1088,512,576,112.5
65,5,10,16,1024,-1008,-98.4375
65,5,11,1061,2048,-987,-48.193359375
65,5,12,2640,4096,-1456,-35.546875
65,5,13,10074,8192,1882,22.9736328125
65,5,14,13824,16384,-2560,-15.625
65,5,15,33850,32768,1082,3.302001953125
65,6,1,0,2,-2,-100.0
65,6,2,3,4,-1,-25.0
65,6,3,3,8,-5,-62.5
65,6,4,15,16,-1,-6.25
65,6,5,29,32,-3,-9.375
65,6,6,118,64,54,84.375
65,6,7,258,128,130,101.5625
65,6,8,85,256,-171,-66.796875
65,6,9,935,512,423,82.6171875
65,6,10,1217,1024,193,18.84765625
65,6,11,2232,2048,184,8.984375
65,6,12,4266,4096,170,4.150390625
65,6,13,4891,8192,-3301,-40.29541015625
65,6,14,20733,16384,4349,26.544189453125
65,6,15,42633,32768,9865,30.1055908203125
65,7,1,0,2,-2,-100.0
65,7,2,2,4,-2,-50.0
65,7,3,7,8,-1,-12.5
65,7,4,3,16,-13,-81.25
65,7,5,27,32,-5,-15.625
65,7,6,43,64,-21,-32.8125
65,7,7,20,128,-108,-84.375
65,7,8,242,256,-14,-5.46875
65,7,9,289,512,-223,-43.5546875
65,7,10,803,1024,-221,-21.58203125
65,7,11,4461,2048,2413,117.822265625
65,7,12,2864,4096,-1232,-30.078125
65,7,13,9345,8192,1153,14.07470703125
65,7,14,651,16384,-15733,-96.026611328125
65,7,15,31986,32768,-782,-2.386474609375
65,8,1,0,2,-2,-100.0
65,8,2,1,4,-3,-75.0
65,8,3,2,8,-6,-75.0
65,8,4,21,16,5,31.25
65,8,5,54,32,22,68.75
65,8,6,27,64,-37,-57.8125
65,8,7,269,128,141,110.15625
65,8,8,400,256,144,56.25
65,8,9,85,512,-427,-83.3984375
65,8,10,581,1024,-443,-43.26171875
65,8,11,3733,2048,1685,82.275390625
65,8,12,738,4096,-3358,-81.982421875
65,8,13,12899,8192,4707,57.45849609375
65,8,14,14611,16384,-1773,-10.821533203125
65,8,15,26328,32768,-6440,-19.6533203125
65,9,1,0,2,-2,-100.0
65,9,2,4,4,0,0.0
65,9,3,2,8,-6,-75.0
65,9,4,28,16,12,75.0
65,9,5,39,32,7,21.875
65,9,6,5,64,-59,-92.1875
65,9,7,151,128,23,17.96875
65,9,8,402,256,146,57.03125
65,9,9,418,512,-94,-18.359375
65,9,10,565,1024,-459,-44.82421875
65,9,11,1289,2048,-759,-37.060546875
65,9,12,7365,4096,3269,79.8095703125
65,9,13,674,8192,-7518,-91.7724609375
65,9,14,47691,16384,31307,191.082763671875
65,9,15,36923,32768,4155,12.6800537109375
65,10,1,0,2,-2,-100.0
65,10,2,2,4,-2,-50.0
65,10,3,2,8,-6,-75.0
65,10,4,8,16,-8,-50.0
65,10,5,19,32,-13,-40.625
65,10,6,103,64,39,60.9375
65,10,7,220,128,92,71.875
65,10,8,260,256,4,1.5625
65,10,9,273,512,-239,-46.6796875
65,10,10,1991,1024,967,94.43359375
65,10,11,253,2048,-1795,-87.646484375
65,10,12,1813,4096,-2283,-55.7373046875
65,10,13,6916,8192,-1276,-15.576171875
65,10,14,1983,16384,-14401,-87.896728515625
65,10,15,44586,32768,11818,36.065673828125
65,11,1,0,2,-2,-100.0
65,11,2,3,4,-1,-25.0
65,11,3,3,8,-5,-62.5
65,11,4,12,16,-4,-25.0
65,11,5,13,32,-19,-59.375
65,11,6,28,64,-36,-56.25
65,11,7,45,128,-83,-64.84375
65,11,8,256,256,0,0.0
65,11,9,2114,512,1602,312.890625
65,11,10,1762,1024,738,72.0703125
65,11,11,502,2048,-1546,-75.48828125
65,11,12,4458,4096,362,8.837890625
65,11,13,7450,8192,-742,-9.0576171875
65,11,14,1478,16384,-14906,-90.97900390625
65,11,15,41016,32768,8248,25.1708984375
65,12,1,0,2,-2,-100.0
65,12,2,3,4,-1,-25.0
65,12,3,9,8,1,12.5
65,12,4,4,16,-12,-75.0
65,12,5,7,32,-25,-78.125
65,12,6,115,64,51,79.6875
65,12,7,14,128,-114,-89.0625
65,12,8,233,256,-23,-8.984375
65,12,9,448,512,-64,-12.5
65,12,10,999,1024,-25,-2.44140625
65,12,11,23,2048,-2025,-98.876953125
65,12,12,1554,4096,-2542,-62.060546875
65,12,13,12597,8192,4405,53.77197265625
65,12,14,37882,16384,21498,131.21337890625
65,12,15,7754,32768,-25014,-76.336669921875
65,13,1,0,2,-2,-100.0
65,13,2,1,4,-3,-75.0
65,13,3,3,8,-5,-62.5
65,13,4,35,16,19,118.75
65,13,5,68,32,36,112.5
65,13,6,65,64,1,1.5625
65,13,7,154,128,26,20.3125
65,13,8,262,256,6,2.34375
65,13,9,1054,512,542,105.859375
65,13,10,957,1024,-67,-6.54296875
65,13,11,1105,2048,-943,-46.044921875
65,13,12,7578,4096,3482,85.009765625
65,13,13,6336,8192,-1856,-22.65625
65,13,14,6321,16384,-10063,-61.419677734375
65,13,15,103041,32768,70273,214.4561767578125
65,14,1,0,2,-2,-100.0
65,14,2,2,4,-2,-50.0
65,14,3,7,8,-1,-12.5
65,14,4,26,16,10,62.5
65,14,5,19,32,-13,-40.625
65,14,6,36,64,-28,-43.75
65,14,7,175,128,47,36.71875
65,14,8,198,256,-58,-22.65625
65,14,9,268,512,-244,-47.65625
65,14,10,1252,1024,228,22.265625
65,14,11,117,2048,-1931,-94.287109375
65,14,12,1658,4096,-2438,-59.521484375
65,14,13,3109,8192,-5083,-62.04833984375
65,14,14,26690,16384,10306,62.90283203125
65,14,15,19834,32768,-12934,-39.471435546875
65,15,1,0,2,-2,-100.0
65,15,2,2,4,-2,-50.0
65,15,3,6,8,-2,-25.0
65,15,4,37,16,21,131.25
65,15,5,34,32,2,6.25
65,15,6,32,64,-32,-50.0
65,15,7,9,128,-119,-92.96875
65,15,8,71,256,-185,-72.265625
65,15,9,1683,512,1171,228.7109375
65,15,10,607,1024,-417,-40.72265625
65,15,11,605,2048,-1443,-70.458984375
65,15,12,2571,4096,-1525,-37.2314453125
65,15,13,2414,8192,-5778,-70.5322265625
65,15,14,29373,16384,12989,79.278564453125
65,15,15,6554,32768,-26214,-79.998779296875
65,16,1,0,2,-2,-100.0
65,16,2,1,4,-3,-75.0
65,16,3,2,8,-6,-75.0
65,16,4,13,16,-3,-18.75
65,16,5,44,32,12,37.5
65,16,6,84,64,20,31.25
65,16,7,151,128,23,17.96875
65,16,8,8,256,-248,-96.875
65,16,9,778,512,266,51.953125
65,16,10,70,1024,-954,-93.1640625
65,16,11,663,2048,-1385,-67.626953125
65,16,12,188,4096,-3908,-95.41015625
65,16,13,13460,8192,5268,64.306640625
65,16,14,27824,16384,11440,69.82421875
65,16,15,187040,32768,154272,470.80078125
65,17,1,0,2,-2,-100.0
65,17,2,4,4,0,0.0
65,17,3,5,8,-3,-37.5
65,17,4,58,16,42,262.5
65,17,5,33,32,1,3.125
65,17,6,55,64,-9,-14.0625
65,17,7,8,128,-120,-93.75
65,17,8,52,256,-204,-79.6875
65,17,9,529,512,17,3.3203125
65,17,10,306,1024,-718,-70.1171875
65,17,11,2501,2048,453,22.119140625
65,17,12,397,4096,-3699,-90.3076171875
65,17,13,11247,8192,3055,37.29248046875
65,17,14,29561,16384,13177,80.426025390625
65,17,15,10606,32768,-22162,-67.633056640625
65,18,1,0,2,-2,-100.0
65,18,2,2,4,-2,-50.0
65,18,3,3,8,-5,-62.5
65,18,4,15,16,-1,-6.25
65,18,5,29,32,-3,-9.375
65,18,6,19,64,-45,-70.3125
65,18,7,93,128,-35,-27.34375
65,18,8,30,256,-226,-88.28125
65,18,9,1036,512,524,102.34375
65,18,10,730,1024,-294,-28.7109375
65,18,11,269,2048,-1779,-86.865234375
65,18,12,1130,4096,-2966,-72.412109375
65,18,13,2579,8192,-5613,-68.51806640625
65,18,14,25627,16384,9243,56.414794921875
65,18,15,74517,32768,41749,127.4078369140625
65,19,1,0,2,-2,-100.0
65,19,2,1,4,-3,-75.0
65,19,3,4,8,-4,-50.0
65,19,4,3,16,-13,-81.25
65,19,5,4,32,-28,-87.5
65,19,6,27,64,-37,-57.8125
65,19,7,178,128,50,39.0625
65,19,8,132,256,-124,-48.4375
65,19,9,73,512,-439,-85.7421875
65,19,10,1767,1024,743,72.55859375
65,19,11,1495,2048,-553,-27.001953125
65,19,12,269,4096,-3827,-93.4326171875
65,19,13,80,8192,-8112,-99.0234375
65,19,14,13014,16384,-3370,-20.56884765625
65,19,15,9720,32768,-23048,-70.3369140625
65,20,1,0,2,-2,-100.0
65,20,2,1,4,-3,-75.0
65,20,3,2,8,-6,-75.0
65,20,4,7,16,-9,-56.25
65,20,5,15,32,-17,-53.125
65,20,6,75,64,11,17.1875
65,20,7,134,128,6,4.6875
65,20,8,601,256,345,134.765625
65,20,9,456,512,-56,-10.9375
65,20,10,269,1024,-755,-73.73046875
65,20,11,32,2048,-2016,-98.4375
65,20,12,150,4096,-3946,-96.337890625
65,20,13,2903,8192,-5289,-64.56298828125
65,20,14,9362,16384,-7022,-42.85888671875
65,20,15,128272,32768,95504,291.455078125
65,21,1,0,2,-2,-100.0
65,21,2,2,4,-2,-50.0
65,21,3,18,8,10,125.0
65,21,4,6,16,-10,-62.5
65,21,5,5,32,-27,-84.375
65,21,6,29,64,-35,-54.6875
65,21,7,123,128,-5,-3.90625
65,21,8,326,256,70,27.34375
65,21,9,1123,512,611,119.3359375
65,21,10,1680,1024,656,64.0625
65,21,11,3126,2048,1078,52.63671875
65,21,12,1666,4096,-2430,-59.326171875
65,21,13,8280,8192,88,1.07421875
65,21,14,14351,16384,-2033,-12.408447265625
65,21,15,25258,32768,-7510,-22.918701171875
65,22,1,0,2,-2,-100.0
65,22,2,5,4,1,25.0
65,22,3,2,8,-6,-75.0
65,22,4,3,16,-13,-81.25
65,22,5,41,32,9,28.125
65,22,6,101,64,37,57.8125
65,22,7,25,128,-103,-80.46875
65,22,8,131,256,-125,-48.828125
65,22,9,220,512,-292,-57.03125
65,22,10,1688,1024,664,64.84375
65,22,11,48,2048,-2000,-97.65625
65,22,12,2496,4096,-1600,-39.0625
65,22,13,8432,8192,240,2.9296875
65,22,14,4314,16384,-12070,-73.66943359375
65,22,15,10743,32768,-22025,-67.2149658203125
65,23,1,0,2,-2,-100.0
65,23,2,4,4,0,0.0
65,23,3,7,8,-1,-12.5
65,23,4,30,16,14,87.5
65,23,5,10,32,-22,-68.75
65,23,6,5,64,-59,-92.1875
65,23,7,134,128,6,4.6875
65,23,8,141,256,-115,-44.921875
65,23,9,345,512,-167,-32.6171875
65,23,10,1839,1024,815,79.58984375
65,23,11,677,2048,-1371,-66.943359375
65,23,12,13906,4096,9810,239.501953125
65,23,13,2472,8192,-5720,-69.82421875
65,23,14,4989,16384,-11395,-69.549560546875
65,23,15,31950,32768,-818,-2.496337890625
65,24,1,0,2,-2,-100.0
65,24,2,2,4,-2,-50.0
65,24,3,5,8,-3,-37.5
65,24,4,17,16,1,6.25
65,24,5,4,32,-28,-87.5
65,24,6,17,64,-47,-73.4375
65,24,7,91,128,-37,-28.90625
65,24,8,32,256,-224,-87.5
65,24,9,30,512,-482,-94.140625
65,24,10,2280,1024,1256,122.65625
65,24,11,970,2048,-1078,-52.63671875
65,24,12,4027,4096,-69,-1.6845703125
65,24,13,1394,8192,-6798,-82.9833984375
65,24,14,31474,16384,15090,92.10205078125
65,24,15,55419,32768,22651,69.1253662109375
65,25,1,0,2,-2,-100.0
65,25,2,1,4,-3,-75.0
65,25,3,9,8,1,12.5
65,25,4,4,16,-12,-75.0
65,25,5,28,32,-4,-12.5
65,25,6,160,64,96,150.0
65,25,7,49,128,-79,-61.71875
65,25,8,189,256,-67,-26.171875
65,25,9,410,512,-102,-19.921875
65,25,10,2351,1024,1327,129.58984375
65,25,11,6198,2048,4150,202.63671875
65,25,12,2087,4096,-2009,-49.0478515625
65,25,13,510,8192,-7682,-93.7744140625
65,25,14,9392,16384,-6992,-42.67578125
65,25,15,50384,32768,17616,53.759765625
65,26,1,0,2,-2,-100.0
65,26,2,1,4,-3,-75.0
65,26,3,3,8,-5,-62.5
65,26,4,13,16,-3,-18.75
65,26,5,83,32,51,159.375
65,26,6,27,64,-37,-57.8125
65,26,7,16,128,-112,-87.5
65,26,8,182,256,-74,-28.90625
65,26,9,112,512,-400,-78.125
65,26,10,723,1024,-301,-29.39453125
65,26,11,54,2048,-1994,-97.36328125
65,26,12,2570,4096,-1526,-37.255859375
65,26,13,19565,8192,11373,138.83056640625
65,26,14,86645,16384,70261,428.839111328125
65,26,15,107568,32768,74800,228.271484375
65,27,1,0,2,-2,-100.0
65,27,2,1,4,-3,-75.0
65,27,3,4,8,-4,-50.0
65,27,4,7,16,-9,-56.25
65,27,5,16,32,-16,-50.0
65,27,6,63,64,-1,-1.5625
65,27,7,81,128,-47,-36.71875
65,27,8,156,256,-100,-39.0625
65,27,9,208,512,-304,-59.375
65,27,10,2890,1024,1866,182.2265625
65,27,11,3339,2048,1291,63.037109375
65,27,12,14107,4096,10011,244.4091796875
65,27,13,3949,8192,-4243,-51.79443359375
65,27,14,43864,16384,27480,167.724609375
65,27,15,37094,32768,4326,13.201904296875
65,28,1,0,2,-2,-100.0
65,28,2,1,4,-3,-75.0
65,28,3,6,8,-2,-25.0
65,28,4,36,16,20,125.0
65,28,5,35,32,3,9.375
65,28,6,28,64,-36,-56.25
65,28,7,270,128,142,110.9375
65,28,8,21,256,-235,-91.796875
65,28,9,146,512,-366,-71.484375
65,28,10,5094,1024,4070,397.4609375
65,28,11,3846,2048,1798,87.79296875
65,28,12,5931,4096,1835,44.7998046875
65,28,13,769,8192,-7423,-90.61279296875
65,28,14,17885,16384,1501,9.161376953125
65,28,15,127966,32768,95198,290.521240234375
65,29,1,0,2,-2,-100.0
65,29,2,1,4,-3,-75.0
65,29,3,21,8,13,162.5
65,29,4,3,16,-13,-81.25
65,29,5,12,32,-20,-62.5
65,29,6,97,64,33,51.5625
65,29,7,140,128,12,9.375
65,29,8,141,256,-115,-44.921875
65,29,9,995,512,483,94.3359375
65,29,10,2009,1024,985,96.19140625
65,29,11,122,2048,-1926,-94.04296875
65,29,12,2633,4096,-1463,-35.7177734375
65,29,13,1899,8192,-6293,-76.81884765625
65,29,14,5545,16384,-10839,-66.156005859375
65,29,15,2587,32768,-30181,-92.1051025390625
65,30,1,0,2,-2,-100.0
65,30,2,1,4,-3,-75.0
65,30,3,5,8,-3,-37.5
65,30,4,9,16,-7,-43.75
65,30,5,13,32,-19,-59.375
65,30,6,49,64,-15,-23.4375
65,30,7,9,128,-119,-92.96875
65,30,8,86,256,-170,-66.40625
65,30,9,106,512,-406,-79.296875
65,30,10,1451,1024,427,41.69921875
65,30,11,3599,2048,1551,75.732421875
65,30,12,59,4096,-4037,-98.5595703125
65,30,13,511,8192,-7681,-93.76220703125
65,30,14,12254,16384,-4130,-25.20751953125
65,30,15,77486,32768,44718,136.468505859375
65,31,1,0,2,-2,-100.0
65,31,2,6,4,2,50.0
65,31,3,10,8,2,25.0
65,31,4,3,16,-13,-81.25
65,31,5,12,32,-20,-62.5
65,31,6,63,64,-1,-1.5625
65,31,7,221,128,93,72.65625
65,31,8,308,256,52,20.3125
65,31,9,1141,512,629,122.8515625
65,31,10,1082,1024,58,5.6640625
65,31,11,383,2048,-1665,-81.298828125
65,31,12,19,4096,-4077,-99.5361328125
65,31,13,13098,8192,4906,59.8876953125
65,31,14,15823,16384,-561,-3.424072265625
65,31,15,6410,32768,-26358,-80.438232421875
65,32,1,0,2,-2,-100.0
65,32,2,1,4,-3,-75.0
65,32,3,2,8,-6,-75.0
65,32,4,11,16,-5,-31.25
65,32,5,7,32,-25,-78.125
65,32,6,65,64,1,1.5625
65,32,7,77,128,-51,-39.84375
65,32,8,137,256,-119,-46.484375
65,32,9,608,512,96,18.75
65,32,10,521,1024,-503,-49.12109375
65,32,11,710,2048,-1338,-65.33203125
65,32,12,4138,4096,42,1.025390625
65,32,13,3628,8192,-4564,-55.712890625
65,32,14,15695,16384,-689,-4.205322265625
65,32,15,12634,32768,-20134,-61.444091796875
65,33,1,0,2,-2,-100.0
65,33,2,3,4,-1,-25.0
65,33,3,10,8,2,25.0
65,33,4,6,16,-10,-62.5
65,33,5,18,32,-14,-43.75
65,33,6,75,64,11,17.1875
65,33,7,85,128,-43,-33.59375
65,33,8,701,256,445,173.828125
65,33,9,137,512,-375,-73.2421875
65,33,10,385,1024,-639,-62.40234375
65,33,11,2659,2048,611,29.833984375
65,33,12,1342,4096,-2754,-67.236328125
65,33,13,2111,8192,-6081,-74.23095703125
65,33,14,525,16384,-15859,-96.795654296875
65,33,15,31309,32768,-1459,-4.4525146484375
65,34,1,0,2,-2,-100.0
65,34,2,2,4,-2,-50.0
65,34,3,2,8,-6,-75.0
65,34,4,8,16,-8,-50.0
65,34,5,137,32,105,328.125
65,34,6,9,64,-55,-85.9375
65,34,7,46,128,-82,-64.0625
65,34,8,77,256,-179,-69.921875
65,34,9,357,512,-155,-30.2734375
65,34,10,1439,1024,415,40.52734375
65,34,11,1710,2048,-338,-16.50390625
65,34,12,2610,4096,-1486,-36.279296875
65,34,13,1543,8192,-6649,-81.16455078125
65,34,14,87142,16384,70758,431.87255859375
65,34,15,12552,32768,-20216,-61.6943359375
65,35,1,0,2,-2,-100.0
65,35,2,1,4,-3,-75.0
65,35,3,4,8,-4,-50.0
65,35,4,18,16,2,12.5
65,35,5,17,32,-15,-46.875
65,35,6,327,64,263,410.9375
65,35,7,9,128,-119,-92.96875
65,35,8,782,256,526,205.46875
65,35,9,519,512,7,1.3671875
65,35,10,50,1024,-974,-95.1171875
65,35,11,1249,2048,-799,-39.013671875
65,35,12,1122,4096,-2974,-72.607421875
65,35,13,11966,8192,3774,46.0693359375
65,35,14,5549,16384,-10835,-66.131591796875
65,35,15,963,32768,-31805,-97.0611572265625
65,36,1,0,2,-2,-100.0
65,36,2,1,4,-3,-75.0
65,36,3,2,8,-6,-75.0
65,36,4,22,16,6,37.5
65,36,5,56,32,24,75.0
65,36,6,6,64,-58,-90.625
65,36,7,168,128,40,31.25
65,36,8,203,256,-53,-20.703125
65,36,9,243,512,-269,-52.5390625
65,36,10,637,1024,-387,-37.79296875
65,36,11,2642,2048,594,29.00390625
65,36,12,514,4096,-3582,-87.451171875
65,36,13,18399,8192,10207,124.59716796875
65,36,14,12375,16384,-4009,-24.468994140625
65,36,15,98779,32768,66011,201.4495849609375
65,37,1,0,2,-2,-100.0
65,37,2,1,4,-3,-75.0
65,37,3,2,8,-6,-75.0
65,37,4,13,16,-3,-18.75
65,37,5,65,32,33,103.125
65,37,6,72,64,8,12.5
65,37,7,37,128,-91,-71.09375
65,37,8,97,256,-159,-62.109375
65,37,9,404,512,-108,-21.09375
65,37,10,3326,1024,2302,224.8046875
65,37,11,3660,2048,1612,78.7109375
65,37,12,971,4096,-3125,-76.2939453125
65,37,13,8762,8192,570,6.9580078125
65,37,14,20313,16384,3929,23.980712890625
65,37,15,22844,32768,-9924,-30.28564453125
65,38,1,0,2,-2,-100.0
65,38,2,2,4,-2,-50.0
65,38,3,4,8,-4,-50.0
65,38,4,4,16,-12,-75.0
65,38,5,27,32,-5,-15.625
65,38,6,37,64,-27,-42.1875
65,38,7,98,128,-30,-23.4375
65,38,8,94,256,-162,-63.28125
65,38,9,711,512,199,38.8671875
65,38,10,988,1024,-36,-3.515625
65,38,11,1572,2048,-476,-23.2421875
65,38,12,171,4096,-3925,-95.8251953125
65,38,13,1135,8192,-7057,-86.14501953125
65,38,14,25278,16384,8894,54.28466796875
65,38,15,17686,32768,-15082,-46.026611328125
65,39,1,0,2,-2,-100.0
65,39,2,1,4,-3,-75.0
65,39,3,19,8,11,137.5
65,39,4,15,16,-1,-6.25
65,39,5,17,32,-15,-46.875
65,39,6,5,64,-59,-92.1875
65,39,7,92,128,-36,-28.125
65,39,8,49,256,-207,-80.859375
65,39,9,142,512,-370,-72.265625
65,39,10,953,1024,-71,-6.93359375
65,39,11,2712,2048,664,32.421875
65,39,12,4512,4096,416,10.15625
65,39,13,24121,8192,15929,194.44580078125
65,39,14,31703,16384,15319,93.499755859375
65,39,15,858,32768,-31910,-97.381591796875
65,40,1,0,2,-2,-100.0
65,40,2,2,4,-2,-50.0
65,40,3,12,8,4,50.0
65,40,4,12,16,-4,-25.0
65,40,5,48,32,16,50.0
65,40,6,76,64,12,18.75
65,40,7,131,128,3,2.34375
65,40,8,306,256,50,19.53125
65,40,9,2996,512,2484,485.15625
65,40,10,1723,1024,699,68.26171875
65,40,11,2171,2048,123,6.005859375
65,40,12,5791,4096,1695,41.3818359375
65,40,13,4900,8192,-3292,-40.185546875
65,40,14,21837,16384,5453,33.282470703125
65,40,15,104841,32768,72073,219.9493408203125
65,41,1,0,2,-2,-100.0
65,41,2,1,4,-3,-75.0
65,41,3,4,8,-4,-50.0
65,41,4,10,16,-6,-37.5
65,41,5,14,32,-18,-56.25
65,41,6,31,64,-33,-51.5625
65,41,7,363,128,235,183.59375
65,41,8,231,256,-25,-9.765625
65,41,9,159,512,-353,-68.9453125
65,41,10,248,1024,-776,-75.78125
65,41,11,200,2048,-1848,-90.234375
65,41,12,3110,4096,-986,-24.072265625
65,41,13,9184,8192,992,12.109375
65,41,14,14611,16384,-1773,-10.821533203125
65,41,15,4636,32768,-28132,-85.85205078125
65,42,1,0,2,-2,-100.0
65,42,2,5,4,1,25.0
65,42,3,9,8,1,12.5
65,42,4,3,16,-13,-81.25
65,42,5,82,32,50,156.25
65,42,6,16,64,-48,-75.0
65,42,7,380,128,252,196.875
65,42,8,27,256,-229,-89.453125
65,42,9,18,512,-494,-96.484375
65,42,10,567,1024,-457,-44.62890625
65,42,11,574,2048,-1474,-71.97265625
65,42,12,1079,4096,-3017,-73.6572265625
65,42,13,4489,8192,-3703,-45.20263671875
65,42,14,1983,16384,-14401,-87.896728515625
65,42,15,20100,32768,-12668,-38.65966796875
65,43,1,0,2,-2,-100.0
65,43,2,4,4,0,0.0
65,43,3,2,8,-6,-75.0
65,43,4,32,16,16,100.0
65,43,5,5,32,-27,-84.375
65,43,6,8,64,-56,-87.5
65,43,7,116,128,-12,-9.375
65,43,8,225,256,-31,-12.109375
65,43,9,895,512,383,74.8046875
65,43,10,176,1024,-848,-82.8125
65,43,11,532,2048,-1516,-74.0234375
65,43,12,1940,4096,-2156,-52.63671875
65,43,13,2399,8192,-5793,-70.71533203125
65,43,14,8146,16384,-8238,-50.28076171875
65,43,15,6115,32768,-26653,-81.3385009765625
65,44,1,0,2,-2,-100.0
65,44,2,9,4,5,125.0
65,44,3,14,8,6,75.0
65,44,4,3,16,-13,-81.25
65,44,5,15,32,-17,-53.125
65,44,6,31,64,-33,-51.5625
65,44,7,48,128,-80,-62.5
65,44,8,27,256,-229,-89.453125
65,44,9,595,512,83,16.2109375
65,44,10,364,1024,-660,-64.453125
65,44,11,1641,2048,-407,-19.873046875
65,44,12,1911,4096,-2185,-53.3447265625
65,44,13,25,8192,-8167,-99.69482421875
65,44,14,8552,16384,-7832,-47.802734375
65,44,15,55897,32768,23129,70.5841064453125
65,45,1,0,2,-2,-100.0
65,45,2,1,4,-3,-75.0
65,45,3,7,8,-1,-12.5
65,45,4,8,16,-8,-50.0
65,45,5,24,32,-8,-25.0
65,45,6,18,64,-46,-71.875
65,45,7,33,128,-95,-74.21875
65,45,8,124,256,-132,-51.5625
65,45,9,794,512,282,55.078125
65,45,10,17,1024,-1007,-98.33984375
65,45,11,2431,2048,383,18.701171875
65,45,12,639,4096,-3457,-84.3994140625
65,45,13,12751,8192,4559,55.65185546875
65,45,14,9442,16384,-6942,-42.37060546875
65,45,15,49873,32768,17105,52.2003173828125
65,46,1,0,2,-2,-100.0
65,46,2,3,4,-1,-25.0
65,46,3,12,8,4,50.0
65,46,4,15,16,-1,-6.25
65,46,5,23,32,-9,-28.125
65,46,6,9,64,-55,-85.9375
65,46,7,52,128,-76,-59.375
65,46,8,149,256,-107,-41.796875
65,46,9,369,512,-143,-27.9296875
65,46,10,949,1024,-75,-7.32421875
65,46,11,637,2048,-1411,-68.896484375
65,46,12,3212,4096,-884,-21.58203125
65,46,13,18245,8192,10053,122.71728515625
65,46,14,11897,16384,-4487,-27.386474609375
65,46,15,2294,32768,-30474,-92.999267578125
65,47,1,0,2,-2,-100.0
65,47,2,1,4,-3,-75.0
65,47,3,4,8,-4,-50.0
65,47,4,62,16,46,287.5
65,47,5,60,32,28,87.5
65,47,6,113,64,49,76.5625
65,47,7,32,128,-96,-75.0
65,47,8,76,256,-180,-70.3125
65,47,9,90,512,-422,-82.421875
65,47,10,2512,1024,1488,145.3125
65,47,11,1926,2048,-122,-5.95703125
65,47,12,2757,4096,-1339,-32.6904296875
65,47,13,160,8192,-8032,-98.046875
65,47,14,6892,16384,-9492,-57.9345703125
65,47,15,11609,32768,-21159,-64.5721435546875
65,48,1,0,2,-2,-100.0
65,48,2,1,4,-3,-75.0
65,48,3,4,8,-4,-50.0
65,48,4,13,16,-3,-18.75
65,48,5,55,32,23,71.875
65,48,6,14,64,-50,-78.125
65,48,7,16,128,-112,-87.5
65,48,8,129,256,-127,-49.609375
65,48,9,1226,512,714,139.453125
65,48,10,122,1024,-902,-88.0859375
65,48,11,4887,2048,2839,138.623046875
65,48,12,3774,4096,-322,-7.861328125
65,48,13,13360,8192,5168,63.0859375
65,48,14,6722,16384,-9662,-58.97216796875
65,48,15,5463,32768,-27305,-83.3282470703125
65,49,1,0,2,-2,-100.0
65,49,2,4,4,0,0.0
65,49,3,4,8,-4,-50.0
65,49,4,3,16,-13,-81.25
65,49,5,4,32,-28,-87.5
65,49,6,31,64,-33,-51.5625
65,49,7,84,128,-44,-34.375
65,49,8,60,256,-196,-76.5625
65,49,9,863,512,351,68.5546875
65,49,10,1378,1024,354,34.5703125
65,49,11,161,2048,-1887,-92.138671875
65,49,12,2709,4096,-1387,-33.8623046875
65,49,13,7957,8192,-235,-2.86865234375
65,49,14,59922,16384,43538,265.73486328125
65,49,15,4957,32768,-27811,-84.8724365234375
65,50,1,0,2,-2,-100.0
65,50,2,4,4,0,0.0
65,50,3,5,8,-3,-37.5
65,50,4,8,16,-8,-50.0
65,50,5,8,32,-24,-75.0
65,50,6,9,64,-55,-85.9375
65,50,7,132,128,4,3.125
65,50,8,211,256,-45,-17.578125
65,50,9,147,512,-365,-71.2890625
65,50,10,1292,1024,268,26.171875
65,50,11,3955,2048,1907,93.115234375
65,50,12,6322,4096,2226,54.345703125
65,50,13,8378,8192,186,2.2705078125
65,50,14,977,16384,-15407,-94.036865234375
65,50,15,20237,32768,-12531,-38.2415771484375
65,51,1,0,2,-2,-100.0
65,51,2,4,4,0,0.0
65,51,3,2,8,-6,-75.0
65,51,4,21,16,5,31.25
65,51,5,10,32,-22,-68.75
65,51,6,78,64,14,21.875
65,51,7,143,128,15,11.71875
65,51,8,546,256,290,113.28125
65,51,9,340,512,-172,-33.59375
65,51,10,779,1024,-245,-23.92578125
65,51,11,1618,2048,-430,-20.99609375
65,51,12,4218,4096,122,2.978515625
65,51,13,19200,8192,11008,134.375
65,51,14,5224,16384,-11160,-68.115234375
65,51,15,11777,32768,-20991,-64.0594482421875
65,52,1,0,2,-2,-100.0
65,52,2,1,4,-3,-75.0
65,52,3,4,8,-4,-50.0
65,52,4,8,16,-8,-50.0
65,52,5,23,32,-9,-28.125
65,52,6,26,64,-38,-59.375
65,52,7,63,128,-65,-50.78125
65,52,8,131,256,-125,-48.828125
65,52,9,181,512,-331,-64.6484375
65,52,10,173,1024,-851,-83.10546875
65,52,11,1403,2048,-645,-31.494140625
65,52,12,6521,4096,2425,59.2041015625
65,52,13,6979,8192,-1213,-14.80712890625
65,52,14,40686,16384,24302,148.32763671875
65,52,15,6098,32768,-26670,-81.390380859375
65,53,1,0,2,-2,-100.0
65,53,2,2,4,-2,-50.0
65,53,3,2,8,-6,-75.0
65,53,4,19,16,3,18.75
65,53,5,16,32,-16,-50.0
65,53,6,83,64,19,29.6875
65,53,7,137,128,9,7.03125
65,53,8,641,256,385,150.390625
65,53,9,454,512,-58,-11.328125
65,53,10,149,1024,-875,-85.44921875
65,53,11,2068,2048,20,0.9765625
65,53,12,3047,4096,-1049,-25.6103515625
65,53,13,1108,8192,-7084,-86.474609375
65,53,14,36551,16384,20167,123.089599609375
65,53,15,42360,32768,9592,29.2724609375
65,54,1,0,2,-2,-100.0
65,54,2,1,4,-3,-75.0
65,54,3,2,8,-6,-75.0
65,54,4,3,16,-13,-81.25
65,54,5,112,32,80,250.0
65,54,6,5,64,-59,-92.1875
65,54,7,8,128,-120,-93.75
65,54,8,255,256,-1,-0.390625
65,54,9,392,512,-120,-23.4375
65,54,10,1396,1024,372,36.328125
65,54,11,399,2048,-1649,-80.517578125
65,54,12,1964,4096,-2132,-52.05078125
65,54,13,23963,8192,15771,192.51708984375
65,54,14,24826,16384,8442,51.52587890625
65,54,15,1315,32768,-31453,-95.9869384765625
65,55,1,0,2,-2,-100.0
65,55,2,1,4,-3,-75.0
65,55,3,5,8,-3,-37.5
65,55,4,6,16,-10,-62.5
65,55,5,12,32,-20,-62.5
65,55,6,48,64,-16,-25.0
65,55,7,368,128,240,187.5
65,55,8,112,256,-144,-56.25
65,55,9,854,512,342,66.796875
65,55,10,209,1024,-815,-79.58984375
65,55,11,147,2048,-1901,-92.822265625
65,55,12,8272,4096,4176,101.953125
65,55,13,2039,8192,-6153,-75.10986328125
65,55,14,6786,16384,-9598,-58.58154296875
65,55,15,48762,32768,15994,48.809814453125
65,56,1,0,2,-2,-100.0
65,56,2,1,4,-3,-75.0
65,56,3,2,8,-6,-75.0
65,56,4,5,16,-11,-68.75
65,56,5,20,32,-12,-37.5
65,56,6,86,64,22,34.375
65,56,7,14,128,-114,-89.0625
65,56,8,241,256,-15,-5.859375
65,56,9,178,512,-334,-65.234375
65,56,10,3599,1024,2575,251.46484375
65,56,11,445,2048,-1603,-78.271484375
65,56,12,2631,4096,-1465,-35.7666015625
65,56,13,1894,8192,-6298,-76.8798828125
65,56,14,31195,16384,14811,90.399169921875
65,56,15,46385,32768,13617,41.5557861328125
65,57,1,0,2,-2,-100.0
65,57,2,1,4,-3,-75.0
65,57,3,10,8,2,25.0
65,57,4,8,16,-8,-50.0
65,57,5,33,32,1,3.125
65,57,6,7,64,-57,-89.0625
65,57,7,34,128,-94,-73.4375
65,57,8,613,256,357,139.453125
65,57,9,386,512,-126,-24.609375
65,57,10,337,1024,-687,-67.08984375
65,57,11,129,2048,-1919,-93.701171875
65,57,12,4497,4096,401,9.7900390625
65,57,13,1701,8192,-6491,-79.23583984375
65,57,14,23246,16384,6862,41.88232421875
65,57,15,6512,32768,-26256,-80.126953125
65,58,1,0,2,-2,-100.0
65,58,2,1,4,-3,-75.0
65,58,3,3,8,-5,-62.5
65,58,4,29,16,13,81.25
65,58,5,18,32,-14,-43.75
65,58,6,5,64,-59,-92.1875
65,58,7,85,128,-43,-33.59375
65,58,8,369,256,113,44.140625
65,58,9,1324,512,812,158.59375
65,58,10,1858,1024,834,81.4453125
65,58,11,369,2048,-1679,-81.982421875
65,58,12,2107,4096,-1989,-48.5595703125
65,58,13,493,8192,-7699,-93.98193359375
65,58,14,16153,16384,-231,-1.409912109375
65,58,15,5493,32768,-27275,-83.2366943359375
65,59,1,0,2,-2,-100.0
65,59,2,2,4,-2,-50.0
65,59,3,6,8,-2,-25.0
65,59,4,25,16,9,56.25
65,59,5,26,32,-6,-18.75
65,59,6,48,64,-16,-25.0
65,59,7,60,128,-68,-53.125
65,59,8,27,256,-229,-89.453125
65,59,9,76,512,-436,-85.15625
65,59,10,519,1024,-505,-49.31640625
65,59,11,2586,2048,538,26.26953125
65,59,12,5863,4096,1767,43.1396484375
65,59,13,11188,8192,2996,36.572265625
65,59,14,18394,16384,2010,12.26806640625
65,59,15,4944,32768,-27824,-84.912109375
65,60,1,0,2,-2,-100.0
65,60,2,3,4,-1,-25.0
65,60,3,4,8,-4,-50.0
65,60,4,4,16,-12,-75.0
65,60,5,71,32,39,121.875
65,60,6,168,64,104,162.5
65,60,7,39,128,-89,-69.53125
65,60,8,14,256,-242,-94.53125
65,60,9,868,512,356,69.53125
65,60,10,976,1024,-48,-4.6875
65,60,11,1011,2048,-1037,-50.634765625
65,60,12,3732,4096,-364,-8.88671875
65,60,13,386,8192,-7806,-95.2880859375
65,60,14,15555,16384,-829,-5.059814453125
65,60,15,15754,32768,-17014,-51.922607421875
65,61,1,0,2,-2,-100.0
65,61,2,1,4,-3,-75.0
65,61,3,6,8,-2,-25.0
65,61,4,4,16,-12,-75.0
65,61,5,10,32,-22,-68.75
65,61,6,149,64,85,132.8125
65,61,7,136,128,8,6.25
65,61,8,244,256,-12,-4.6875
65,61,9,63,512,-449,-87.6953125
65,61,10,3445,1024,2421,236.42578125
65,61,11,1757,2048,-291,-14.208984375
65,61,12,7201,4096,3105,75.8056640625
65,61,13,12267,8192,4075,49.74365234375
65,61,14,5140,16384,-11244,-68.6279296875
65,61,15,7007,32768,-25761,-78.6163330078125
65,62,1,0,2,-2,-100.0
65,62,2,3,4,-1,-25.0
65,62,3,4,8,-4,-50.0
65,62,4,21,16,5,31.25
65,62,5,10,32,-22,-68.75
65,62,6,27,64,-37,-57.8125
65,62,7,139,128,11,8.59375
65,62,8,7,256,-249,-97.265625
65,62,9,1597,512,1085,211.9140625
65,62,10,812,1024,-212,-20.703125
65,62,11,4670,2048,2622,128.02734375
65,62,12,1718,4096,-2378,-58.056640625
65,62,13,7337,8192,-855,-10.43701171875
65,62,14,14764,16384,-1620,-9.8876953125
65,62,15,60615,32768,27847,84.9822998046875
65,63,1,0,2,-2,-100.0
65,63,2,2,4,-2,-50.0
65,63,3,2,8,-6,-75.0
65,63,4,22,16,6,37.5
65,63,5,18,32,-14,-43.75
65,63,6,71,64,7,10.9375
65,63,7,177,128,49,38.28125
65,63,8,68,256,-188,-73.4375
65,63,9,769,512,257,50.1953125
65,63,10,1883,1024,859,83.88671875
65,63,11,200,2048,-1848,-90.234375
65,63,12,2682,4096,-1414,-34.521484375
65,63,13,10590,8192,2398,29.2724609375
65,63,14,6013,16384,-10371,-63.299560546875
65,63,15,84,32768,-32684,-99.74365234375
65,64,1,0,2,-2,-100.0
65,64,2,2,4,-2,-50.0
65,64,3,10,8,2,25.0
65,64,4,27,16,11,68.75
65,64,5,4,32,-28,-87.5
65,64,6,6,64,-58,-90.625
65,64,7,294,128,166,129.6875
65,64,8,74,256,-182,-71.09375
65,64,9,822,512,310,60.546875
65,64,10,1738,1024,714,69.7265625
65,64,11,178,2048,-1870,-91.30859375
65,64,12,123,4096,-3973,-96.9970703125
65,64,13,14035,8192,5843,71.32568359375
65,64,14,4451,16384,-11933,-72.833251953125
65,64,15,27197,32768,-5571,-17.0013427734375
65,65,1,0,2,-2,-100.0
65,65,2,2,4,-2,-50.0
65,65,3,2,8,-6,-75.0
65,65,4,5,16,-11,-68.75
65,65,5,4,32,-28,-87.5
65,65,6,238,64,174,271.875
65,65,7,79,128,-49,-38.28125
65,65,8,446,256,190,74.21875
65,65,9,22,512,-490,-95.703125
65,65,10,1639,1024,615,60.05859375
65,65,11,4030,2048,1982,96.77734375
65,65,12,1302,4096,-2794,-68.212890625
65,65,13,10510,8192,2318,28.2958984375
65,65,14,20081,16384,3697,22.564697265625
65,65,15,12225,32768,-20543,-62.6922607421875
66,1,1,0,2,-2,-100.0
66,1,2,3,4,-1,-25.0
66,1,3,3,8,-5,-62.5
66,1,4,22,16,6,37.5
66,1,5,20,32,-12,-37.5
66,1,6,26,64,-38,-59.375
66,1,7,247,128,119,92.96875
66,1,8,37,256,-219,-85.546875
66,1,9,60,512,-452,-88.28125
66,1,10,1123,1024,99,9.66796875
66,1,11,4440,2048,2392,116.796875
66,1,12,587,4096,-3509,-85.6689453125
66,1,13,7164,8192,-1028,-12.548828125
66,1,14,15675,16384,-709,-4.327392578125
66,1,15,4369,32768,-28399,-86.6668701171875
66,2,1,0,2,-2,-100.0
66,2,2,3,4,-1,-25.0
66,2,3,4,8,-4,-50.0
66,2,4,18,16,2,12.5
66,2,5,10,32,-22,-68.75
66,2,6,50,64,-14,-21.875
66,2,7,92,128,-36,-28.125
66,2,8,83,256,-173,-67.578125
66,2,9,1181,512,669,130.6640625
66,2,10,244,1024,-780,-76.171875
66,2,11,219,2048,-1829,-89.306640625
66,2,12,3979,4096,-117,-2.8564453125
66,2,13,3716,8192,-4476,-54.638671875
66,2,14,3278,16384,-13106,-79.99267578125
66,2,15,13475,32768,-19293,-58.8775634765625
66,3,1,0,2,-2,-100.0
66,3,2,5,4,1,25.0
66,3,3,2,8,-6,-75.0
66,3,4,38,16,22,137.5
66,3,5,11,32,-21,-65.625
66,3,6,5,64,-59,-92.1875
66,3,7,127,128,-1,-0.78125
66,3,8,286,256,30,11.71875
66,3,9,306,512,-206,-40.234375
66,3,10,1100,1024,76,7.421875
66,3,11,30,2048,-2018,-98.53515625
66,3,12,2826,4096,-1270,-31.005859375
66,3,13,739,8192,-7453,-90.97900390625
66,3,14,40621,16384,24237,147.930908203125
66,3,15,27970,32768,-4798,-14.642333984375
66,4,1,0,2,-2,-100.0
66,4,2,2,4,-2,-50.0
66,4,3,4,8,-4,-50.0
66,4,4,6,16,-10,-62.5
66,4,5,4,32,-28,-87.5
66,4,6,117,64,53,82.8125
66,4,7,53,128,-75,-58.59375
66,4,8,686,256,430,167.96875
66,4,9,279,512,-233,-45.5078125
66,4,10,2347,1024,1323,129.19921875
66,4,11,2099,2048,51,2.490234375
66,4,12,8571,4096,4475,109.2529296875
66,4,13,17353,8192,9161,111.82861328125
66,4,14,326,16384,-16058,-98.01025390625
66,4,15,16782,32768,-15986,-48.785400390625
66,5,1,0,2,-2,-100.0
66,5,2,1,4,-3,-75.0
66,5,3,3,8,-5,-62.5
66,5,4,25,16,9,56.25
66,5,5,26,32,-6,-18.75
66,5,6,36,64,-28,-43.75
66,5,7,26,128,-102,-79.6875
66,5,8,285,256,29,11.328125
66,5,9,62,512,-450,-87.890625
66,5,10,2518,1024,1494,145.8984375
66,5,11,3709,2048,1661,81.103515625
66,5,12,6613,4096,2517,61.4501953125
66,5,13,7229,8192,-963,-11.75537109375
66,5,14,28152,16384,11768,71.826171875
66,5,15,21936,32768,-10832,-33.056640625
66,6,1,0,2,-2,-100.0
66,6,2,2,4,-2,-50.0
66,6,3,2,8,-6,-75.0
66,6,4,10,16,-6,-37.5
66,6,5,83,32,51,159.375
66,6,6,145,64,81,126.5625
66,6,7,58,128,-70,-54.6875
66,6,8,1327,256,1071,418.359375
66,6,9,401,512,-111,-21.6796875
66,6,10,2042,1024,1018,99.4140625
66,6,11,411,2048,-1637,-79.931640625
66,6,12,617,4096,-3479,-84.9365234375
66,6,13,35594,8192,27402,334.4970703125
66,6,14,6087,16384,-10297,-62.847900390625
66,6,15,6293,32768,-26475,-80.7952880859375
66,7,1,0,2,-2,-100.0
66,7,2,2,4,-2,-50.0
66,7,3,12,8,4,50.0
66,7,4,3,16,-13,-81.25
66,7,5,54,32,22,68.75
66,7,6,90,64,26,40.625
66,7,7,10,128,-118,-92.1875
66,7,8,149,256,-107,-41.796875
66,7,9,25,512,-487,-95.1171875
66,7,10,316,1024,-708,-69.140625
66,7,11,470,2048,-1578,-77.05078125
66,7,12,1049,4096,-3047,-74.3896484375
66,7,13,1368,8192,-6824,-83.30078125
66,7,14,10571,16384,-5813,-35.479736328125
66,7,15,10050,32768,-22718,-69.329833984375
66,8,1,0,2,-2,-100.0
66,8,2,1,4,-3,-75.0
66,8,3,6,8,-2,-25.0
66,8,4,4,16,-12,-75.0
66,8,5,73,32,41,128.125
66,8,6,40,64,-24,-37.5
66,8,7,14,128,-114,-89.0625
66,8,8,137,256,-119,-46.484375
66,8,9,23,512,-489,-95.5078125
66,8,10,1343,1024,319,31.15234375
66,8,11,3948,2048,1900,92.7734375
66,8,12,3655,4096,-441,-10.7666015625
66,8,13,6553,8192,-1639,-20.00732421875
66,8,14,28577,16384,12193,74.420166015625
66,8,15,7491,32768,-25277,-77.1392822265625
66,9,1,0,2,-2,-100.0
66,9,2,1,4,-3,-75.0
66,9,3,17,8,9,112.5
66,9,4,9,16,-7,-43.75
66,9,5,40,32,8,25.0
66,9,6,21,64,-43,-67.1875
66,9,7,290,128,162,126.5625
66,9,8,851,256,595,232.421875
66,9,9,1384,512,872,170.3125
66,9,10,517,1024,-507,-49.51171875
66,9,11,449,2048,-1599,-78.076171875
66,9,12,664,4096,-3432,-83.7890625
66,9,13,2755,8192,-5437,-66.36962890625
66,9,14,11222,16384,-5162,-31.50634765625
66,9,15,139591,32768,106823,325.9979248046875
66,10,1,0,2,-2,-100.0
66,10,2,2,4,-2,-50.0
66,10,3,2,8,-6,-75.0
66,10,4,7,16,-9,-56.25
66,10,5,15,32,-17,-53.125
66,10,6,8,64,-56,-87.5
66,10,7,110,128,-18,-14.0625
66,10,8,805,256,549,214.453125
66,10,9,730,512,218,42.578125
66,10,10,987,1024,-37,-3.61328125
66,10,11,5742,2048,3694,180.37109375
66,10,12,6467,4096,2371,57.8857421875
66,10,13,21510,8192,13318,162.5732421875
66,10,14,50253,16384,33869,206.719970703125
66,10,15,13437,32768,-19331,-58.9935302734375
66,11,1,0,2,-2,-100.0
66,11,2,1,4,-3,-75.0
66,11,3,2,8,-6,-75.0
66,11,4,5,16,-11,-68.75
66,11,5,26,32,-6,-18.75
66,11,6,67,64,3,4.6875
66,11,7,207,128,79,61.71875
66,11,8,24,256,-232,-90.625
66,11,9,128,512,-384,-75.0
66,11,10,643,1024,-381,-37.20703125
66,11,11,425,2048,-1623,-79.248046875
66,11,12,9971,4096,5875,143.4326171875
66,11,13,1823,8192,-6369,-77.74658203125
66,11,14,5686,16384,-10698,-65.29541015625
66,11,15,57497,32768,24729,75.4669189453125
66,12,1,0,2,-2,-100.0
66,12,2,2,4,-2,-50.0
66,12,3,3,8,-5,-62.5
66,12,4,4,16,-12,-75.0
66,12,5,6,32,-26,-81.25
66,12,6,43,64,-21,-32.8125
66,12,7,47,128,-81,-63.28125
66,12,8,134,256,-122,-47.65625
66,12,9,148,512,-364,-71.09375
66,12,10,306,1024,-718,-70.1171875
66,12,11,256,2048,-1792,-87.5
66,12,12,508,4096,-3588,-87.59765625
66,12,13,12665,8192,4473,54.60205078125
66,12,14,3122,16384,-13262,-80.94482421875
66,12,15,27476,32768,-5292,-16.14990234375
66,13,1,0,2,-2,-100.0
66,13,2,1,4,-3,-75.0
66,13,3,2,8,-6,-75.0
66,13,4,12,16,-4,-25.0
66,13,5,4,32,-28,-87.5
66,13,6,96,64,32,50.0
66,13,7,79,128,-49,-38.28125
66,13,8,168,256,-88,-34.375
66,13,9,76,512,-436,-85.15625
66,13,10,968,1024,-56,-5.46875
66,13,11,45,2048,-2003,-97.802734375
66,13,12,952,4096,-3144,-76.7578125
66,13,13,7728,8192,-464,-5.6640625
66,13,14,15244,16384,-1140,-6.9580078125
66,13,15,82567,32768,49799,151.9744873046875
66,14,1,0,2,-2,-100.0
66,14,2,3,4,-1,-25.0
66,14,3,4,8,-4,-50.0
66,14,4,17,16,1,6.25
66,14,5,40,32,8,25.0
66,14,6,34,64,-30,-46.875
66,14,7,96,128,-32,-25.0
66,14,8,159,256,-97,-37.890625
66,14,9,319,512,-193,-37.6953125
66,14,10,2566,1024,1542,150.5859375
66,14,11,795,2048,-1253,-61.181640625
66,14,12,190,4096,-3906,-95.361328125
66,14,13,1916,8192,-6276,-76.611328125
66,14,14,18667,16384,2283,13.934326171875
66,14,15,21623,32768,-11145,-34.0118408203125
66,15,1,0,2,-2,-100.0
66,15,2,1,4,-3,-75.0
66,15,3,9,8,1,12.5
66,15,4,6,16,-10,-62.5
66,15,5,32,32,0,0.0
66,15,6,51,64,-13,-20.3125
66,15,7,72,128,-56,-43.75
66,15,8,63,256,-193,-75.390625
66,15,9,829,512,317,61.9140625
66,15,10,1532,1024,508,49.609375
66,15,11,5974,2048,3926,191.69921875
66,15,12,6316,4096,2220,54.19921875
66,15,13,3749,8192,-4443,-54.23583984375
66,15,14,14405,16384,-1979,-12.078857421875
66,15,15,25541,32768,-7227,-22.0550537109375
66,16,1,0,2,-2,-100.0
66,16,2,1,4,-3,-75.0
66,16,3,4,8,-4,-50.0
66,16,4,11,16,-5,-31.25
66,16,5,15,32,-17,-53.125
66,16,6,80,64,16,25.0
66,16,7,304,128,176,137.5
66,16,8,198,256,-58,-22.65625
66,16,9,1870,512,1358,265.234375
66,16,10,112,1024,-912,-89.0625
66,16,11,499,2048,-1549,-75.634765625
66,16,12,2322,4096,-1774,-43.310546875
66,16,13,510,8192,-7682,-93.7744140625
66,16,14,31393,16384,15009,91.607666015625
66,16,15,29350,32768,-3418,-10.430908203125
66,17,1,0,2,-2,-100.0
66,17,2,1,4,-3,-75.0
66,17,3,3,8,-5,-62.5
66,17,4,6,16,-10,-62.5
66,17,5,11,32,-21,-65.625
66,17,6,31,64,-33,-51.5625
66,17,7,197,128,69,53.90625
66,17,8,529,256,273,106.640625
66,17,9,25,512,-487,-95.1171875
66,17,10,522,1024,-502,-49.0234375
66,17,11,3781,2048,1733,84.619140625
66,17,12,224,4096,-3872,-94.53125
66,17,13,12223,8192,4031,49.20654296875
66,17,14,5237,16384,-11147,-68.035888671875
66,17,15,7805,32768,-24963,-76.1810302734375
66,18,1,0,2,-2,-100.0
66,18,2,2,4,-2,-50.0
66,18,3,5,8,-3,-37.5
66,18,4,3,16,-13,-81.25
66,18,5,26,32,-6,-18.75
66,18,6,7,64,-57,-89.0625
66,18,7,81,128,-47,-36.71875
66,18,8,328,256,72,28.125
66,18,9,642,512,130,25.390625
66,18,10,2472,1024,1448,141.40625
66,18,11,5366,2048,3318,162.01171875
66,18,12,8207,4096,4111,100.3662109375
66,18,13,11062,8192,2870,35.0341796875
66,18,14,9745,16384,-6639,-40.521240234375
66,18,15,16720,32768,-16048,-48.974609375
66,19,1,0,2,-2,-100.0
66,19,2,3,4,-1,-25.0
66,19,3,8,8,0,0.0
66,19,4,12,16,-4,-25.0
66,19,5,37,32,5,15.625
66,19,6,153,64,89,139.0625
66,19,7,9,128,-119,-92.96875
66,19,8,186,256,-70,-27.34375
66,19,9,73,512,-439,-85.7421875
66,19,10,1748,1024,724,70.703125
66,19,11,2001,2048,-47,-2.294921875
66,19,12,2367,4096,-1729,-42.2119140625
66,19,13,6663,8192,-1529,-18.66455078125
66,19,14,486,16384,-15898,-97.03369140625
66,19,15,11573,32768,-21195,-64.6820068359375
66,20,1,0,2,-2,-100.0
66,20,2,1,4,-3,-75.0
66,20,3,28,8,20,250.0
66,20,4,3,16,-13,-81.25
66,20,5,12,32,-20,-62.5
66,20,6,40,64,-24,-37.5
66,20,7,65,128,-63,-49.21875
66,20,8,186,256,-70,-27.34375
66,20,9,670,512,158,30.859375
66,20,10,409,1024,-615,-60.05859375
66,20,11,182,2048,-1866,-91.11328125
66,20,12,523,4096,-3573,-87.2314453125
66,20,13,10843,8192,2651,32.36083984375
66,20,14,4862,16384,-11522,-70.32470703125
66,20,15,20887,32768,-11881,-36.2579345703125
66,21,1,0,2,-2,-100.0
66,21,2,1,4,-3,-75.0
66,21,3,3,8,-5,-62.5
66,21,4,20,16,4,25.0
66,21,5,33,32,1,3.125
66,21,6,16,64,-48,-75.0
66,21,7,264,128,136,106.25
66,21,8,209,256,-47,-18.359375
66,21,9,56,512,-456,-89.0625
66,21,10,67,1024,-957,-93.45703125
66,21,11,512,2048,-1536,-75.0
66,21,12,3412,4096,-684,-16.69921875
66,21,13,3419,8192,-4773,-58.26416015625
66,21,14,30997,16384,14613,89.190673828125
66,21,15,43991,32768,11223,34.2498779296875
66,22,1,0,2,-2,-100.0
66,22,2,1,4,-3,-75.0
66,22,3,5,8,-3,-37.5
66,22,4,19,16,3,18.75
66,22,5,28,32,-4,-12.5
66,22,6,151,64,87,135.9375
66,22,7,12,128,-116,-90.625
66,22,8,209,256,-47,-18.359375
66,22,9,29,512,-483,-94.3359375
66,22,10,313,1024,-711,-69.43359375
66,22,11,697,2048,-1351,-65.966796875
66,22,12,3023,4096,-1073,-26.1962890625
66,22,13,749,8192,-7443,-90.85693359375
66,22,14,3153,16384,-13231,-80.755615234375
66,22,15,9886,32768,-22882,-69.830322265625
66,23,1,0,2,-2,-100.0
66,23,2,2,4,-2,-50.0
66,23,3,4,8,-4,-50.0
66,23,4,22,16,6,37.5
66,23,5,19,32,-13,-40.625
66,23,6,16,64,-48,-75.0
66,23,7,89,128,-39,-30.46875
66,23,8,159,256,-97,-37.890625
66,23,9,1281,512,769,150.1953125
66,23,10,1536,1024,512,50.0
66,23,11,1146,2048,-902,-44.04296875
66,23,12,2416,4096,-1680,-41.015625
66,23,13,3273,8192,-4919,-60.04638671875
66,23,14,16367,16384,-17,-0.103759765625
66,23,15,25028,32768,-7740,-23.62060546875
66,24,1,0,2,-2,-100.0
66,24,2,2,4,-2,-50.0
66,24,3,3,8,-5,-62.5
66,24,4,6,16,-10,-62.5
66,24,5,42,32,10,31.25
66,24,6,79,64,15,23.4375
66,24,7,25,128,-103,-80.46875
66,24,8,206,256,-50,-19.53125
66,24,9,116,512,-396,-77.34375
66,24,10,186,1024,-838,-81.8359375
66,24,11,2230,2048,182,8.88671875
66,24,12,1472,4096,-2624,-64.0625
66,24,13,60678,8192,52486,640.6982421875
66,24,14,13408,16384,-2976,-18.1640625
66,24,15,48298,32768,15530,47.393798828125
66,25,1,0,2,-2,-100.0
66,25,2,3,4,-1,-25.0
66,25,3,11,8,3,37.5
66,25,4,3,16,-13,-81.25
66,25,5,16,32,-16,-50.0
66,25,6,102,64,38,59.375
66,25,7,465,128,337,263.28125
66,25,8,92,256,-164,-64.0625
66,25,9,1255,512,743,145.1171875
66,25,10,2400,1024,1376,134.375
66,25,11,2172,2048,124,6.0546875
66,25,12,631,4096,-3465,-84.5947265625
66,25,13,3128,8192,-5064,-61.81640625
66,25,14,62853,16384,46469,283.624267578125
66,25,15,25232,32768,-7536,-22.998046875
66,26,1,0,2,-2,-100.0
66,26,2,1,4,-3,-75.0
66,26,3,10,8,2,25.0
66,26,4,35,16,19,118.75
66,26,5,61,32,29,90.625
66,26,6,41,64,-23,-35.9375
66,26,7,110,128,-18,-14.0625
66,26,8,169,256,-87,-33.984375
66,26,9,574,512,62,12.109375
66,26,10,772,1024,-252,-24.609375
66,26,11,154,2048,-1894,-92.48046875
66,26,12,7007,4096,2911,71.0693359375
66,26,13,43207,8192,35015,427.42919921875
66,26,14,479,16384,-15905,-97.076416015625
66,26,15,27003,32768,-5765,-17.5933837890625
66,27,1,0,2,-2,-100.0
66,27,2,1,4,-3,-75.0
66,27,3,14,8,6,75.0
66,27,4,32,16,16,100.0
66,27,5,17,32,-15,-46.875
66,27,6,9,64,-55,-85.9375
66,27,7,33,128,-95,-74.21875
66,27,8,232,256,-24,-9.375
66,27,9,917,512,405,79.1015625
66,27,10,386,1024,-638,-62.3046875
66,27,11,3483,2048,1435,70.068359375
66,27,12,5932,4096,1836,44.82421875
66,27,13,8197,8192,5,0.06103515625
66,27,14,4417,16384,-11967,-73.040771484375
66,27,15,4522,32768,-28246,-86.199951171875
66,28,1,0,2,-2,-100.0
66,28,2,2,4,-2,-50.0
66,28,3,4,8,-4,-50.0
66,28,4,27,16,11,68.75
66,28,5,16,32,-16,-50.0
66,28,6,116,64,52,81.25
66,28,7,29,128,-99,-77.34375
66,28,8,668,256,412,160.9375
66,28,9,818,512,306,59.765625
66,28,10,3082,1024,2058,200.9765625
66,28,11,3565,2048,1517,74.072265625
66,28,12,8235,4096,4139,101.0498046875
66,28,13,2296,8192,-5896,-71.97265625
66,28,14,15984,16384,-400,-2.44140625
66,28,15,22934,32768,-9834,-30.010986328125
66,29,1,0,2,-2,-100.0
66,29,2,2,4,-2,-50.0
66,29,3,5,8,-3,-37.5
66,29,4,11,16,-5,-31.25
66,29,5,73,32,41,128.125
66,29,6,29,64,-35,-54.6875
66,29,7,113,128,-15,-11.71875
66,29,8,111,256,-145,-56.640625
66,29,9,307,512,-205,-40.0390625
66,29,10,146,1024,-878,-85.7421875
66,29,11,537,2048,-1511,-73.779296875
66,29,12,3118,4096,-978,-23.876953125
66,29,13,5629,8192,-2563,-31.28662109375
66,29,14,1976,16384,-14408,-87.939453125
66,29,15,225,32768,-32543,-99.3133544921875
66,30,1,0,2,-2,-100.0
66,30,2,3,4,-1,-25.0
66,30,3,2,8,-6,-75.0
66,30,4,13,16,-3,-18.75
66,30,5,101,32,69,215.625
66,30,6,54,64,-10,-15.625
66,30,7,32,128,-96,-75.0
66,30,8,181,256,-75,-29.296875
66,30,9,16,512,-496,-96.875
66,30,10,3171,1024,2147,209.66796875
66,30,11,331,2048,-1717,-83.837890625
66,30,12,5527,4096,1431,34.9365234375
66,30,13,7253,8192,-939,-11.46240234375
66,30,14,19249,16384,2865,17.486572265625
66,30,15,9967,32768,-22801,-69.5831298828125
66,31,1,0,2,-2,-100.0
66,31,2,4,4,0,0.0
66,31,3,2,8,-6,-75.0
66,31,4,9,16,-7,-43.75
66,31,5,31,32,-1,-3.125
66,31,6,14,64,-50,-78.125
66,31,7,16,128,-112,-87.5
66,31,8,202,256,-54,-21.09375
66,31,9,33,512,-479,-93.5546875
66,31,10,12,1024,-1012,-98.828125
66,31,11,2155,2048,107,5.224609375
66,31,12,5959,4096,1863,45.4833984375
66,31,13,2189,8192,-6003,-73.27880859375
66,31,14,2307,16384,-14077,-85.919189453125
66,31,15,9334,32768,-23434,-71.514892578125
66,32,1,0,2,-2,-100.0
66,32,2,2,4,-2,-50.0
66,32,3,9,8,1,12.5
66,32,4,12,16,-4,-25.0
66,32,5,12,32,-20,-62.5
66,32,6,32,64,-32,-50.0
66,32,7,211,128,83,64.84375
66,32,8,305,256,49,19.140625
66,32,9,498,512,-14,-2.734375
66,32,10,2846,1024,1822,177.9296875
66,32,11,353,2048,-1695,-82.763671875
66,32,12,503,4096,-3593,-87.7197265625
66,32,13,3868,8192,-4324,-52.783203125
66,32,14,30181,16384,13797,84.210205078125
66,32,15,4152,32768,-28616,-87.3291015625
66,33,1,0,2,-2,-100.0
66,33,2,1,4,-3,-75.0
66,33,3,9,8,1,12.5
66,33,4,11,16,-5,-31.25
66,33,5,50,32,18,56.25
66,33,6,57,64,-7,-10.9375
66,33,7,221,128,93,72.65625
66,33,8,134,256,-122,-47.65625
66,33,9,681,512,169,33.0078125
66,33,10,278,1024,-746,-72.8515625
66,33,11,2050,2048,2,0.09765625
66,33,12,6820,4096,2724,66.50390625
66,33,13,28301,8192,20109,245.47119140625
66,33,14,34927,16384,18543,113.177490234375
66,33,15,26088,32768,-6680,-20.3857421875
66,34,1,0,2,-2,-100.0
66,34,2,2,4,-2,-50.0
66,34,3,2,8,-6,-75.0
66,34,4,30,16,14,87.5
66,34,5,49,32,17,53.125
66,34,6,32,64,-32,-50.0
66,34,7,157,128,29,22.65625
66,34,8,19,256,-237,-92.578125
66,34,9,31,512,-481,-93.9453125
66,34,10,3571,1024,2547,248.73046875
66,34,11,840,2048,-1208,-58.984375
66,34,12,15135,4096,11039,269.5068359375
66,34,13,13646,8192,5454,66.5771484375
66,34,14,13481,16384,-2903,-17.718505859375
66,34,15,22621,32768,-10147,-30.9661865234375
66,35,1,0,2,-2,-100.0
66,35,2,3,4,-1,-25.0
66,35,3,2,8,-6,-75.0
66,35,4,45,16,29,181.25
66,35,5,40,32,8,25.0
66,35,6,57,64,-7,-10.9375
66,35,7,141,128,13,10.15625
66,35,8,30,256,-226,-88.28125
66,35,9,478,512,-34,-6.640625
66,35,10,240,1024,-784,-76.5625
66,35,11,1369,2048,-679,-33.154296875
66,35,12,2545,4096,-1551,-37.8662109375
66,35,13,2942,8192,-5250,-64.0869140625
66,35,14,68630,16384,52246,318.88427734375
66,35,15,37547,32768,4779,14.5843505859375
66,36,1,0,2,-2,-100.0
66,36,2,1,4,-3,-75.0
66,36,3,6,8,-2,-25.0
66,36,4,31,16,15,93.75
66,36,5,59,32,27,84.375
66,36,6,30,64,-34,-53.125
66,36,7,253,128,125,97.65625
66,36,8,176,256,-80,-31.25
66,36,9,544,512,32,6.25
66,36,10,5284,1024,4260,416.015625
66,36,11,1160,2048,-888,-43.359375
66,36,12,9669,4096,5573,136.0595703125
66,36,13,3258,8192,-4934,-60.2294921875
66,36,14,41933,16384,25549,155.938720703125
66,36,15,12308,32768,-20460,-62.43896484375
66,37,1,0,2,-2,-100.0
66,37,2,2,4,-2,-50.0
66,37,3,4,8,-4,-50.0
66,37,4,12,16,-4,-25.0
66,37,5,49,32,17,53.125
66,37,6,109,64,45,70.3125
66,37,7,105,128,-23,-17.96875
66,37,8,406,256,150,58.59375
66,37,9,764,512,252,49.21875
66,37,10,309,1024,-715,-69.82421875
66,37,11,1179,2048,-869,-42.431640625
66,37,12,1383,4096,-2713,-66.2353515625
66,37,13,33329,8192,25137,306.84814453125
66,37,14,10987,16384,-5397,-32.940673828125
66,37,15,71790,32768,39022,119.085693359375
66,38,1,0,2,-2,-100.0
66,38,2,1,4,-3,-75.0
66,38,3,4,8,-4,-50.0
66,38,4,16,16,0,0.0
66,38,5,14,32,-18,-56.25
66,38,6,11,64,-53,-82.8125
66,38,7,650,128,522,407.8125
66,38,8,219,256,-37,-14.453125
66,38,9,126,512,-386,-75.390625
66,38,10,1364,1024,340,33.203125
66,38,11,2495,2048,447,21.826171875
66,38,12,3483,4096,-613,-14.9658203125
66,38,13,2113,8192,-6079,-74.20654296875
66,38,14,54079,16384,37695,230.072021484375
66,38,15,20514,32768,-12254,-37.396240234375
66,39,1,0,2,-2,-100.0
66,39,2,1,4,-3,-75.0
66,39,3,5,8,-3,-37.5
66,39,4,4,16,-12,-75.0
66,39,5,30,32,-2,-6.25
66,39,6,48,64,-16,-25.0
66,39,7,57,128,-71,-55.46875
66,39,8,190,256,-66,-25.78125
66,39,9,164,512,-348,-67.96875
66,39,10,42,1024,-982,-95.8984375
66,39,11,1486,2048,-562,-27.44140625
66,39,12,4350,4096,254,6.201171875
66,39,13,755,8192,-7437,-90.78369140625
66,39,14,26120,16384,9736,59.423828125
66,39,15,1148,32768,-31620,-96.49658203125
66,40,1,0,2,-2,-100.0
66,40,2,1,4,-3,-75.0
66,40,3,2,8,-6,-75.0
66,40,4,20,16,4,25.0
66,40,5,44,32,12,37.5
66,40,6,58,64,-6,-9.375
66,40,7,13,128,-115,-89.84375
66,40,8,463,256,207,80.859375
66,40,9,170,512,-342,-66.796875
66,40,10,9,1024,-1015,-99.12109375
66,40,11,72,2048,-1976,-96.484375
66,40,12,16735,4096,12639,308.5693359375
66,40,13,10059,8192,1867,22.79052734375
66,40,14,438,16384,-15946,-97.32666015625
66,40,15,58488,32768,25720,78.4912109375
66,41,1,0,2,-2,-100.0
66,41,2,6,4,2,50.0
66,41,3,5,8,-3,-37.5
66,41,4,3,16,-13,-81.25
66,41,5,25,32,-7,-21.875
66,41,6,74,64,10,15.625
66,41,7,6,128,-122,-95.3125
66,41,8,58,256,-198,-77.34375
66,41,9,1002,512,490,95.703125
66,41,10,21,1024,-1003,-97.94921875
66,41,11,157,2048,-1891,-92.333984375
66,41,12,230,4096,-3866,-94.384765625
66,41,13,17501,8192,9309,113.63525390625
66,41,14,4530,16384,-11854,-72.35107421875
66,41,15,23833,32768,-8935,-27.2674560546875
66,42,1,0,2,-2,-100.0
66,42,2,3,4,-1,-25.0
66,42,3,5,8,-3,-37.5
66,42,4,25,16,9,56.25
66,42,5,7,32,-25,-78.125
66,42,6,132,64,68,106.25
66,42,7,79,128,-49,-38.28125
66,42,8,13,256,-243,-94.921875
66,42,9,108,512,-404,-78.90625
66,42,10,475,1024,-549,-53.61328125
66,42,11,1397,2048,-651,-31.787109375
66,42,12,1133,4096,-2963,-72.3388671875
66,42,13,12935,8192,4743,57.89794921875
66,42,14,5347,16384,-11037,-67.364501953125
66,42,15,57886,32768,25118,76.654052734375
66,43,1,0,2,-2,-100.0
66,43,2,1,4,-3,-75.0
66,43,3,2,8,-6,-75.0
66,43,4,15,16,-1,-6.25
66,43,5,4,32,-28,-87.5
66,43,6,75,64,11,17.1875
66,43,7,125,128,-3,-2.34375
66,43,8,130,256,-126,-49.21875
66,43,9,39,512,-473,-92.3828125
66,43,10,2303,1024,1279,124.90234375
66,43,11,825,2048,-1223,-59.716796875
66,43,12,15827,4096,11731,286.4013671875
66,43,13,2810,8192,-5382,-65.6982421875
66,43,14,20000,16384,3616,22.0703125
66,43,15,289,32768,-32479,-99.1180419921875
66,44,1,0,2,-2,-100.0
66,44,2,1,4,-3,-75.0
66,44,3,2,8,-6,-75.0
66,44,4,22,16,6,37.5
66,44,5,37,32,5,15.625
66,44,6,55,64,-9,-14.0625
66,44,7,387,128,259,202.34375
66,44,8,301,256,45,17.578125
66,44,9,1499,512,987,192.7734375
66,44,10,664,1024,-360,-35.15625
66,44,11,616,2048,-1432,-69.921875
66,44,12,1519,4096,-2577,-62.9150390625
66,44,13,31142,8192,22950,280.1513671875
66,44,14,14014,16384,-2370,-14.46533203125
66,44,15,7178,32768,-25590,-78.094482421875
66,45,1,0,2,-2,-100.0
66,45,2,2,4,-2,-50.0
66,45,3,3,8,-5,-62.5
66,45,4,3,16,-13,-81.25
66,45,5,11,32,-21,-65.625
66,45,6,126,64,62,96.875
66,45,7,70,128,-58,-45.3125
66,45,8,428,256,172,67.1875
66,45,9,305,512,-207,-40.4296875
66,45,10,1410,1024,386,37.6953125
66,45,11,1925,2048,-123,-6.005859375
66,45,12,6300,4096,2204,53.80859375
66,45,13,1568,8192,-6624,-80.859375
66,45,14,7648,16384,-8736,-53.3203125
66,45,15,7716,32768,-25052,-76.45263671875
66,46,1,0,2,-2,-100.0
66,46,2,2,4,-2,-50.0
66,46,3,6,8,-2,-25.0
66,46,4,25,16,9,56.25
66,46,5,8,32,-24,-75.0
66,46,6,128,64,64,100.0
66,46,7,158,128,30,23.4375
66,46,8,431,256,175,68.359375
66,46,9,181,512,-331,-64.6484375
66,46,10,2368,1024,1344,131.25
66,46,11,7950,2048,5902,288.18359375
66,46,12,2446,4096,-1650,-40.283203125
66,46,13,3451,8192,-4741,-57.87353515625
66,46,14,2225,16384,-14159,-86.419677734375
66,46,15,13308,32768,-19460,-59.38720703125
66,47,1,0,2,-2,-100.0
66,47,2,1,4,-3,-75.0
66,47,3,13,8,5,62.5
66,47,4,6,16,-10,-62.5
66,47,5,7,32,-25,-78.125
66,47,6,112,64,48,75.0
66,47,7,129,128,1,0.78125
66,47,8,360,256,104,40.625
66,47,9,131,512,-381,-74.4140625
66,47,10,1832,1024,808,78.90625
66,47,11,4508,2048,2460,120.1171875
66,47,12,1994,4096,-2102,-51.318359375
66,47,13,3804,8192,-4388,-53.564453125
66,47,14,18478,16384,2094,12.78076171875
66,47,15,37547,32768,4779,14.5843505859375
66,48,1,0,2,-2,-100.0
66,48,2,5,4,1,25.0
66,48,3,3,8,-5,-62.5
66,48,4,4,16,-12,-75.0
66,48,5,6,32,-26,-81.25
66,48,6,138,64,74,115.625
66,48,7,205,128,77,60.15625
66,48,8,73,256,-183,-71.484375
66,48,9,525,512,13,2.5390625
66,48,10,419,1024,-605,-59.08203125
66,48,11,1178,2048,-870,-42.48046875
66,48,12,12414,4096,8318,203.076171875
66,48,13,1442,8192,-6750,-82.3974609375
66,48,14,38274,16384,21890,133.60595703125
66,48,15,119419,32768,86651,264.4378662109375
66,49,1,0,2,-2,-100.0
66,49,2,3,4,-1,-25.0
66,49,3,4,8,-4,-50.0
66,49,4,6,16,-10,-62.5
66,49,5,84,32,52,162.5
66,49,6,87,64,23,35.9375
66,49,7,29,128,-99,-77.34375
66,49,8,107,256,-149,-58.203125
66,49,9,733,512,221,43.1640625
66,49,10,96,1024,-928,-90.625
66,49,11,1700,2048,-348,-16.9921875
66,49,12,6788,4096,2692,65.72265625
66,49,13,16220,8192,8028,97.998046875
66,49,14,23598,16384,7214,44.03076171875
66,49,15,3114,32768,-29654,-90.496826171875
66,50,1,0,2,-2,-100.0
66,50,2,1,4,-3,-75.0
66,50,3,6,8,-2,-25.0
66,50,4,16,16,0,0.0
66,50,5,121,32,89,278.125
66,50,6,41,64,-23,-35.9375
66,50,7,99,128,-29,-22.65625
66,50,8,107,256,-149,-58.203125
66,50,9,163,512,-349,-68.1640625
66,50,10,2218,1024,1194,116.6015625
66,50,11,555,2048,-1493,-72.900390625
66,50,12,7749,4096,3653,89.1845703125
66,50,13,13765,8192,5573,68.02978515625
66,50,14,56656,16384,40272,245.80078125
66,50,15,6754,32768,-26014,-79.388427734375
66,51,1,0,2,-2,-100.0
66,51,2,2,4,-2,-50.0
66,51,3,3,8,-5,-62.5
66,51,4,19,16,3,18.75
66,51,5,10,32,-22,-68.75
66,51,6,23,64,-41,-64.0625
66,51,7,73,128,-55,-42.96875
66,51,8,22,256,-234,-91.40625
66,51,9,286,512,-226,-44.140625
66,51,10,242,1024,-782,-76.3671875
66,51,11,856,2048,-1192,-58.203125
66,51,12,1125,4096,-2971,-72.5341796875
66,51,13,4476,8192,-3716,-45.361328125
66,51,14,8374,16384,-8010,-48.88916015625
66,51,15,10487,32768,-22281,-67.9962158203125
66,52,1,0,2,-2,-100.0
66,52,2,2,4,-2,-50.0
66,52,3,7,8,-1,-12.5
66,52,4,31,16,15,93.75
66,52,5,169,32,137,428.125
66,52,6,76,64,12,18.75
66,52,7,13,128,-115,-89.84375
66,52,8,139,256,-117,-45.703125
66,52,9,223,512,-289,-56.4453125
66,52,10,958,1024,-66,-6.4453125
66,52,11,60,2048,-1988,-97.0703125
66,52,12,1171,4096,-2925,-71.4111328125
66,52,13,1448,8192,-6744,-82.32421875
66,52,14,1068,16384,-15316,-93.4814453125
66,52,15,2136,32768,-30632,-93.4814453125
66,53,1,0,2,-2,-100.0
66,53,2,2,4,-2,-50.0
66,53,3,10,8,2,25.0
66,53,4,3,16,-13,-81.25
66,53,5,29,32,-3,-9.375
66,53,6,5,64,-59,-92.1875
66,53,7,119,128,-9,-7.03125
66,53,8,27,256,-229,-89.453125
66,53,9,41,512,-471,-91.9921875
66,53,10,1967,1024,943,92.08984375
66,53,11,4796,2048,2748,134.1796875
66,53,12,639,4096,-3457,-84.3994140625
66,53,13,15084,8192,6892,84.130859375
66,53,14,7552,16384,-8832,-53.90625
66,53,15,17173,32768,-15595,-47.5921630859375
66,54,1,0,2,-2,-100.0
66,54,2,1,4,-3,-75.0
66,54,3,2,8,-6,-75.0
66,54,4,6,16,-10,-62.5
66,54,5,54,32,22,68.75
66,54,6,14,64,-50,-78.125
66,54,7,32,128,-96,-75.0
66,54,8,227,256,-29,-11.328125
66,54,9,2306,512,1794,350.390625
66,54,10,2046,1024,1022,99.8046875
66,54,11,1270,2048,-778,-37.98828125
66,54,12,4613,4096,517,12.6220703125
66,54,13,11628,8192,3436,41.943359375
66,54,14,16339,16384,-45,-0.274658203125
66,54,15,21776,32768,-10992,-33.544921875
66,55,1,0,2,-2,-100.0
66,55,2,1,4,-3,-75.0
66,55,3,4,8,-4,-50.0
66,55,4,18,16,2,12.5
66,55,5,4,32,-28,-87.5
66,55,6,14,64,-50,-78.125
66,55,7,48,128,-80,-62.5
66,55,8,202,256,-54,-21.09375
66,55,9,330,512,-182,-35.546875
66,55,10,544,1024,-480,-46.875
66,55,11,845,2048,-1203,-58.740234375
66,55,12,130,4096,-3966,-96.826171875
66,55,13,15363,8192,7171,87.53662109375
66,55,14,16001,16384,-383,-2.337646484375
66,55,15,43903,32768,11135,33.9813232421875
66,56,1,0,2,-2,-100.0
66,56,2,1,4,-3,-75.0
66,56,3,12,8,4,50.0
66,56,4,5,16,-11,-68.75
66,56,5,33,32,1,3.125
66,56,6,81,64,17,26.5625
66,56,7,45,128,-83,-64.84375
66,56,8,133,256,-123,-48.046875
66,56,9,875,512,363,70.8984375
66,56,10,774,1024,-250,-24.4140625
66,56,11,309,2048,-1739,-84.912109375
66,56,12,8476,4096,4380,106.93359375
66,56,13,4770,8192,-3422,-41.7724609375
66,56,14,1838,16384,-14546,-88.78173828125
66,56,15,48681,32768,15913,48.5626220703125
66,57,1,0,2,-2,-100.0
66,57,2,1,4,-3,-75.0
66,57,3,4,8,-4,-50.0
66,57,4,16,16,0,0.0
66,57,5,110,32,78,243.75
66,57,6,12,64,-52,-81.25
66,57,7,150,128,22,17.1875
66,57,8,2023,256,1767,690.234375
66,57,9,2196,512,1684,328.90625
66,57,10,182,1024,-842,-82.2265625
66,57,11,725,2048,-1323,-64.599609375
66,57,12,6681,4096,2585,63.1103515625
66,57,13,2848,8192,-5344,-65.234375
66,57,14,4380,16384,-12004,-73.2666015625
66,57,15,21325,32768,-11443,-34.9212646484375
66,58,1,0,2,-2,-100.0
66,58,2,1,4,-3,-75.0
66,58,3,4,8,-4,-50.0
66,58,4,16,16,0,0.0
66,58,5,24,32,-8,-25.0
66,58,6,53,64,-11,-17.1875
66,58,7,27,128,-101,-78.90625
66,58,8,52,256,-204,-79.6875
66,58,9,181,512,-331,-64.6484375
66,58,10,374,1024,-650,-63.4765625
66,58,11,254,2048,-1794,-87.59765625
66,58,12,9561,4096,5465,133.4228515625
66,58,13,17881,8192,9689,118.27392578125
66,58,14,1986,16384,-14398,-87.87841796875
66,58,15,51661,32768,18893,57.6568603515625
66,59,1,0,2,-2,-100.0
66,59,2,5,4,1,25.0
66,59,3,9,8,1,12.5
66,59,4,25,16,9,56.25
66,59,5,15,32,-17,-53.125
66,59,6,22,64,-42,-65.625
66,59,7,267,128,139,108.59375
66,59,8,100,256,-156,-60.9375
66,59,9,496,512,-16,-3.125
66,59,10,589,1024,-435,-42.48046875
66,59,11,2801,2048,753,36.767578125
66,59,12,10754,4096,6658,162.548828125
66,59,13,113,8192,-8079,-98.62060546875
66,59,14,24525,16384,8141,49.688720703125
66,59,15,35997,32768,3229,9.8541259765625
66,60,1,0,2,-2,-100.0
66,60,2,3,4,-1,-25.0
66,60,3,2,8,-6,-75.0
66,60,4,15,16,-1,-6.25
66,60,5,47,32,15,46.875
66,60,6,16,64,-48,-75.0
66,60,7,45,128,-83,-64.84375
66,60,8,51,256,-205,-80.078125
66,60,9,401,512,-111,-21.6796875
66,60,10,1072,1024,48,4.6875
66,60,11,1053,2048,-995,-48.583984375
66,60,12,834,4096,-3262,-79.638671875
66,60,13,30677,8192,22485,274.47509765625
66,60,14,943,16384,-15441,-94.244384765625
66,60,15,11917,32768,-20851,-63.6322021484375
66,61,1,0,2,-2,-100.0
66,61,2,2,4,-2,-50.0
66,61,3,4,8,-4,-50.0
66,61,4,43,16,27,168.75
66,61,5,6,32,-26,-81.25
66,61,6,15,64,-49,-76.5625
66,61,7,245,128,117,91.40625
66,61,8,269,256,13,5.078125
66,61,9,148,512,-364,-71.09375
66,61,10,965,1024,-59,-5.76171875
66,61,11,249,2048,-1799,-87.841796875
66,61,12,381,4096,-3715,-90.6982421875
66,61,13,6450,8192,-1742,-21.2646484375
66,61,14,18032,16384,1648,10.05859375
66,61,15,19743,32768,-13025,-39.7491455078125
66,62,1,0,2,-2,-100.0
66,62,2,1,4,-3,-75.0
66,62,3,2,8,-6,-75.0
66,62,4,9,16,-7,-43.75
66,62,5,53,32,21,65.625
66,62,6,139,64,75,117.1875
66,62,7,27,128,-101,-78.90625
66,62,8,258,256,2,0.78125
66,62,9,514,512,2,0.390625
66,62,10,1090,1024,66,6.4453125
66,62,11,464,2048,-1584,-77.34375
66,62,12,10964,4096,6868,167.67578125
66,62,13,1834,8192,-6358,-77.6123046875
66,62,14,2886,16384,-13498,-82.38525390625
66,62,15,24272,32768,-8496,-25.927734375
66,63,1,0,2,-2,-100.0
66,63,2,1,4,-3,-75.0
66,63,3,7,8,-1,-12.5
66,63,4,17,16,1,6.25
66,63,5,34,32,2,6.25
66,63,6,25,64,-39,-60.9375
66,63,7,69,128,-59,-46.09375
66,63,8,397,256,141,55.078125
66,63,9,21,512,-491,-95.8984375
66,63,10,750,1024,-274,-26.7578125
66,63,11,2683,2048,635,31.005859375
66,63,12,693,4096,-3403,-83.0810546875
66,63,13,463,8192,-7729,-94.34814453125
66,63,14,1962,16384,-14422,-88.02490234375
66,63,15,1011,32768,-31757,-96.9146728515625
66,64,1,0,2,-2,-100.0
66,64,2,3,4,-1,-25.0
66,64,3,7,8,-1,-12.5
66,64,4,41,16,25,156.25
66,64,5,62,32,30,93.75
66,64,6,233,64,169,264.0625
66,64,7,76,128,-52,-40.625
66,64,8,513,256,257,100.390625
66,64,9,142,512,-370,-72.265625
66,64,10,1159,1024,135,13.18359375
66,64,11,6267,2048,4219,206.005859375
66,64,12,5676,4096,1580,38.57421875
66,64,13,2058,8192,-6134,-74.8779296875
66,64,14,10891,16384,-5493,-33.526611328125
66,64,15,32021,32768,-747,-2.2796630859375
66,65,1,0,2,-2,-100.0
66,65,2,1,4,-3,-75.0
66,65,3,6,8,-2,-25.0
66,65,4,7,16,-9,-56.25
66,65,5,26,32,-6,-18.75
66,65,6,16,64,-48,-75.0
66,65,7,33,128,-95,-74.21875
66,65,8,64,256,-192,-75.0
66,65,9,49,512,-463,-90.4296875
66,65,10,1089,1024,65,6.34765625
66,65,11,19,2048,-2029,-99.072265625
66,65,12,3668,4096,-428,-10.44921875
66,65,13,11345,8192,3153,38.48876953125
66,65,14,4549,16384,-11835,-72.235107421875
66,65,15,9820,32768,-22948,-70.03173828125
66,66,1,0,2,-2,-100.0
66,66,2,1,4,-3,-75.0
66,66,3,4,8,-4,-50.0
66,66,4,26,16,10,62.5
66,66,5,8,32,-24,-75.0
66,66,6,25,64,-39,-60.9375
66,66,7,16,128,-112,-87.5
66,66,8,447,256,191,74.609375
66,66,9,204,512,-308,-60.15625
66,66,10,1722,1024,698,68.1640625
66,66,11,4098,2048,2050,100.09765625
66,66,12,1227,4096,-2869,-70.0439453125
66,66,13,88,8192,-8104,-98.92578125
66,66,14,17102,16384,718,4.38232421875
66,66,15,60489,32768,27721,84.5977783203125
67,1,1,0,2,-2,-100.0
67,1,2,2,4,-2,-50.0
67,1,3,3,8,-5,-62.5
67,1,4,11,16,-5,-31.25
67,1,5,18,32,-14,-43.75
67,1,6,5,64,-59,-92.1875
67,1,7,141,128,13,10.15625
67,1,8,376,256,120,46.875
67,1,9,211,512,-301,-58.7890625
67,1,10,907,1024,-117,-11.42578125
67,1,11,4182,2048,2134,104.19921875
67,1,12,2023,4096,-2073,-50.6103515625
67,1,13,4746,8192,-3446,-42.0654296875
67,1,14,20669,16384,4285,26.153564453125
67,1,15,27650,32768,-5118,-15.618896484375
67,2,1,0,2,-2,-100.0
67,2,2,5,4,1,25.0
67,2,3,3,8,-5,-62.5
67,2,4,9,16,-7,-43.75
67,2,5,31,32,-1,-3.125
67,2,6,86,64,22,34.375
67,2,7,86,128,-42,-32.8125
67,2,8,67,256,-189,-73.828125
67,2,9,60,512,-452,-88.28125
67,2,10,84,1024,-940,-91.796875
67,2,11,2586,2048,538,26.26953125
67,2,12,1753,4096,-2343,-57.2021484375
67,2,13,17345,8192,9153,111.73095703125
67,2,14,8411,16384,-7973,-48.663330078125
67,2,15,17911,32768,-14857,-45.3399658203125
67,3,1,0,2,-2,-100.0
67,3,2,3,4,-1,-25.0
67,3,3,5,8,-3,-37.5
67,3,4,4,16,-12,-75.0
67,3,5,5,32,-27,-84.375
67,3,6,14,64,-50,-78.125
67,3,7,37,128,-91,-71.09375
67,3,8,40,256,-216,-84.375
67,3,9,764,512,252,49.21875
67,3,10,1210,1024,186,18.1640625
67,3,11,4713,2048,2665,130.126953125
67,3,12,2732,4096,-1364,-33.30078125
67,3,13,31392,8192,23200,283.203125
67,3,14,16413,16384,29,0.177001953125
67,3,15,11881,32768,-20887,-63.7420654296875
67,4,1,0,2,-2,-100.0
67,4,2,1,4,-3,-75.0
67,4,3,10,8,2,25.0
67,4,4,14,16,-2,-12.5
67,4,5,26,32,-6,-18.75
67,4,6,10,64,-54,-84.375
67,4,7,78,128,-50,-39.0625
67,4,8,1360,256,1104,431.25
67,4,9,633,512,121,23.6328125
67,4,10,692,1024,-332,-32.421875
67,4,11,2917,2048,869,42.431640625
67,4,12,409,4096,-3687,-90.0146484375
67,4,13,14391,8192,6199,75.67138671875
67,4,14,10303,16384,-6081,-37.115478515625
67,4,15,39552,32768,6784,20.703125
67,5,1,0,2,-2,-100.0
67,5,2,2,4,-2,-50.0
67,5,3,4,8,-4,-50.0
67,5,4,36,16,20,125.0
67,5,5,11,32,-21,-65.625
67,5,6,50,64,-14,-21.875
67,5,7,213,128,85,66.40625
67,5,8,646,256,390,152.34375
67,5,9,699,512,187,36.5234375
67,5,10,3754,1024,2730,266.6015625
67,5,11,612,2048,-1436,-70.1171875
67,5,12,8925,4096,4829,117.8955078125
67,5,13,13789,8192,5597,68.32275390625
67,5,14,36787,16384,20403,124.530029296875
67,5,15,12104,32768,-20664,-63.0615234375
67,6,1,0,2,-2,-100.0
67,6,2,1,4,-3,-75.0
67,6,3,4,8,-4,-50.0
67,6,4,14,16,-2,-12.5
67,6,5,27,32,-5,-15.625
67,6,6,170,64,106,165.625
67,6,7,44,128,-84,-65.625
67,6,8,101,256,-155,-60.546875
67,6,9,902,512,390,76.171875
67,6,10,533,1024,-491,-47.94921875
67,6,11,2871,2048,823,40.185546875
67,6,12,4618,4096,522,12.744140625
67,6,13,201,8192,-7991,-97.54638671875
67,6,14,2498,16384,-13886,-84.75341796875
67,6,15,8815,32768,-23953,-73.0987548828125
67,7,1,0,2,-2,-100.0
67,7,2,1,4,-3,-75.0
67,7,3,2,8,-6,-75.0
67,7,4,5,16,-11,-68.75
67,7,5,48,32,16,50.0
67,7,6,28,64,-36,-56.25
67,7,7,182,128,54,42.1875
67,7,8,466,256,210,82.03125
67,7,9,1320,512,808,157.8125
67,7,10,411,1024,-613,-59.86328125
67,7,11,53,2048,-1995,-97.412109375
67,7,12,5987,4096,1891,46.1669921875
67,7,13,4288,8192,-3904,-47.65625
67,7,14,22232,16384,5848,35.693359375
67,7,15,11582,32768,-21186,-64.654541015625
67,8,1,0,2,-2,-100.0
67,8,2,1,4,-3,-75.0
67,8,3,6,8,-2,-25.0
67,8,4,3,16,-13,-81.25
67,8,5,37,32,5,15.625
67,8,6,5,64,-59,-92.1875
67,8,7,226,128,98,76.5625
67,8,8,212,256,-44,-17.1875
67,8,9,1515,512,1003,195.8984375
67,8,10,172,1024,-852,-83.203125
67,8,11,326,2048,-1722,-84.08203125
67,8,12,7160,4096,3064,74.8046875
67,8,13,4104,8192,-4088,-49.90234375
67,8,14,2097,16384,-14287,-87.200927734375
67,8,15,18658,32768,-14110,-43.060302734375
67,9,1,0,2,-2,-100.0
67,9,2,3,4,-1,-25.0
67,9,3,2,8,-6,-75.0
67,9,4,4,16,-12,-75.0
67,9,5,8,32,-24,-75.0
67,9,6,50,64,-14,-21.875
67,9,7,298,128,170,132.8125
67,9,8,1044,256,788,307.8125
67,9,9,3413,512,2901,566.6015625
67,9,10,1378,1024,354,34.5703125
67,9,11,1120,2048,-928,-45.3125
67,9,12,402,4096,-3694,-90.185546875
67,9,13,4262,8192,-3930,-47.9736328125
67,9,14,53374,16384,36990,225.76904296875
67,9,15,16178,32768,-16590,-50.628662109375
67,10,1,0,2,-2,-100.0
67,10,2,1,4,-3,-75.0
67,10,3,9,8,1,12.5
67,10,4,4,16,-12,-75.0
67,10,5,141,32,109,340.625
67,10,6,29,64,-35,-54.6875
67,10,7,28,128,-100,-78.125
67,10,8,275,256,19,7.421875
67,10,9,768,512,256,50.0
67,10,10,51,1024,-973,-95.01953125
67,10,11,459,2048,-1589,-77.587890625
67,10,12,4725,4096,629,15.3564453125
67,10,13,5900,8192,-2292,-27.978515625
67,10,14,10176,16384,-6208,-37.890625
67,10,15,21868,32768,-10900,-33.26416015625
67,11,1,0,2,-2,-100.0
67,11,2,3,4,-1,-25.0
67,11,3,2,8,-6,-75.0
67,11,4,24,16,8,50.0
67,11,5,13,32,-19,-59.375
67,11,6,40,64,-24,-37.5
67,11,7,7,128,-121,-94.53125
67,11,8,64,256,-192,-75.0
67,11,9,323,512,-189,-36.9140625
67,11,10,245,1024,-779,-76.07421875
67,11,11,1923,2048,-125,-6.103515625
67,11,12,933,4096,-3163,-77.2216796875
67,11,13,18649,8192,10457,127.64892578125
67,11,14,4890,16384,-11494,-70.15380859375
67,11,15,4125,32768,-28643,-87.4114990234375
67,12,1,0,2,-2,-100.0
67,12,2,3,4,-1,-25.0
67,12,3,9,8,1,12.5
67,12,4,3,16,-13,-81.25
67,12,5,55,32,23,71.875
67,12,6,61,64,-3,-4.6875
67,12,7,35,128,-93,-72.65625
67,12,8,193,256,-63,-24.609375
67,12,9,372,512,-140,-27.34375
67,12,10,1226,1024,202,19.7265625
67,12,11,552,2048,-1496,-73.046875
67,12,12,1576,4096,-2520,-61.5234375
67,12,13,3465,8192,-4727,-57.70263671875
67,12,14,5337,16384,-11047,-67.425537109375
67,12,15,12919,32768,-19849,-60.5743408203125
67,13,1,0,2,-2,-100.0
67,13,2,4,4,0,0.0
67,13,3,13,8,5,62.5
67,13,4,6,16,-10,-62.5
67,13,5,51,32,19,59.375
67,13,6,34,64,-30,-46.875
67,13,7,36,128,-92,-71.875
67,13,8,1262,256,1006,392.96875
67,13,9,398,512,-114,-22.265625
67,13,10,412,1024,-612,-59.765625
67,13,11,3812,2048,1764,86.1328125
67,13,12,3333,4096,-763,-18.6279296875
67,13,13,23837,8192,15645,190.97900390625
67,13,14,20842,16384,4458,27.20947265625
67,13,15,51535,32768,18767,57.2723388671875
67,14,1,0,2,-2,-100.0
67,14,2,1,4,-3,-75.0
67,14,3,19,8,11,137.5
67,14,4,13,16,-3,-18.75
67,14,5,14,32,-18,-56.25
67,14,6,73,64,9,14.0625
67,14,7,126,128,-2,-1.5625
67,14,8,179,256,-77,-30.078125
67,14,9,61,512,-451,-88.0859375
67,14,10,1141,1024,117,11.42578125
67,14,11,595,2048,-1453,-70.947265625
67,14,12,4459,4096,363,8.8623046875
67,14,13,1058,8192,-7134,-87.0849609375
67,14,14,20427,16384,4043,24.676513671875
67,14,15,2396,32768,-30372,-92.68798828125
67,15,1,0,2,-2,-100.0
67,15,2,1,4,-3,-75.0
67,15,3,19,8,11,137.5
67,15,4,11,16,-5,-31.25
67,15,5,9,32,-23,-71.875
67,15,6,41,64,-23,-35.9375
67,15,7,363,128,235,183.59375
67,15,8,586,256,330,128.90625
67,15,9,690,512,178,34.765625
67,15,10,1093,1024,69,6.73828125
67,15,11,425,2048,-1623,-79.248046875
67,15,12,5347,4096,1251,30.5419921875
67,15,13,2520,8192,-5672,-69.23828125
67,15,14,4256,16384,-12128,-74.0234375
67,15,15,1936,32768,-30832,-94.091796875
67,16,1,0,2,-2,-100.0
67,16,2,2,4,-2,-50.0
67,16,3,2,8,-6,-75.0
67,16,4,11,16,-5,-31.25
67,16,5,6,32,-26,-81.25
67,16,6,11,64,-53,-82.8125
67,16,7,539,128,411,321.09375
67,16,8,172,256,-84,-32.8125
67,16,9,750,512,238,46.484375
67,16,10,1724,1024,700,68.359375
67,16,11,720,2048,-1328,-64.84375
67,16,12,4044,4096,-52,-1.26953125
67,16,13,5732,8192,-2460,-30.029296875
67,16,14,8608,16384,-7776,-47.4609375
67,16,15,6366,32768,-26402,-80.572509765625
67,17,1,0,2,-2,-100.0
67,17,2,3,4,-1,-25.0
67,17,3,6,8,-2,-25.0
67,17,4,9,16,-7,-43.75
67,17,5,11,32,-21,-65.625
67,17,6,10,64,-54,-84.375
67,17,7,157,128,29,22.65625
67,17,8,94,256,-162,-63.28125
67,17,9,44,512,-468,-91.40625
67,17,10,62,1024,-962,-93.9453125
67,17,11,272,2048,-1776,-86.71875
67,17,12,8030,4096,3934,96.044921875
67,17,13,5497,8192,-2695,-32.89794921875
67,17,14,14931,16384,-1453,-8.868408203125
67,17,15,1753,32768,-31015,-94.6502685546875
67,18,1,0,2,-2,-100.0
67,18,2,1,4,-3,-75.0
67,18,3,20,8,12,150.0
67,18,4,17,16,1,6.25
67,18,5,57,32,25,78.125
67,18,6,39,64,-25,-39.0625
67,18,7,10,128,-118,-92.1875
67,18,8,565,256,309,120.703125
67,18,9,320,512,-192,-37.5
67,18,10,990,1024,-34,-3.3203125
67,18,11,146,2048,-1902,-92.87109375
67,18,12,3417,4096,-679,-16.5771484375
67,18,13,14873,8192,6681,81.55517578125
67,18,14,7468,16384,-8916,-54.4189453125
67,18,15,27042,32768,-5726,-17.474365234375
67,19,1,0,2,-2,-100.0
67,19,2,4,4,0,0.0
67,19,3,2,8,-6,-75.0
67,19,4,9,16,-7,-43.75
67,19,5,73,32,41,128.125
67,19,6,110,64,46,71.875
67,19,7,157,128,29,22.65625
67,19,8,721,256,465,181.640625
67,19,9,598,512,86,16.796875
67,19,10,952,1024,-72,-7.03125
67,19,11,265,2048,-1783,-87.060546875
67,19,12,2238,4096,-1858,-45.361328125
67,19,13,862,8192,-7330,-89.4775390625
67,19,14,17793,16384,1409,8.599853515625
67,19,15,1324,32768,-31444,-95.95947265625
67,20,1,0,2,-2,-100.0
67,20,2,1,4,-3,-75.0
67,20,3,3,8,-5,-62.5
67,20,4,12,16,-4,-25.0
67,20,5,39,32,7,21.875
67,20,6,56,64,-8,-12.5
67,20,7,298,128,170,132.8125
67,20,8,306,256,50,19.53125
67,20,9,554,512,42,8.203125
67,20,10,382,1024,-642,-62.6953125
67,20,11,1088,2048,-960,-46.875
67,20,12,886,4096,-3210,-78.369140625
67,20,13,9797,8192,1605,19.59228515625
67,20,14,65509,16384,49125,299.835205078125
67,20,15,19273,32768,-13495,-41.1834716796875
67,21,1,0,2,-2,-100.0
67,21,2,1,4,-3,-75.0
67,21,3,10,8,2,25.0
67,21,4,5,16,-11,-68.75
67,21,5,9,32,-23,-71.875
67,21,6,35,64,-29,-45.3125
67,21,7,64,128,-64,-50.0
67,21,8,8,256,-248,-96.875
67,21,9,202,512,-310,-60.546875
67,21,10,1147,1024,123,12.01171875
67,21,11,4360,2048,2312,112.890625
67,21,12,6425,4096,2329,56.8603515625
67,21,13,3789,8192,-4403,-53.74755859375
67,21,14,10505,16384,-5879,-35.882568359375
67,21,15,9407,32768,-23361,-71.2921142578125
67,22,1,0,2,-2,-100.0
67,22,2,1,4,-3,-75.0
67,22,3,12,8,4,50.0
67,22,4,25,16,9,56.25
67,22,5,14,32,-18,-56.25
67,22,6,127,64,63,98.4375
67,22,7,38,128,-90,-70.3125
67,22,8,386,256,130,50.78125
67,22,9,1458,512,946,184.765625
67,22,10,534,1024,-490,-47.8515625
67,22,11,1521,2048,-527,-25.732421875
67,22,12,7449,4096,3353,81.8603515625
67,22,13,502,8192,-7690,-93.8720703125
67,22,14,13243,16384,-3141,-19.171142578125
67,22,15,101766,32768,68998,210.565185546875
67,23,1,0,2,-2,-100.0
67,23,2,6,4,2,50.0
67,23,3,2,8,-6,-75.0
67,23,4,7,16,-9,-56.25
67,23,5,38,32,6,18.75
67,23,6,55,64,-9,-14.0625
67,23,7,143,128,15,11.71875
67,23,8,145,256,-111,-43.359375
67,23,9,191,512,-321,-62.6953125
67,23,10,1770,1024,746,72.8515625
67,23,11,541,2048,-1507,-73.583984375
67,23,12,2778,4096,-1318,-32.177734375
67,23,13,3358,8192,-4834,-59.0087890625
67,23,14,6483,16384,-9901,-60.430908203125
67,23,15,7425,32768,-25343,-77.3406982421875
67,24,1,0,2,-2,-100.0
67,24,2,2,4,-2,-50.0
67,24,3,5,8,-3,-37.5
67,24,4,3,16,-13,-81.25
67,24,5,31,32,-1,-3.125
67,24,6,26,64,-38,-59.375
67,24,7,237,128,109,85.15625
67,24,8,903,256,647,252.734375
67,24,9,497,512,-15,-2.9296875
67,24,10,1221,1024,197,19.23828125
67,24,11,599,2048,-1449,-70.751953125
67,24,12,4315,4096,219,5.3466796875
67,24,13,1694,8192,-6498,-79.3212890625
67,24,14,23109,16384,6725,41.046142578125
67,24,15,7403,32768,-25365,-77.4078369140625
67,25,1,0,2,-2,-100.0
67,25,2,2,4,-2,-50.0
67,25,3,3,8,-5,-62.5
67,25,4,3,16,-13,-81.25
67,25,5,4,32,-28,-87.5
67,25,6,5,64,-59,-92.1875
67,25,7,93,128,-35,-27.34375
67,25,8,120,256,-136,-53.125
67,25,9,638,512,126,24.609375
67,25,10,131,1024,-893,-87.20703125
67,25,11,1161,2048,-887,-43.310546875
67,25,12,8034,4096,3938,96.142578125
67,25,13,1155,8192,-7037,-85.90087890625
67,25,14,51961,16384,35577,217.144775390625
67,25,15,101417,32768,68649,209.5001220703125
67,26,1,0,2,-2,-100.0
67,26,2,7,4,3,75.0
67,26,3,5,8,-3,-37.5
67,26,4,26,16,10,62.5
67,26,5,56,32,24,75.0
67,26,6,75,64,11,17.1875
67,26,7,103,128,-25,-19.53125
67,26,8,20,256,-236,-92.1875
67,26,9,269,512,-243,-47.4609375
67,26,10,1547,1024,523,51.07421875
67,26,11,109,2048,-1939,-94.677734375
67,26,12,2986,4096,-1110,-27.099609375
67,26,13,2000,8192,-6192,-75.5859375
67,26,14,1764,16384,-14620,-89.2333984375
67,26,15,53121,32768,20353,62.1124267578125
67,27,1,0,2,-2,-100.0
67,27,2,2,4,-2,-50.0
67,27,3,3,8,-5,-62.5
67,27,4,4,16,-12,-75.0
67,27,5,37,32,5,15.625
67,27,6,54,64,-10,-15.625
67,27,7,115,128,-13,-10.15625
67,27,8,390,256,134,52.34375
67,27,9,19,512,-493,-96.2890625
67,27,10,505,1024,-519,-50.68359375
67,27,11,1654,2048,-394,-19.23828125
67,27,12,2373,4096,-1723,-42.0654296875
67,27,13,13011,8192,4819,58.82568359375
67,27,14,8087,16384,-8297,-50.640869140625
67,27,15,36203,32768,3435,10.4827880859375
67,28,1,0,2,-2,-100.0
67,28,2,1,4,-3,-75.0
67,28,3,4,8,-4,-50.0
67,28,4,5,16,-11,-68.75
67,28,5,37,32,5,15.625
67,28,6,160,64,96,150.0
67,28,7,35,128,-93,-72.65625
67,28,8,240,256,-16,-6.25
67,28,9,115,512,-397,-77.5390625
67,28,10,1889,1024,865,84.47265625
67,28,11,25,2048,-2023,-98.779296875
67,28,12,4361,4096,265,6.4697265625
67,28,13,4500,8192,-3692,-45.068359375
67,28,14,7045,16384,-9339,-57.000732421875
67,28,15,22234,32768,-10534,-32.147216796875
67,29,1,0,2,-2,-100.0
67,29,2,2,4,-2,-50.0
67,29,3,13,8,5,62.5
67,29,4,4,16,-12,-75.0
67,29,5,26,32,-6,-18.75
67,29,6,26,64,-38,-59.375
67,29,7,116,128,-12,-9.375
67,29,8,21,256,-235,-91.796875
67,29,9,364,512,-148,-28.90625
67,29,10,167,1024,-857,-83.69140625
67,29,11,588,2048,-1460,-71.2890625
67,29,12,336,4096,-3760,-91.796875
67,29,13,1169,8192,-7023,-85.72998046875
67,29,14,7712,16384,-8672,-52.9296875
67,29,15,23822,32768,-8946,-27.301025390625
67,30,1,0,2,-2,-100.0
67,30,2,1,4,-3,-75.0
67,30,3,4,8,-4,-50.0
67,30,4,19,16,3,18.75
67,30,5,8,32,-24,-75.0
67,30,6,23,64,-41,-64.0625
67,30,7,61,128,-67,-52.34375
67,30,8,727,256,471,183.984375
67,30,9,741,512,229,44.7265625
67,30,10,391,1024,-633,-61.81640625
67,30,11,3046,2048,998,48.73046875
67,30,12,3213,4096,-883,-21.5576171875
67,30,13,2207,8192,-5985,-73.05908203125
67,30,14,22942,16384,6558,40.02685546875
67,30,15,83380,32768,50612,154.45556640625
67,31,1,0,2,-2,-100.0
67,31,2,1,4,-3,-75.0
67,31,3,4,8,-4,-50.0
67,31,4,8,16,-8,-50.0
67,31,5,41,32,9,28.125
67,31,6,36,64,-28,-43.75
67,31,7,196,128,68,53.125
67,31,8,116,256,-140,-54.6875
67,31,9,114,512,-398,-77.734375
67,31,10,660,1024,-364,-35.546875
67,31,11,2327,2048,279,13.623046875
67,31,12,7503,4096,3407,83.1787109375
67,31,13,31820,8192,23628,288.427734375
67,31,14,3781,16384,-12603,-76.922607421875
67,31,15,18050,32768,-14718,-44.915771484375
67,32,1,0,2,-2,-100.0
67,32,2,2,4,-2,-50.0
67,32,3,7,8,-1,-12.5
67,32,4,3,16,-13,-81.25
67,32,5,16,32,-16,-50.0
67,32,6,59,64,-5,-7.8125
67,32,7,7,128,-121,-94.53125
67,32,8,230,256,-26,-10.15625
67,32,9,164,512,-348,-67.96875
67,32,10,2887,1024,1863,181.93359375
67,32,11,1541,2048,-507,-24.755859375
67,32,12,3053,4096,-1043,-25.4638671875
67,32,13,23937,8192,15745,192.19970703125
67,32,14,400,16384,-15984,-97.55859375
67,32,15,36359,32768,3591,10.9588623046875
67,33,1,0,2,-2,-100.0
67,33,2,1,4,-3,-75.0
67,33,3,7,8,-1,-12.5
67,33,4,6,16,-10,-62.5
67,33,5,56,32,24,75.0
67,33,6,21,64,-43,-67.1875
67,33,7,179,128,51,39.84375
67,33,8,9,256,-247,-96.484375
67,33,9,35,512,-477,-93.1640625
67,33,10,2952,1024,1928,188.28125
67,33,11,192,2048,-1856,-90.625
67,33,12,2431,4096,-1665,-40.6494140625
67,33,13,16425,8192,8233,100.50048828125
67,33,14,88,16384,-16296,-99.462890625
67,33,15,74263,32768,41495,126.6326904296875
67,34,1,0,2,-2,-100.0
67,34,2,2,4,-2,-50.0
67,34,3,3,8,-5,-62.5
67,34,4,32,16,16,100.0
67,34,5,17,32,-15,-46.875
67,34,6,27,64,-37,-57.8125
67,34,7,54,128,-74,-57.8125
67,34,8,219,256,-37,-14.453125
67,34,9,395,512,-117,-22.8515625
67,34,10,1333,1024,309,30.17578125
67,34,11,2363,2048,315,15.380859375
67,34,12,6678,4096,2582,63.037109375
67,34,13,9448,8192,1256,15.33203125
67,34,14,16827,16384,443,2.703857421875
67,34,15,16752,32768,-16016,-48.876953125
67,35,1,0,2,-2,-100.0
67,35,2,2,4,-2,-50.0
67,35,3,3,8,-5,-62.5
67,35,4,27,16,11,68.75
67,35,5,58,32,26,81.25
67,35,6,5,64,-59,-92.1875
67,35,7,139,128,11,8.59375
67,35,8,172,256,-84,-32.8125
67,35,9,291,512,-221,-43.1640625
67,35,10,675,1024,-349,-34.08203125
67,35,11,3926,2048,1878,91.69921875
67,35,12,4063,4096,-33,-0.8056640625
67,35,13,4006,8192,-4186,-51.0986328125
67,35,14,2214,16384,-14170,-86.48681640625
67,35,15,3523,32768,-29245,-89.2486572265625
67,36,1,0,2,-2,-100.0
67,36,2,2,4,-2,-50.0
67,36,3,12,8,4,50.0
67,36,4,54,16,38,237.5
67,36,5,38,32,6,18.75
67,36,6,12,64,-52,-81.25
67,36,7,25,128,-103,-80.46875
67,36,8,11,256,-245,-95.703125
67,36,9,68,512,-444,-86.71875
67,36,10,662,1024,-362,-35.3515625
67,36,11,1630,2048,-418,-20.41015625
67,36,12,596,4096,-3500,-85.44921875
67,36,13,634,8192,-7558,-92.2607421875
67,36,14,5752,16384,-10632,-64.892578125
67,36,15,1643,32768,-31125,-94.9859619140625
67,37,1,0,2,-2,-100.0
67,37,2,4,4,0,0.0
67,37,3,2,8,-6,-75.0
67,37,4,3,16,-13,-81.25
67,37,5,10,32,-22,-68.75
67,37,6,21,64,-43,-67.1875
67,37,7,130,128,2,1.5625
67,37,8,686,256,430,167.96875
67,37,9,916,512,404,78.90625
67,37,10,3369,1024,2345,229.00390625
67,37,11,2687,2048,639,31.201171875
67,37,12,3878,4096,-218,-5.322265625
67,37,13,5731,8192,-2461,-30.04150390625
67,37,14,11875,16384,-4509,-27.520751953125
67,37,15,19444,32768,-13324,-40.66162109375
67,38,1,0,2,-2,-100.0
67,38,2,2,4,-2,-50.0
67,38,3,2,8,-6,-75.0
67,38,4,22,16,6,37.5
67,38,5,10,32,-22,-68.75
67,38,6,21,64,-43,-67.1875
67,38,7,50,128,-78,-60.9375
67,38,8,29,256,-227,-88.671875
67,38,9,1119,512,607,118.5546875
67,38,10,2737,1024,1713,167.28515625
67,38,11,2078,2048,30,1.46484375
67,38,12,59,4096,-4037,-98.5595703125
67,38,13,5214,8192,-2978,-36.3525390625
67,38,14,1535,16384,-14849,-90.631103515625
67,38,15,63676,32768,30908,94.32373046875
67,39,1,0,2,-2,-100.0
67,39,2,1,4,-3,-75.0
67,39,3,11,8,3,37.5
67,39,4,15,16,-1,-6.25
67,39,5,6,32,-26,-81.25
67,39,6,72,64,8,12.5
67,39,7,257,128,129,100.78125
67,39,8,80,256,-176,-68.75
67,39,9,822,512,310,60.546875
67,39,10,1167,1024,143,13.96484375
67,39,11,90,2048,-1958,-95.60546875
67,39,12,692,4096,-3404,-83.10546875
67,39,13,83,8192,-8109,-98.98681640625
67,39,14,32163,16384,15779,96.307373046875
67,39,15,27107,32768,-5661,-17.2760009765625
67,40,1,0,2,-2,-100.0
67,40,2,6,4,2,50.0
67,40,3,4,8,-4,-50.0
67,40,4,4,16,-12,-75.0
67,40,5,11,32,-21,-65.625
67,40,6,55,64,-9,-14.0625
67,40,7,221,128,93,72.65625
67,40,8,307,256,51,19.921875
67,40,9,230,512,-282,-55.078125
67,40,10,866,1024,-158,-15.4296875
67,40,11,11004,2048,8956,437.3046875
67,40,12,10043,4096,5947,145.1904296875
67,40,13,13990,8192,5798,70.7763671875
67,40,14,5958,16384,-10426,-63.63525390625
67,40,15,40617,32768,7849,23.9532470703125
67,41,1,0,2,-2,-100.0
67,41,2,5,4,1,25.0
67,41,3,2,8,-6,-75.0
67,41,4,9,16,-7,-43.75
67,41,5,9,32,-23,-71.875
67,41,6,150,64,86,134.375
67,41,7,23,128,-105,-82.03125
67,41,8,236,256,-20,-7.8125
67,41,9,107,512,-405,-79.1015625
67,41,10,1247,1024,223,21.77734375
67,41,11,969,2048,-1079,-52.685546875
67,41,12,10215,4096,6119,149.3896484375
67,41,13,7406,8192,-786,-9.5947265625
67,41,14,1414,16384,-14970,-91.36962890625
67,41,15,32436,32768,-332,-1.01318359375
67,42,1,0,2,-2,-100.0
67,42,2,3,4,-1,-25.0
67,42,3,7,8,-1,-12.5
67,42,4,16,16,0,0.0
67,42,5,10,32,-22,-68.75
67,42,6,37,64,-27,-42.1875
67,42,7,12,128,-116,-90.625
67,42,8,398,256,142,55.46875
67,42,9,71,512,-441,-86.1328125
67,42,10,98,1024,-926,-90.4296875
67,42,11,901,2048,-1147,-56.005859375
67,42,12,1627,4096,-2469,-60.2783203125
67,42,13,3954,8192,-4238,-51.7333984375
67,42,14,27269,16384,10885,66.436767578125
67,42,15,26942,32768,-5826,-17.779541015625
67,43,1,0,2,-2,-100.0
67,43,2,3,4,-1,-25.0
67,43,3,15,8,7,87.5
67,43,4,5,16,-11,-68.75
67,43,5,21,32,-11,-34.375
67,43,6,18,64,-46,-71.875
67,43,7,88,128,-40,-31.25
67,43,8,450,256,194,75.78125
67,43,9,1998,512,1486,290.234375
67,43,10,350,1024,-674,-65.8203125
67,43,11,1724,2048,-324,-15.8203125
67,43,12,4600,4096,504,12.3046875
67,43,13,1948,8192,-6244,-76.220703125
67,43,14,16431,16384,47,0.286865234375
67,43,15,7728,32768,-25040,-76.416015625
67,44,1,0,2,-2,-100.0
67,44,2,5,4,1,25.0
67,44,3,2,8,-6,-75.0
67,44,4,3,16,-13,-81.25
67,44,5,57,32,25,78.125
67,44,6,15,64,-49,-76.5625
67,44,7,120,128,-8,-6.25
67,44,8,43,256,-213,-83.203125
67,44,9,162,512,-350,-68.359375
67,44,10,197,1024,-827,-80.76171875
67,44,11,855,2048,-1193,-58.251953125
67,44,12,2375,4096,-1721,-42.0166015625
67,44,13,3161,8192,-5031,-61.41357421875
67,44,14,37397,16384,21013,128.253173828125
67,44,15,14803,32768,-17965,-54.8248291015625
67,45,1,0,2,-2,-100.0
67,45,2,3,4,-1,-25.0
67,45,3,12,8,4,50.0
67,45,4,3,16,-13,-81.25
67,45,5,9,32,-23,-71.875
67,45,6,73,64,9,14.0625
67,45,7,201,128,73,57.03125
67,45,8,103,256,-153,-59.765625
67,45,9,1027,512,515,100.5859375
67,45,10,509,1024,-515,-50.29296875
67,45,11,1436,2048,-612,-29.8828125
67,45,12,3913,4096,-183,-4.4677734375
67,45,13,1767,8192,-6425,-78.43017578125
67,45,14,47001,16384,30617,186.871337890625
67,45,15,18215,32768,-14553,-44.4122314453125
67,46,1,0,2,-2,-100.0
67,46,2,1,4,-3,-75.0
67,46,3,3,8,-5,-62.5
67,46,4,12,16,-4,-25.0
67,46,5,260,32,228,712.5
67,46,6,17,64,-47,-73.4375
67,46,7,240,128,112,87.5
67,46,8,289,256,33,12.890625
67,46,9,67,512,-445,-86.9140625
67,46,10,784,1024,-240,-23.4375
67,46,11,147,2048,-1901,-92.822265625
67,46,12,2880,4096,-1216,-29.6875
67,46,13,6977,8192,-1215,-14.83154296875
67,46,14,12263,16384,-4121,-25.152587890625
67,46,15,11430,32768,-21338,-65.118408203125
67,47,1,0,2,-2,-100.0
67,47,2,1,4,-3,-75.0
67,47,3,4,8,-4,-50.0
67,47,4,34,16,18,112.5
67,47,5,12,32,-20,-62.5
67,47,6,117,64,53,82.8125
67,47,7,25,128,-103,-80.46875
67,47,8,90,256,-166,-64.84375
67,47,9,333,512,-179,-34.9609375
67,47,10,813,1024,-211,-20.60546875
67,47,11,639,2048,-1409,-68.798828125
67,47,12,246,4096,-3850,-93.994140625
67,47,13,43090,8192,34898,426.0009765625
67,47,14,66006,16384,49622,302.86865234375
67,47,15,8560,32768,-24208,-73.876953125
67,48,1,0,2,-2,-100.0
67,48,2,1,4,-3,-75.0
67,48,3,5,8,-3,-37.5
67,48,4,11,16,-5,-31.25
67,48,5,102,32,70,218.75
67,48,6,7,64,-57,-89.0625
67,48,7,334,128,206,160.9375
67,48,8,69,256,-187,-73.046875
67,48,9,264,512,-248,-48.4375
67,48,10,779,1024,-245,-23.92578125
67,48,11,3435,2048,1387,67.724609375
67,48,12,462,4096,-3634,-88.720703125
67,48,13,19783,8192,11591,141.49169921875
67,48,14,39848,16384,23464,143.212890625
67,48,15,57834,32768,25066,76.495361328125
67,49,1,0,2,-2,-100.0
67,49,2,2,4,-2,-50.0
67,49,3,2,8,-6,-75.0
67,49,4,3,16,-13,-81.25
67,49,5,60,32,28,87.5
67,49,6,64,64,0,0.0
67,49,7,13,128,-115,-89.84375
67,49,8,166,256,-90,-35.15625
67,49,9,68,512,-444,-86.71875
67,49,10,757,1024,-267,-26.07421875
67,49,11,732,2048,-1316,-64.2578125
67,49,12,1566,4096,-2530,-61.767578125
67,49,13,14197,8192,6005,73.30322265625
67,49,14,15441,16384,-943,-5.755615234375
67,49,15,64579,32768,31811,97.0794677734375
67,50,1,0,2,-2,-100.0
67,50,2,1,4,-3,-75.0
67,50,3,34,8,26,325.0
67,50,4,5,16,-11,-68.75
67,50,5,4,32,-28,-87.5
67,50,6,12,64,-52,-81.25
67,50,7,24,128,-104,-81.25
67,50,8,123,256,-133,-51.953125
67,50,9,314,512,-198,-38.671875
67,50,10,2046,1024,1022,99.8046875
67,50,11,5908,2048,3860,188.4765625
67,50,12,15305,4096,11209,273.6572265625
67,50,13,14078,8192,5886,71.8505859375
67,50,14,2224,16384,-14160,-86.42578125
67,50,15,31138,32768,-1630,-4.974365234375
67,51,1,0,2,-2,-100.0
67,51,2,2,4,-2,-50.0
67,51,3,7,8,-1,-12.5
67,51,4,3,16,-13,-81.25
67,51,5,8,32,-24,-75.0
67,51,6,53,64,-11,-17.1875
67,51,7,46,128,-82,-64.0625
67,51,8,49,256,-207,-80.859375
67,51,9,449,512,-63,-12.3046875
67,51,10,2605,1024,1581,154.39453125
67,51,11,707,2048,-1341,-65.478515625
67,51,12,4081,4096,-15,-0.3662109375
67,51,13,992,8192,-7200,-87.890625
67,51,14,51899,16384,35515,216.766357421875
67,51,15,258,32768,-32510,-99.212646484375
67,52,1,0,2,-2,-100.0
67,52,2,3,4,-1,-25.0
67,52,3,2,8,-6,-75.0
67,52,4,10,16,-6,-37.5
67,52,5,5,32,-27,-84.375
67,52,6,47,64,-17,-26.5625
67,52,7,92,128,-36,-28.125
67,52,8,48,256,-208,-81.25
67,52,9,842,512,330,64.453125
67,52,10,1781,1024,757,73.92578125
67,52,11,1027,2048,-1021,-49.853515625
67,52,12,517,4096,-3579,-87.3779296875
67,52,13,8274,8192,82,1.0009765625
67,52,14,31199,16384,14815,90.423583984375
67,52,15,37480,32768,4712,14.3798828125
67,53,1,0,2,-2,-100.0
67,53,2,1,4,-3,-75.0
67,53,3,3,8,-5,-62.5
67,53,4,18,16,2,12.5
67,53,5,13,32,-19,-59.375
67,53,6,143,64,79,123.4375
67,53,7,83,128,-45,-35.15625
67,53,8,264,256,8,3.125
67,53,9,632,512,120,23.4375
67,53,10,147,1024,-877,-85.64453125
67,53,11,124,2048,-1924,-93.9453125
67,53,12,1089,4096,-3007,-73.4130859375
67,53,13,7675,8192,-517,-6.31103515625
67,53,14,1382,16384,-15002,-91.56494140625
67,53,15,13449,32768,-19319,-58.9569091796875
67,54,1,0,2,-2,-100.0
67,54,2,1,4,-3,-75.0
67,54,3,6,8,-2,-25.0
67,54,4,8,16,-8,-50.0
67,54,5,9,32,-23,-71.875
67,54,6,95,64,31,48.4375
67,54,7,17,128,-111,-86.71875
67,54,8,335,256,79,30.859375
67,54,9,436,512,-76,-14.84375
67,54,10,131,1024,-893,-87.20703125
67,54,11,345,2048,-1703,-83.154296875
67,54,12,1306,4096,-2790,-68.115234375
67,54,13,4739,8192,-3453,-42.15087890625
67,54,14,2475,16384,-13909,-84.893798828125
67,54,15,16512,32768,-16256,-49.609375
67,55,1,0,2,-2,-100.0
67,55,2,1,4,-3,-75.0
67,55,3,5,8,-3,-37.5
67,55,4,6,16,-10,-62.5
67,55,5,11,32,-21,-65.625
67,55,6,95,64,31,48.4375
67,55,7,109,128,-19,-14.84375
67,55,8,940,256,684,267.1875
67,55,9,910,512,398,77.734375
67,55,10,1203,1024,179,17.48046875
67,55,11,1009,2048,-1039,-50.732421875
67,55,12,4866,4096,770,18.798828125
67,55,13,8894,8192,702,8.5693359375
67,55,14,88452,16384,72068,439.8681640625
67,55,15,4980,32768,-27788,-84.80224609375
67,56,1,0,2,-2,-100.0
67,56,2,1,4,-3,-75.0
67,56,3,9,8,1,12.5
67,56,4,3,16,-13,-81.25
67,56,5,16,32,-16,-50.0
67,56,6,149,64,85,132.8125
67,56,7,431,128,303,236.71875
67,56,8,66,256,-190,-74.21875
67,56,9,417,512,-95,-18.5546875
67,56,10,520,1024,-504,-49.21875
67,56,11,4248,2048,2200,107.421875
67,56,12,4789,4096,693,16.9189453125
67,56,13,383,8192,-7809,-95.32470703125
67,56,14,37588,16384,21204,129.4189453125
67,56,15,24743,32768,-8025,-24.4903564453125
67,57,1,0,2,-2,-100.0
67,57,2,3,4,-1,-25.0
67,57,3,2,8,-6,-75.0
67,57,4,24,16,8,50.0
67,57,5,12,32,-20,-62.5
67,57,6,74,64,10,15.625
67,57,7,10,128,-118,-92.1875
67,57,8,113,256,-143,-55.859375
67,57,9,176,512,-336,-65.625
67,57,10,299,1024,-725,-70.80078125
67,57,11,10159,2048,8111,396.044921875
67,57,12,3118,4096,-978,-23.876953125
67,57,13,8132,8192,-60,-0.732421875
67,57,14,41822,16384,25438,155.26123046875
67,57,15,3502,32768,-29266,-89.312744140625
67,58,1,0,2,-2,-100.0
67,58,2,2,4,-2,-50.0
67,58,3,8,8,0,0.0
67,58,4,3,16,-13,-81.25
67,58,5,102,32,70,218.75
67,58,6,140,64,76,118.75
67,58,7,156,128,28,21.875
67,58,8,64,256,-192,-75.0
67,58,9,470,512,-42,-8.203125
67,58,10,305,1024,-719,-70.21484375
67,58,11,2855,2048,807,39.404296875
67,58,12,99,4096,-3997,-97.5830078125
67,58,13,37684,8192,29492,360.009765625
67,58,14,5719,16384,-10665,-65.093994140625
67,58,15,78081,32768,45313,138.2843017578125
67,59,1,0,2,-2,-100.0
67,59,2,1,4,-3,-75.0
67,59,3,2,8,-6,-75.0
67,59,4,7,16,-9,-56.25
67,59,5,58,32,26,81.25
67,59,6,37,64,-27,-42.1875
67,59,7,336,128,208,162.5
67,59,8,747,256,491,191.796875
67,59,9,848,512,336,65.625
67,59,10,1558,1024,534,52.1484375
67,59,11,1752,2048,-296,-14.453125
67,59,12,3996,4096,-100,-2.44140625
67,59,13,14835,8192,6643,81.09130859375
67,59,14,2334,16384,-14050,-85.75439453125
67,59,15,19920,32768,-12848,-39.208984375
67,60,1,0,2,-2,-100.0
67,60,2,3,4,-1,-25.0
67,60,3,7,8,-1,-12.5
67,60,4,20,16,4,25.0
67,60,5,45,32,13,40.625
67,60,6,15,64,-49,-76.5625
67,60,7,212,128,84,65.625
67,60,8,560,256,304,118.75
67,60,9,1237,512,725,141.6015625
67,60,10,5980,1024,4956,483.984375
67,60,11,1878,2048,-170,-8.30078125
67,60,12,2349,4096,-1747,-42.6513671875
67,60,13,12527,8192,4335,52.91748046875
67,60,14,36077,16384,19693,120.196533203125
67,60,15,9667,32768,-23101,-70.4986572265625
67,61,1,0,2,-2,-100.0
67,61,2,3,4,-1,-25.0
67,61,3,6,8,-2,-25.0
67,61,4,40,16,24,150.0
67,61,5,31,32,-1,-3.125
67,61,6,102,64,38,59.375
67,61,7,874,128,746,582.8125
67,61,8,57,256,-199,-77.734375
67,61,9,443,512,-69,-13.4765625
67,61,10,1052,1024,28,2.734375
67,61,11,1006,2048,-1042,-50.87890625
67,61,12,23783,4096,19687,480.6396484375
67,61,13,5095,8192,-3097,-37.80517578125
67,61,14,7249,16384,-9135,-55.755615234375
67,61,15,12137,32768,-20631,-62.9608154296875
67,62,1,0,2,-2,-100.0
67,62,2,1,4,-3,-75.0
67,62,3,2,8,-6,-75.0
67,62,4,13,16,-3,-18.75
67,62,5,41,32,9,28.125
67,62,6,109,64,45,70.3125
67,62,7,557,128,429,335.15625
67,62,8,211,256,-45,-17.578125
67,62,9,146,512,-366,-71.484375
67,62,10,705,1024,-319,-31.15234375
67,62,11,628,2048,-1420,-69.3359375
67,62,12,3680,4096,-416,-10.15625
67,62,13,1512,8192,-6680,-81.54296875
67,62,14,5775,16384,-10609,-64.752197265625
67,62,15,63269,32768,30501,93.0816650390625
67,63,1,0,2,-2,-100.0
67,63,2,4,4,0,0.0
67,63,3,7,8,-1,-12.5
67,63,4,3,16,-13,-81.25
67,63,5,29,32,-3,-9.375
67,63,6,301,64,237,370.3125
67,63,7,15,128,-113,-88.28125
67,63,8,120,256,-136,-53.125
67,63,9,1232,512,720,140.625
67,63,10,721,1024,-303,-29.58984375
67,63,11,622,2048,-1426,-69.62890625
67,63,12,78,4096,-4018,-98.095703125
67,63,13,15521,8192,7329,89.46533203125
67,63,14,8095,16384,-8289,-50.592041015625
67,63,15,8494,32768,-24274,-74.078369140625
67,64,1,0,2,-2,-100.0
67,64,2,1,4,-3,-75.0
67,64,3,12,8,4,50.0
67,64,4,4,16,-12,-75.0
67,64,5,32,32,0,0.0
67,64,6,57,64,-7,-10.9375
67,64,7,174,128,46,35.9375
67,64,8,623,256,367,143.359375
67,64,9,352,512,-160,-31.25
67,64,10,1831,1024,807,78.80859375
67,64,11,2800,2048,752,36.71875
67,64,12,3565,4096,-531,-12.9638671875
67,64,13,4178,8192,-4014,-48.9990234375
67,64,14,10826,16384,-5558,-33.92333984375
67,64,15,1347,32768,-31421,-95.8892822265625
67,65,1,0,2,-2,-100.0
67,65,2,4,4,0,0.0
67,65,3,3,8,-5,-62.5
67,65,4,3,16,-13,-81.25
67,65,5,65,32,33,103.125
67,65,6,99,64,35,54.6875
67,65,7,11,128,-117,-91.40625
67,65,8,104,256,-152,-59.375
67,65,9,238,512,-274,-53.515625
67,65,10,5864,1024,4840,472.65625
67,65,11,194,2048,-1854,-90.52734375
67,65,12,553,4096,-3543,-86.4990234375
67,65,13,356,8192,-7836,-95.654296875
67,65,14,16430,16384,46,0.28076171875
67,65,15,19062,32768,-13706,-41.827392578125
67,66,1,0,2,-2,-100.0
67,66,2,5,4,1,25.0
67,66,3,6,8,-2,-25.0
67,66,4,9,16,-7,-43.75
67,66,5,10,32,-22,-68.75
67,66,6,101,64,37,57.8125
67,66,7,31,128,-97,-75.78125
67,66,8,542,256,286,111.71875
67,66,9,965,512,453,88.4765625
67,66,10,723,1024,-301,-29.39453125
67,66,11,971,2048,-1077,-52.587890625
67,66,12,413,4096,-3683,-89.9169921875
67,66,13,1296,8192,-6896,-84.1796875
67,66,14,791,16384,-15593,-95.172119140625
67,66,15,70058,32768,37290,113.800048828125
67,67,1,0,2,-2,-100.0
67,67,2,1,4,-3,-75.0
67,67,3,2,8,-6,-75.0
67,67,4,21,16,5,31.25
67,67,5,27,32,-5,-15.625
67,67,6,126,64,62,96.875
67,67,7,17,128,-111,-86.71875
67,67,8,1297,256,1041,406.640625
67,67,9,626,512,114,22.265625
67,67,10,966,1024,-58,-5.6640625
67,67,11,909,2048,-1139,-55.615234375
67,67,12,2046,4096,-2050,-50.048828125
67,67,13,31640,8192,23448,286.23046875
67,67,14,51686,16384,35302,215.46630859375
67,67,15,53035,32768,20267,61.8499755859375
68,1,1,0,2,-2,-100.0
68,1,2,1,4,-3,-75.0
68,1,3,2,8,-6,-75.0
68,1,4,37,16,21,131.25
68,1,5,17,32,-15,-46.875
68,1,6,275,64,211,329.6875
68,1,7,71,128,-57,-44.53125
68,1,8,195,256,-61,-23.828125
68,1,9,77,512,-435,-84.9609375
68,1,10,737,1024,-287,-28.02734375
68,1,11,2355,2048,307,14.990234375
68,1,12,584,4096,-3512,-85.7421875
68,1,13,8314,8192,122,1.4892578125
68,1,14,21632,16384,5248,32.03125
68,1,15,44181,32768,11413,34.8297119140625
68,2,1,0,2,-2,-100.0
68,2,2,3,4,-1,-25.0
68,2,3,2,8,-6,-75.0
68,2,4,6,16,-10,-62.5
68,2,5,9,32,-23,-71.875
68,2,6,67,64,3,4.6875
68,2,7,66,128,-62,-48.4375
68,2,8,164,256,-92,-35.9375
68,2,9,295,512,-217,-42.3828125
68,2,10,151,1024,-873,-85.25390625
68,2,11,1791,2048,-257,-12.548828125
68,2,12,6582,4096,2486,60.693359375
68,2,13,1092,8192,-7100,-86.669921875
68,2,14,16622,16384,238,1.45263671875
68,2,15,54500,32768,21732,66.32080078125
68,3,1,0,2,-2,-100.0
68,3,2,1,4,-3,-75.0
68,3,3,2,8,-6,-75.0
68,3,4,5,16,-11,-68.75
68,3,5,65,32,33,103.125
68,3,6,40,64,-24,-37.5
68,3,7,19,128,-109,-85.15625
68,3,8,66,256,-190,-74.21875
68,3,9,42,512,-470,-91.796875
68,3,10,1583,1024,559,54.58984375
68,3,11,54,2048,-1994,-97.36328125
68,3,12,10548,4096,6452,157.51953125
68,3,13,7277,8192,-915,-11.16943359375
68,3,14,57344,16384,40960,250.0
68,3,15,76181,32768,43413,132.4859619140625
68,4,1,0,2,-2,-100.0
68,4,2,2,4,-2,-50.0
68,4,3,9,8,1,12.5
68,4,4,3,16,-13,-81.25
68,4,5,35,32,3,9.375
68,4,6,5,64,-59,-92.1875
68,4,7,120,128,-8,-6.25
68,4,8,679,256,423,165.234375
68,4,9,230,512,-282,-55.078125
68,4,10,3277,1024,2253,220.01953125
68,4,11,4886,2048,2838,138.57421875
68,4,12,1791,4096,-2305,-56.2744140625
68,4,13,3763,8192,-4429,-54.06494140625
68,4,14,21083,16384,4699,28.680419921875
68,4,15,522,32768,-32246,-98.406982421875
68,5,1,0,2,-2,-100.0
68,5,2,4,4,0,0.0
68,5,3,13,8,5,62.5
68,5,4,3,16,-13,-81.25
68,5,5,56,32,24,75.0
68,5,6,21,64,-43,-67.1875
68,5,7,35,128,-93,-72.65625
68,5,8,26,256,-230,-89.84375
68,5,9,2442,512,1930,376.953125
68,5,10,130,1024,-894,-87.3046875
68,5,11,2805,2048,757,36.962890625
68,5,12,3058,4096,-1038,-25.341796875
68,5,13,5194,8192,-2998,-36.5966796875
68,5,14,2455,16384,-13929,-85.015869140625
68,5,15,36338,32768,3570,10.894775390625
68,6,1,0,2,-2,-100.0
68,6,2,1,4,-3,-75.0
68,6,3,18,8,10,125.0
68,6,4,12,16,-4,-25.0
68,6,5,19,32,-13,-40.625
68,6,6,8,64,-56,-87.5
68,6,7,30,128,-98,-76.5625
68,6,8,276,256,20,7.8125
68,6,9,31,512,-481,-93.9453125
68,6,10,1395,1024,371,36.23046875
68,6,11,1996,2048,-52,-2.5390625
68,6,12,3306,4096,-790,-19.287109375
68,6,13,10253,8192,2061,25.15869140625
68,6,14,22933,16384,6549,39.971923828125
68,6,15,71937,32768,39169,119.5343017578125
68,7,1,0,2,-2,-100.0
68,7,2,1,4,-3,-75.0
68,7,3,13,8,5,62.5
68,7,4,10,16,-6,-37.5
68,7,5,54,32,22,68.75
68,7,6,7,64,-57,-89.0625
68,7,7,32,128,-96,-75.0
68,7,8,409,256,153,59.765625
68,7,9,442,512,-70,-13.671875
68,7,10,330,1024,-694,-67.7734375
68,7,11,1293,2048,-755,-36.865234375
68,7,12,2032,4096,-2064,-50.390625
68,7,13,5575,8192,-2617,-31.94580078125
68,7,14,9510,16384,-6874,-41.95556640625
68,7,15,12897,32768,-19871,-60.6414794921875
68,8,1,0,2,-2,-100.0
68,8,2,3,4,-1,-25.0
68,8,3,8,8,0,0.0
68,8,4,3,16,-13,-81.25
68,8,5,8,32,-24,-75.0
68,8,6,10,64,-54,-84.375
68,8,7,68,128,-60,-46.875
68,8,8,870,256,614,239.84375
68,8,9,706,512,194,37.890625
68,8,10,796,1024,-228,-22.265625
68,8,11,1250,2048,-798,-38.96484375
68,8,12,2736,4096,-1360,-33.203125
68,8,13,2845,8192,-5347,-65.27099609375
68,8,14,5144,16384,-11240,-68.603515625
68,8,15,14577,32768,-18191,-55.5145263671875
68,9,1,0,2,-2,-100.0
68,9,2,1,4,-3,-75.0
68,9,3,2,8,-6,-75.0
68,9,4,8,16,-8,-50.0
68,9,5,68,32,36,112.5
68,9,6,57,64,-7,-10.9375
68,9,7,100,128,-28,-21.875
68,9,8,681,256,425,166.015625
68,9,9,42,512,-470,-91.796875
68,9,10,1164,1024,140,13.671875
68,9,11,3250,2048,1202,58.69140625
68,9,12,3081,4096,-1015,-24.7802734375
68,9,13,31169,8192,22977,280.48095703125
68,9,14,3373,16384,-13011,-79.412841796875
68,9,15,27567,32768,-5201,-15.8721923828125
68,10,1,0,2,-2,-100.0
68,10,2,1,4,-3,-75.0
68,10,3,3,8,-5,-62.5
68,10,4,16,16,0,0.0
68,10,5,4,32,-28,-87.5
68,10,6,9,64,-55,-85.9375
68,10,7,68,128,-60,-46.875
68,10,8,241,256,-15,-5.859375
68,10,9,272,512,-240,-46.875
68,10,10,9,1024,-1015,-99.12109375
68,10,11,179,2048,-1869,-91.259765625
68,10,12,3680,4096,-416,-10.15625
68,10,13,5689,8192,-2503,-30.55419921875
68,10,14,55036,16384,38652,235.9130859375
68,10,15,28607,32768,-4161,-12.6983642578125
68,11,1,0,2,-2,-100.0
68,11,2,5,4,1,25.0
68,11,3,5,8,-3,-37.5
68,11,4,10,16,-6,-37.5
68,11,5,55,32,23,71.875
68,11,6,123,64,59,92.1875
68,11,7,210,128,82,64.0625
68,11,8,218,256,-38,-14.84375
68,11,9,298,512,-214,-41.796875
68,11,10,636,1024,-388,-37.890625
68,11,11,156,2048,-1892,-92.3828125
68,11,12,1843,4096,-2253,-55.0048828125
68,11,13,28724,8192,20532,250.634765625
68,11,14,4077,16384,-12307,-75.115966796875
68,11,15,24062,32768,-8706,-26.568603515625
68,12,1,0,2,-2,-100.0
68,12,2,3,4,-1,-25.0
68,12,3,5,8,-3,-37.5
68,12,4,3,16,-13,-81.25
68,12,5,20,32,-12,-37.5
68,12,6,21,64,-43,-67.1875
68,12,7,154,128,26,20.3125
68,12,8,379,256,123,48.046875
68,12,9,405,512,-107,-20.8984375
68,12,10,1139,1024,115,11.23046875
68,12,11,1607,2048,-441,-21.533203125
68,12,12,9637,4096,5541,135.2783203125
68,12,13,8369,8192,177,2.16064453125
68,12,14,611,16384,-15773,-96.270751953125
68,12,15,83885,32768,51117,155.9967041015625
68,13,1,0,2,-2,-100.0
68,13,2,3,4,-1,-25.0
68,13,3,3,8,-5,-62.5
68,13,4,5,16,-11,-68.75
68,13,5,8,32,-24,-75.0
68,13,6,33,64,-31,-48.4375
68,13,7,79,128,-49,-38.28125
68,13,8,503,256,247,96.484375
68,13,9,1332,512,820,160.15625
68,13,10,39,1024,-985,-96.19140625
68,13,11,1020,2048,-1028,-50.1953125
68,13,12,756,4096,-3340,-81.54296875
68,13,13,6253,8192,-1939,-23.66943359375
68,13,14,7544,16384,-8840,-53.955078125
68,13,15,4079,32768,-28689,-87.5518798828125
68,14,1,0,2,-2,-100.0
68,14,2,1,4,-3,-75.0
68,14,3,2,8,-6,-75.0
68,14,4,9,16,-7,-43.75
68,14,5,53,32,21,65.625
68,14,6,75,64,11,17.1875
68,14,7,195,128,67,52.34375
68,14,8,763,256,507,198.046875
68,14,9,1904,512,1392,271.875
68,14,10,1741,1024,717,70.01953125
68,14,11,460,2048,-1588,-77.5390625
68,14,12,379,4096,-3717,-90.7470703125
68,14,13,5503,8192,-2689,-32.82470703125
68,14,14,953,16384,-15431,-94.183349609375
68,14,15,20515,32768,-12253,-37.3931884765625
68,15,1,0,2,-2,-100.0
68,15,2,3,4,-1,-25.0
68,15,3,10,8,2,25.0
68,15,4,11,16,-5,-31.25
68,15,5,32,32,0,0.0
68,15,6,205,64,141,220.3125
68,15,7,138,128,10,7.8125
68,15,8,65,256,-191,-74.609375
68,15,9,511,512,-1,-0.1953125
68,15,10,703,1024,-321,-31.34765625
68,15,11,2668,2048,620,30.2734375
68,15,12,1391,4096,-2705,-66.0400390625
68,15,13,2844,8192,-5348,-65.283203125
68,15,14,1525,16384,-14859,-90.692138671875
68,15,15,61223,32768,28455,86.8377685546875
68,16,1,0,2,-2,-100.0
68,16,2,1,4,-3,-75.0
68,16,3,2,8,-6,-75.0
68,16,4,9,16,-7,-43.75
68,16,5,11,32,-21,-65.625
68,16,6,264,64,200,312.5
68,16,7,243,128,115,89.84375
68,16,8,80,256,-176,-68.75
68,16,9,320,512,-192,-37.5
68,16,10,113,1024,-911,-88.96484375
68,16,11,4273,2048,2225,108.642578125
68,16,12,7279,4096,3183,77.7099609375
68,16,13,1494,8192,-6698,-81.7626953125
68,16,14,1090,16384,-15294,-93.34716796875
68,16,15,31153,32768,-1615,-4.9285888671875
68,17,1,0,2,-2,-100.0
68,17,2,1,4,-3,-75.0
68,17,3,3,8,-5,-62.5
68,17,4,6,16,-10,-62.5
68,17,5,35,32,3,9.375
68,17,6,6,64,-58,-90.625
68,17,7,94,128,-34,-26.5625
68,17,8,73,256,-183,-71.484375
68,17,9,918,512,406,79.296875
68,17,10,1884,1024,860,83.984375
68,17,11,899,2048,-1149,-56.103515625
68,17,12,504,4096,-3592,-87.6953125
68,17,13,9796,8192,1604,19.580078125
68,17,14,15690,16384,-694,-4.23583984375
68,17,15,7762,32768,-25006,-76.312255859375
68,18,1,0,2,-2,-100.0
68,18,2,1,4,-3,-75.0
68,18,3,5,8,-3,-37.5
68,18,4,11,16,-5,-31.25
68,18,5,78,32,46,143.75
68,18,6,88,64,24,37.5
68,18,7,159,128,31,24.21875
68,18,8,89,256,-167,-65.234375
68,18,9,15,512,-497,-97.0703125
68,18,10,2249,1024,1225,119.62890625
68,18,11,1486,2048,-562,-27.44140625
68,18,12,10721,4096,6625,161.7431640625
68,18,13,1808,8192,-6384,-77.9296875
68,18,14,24707,16384,8323,50.799560546875
68,18,15,6292,32768,-26476,-80.79833984375
68,19,1,0,2,-2,-100.0
68,19,2,2,4,-2,-50.0
68,19,3,11,8,3,37.5
68,19,4,42,16,26,162.5
68,19,5,39,32,7,21.875
68,19,6,100,64,36,56.25
68,19,7,28,128,-100,-78.125
68,19,8,619,256,363,141.796875
68,19,9,136,512,-376,-73.4375
68,19,10,3638,1024,2614,255.2734375
68,19,11,1858,2048,-190,-9.27734375
68,19,12,2651,4096,-1445,-35.2783203125
68,19,13,4587,8192,-3605,-44.00634765625
68,19,14,5896,16384,-10488,-64.013671875
68,19,15,21038,32768,-11730,-35.797119140625
68,20,1,0,2,-2,-100.0
68,20,2,2,4,-2,-50.0
68,20,3,9,8,1,12.5
68,20,4,42,16,26,162.5
68,20,5,8,32,-24,-75.0
68,20,6,217,64,153,239.0625
68,20,7,111,128,-17,-13.28125
68,20,8,97,256,-159,-62.109375
68,20,9,36,512,-476,-92.96875
68,20,10,1102,1024,78,7.6171875
68,20,11,1051,2048,-997,-48.681640625
68,20,12,490,4096,-3606,-88.037109375
68,20,13,2402,8192,-5790,-70.6787109375
68,20,14,18909,16384,2525,15.411376953125
68,20,15,76957,32768,44189,134.8541259765625
68,21,1,0,2,-2,-100.0
68,21,2,1,4,-3,-75.0
68,21,3,2,8,-6,-75.0
68,21,4,6,16,-10,-62.5
68,21,5,29,32,-3,-9.375
68,21,6,60,64,-4,-6.25
68,21,7,147,128,19,14.84375
68,21,8,626,256,370,144.53125
68,21,9,322,512,-190,-37.109375
68,21,10,600,1024,-424,-41.40625
68,21,11,286,2048,-1762,-86.03515625
68,21,12,315,4096,-3781,-92.3095703125
68,21,13,2622,8192,-5570,-67.9931640625
68,21,14,22218,16384,5834,35.60791015625
68,21,15,9540,32768,-23228,-70.88623046875
68,22,1,0,2,-2,-100.0
68,22,2,2,4,-2,-50.0
68,22,3,4,8,-4,-50.0
68,22,4,13,16,-3,-18.75
68,22,5,21,32,-11,-34.375
68,22,6,5,64,-59,-92.1875
68,22,7,467,128,339,264.84375
68,22,8,387,256,131,51.171875
68,22,9,112,512,-400,-78.125
68,22,10,240,1024,-784,-76.5625
68,22,11,6062,2048,4014,195.99609375
68,22,12,6536,4096,2440,59.5703125
68,22,13,2694,8192,-5498,-67.1142578125
68,22,14,11346,16384,-5038,-30.74951171875
68,22,15,44032,32768,11264,34.375
68,23,1,0,2,-2,-100.0
68,23,2,1,4,-3,-75.0
68,23,3,2,8,-6,-75.0
68,23,4,8,16,-8,-50.0
68,23,5,25,32,-7,-21.875
68,23,6,15,64,-49,-76.5625
68,23,7,147,128,19,14.84375
68,23,8,60,256,-196,-76.5625
68,23,9,981,512,469,91.6015625
68,23,10,561,1024,-463,-45.21484375
68,23,11,1067,2048,-981,-47.900390625
68,23,12,1277,4096,-2819,-68.8232421875
68,23,13,9282,8192,1090,13.3056640625
68,23,14,25276,16384,8892,54.2724609375
68,23,15,53386,32768,20618,62.921142578125
68,24,1,0,2,-2,-100.0
68,24,2,1,4,-3,-75.0
68,24,3,3,8,-5,-62.5
68,24,4,4,16,-12,-75.0
68,24,5,108,32,76,237.5
68,24,6,151,64,87,135.9375
68,24,7,19,128,-109,-85.15625
68,24,8,267,256,11,4.296875
68,24,9,1951,512,1439,281.0546875
68,24,10,502,1024,-522,-50.9765625
68,24,11,1279,2048,-769,-37.548828125
68,24,12,11696,4096,7600,185.546875
68,24,13,11792,8192,3600,43.9453125
68,24,14,13297,16384,-3087,-18.841552734375
68,24,15,12900,32768,-19868,-60.63232421875
68,25,1,0,2,-2,-100.0
68,25,2,1,4,-3,-75.0
68,25,3,12,8,4,50.0
68,25,4,8,16,-8,-50.0
68,25,5,9,32,-23,-71.875
68,25,6,96,64,32,50.0
68,25,7,12,128,-116,-90.625
68,25,8,22,256,-234,-91.40625
68,25,9,629,512,117,22.8515625
68,25,10,4195,1024,3171,309.66796875
68,25,11,778,2048,-1270,-62.01171875
68,25,12,4082,4096,-14,-0.341796875
68,25,13,6934,8192,-1258,-15.3564453125
68,25,14,23054,16384,6670,40.71044921875
68,25,15,87583,32768,54815,167.2821044921875
68,26,1,0,2,-2,-100.0
68,26,2,2,4,-2,-50.0
68,26,3,4,8,-4,-50.0
68,26,4,7,16,-9,-56.25
68,26,5,12,32,-20,-62.5
68,26,6,117,64,53,82.8125
68,26,7,144,128,16,12.5
68,26,8,147,256,-109,-42.578125
68,26,9,404,512,-108,-21.09375
68,26,10,1106,1024,82,8.0078125
68,26,11,1670,2048,-378,-18.45703125
68,26,12,304,4096,-3792,-92.578125
68,26,13,38283,8192,30091,367.32177734375
68,26,14,4357,16384,-12027,-73.406982421875
68,26,15,40675,32768,7907,24.1302490234375
68,27,1,0,2,-2,-100.0
68,27,2,1,4,-3,-75.0
68,27,3,7,8,-1,-12.5
68,27,4,7,16,-9,-56.25
68,27,5,4,32,-28,-87.5
68,27,6,36,64,-28,-43.75
68,27,7,137,128,9,7.03125
68,27,8,131,256,-125,-48.828125
68,27,9,373,512,-139,-27.1484375
68,27,10,112,1024,-912,-89.0625
68,27,11,4339,2048,2291,111.865234375
68,27,12,9477,4096,5381,131.3720703125
68,27,13,9549,8192,1357,16.56494140625
68,27,14,20930,16384,4546,27.74658203125
68,27,15,14691,32768,-18077,-55.1666259765625
68,28,1,0,2,-2,-100.0
68,28,2,1,4,-3,-75.0
68,28,3,24,8,16,200.0
68,28,4,9,16,-7,-43.75
68,28,5,28,32,-4,-12.5
68,28,6,63,64,-1,-1.5625
68,28,7,71,128,-57,-44.53125
68,28,8,379,256,123,48.046875
68,28,9,301,512,-211,-41.2109375
68,28,10,283,1024,-741,-72.36328125
68,28,11,795,2048,-1253,-61.181640625
68,28,12,13409,4096,9313,227.3681640625
68,28,13,18954,8192,10762,131.3720703125
68,28,14,41180,16384,24796,151.3427734375
68,28,15,16496,32768,-16272,-49.658203125
68,29,1,0,2,-2,-100.0
68,29,2,3,4,-1,-25.0
68,29,3,11,8,3,37.5
68,29,4,7,16,-9,-56.25
68,29,5,12,32,-20,-62.5
68,29,6,9,64,-55,-85.9375
68,29,7,62,128,-66,-51.5625
68,29,8,443,256,187,73.046875
68,29,9,146,512,-366,-71.484375
68,29,10,854,1024,-170,-16.6015625
68,29,11,1193,2048,-855,-41.748046875
68,29,12,5352,4096,1256,30.6640625
68,29,13,5680,8192,-2512,-30.6640625
68,29,14,711,16384,-15673,-95.660400390625
68,29,15,13405,32768,-19363,-59.0911865234375
68,30,1,0,2,-2,-100.0
68,30,2,5,4,1,25.0
68,30,3,11,8,3,37.5
68,30,4,11,16,-5,-31.25
68,30,5,47,32,15,46.875
68,30,6,53,64,-11,-17.1875
68,30,7,93,128,-35,-27.34375
68,30,8,485,256,229,89.453125
68,30,9,810,512,298,58.203125
68,30,10,805,1024,-219,-21.38671875
68,30,11,668,2048,-1380,-67.3828125
68,30,12,3105,4096,-991,-24.1943359375
68,30,13,11369,8192,3177,38.78173828125
68,30,14,1981,16384,-14403,-87.908935546875
68,30,15,14304,32768,-18464,-56.34765625
68,31,1,0,2,-2,-100.0
68,31,2,1,4,-3,-75.0
68,31,3,4,8,-4,-50.0
68,31,4,8,16,-8,-50.0
68,31,5,5,32,-27,-84.375
68,31,6,140,64,76,118.75
68,31,7,59,128,-69,-53.90625
68,31,8,99,256,-157,-61.328125
68,31,9,224,512,-288,-56.25
68,31,10,698,1024,-326,-31.8359375
68,31,11,3783,2048,1735,84.716796875
68,31,12,877,4096,-3219,-78.5888671875
68,31,13,5555,8192,-2637,-32.18994140625
68,31,14,1102,16384,-15282,-93.27392578125
68,31,15,21984,32768,-10784,-32.91015625
68,32,1,0,2,-2,-100.0
68,32,2,3,4,-1,-25.0
68,32,3,2,8,-6,-75.0
68,32,4,6,16,-10,-62.5
68,32,5,29,32,-3,-9.375
68,32,6,64,64,0,0.0
68,32,7,104,128,-24,-18.75
68,32,8,358,256,102,39.84375
68,32,9,67,512,-445,-86.9140625
68,32,10,30,1024,-994,-97.0703125
68,32,11,551,2048,-1497,-73.095703125
68,32,12,13,4096,-4083,-99.6826171875
68,32,13,5420,8192,-2772,-33.837890625
68,32,14,10556,16384,-5828,-35.5712890625
68,32,15,151631,32768,118863,362.7410888671875
68,33,1,0,2,-2,-100.0
68,33,2,5,4,1,25.0
68,33,3,11,8,3,37.5
68,33,4,35,16,19,118.75
68,33,5,7,32,-25,-78.125
68,33,6,5,64,-59,-92.1875
68,33,7,65,128,-63,-49.21875
68,33,8,289,256,33,12.890625
68,33,9,663,512,151,29.4921875
68,33,10,267,1024,-757,-73.92578125
68,33,11,168,2048,-1880,-91.796875
68,33,12,3272,4096,-824,-20.1171875
68,33,13,4317,8192,-3875,-47.30224609375
68,33,14,6241,16384,-10143,-61.907958984375
68,33,15,35061,32768,2293,6.9976806640625
68,34,1,0,2,-2,-100.0
68,34,2,2,4,-2,-50.0
68,34,3,6,8,-2,-25.0
68,34,4,9,16,-7,-43.75
68,34,5,11,32,-21,-65.625
68,34,6,49,64,-15,-23.4375
68,34,7,37,128,-91,-71.09375
68,34,8,395,256,139,54.296875
68,34,9,926,512,414,80.859375
68,34,10,577,1024,-447,-43.65234375
68,34,11,3874,2048,1826,89.16015625
68,34,12,1867,4096,-2229,-54.4189453125
68,34,13,6404,8192,-1788,-21.826171875
68,34,14,25951,16384,9567,58.392333984375
68,34,15,5641,32768,-27127,-82.7850341796875
68,35,1,0,2,-2,-100.0
68,35,2,4,4,0,0.0
68,35,3,7,8,-1,-12.5
68,35,4,9,16,-7,-43.75
68,35,5,75,32,43,134.375
68,35,6,6,64,-58,-90.625
68,35,7,188,128,60,46.875
68,35,8,142,256,-114,-44.53125
68,35,9,363,512,-149,-29.1015625
68,35,10,4481,1024,3457,337.59765625
68,35,11,4836,2048,2788,136.1328125
68,35,12,5531,4096,1435,35.0341796875
68,35,13,4248,8192,-3944,-48.14453125
68,35,14,17164,16384,780,4.7607421875
68,35,15,53132,32768,20364,62.14599609375
68,36,1,0,2,-2,-100.0
68,36,2,1,4,-3,-75.0
68,36,3,2,8,-6,-75.0
68,36,4,4,16,-12,-75.0
68,36,5,45,32,13,40.625
68,36,6,42,64,-22,-34.375
68,36,7,9,128,-119,-92.96875
68,36,8,164,256,-92,-35.9375
68,36,9,895,512,383,74.8046875
68,36,10,344,1024,-680,-66.40625
68,36,11,1031,2048,-1017,-49.658203125
68,36,12,2274,4096,-1822,-44.482421875
68,36,13,15024,8192,6832,83.3984375
68,36,14,2910,16384,-13474,-82.23876953125
68,36,15,18482,32768,-14286,-43.597412109375
68,37,1,0,2,-2,-100.0
68,37,2,3,4,-1,-25.0
68,37,3,4,8,-4,-50.0
68,37,4,8,16,-8,-50.0
68,37,5,4,32,-28,-87.5
68,37,6,14,64,-50,-78.125
68,37,7,405,128,277,216.40625
68,37,8,150,256,-106,-41.40625
68,37,9,1296,512,784,153.125
68,37,10,633,1024,-391,-38.18359375
68,37,11,294,2048,-1754,-85.64453125
68,37,12,4004,4096,-92,-2.24609375
68,37,13,28702,8192,20510,250.3662109375
68,37,14,21793,16384,5409,33.013916015625
68,37,15,43541,32768,10773,32.8765869140625
68,38,1,0,2,-2,-100.0
68,38,2,1,4,-3,-75.0
68,38,3,16,8,8,100.0
68,38,4,33,16,17,106.25
68,38,5,4,32,-28,-87.5
68,38,6,81,64,17,26.5625
68,38,7,185,128,57,44.53125
68,38,8,380,256,124,48.4375
68,38,9,1018,512,506,98.828125
68,38,10,157,1024,-867,-84.66796875
68,38,11,2147,2048,99,4.833984375
68,38,12,865,4096,-3231,-78.8818359375
68,38,13,2515,8192,-5677,-69.29931640625
68,38,14,6420,16384,-9964,-60.8154296875
68,38,15,13429,32768,-19339,-59.0179443359375
68,39,1,0,2,-2,-100.0
68,39,2,1,4,-3,-75.0
68,39,3,4,8,-4,-50.0
68,39,4,7,16,-9,-56.25
68,39,5,33,32,1,3.125
68,39,6,20,64,-44,-68.75
68,39,7,49,128,-79,-61.71875
68,39,8,127,256,-129,-50.390625
68,39,9,1401,512,889,173.6328125
68,39,10,1398,1024,374,36.5234375
68,39,11,1760,2048,-288,-14.0625
68,39,12,944,4096,-3152,-76.953125
68,39,13,6280,8192,-1912,-23.33984375
68,39,14,4500,16384,-11884,-72.5341796875
68,39,15,37049,32768,4281,13.0645751953125
68,40,1,0,2,-2,-100.0
68,40,2,4,4,0,0.0
68,40,3,2,8,-6,-75.0
68,40,4,13,16,-3,-18.75
68,40,5,7,32,-25,-78.125
68,40,6,43,64,-21,-32.8125
68,40,7,164,128,36,28.125
68,40,8,307,256,51,19.921875
68,40,9,886,512,374,73.046875
68,40,10,1258,1024,234,22.8515625
68,40,11,1765,2048,-283,-13.818359375
68,40,12,940,4096,-3156,-77.05078125
68,40,13,5662,8192,-2530,-30.8837890625
68,40,14,14042,16384,-2342,-14.29443359375
68,40,15,13533,32768,-19235,-58.7005615234375
68,41,1,0,2,-2,-100.0
68,41,2,1,4,-3,-75.0
68,41,3,5,8,-3,-37.5
68,41,4,21,16,5,31.25
68,41,5,22,32,-10,-31.25
68,41,6,175,64,111,173.4375
68,41,7,59,128,-69,-53.90625
68,41,8,104,256,-152,-59.375
68,41,9,212,512,-300,-58.59375
68,41,10,1623,1024,599,58.49609375
68,41,11,152,2048,-1896,-92.578125
68,41,12,501,4096,-3595,-87.7685546875
68,41,13,17388,8192,9196,112.255859375
68,41,14,11814,16384,-4570,-27.89306640625
68,41,15,2107,32768,-30661,-93.5699462890625
68,42,1,0,2,-2,-100.0
68,42,2,2,4,-2,-50.0
68,42,3,8,8,0,0.0
68,42,4,5,16,-11,-68.75
68,42,5,116,32,84,262.5
68,42,6,13,64,-51,-79.6875
68,42,7,68,128,-60,-46.875
68,42,8,108,256,-148,-57.8125
68,42,9,692,512,180,35.15625
68,42,10,1414,1024,390,38.0859375
68,42,11,3150,2048,1102,53.80859375
68,42,12,1799,4096,-2297,-56.0791015625
68,42,13,2080,8192,-6112,-74.609375
68,42,14,32511,16384,16127,98.431396484375
68,42,15,76263,32768,43495,132.7362060546875
68,43,1,0,2,-2,-100.0
68,43,2,1,4,-3,-75.0
68,43,3,8,8,0,0.0
68,43,4,21,16,5,31.25
68,43,5,23,32,-9,-28.125
68,43,6,21,64,-43,-67.1875
68,43,7,71,128,-57,-44.53125
68,43,8,905,256,649,253.515625
68,43,9,69,512,-443,-86.5234375
68,43,10,1998,1024,974,95.1171875
68,43,11,4651,2048,2603,127.099609375
68,43,12,4493,4096,397,9.6923828125
68,43,13,7853,8192,-339,-4.13818359375
68,43,14,8097,16384,-8287,-50.579833984375
68,43,15,6307,32768,-26461,-80.7525634765625
68,44,1,0,2,-2,-100.0
68,44,2,1,4,-3,-75.0
68,44,3,2,8,-6,-75.0
68,44,4,13,16,-3,-18.75
68,44,5,10,32,-22,-68.75
68,44,6,9,64,-55,-85.9375
68,44,7,37,128,-91,-71.09375
68,44,8,93,256,-163,-63.671875
68,44,9,2451,512,1939,378.7109375
68,44,10,1174,1024,150,14.6484375
68,44,11,5767,2048,3719,181.591796875
68,44,12,1410,4096,-2686,-65.576171875
68,44,13,14982,8192,6790,82.8857421875
68,44,14,17103,16384,719,4.388427734375
68,44,15,42006,32768,9238,28.192138671875
68,45,1,0,2,-2,-100.0
68,45,2,8,4,4,100.0
68,45,3,2,8,-6,-75.0
68,45,4,59,16,43,268.75
68,45,5,11,32,-21,-65.625
68,45,6,13,64,-51,-79.6875
68,45,7,78,128,-50,-39.0625
68,45,8,182,256,-74,-28.90625
68,45,9,545,512,33,6.4453125
68,45,10,160,1024,-864,-84.375
68,45,11,1010,2048,-1038,-50.68359375
68,45,12,3153,4096,-943,-23.0224609375
68,45,13,12557,8192,4365,53.28369140625
68,45,14,15064,16384,-1320,-8.056640625
68,45,15,67634,32768,34866,106.402587890625
68,46,1,0,2,-2,-100.0
68,46,2,2,4,-2,-50.0
68,46,3,2,8,-6,-75.0
68,46,4,17,16,1,6.25
68,46,5,12,32,-20,-62.5
68,46,6,28,64,-36,-56.25
68,46,7,99,128,-29,-22.65625
68,46,8,50,256,-206,-80.46875
68,46,9,163,512,-349,-68.1640625
68,46,10,1320,1024,296,28.90625
68,46,11,383,2048,-1665,-81.298828125
68,46,12,724,4096,-3372,-82.32421875
68,46,13,2400,8192,-5792,-70.703125
68,46,14,12408,16384,-3976,-24.267578125
68,46,15,6501,32768,-26267,-80.1605224609375
68,47,1,0,2,-2,-100.0
68,47,2,3,4,-1,-25.0
68,47,3,8,8,0,0.0
68,47,4,9,16,-7,-43.75
68,47,5,17,32,-15,-46.875
68,47,6,29,64,-35,-54.6875
68,47,7,64,128,-64,-50.0
68,47,8,156,256,-100,-39.0625
68,47,9,250,512,-262,-51.171875
68,47,10,1494,1024,470,45.8984375
68,47,11,293,2048,-1755,-85.693359375
68,47,12,2497,4096,-1599,-39.0380859375
68,47,13,6164,8192,-2028,-24.755859375
68,47,14,18092,16384,1708,10.4248046875
68,47,15,7471,32768,-25297,-77.2003173828125
68,48,1,0,2,-2,-100.0
68,48,2,2,4,-2,-50.0
68,48,3,10,8,2,25.0
68,48,4,3,16,-13,-81.25
68,48,5,13,32,-19,-59.375
68,48,6,12,64,-52,-81.25
68,48,7,49,128,-79,-61.71875
68,48,8,141,256,-115,-44.921875
68,48,9,228,512,-284,-55.46875
68,48,10,75,1024,-949,-92.67578125
68,48,11,893,2048,-1155,-56.396484375
68,48,12,11275,4096,7179,175.2685546875
68,48,13,709,8192,-7483,-91.34521484375
68,48,14,8767,16384,-7617,-46.490478515625
68,48,15,2964,32768,-29804,-90.95458984375
68,49,1,0,2,-2,-100.0
68,49,2,1,4,-3,-75.0
68,49,3,3,8,-5,-62.5
68,49,4,8,16,-8,-50.0
68,49,5,12,32,-20,-62.5
68,49,6,60,64,-4,-6.25
68,49,7,444,128,316,246.875
68,49,8,218,256,-38,-14.84375
68,49,9,122,512,-390,-76.171875
68,49,10,1153,1024,129,12.59765625
68,49,11,3924,2048,1876,91.6015625
68,49,12,5014,4096,918,22.412109375
68,49,13,1237,8192,-6955,-84.89990234375
68,49,14,6390,16384,-9994,-60.99853515625
68,49,15,76103,32768,43335,132.2479248046875
68,50,1,0,2,-2,-100.0
68,50,2,1,4,-3,-75.0
68,50,3,5,8,-3,-37.5
68,50,4,7,16,-9,-56.25
68,50,5,50,32,18,56.25
68,50,6,173,64,109,170.3125
68,50,7,116,128,-12,-9.375
68,50,8,263,256,7,2.734375
68,50,9,422,512,-90,-17.578125
68,50,10,4155,1024,3131,305.76171875
68,50,11,3725,2048,1677,81.884765625
68,50,12,858,4096,-3238,-79.052734375
68,50,13,14467,8192,6275,76.59912109375
68,50,14,1811,16384,-14573,-88.946533203125
68,50,15,43498,32768,10730,32.745361328125
68,51,1,0,2,-2,-100.0
68,51,2,2,4,-2,-50.0
68,51,3,7,8,-1,-12.5
68,51,4,23,16,7,43.75
68,51,5,18,32,-14,-43.75
68,51,6,68,64,4,6.25
68,51,7,43,128,-85,-66.40625
68,51,8,369,256,113,44.140625
68,51,9,979,512,467,91.2109375
68,51,10,519,1024,-505,-49.31640625
68,51,11,2315,2048,267,13.037109375
68,51,12,1627,4096,-2469,-60.2783203125
68,51,13,717,8192,-7475,-91.24755859375
68,51,14,8853,16384,-7531,-45.965576171875
68,51,15,34361,32768,1593,4.8614501953125
68,52,1,0,2,-2,-100.0
68,52,2,1,4,-3,-75.0
68,52,3,2,8,-6,-75.0
68,52,4,9,16,-7,-43.75
68,52,5,7,32,-25,-78.125
68,52,6,16,64,-48,-75.0
68,52,7,465,128,337,263.28125
68,52,8,556,256,300,117.1875
68,52,9,190,512,-322,-62.890625
68,52,10,2223,1024,1199,117.08984375
68,52,11,1968,2048,-80,-3.90625
68,52,12,5666,4096,1570,38.330078125
68,52,13,2365,8192,-5827,-71.13037109375
68,52,14,1739,16384,-14645,-89.385986328125
68,52,15,36045,32768,3277,10.0006103515625
68,53,1,0,2,-2,-100.0
68,53,2,1,4,-3,-75.0
68,53,3,5,8,-3,-37.5
68,53,4,25,16,9,56.25
68,53,5,10,32,-22,-68.75
68,53,6,25,64,-39,-60.9375
68,53,7,366,128,238,185.9375
68,53,8,179,256,-77,-30.078125
68,53,9,216,512,-296,-57.8125
68,53,10,1234,1024,210,20.5078125
68,53,11,587,2048,-1461,-71.337890625
68,53,12,5478,4096,1382,33.740234375
68,53,13,12935,8192,4743,57.89794921875
68,53,14,29844,16384,13460,82.1533203125
68,53,15,6069,32768,-26699,-81.4788818359375
68,54,1,0,2,-2,-100.0
68,54,2,1,4,-3,-75.0
68,54,3,2,8,-6,-75.0
68,54,4,7,16,-9,-56.25
68,54,5,7,32,-25,-78.125
68,54,6,82,64,18,28.125
68,54,7,23,128,-105,-82.03125
68,54,8,188,256,-68,-26.5625
68,54,9,169,512,-343,-66.9921875
68,54,10,2397,1024,1373,134.08203125
68,54,11,1732,2048,-316,-15.4296875
68,54,12,8500,4096,4404,107.51953125
68,54,13,21273,8192,13081,159.68017578125
68,54,14,7717,16384,-8667,-52.899169921875
68,54,15,132165,32768,99397,303.3355712890625
68,55,1,0,2,-2,-100.0
68,55,2,2,4,-2,-50.0
68,55,3,2,8,-6,-75.0
68,55,4,10,16,-6,-37.5
68,55,5,65,32,33,103.125
68,55,6,18,64,-46,-71.875
68,55,7,106,128,-22,-17.1875
68,55,8,238,256,-18,-7.03125
68,55,9,958,512,446,87.109375
68,55,10,197,1024,-827,-80.76171875
68,55,11,1845,2048,-203,-9.912109375
68,55,12,10667,4096,6571,160.4248046875
68,55,13,15098,8192,6906,84.3017578125
68,55,14,60408,16384,44024,268.701171875
68,55,15,3117,32768,-29651,-90.4876708984375
68,56,1,0,2,-2,-100.0
68,56,2,2,4,-2,-50.0
68,56,3,2,8,-6,-75.0
68,56,4,4,16,-12,-75.0
68,56,5,12,32,-20,-62.5
68,56,6,23,64,-41,-64.0625
68,56,7,240,128,112,87.5
68,56,8,641,256,385,150.390625
68,56,9,155,512,-357,-69.7265625
68,56,10,3506,1024,2482,242.3828125
68,56,11,3138,2048,1090,53.22265625
68,56,12,440,4096,-3656,-89.2578125
68,56,13,11469,8192,3277,40.00244140625
68,56,14,46231,16384,29847,182.171630859375
68,56,15,16484,32768,-16284,-49.69482421875
68,57,1,0,2,-2,-100.0
68,57,2,2,4,-2,-50.0
68,57,3,5,8,-3,-37.5
68,57,4,26,16,10,62.5
68,57,5,52,32,20,62.5
68,57,6,42,64,-22,-34.375
68,57,7,94,128,-34,-26.5625
68,57,8,62,256,-194,-75.78125
68,57,9,817,512,305,59.5703125
68,57,10,254,1024,-770,-75.1953125
68,57,11,4017,2048,1969,96.142578125
68,57,12,15228,4096,11132,271.77734375
68,57,13,9722,8192,1530,18.6767578125
68,57,14,606,16384,-15778,-96.30126953125
68,57,15,31476,32768,-1292,-3.94287109375
68,58,1,0,2,-2,-100.0
68,58,2,1,4,-3,-75.0
68,58,3,2,8,-6,-75.0
68,58,4,6,16,-10,-62.5
68,58,5,80,32,48,150.0
68,58,6,119,64,55,85.9375
68,58,7,172,128,44,34.375
68,58,8,49,256,-207,-80.859375
68,58,9,524,512,12,2.34375
68,58,10,975,1024,-49,-4.78515625
68,58,11,1540,2048,-508,-24.8046875
68,58,12,452,4096,-3644,-88.96484375
68,58,13,1800,8192,-6392,-78.02734375
68,58,14,11496,16384,-4888,-29.833984375
68,58,15,11326,32768,-21442,-65.435791015625
68,59,1,0,2,-2,-100.0
68,59,2,2,4,-2,-50.0
68,59,3,5,8,-3,-37.5
68,59,4,8,16,-8,-50.0
68,59,5,29,32,-3,-9.375
68,59,6,40,64,-24,-37.5
68,59,7,46,128,-82,-64.0625
68,59,8,502,256,246,96.09375
68,59,9,1614,512,1102,215.234375
68,59,10,623,1024,-401,-39.16015625
68,59,11,149,2048,-1899,-92.724609375
68,59,12,652,4096,-3444,-84.08203125
68,59,13,13754,8192,5562,67.8955078125
68,59,14,4936,16384,-11448,-69.873046875
68,59,15,17093,32768,-15675,-47.8363037109375
68,60,1,0,2,-2,-100.0
68,60,2,5,4,1,25.0
68,60,3,2,8,-6,-75.0
68,60,4,5,16,-11,-68.75
68,60,5,39,32,7,21.875
68,60,6,81,64,17,26.5625
68,60,7,32,128,-96,-75.0
68,60,8,7,256,-249,-97.265625
68,60,9,347,512,-165,-32.2265625
68,60,10,1061,1024,37,3.61328125
68,60,11,2941,2048,893,43.603515625
68,60,12,3274,4096,-822,-20.068359375
68,60,13,321,8192,-7871,-96.08154296875
68,60,14,16361,16384,-23,-0.140380859375
68,60,15,74325,32768,41557,126.8218994140625
68,61,1,0,2,-2,-100.0
68,61,2,4,4,0,0.0
68,61,3,6,8,-2,-25.0
68,61,4,7,16,-9,-56.25
68,61,5,18,32,-14,-43.75
68,61,6,40,64,-24,-37.5
68,61,7,152,128,24,18.75
68,61,8,81,256,-175,-68.359375
68,61,9,377,512,-135,-26.3671875
68,61,10,484,1024,-540,-52.734375
68,61,11,1260,2048,-788,-38.4765625
68,61,12,1755,4096,-2341,-57.1533203125
68,61,13,21069,8192,12877,157.18994140625
68,61,14,38137,16384,21753,132.769775390625
68,61,15,58089,32768,25321,77.2735595703125
68,62,1,0,2,-2,-100.0
68,62,2,1,4,-3,-75.0
68,62,3,2,8,-6,-75.0
68,62,4,8,16,-8,-50.0
68,62,5,40,32,8,25.0
68,62,6,22,64,-42,-65.625
68,62,7,359,128,231,180.46875
68,62,8,851,256,595,232.421875
68,62,9,106,512,-406,-79.296875
68,62,10,63,1024,-961,-93.84765625
68,62,11,8024,2048,5976,291.796875
68,62,12,4423,4096,327,7.9833984375
68,62,13,3139,8192,-5053,-61.68212890625
68,62,14,24813,16384,8429,51.446533203125
68,62,15,35830,32768,3062,9.344482421875
68,63,1,0,2,-2,-100.0
68,63,2,1,4,-3,-75.0
68,63,3,5,8,-3,-37.5
68,63,4,15,16,-1,-6.25
68,63,5,18,32,-14,-43.75
68,63,6,29,64,-35,-54.6875
68,63,7,67,128,-61,-47.65625
68,63,8,21,256,-235,-91.796875
68,63,9,1449,512,937,183.0078125
68,63,10,1081,1024,57,5.56640625
68,63,11,5825,2048,3777,184.423828125
68,63,12,1931,4096,-2165,-52.8564453125
68,63,13,4345,8192,-3847,-46.96044921875
68,63,14,7987,16384,-8397,-51.251220703125
68,63,15,6134,32768,-26634,-81.280517578125
68,64,1,0,2,-2,-100.0
68,64,2,3,4,-1,-25.0
68,64,3,2,8,-6,-75.0
68,64,4,32,16,16,100.0
68,64,5,48,32,16,50.0
68,64,6,20,64,-44,-68.75
68,64,7,159,128,31,24.21875
68,64,8,141,256,-115,-44.921875
68,64,9,203,512,-309,-60.3515625
68,64,10,90,1024,-934,-91.2109375
68,64,11,159,2048,-1889,-92.236328125
68,64,12,2432,4096,-1664,-40.625
68,64,13,641,8192,-7551,-92.17529296875
68,64,14,15887,16384,-497,-3.033447265625
68,64,15,7284,32768,-25484,-77.77099609375
68,65,1,0,2,-2,-100.0
68,65,2,3,4,-1,-25.0
68,65,3,23,8,15,187.5
68,65,4,9,16,-7,-43.75
68,65,5,61,32,29,90.625
68,65,6,11,64,-53,-82.8125
68,65,7,56,128,-72,-56.25
68,65,8,58,256,-198,-77.34375
68,65,9,447,512,-65,-12.6953125
68,65,10,780,1024,-244,-23.828125
68,65,11,114,2048,-1934,-94.43359375
68,65,12,11869,4096,7773,189.7705078125
68,65,13,955,8192,-7237,-88.34228515625
68,65,14,14653,16384,-1731,-10.565185546875
68,65,15,12490,32768,-20278,-61.883544921875
68,66,1,0,2,-2,-100.0
68,66,2,1,4,-3,-75.0
68,66,3,2,8,-6,-75.0
68,66,4,3,16,-13,-81.25
68,66,5,31,32,-1,-3.125
68,66,6,120,64,56,87.5
68,66,7,189,128,61,47.65625
68,66,8,15,256,-241,-94.140625
68,66,9,373,512,-139,-27.1484375
68,66,10,3350,1024,2326,227.1484375
68,66,11,178,2048,-1870,-91.30859375
68,66,12,3050,4096,-1046,-25.537109375
68,66,13,1557,8192,-6635,-80.99365234375
68,66,14,29477,16384,13093,79.913330078125
68,66,15,16332,32768,-16436,-50.15869140625
68,67,1,0,2,-2,-100.0
68,67,2,4,4,0,0.0
68,67,3,6,8,-2,-25.0
68,67,4,17,16,1,6.25
68,67,5,12,32,-20,-62.5
68,67,6,56,64,-8,-12.5
68,67,7,66,128,-62,-48.4375
68,67,8,160,256,-96,-37.5
68,67,9,1066,512,554,108.203125
68,67,10,279,1024,-745,-72.75390625
68,67,11,738,2048,-1310,-63.96484375
68,67,12,6554,4096,2458,60.009765625
68,67,13,8726,8192,534,6.5185546875
68,67,14,7927,16384,-8457,-51.617431640625
68,67,15,1902,32768,-30866,-94.195556640625
68,68,1,0,2,-2,-100.0
68,68,2,1,4,-3,-75.0
68,68,3,11,8,3,37.5
68,68,4,16,16,0,0.0
68,68,5,4,32,-28,-87.5
68,68,6,92,64,28,43.75
68,68,7,195,128,67,52.34375
68,68,8,41,256,-215,-83.984375
68,68,9,222,512,-290,-56.640625
68,68,10,108,1024,-916,-89.453125
68,68,11,1316,2048,-732,-35.7421875
68,68,12,1491,4096,-2605,-63.5986328125
68,68,13,6479,8192,-1713,-20.91064453125
68,68,14,22738,16384,6354,38.78173828125
68,68,15,40505,32768,7737,23.6114501953125
69,1,1,0,2,-2,-100.0
69,1,2,1,4,-3,-75.0
69,1,3,8,8,0,0.0
69,1,4,8,16,-8,-50.0
69,1,5,18,32,-14,-43.75
69,1,6,50,64,-14,-21.875
69,1,7,67,128,-61,-47.65625
69,1,8,213,256,-43,-16.796875
69,1,9,1674,512,1162,226.953125
69,1,10,118,1024,-906,-88.4765625
69,1,11,924,2048,-1124,-54.8828125
69,1,12,1558,4096,-2538,-61.962890625
69,1,13,5887,8192,-2305,-28.13720703125
69,1,14,372,16384,-16012,-97.7294921875
69,1,15,11389,32768,-21379,-65.2435302734375
69,2,1,0,2,-2,-100.0
69,2,2,3,4,-1,-25.0
69,2,3,2,8,-6,-75.0
69,2,4,5,16,-11,-68.75
69,2,5,25,32,-7,-21.875
69,2,6,23,64,-41,-64.0625
69,2,7,168,128,40,31.25
69,2,8,49,256,-207,-80.859375
69,2,9,208,512,-304,-59.375
69,2,10,635,1024,-389,-37.98828125
69,2,11,305,2048,-1743,-85.107421875
69,2,12,10299,4096,6203,151.4404296875
69,2,13,4345,8192,-3847,-46.96044921875
69,2,14,4115,16384,-12269,-74.884033203125
69,2,15,6819,32768,-25949,-79.1900634765625
69,3,1,0,2,-2,-100.0
69,3,2,3,4,-1,-25.0
69,3,3,6,8,-2,-25.0
69,3,4,18,16,2,12.5
69,3,5,16,32,-16,-50.0
69,3,6,12,64,-52,-81.25
69,3,7,100,128,-28,-21.875
69,3,8,57,256,-199,-77.734375
69,3,9,457,512,-55,-10.7421875
69,3,10,465,1024,-559,-54.58984375
69,3,11,1074,2048,-974,-47.55859375
69,3,12,699,4096,-3397,-82.9345703125
69,3,13,13953,8192,5761,70.32470703125
69,3,14,7506,16384,-8878,-54.18701171875
69,3,15,23453,32768,-9315,-28.4271240234375
69,4,1,0,2,-2,-100.0
69,4,2,3,4,-1,-25.0
69,4,3,17,8,9,112.5
69,4,4,24,16,8,50.0
69,4,5,70,32,38,118.75
69,4,6,20,64,-44,-68.75
69,4,7,138,128,10,7.8125
69,4,8,112,256,-144,-56.25
69,4,9,151,512,-361,-70.5078125
69,4,10,1093,1024,69,6.73828125
69,4,11,9021,2048,6973,340.478515625
69,4,12,6039,4096,1943,47.4365234375
69,4,13,2078,8192,-6114,-74.6337890625
69,4,14,9318,16384,-7066,-43.12744140625
69,4,15,13059,32768,-19709,-60.1470947265625
69,5,1,0,2,-2,-100.0
69,5,2,2,4,-2,-50.0
69,5,3,22,8,14,175.0
69,5,4,22,16,6,37.5
69,5,5,26,32,-6,-18.75
69,5,6,34,64,-30,-46.875
69,5,7,229,128,101,78.90625
69,5,8,125,256,-131,-51.171875
69,5,9,1248,512,736,143.75
69,5,10,375,1024,-649,-63.37890625
69,5,11,1149,2048,-899,-43.896484375
69,5,12,2504,4096,-1592,-38.8671875
69,5,13,1551,8192,-6641,-81.06689453125
69,5,14,19104,16384,2720,16.6015625
69,5,15,68265,32768,35497,108.3282470703125
69,6,1,0,2,-2,-100.0
69,6,2,3,4,-1,-25.0
69,6,3,27,8,19,237.5
69,6,4,37,16,21,131.25
69,6,5,18,32,-14,-43.75
69,6,6,76,64,12,18.75
69,6,7,182,128,54,42.1875
69,6,8,72,256,-184,-71.875
69,6,9,640,512,128,25.0
69,6,10,897,1024,-127,-12.40234375
69,6,11,977,2048,-1071,-52.294921875
69,6,12,64,4096,-4032,-98.4375
69,6,13,21564,8192,13372,163.232421875
69,6,14,3685,16384,-12699,-77.508544921875
69,6,15,131196,32768,98428,300.37841796875
69,7,1,0,2,-2,-100.0
69,7,2,1,4,-3,-75.0
69,7,3,2,8,-6,-75.0
69,7,4,24,16,8,50.0
69,7,5,61,32,29,90.625
69,7,6,16,64,-48,-75.0
69,7,7,33,128,-95,-74.21875
69,7,8,71,256,-185,-72.265625
69,7,9,716,512,204,39.84375
69,7,10,5220,1024,4196,409.765625
69,7,11,1660,2048,-388,-18.9453125
69,7,12,1081,4096,-3015,-73.6083984375
69,7,13,3156,8192,-5036,-61.474609375
69,7,14,4286,16384,-12098,-73.84033203125
69,7,15,122615,32768,89847,274.1912841796875
69,8,1,0,2,-2,-100.0
69,8,2,1,4,-3,-75.0
69,8,3,8,8,0,0.0
69,8,4,3,16,-13,-81.25
69,8,5,15,32,-17,-53.125
69,8,6,60,64,-4,-6.25
69,8,7,7,128,-121,-94.53125
69,8,8,325,256,69,26.953125
69,8,9,237,512,-275,-53.7109375
69,8,10,1031,1024,7,0.68359375
69,8,11,68,2048,-1980,-96.6796875
69,8,12,2626,4096,-1470,-35.888671875
69,8,13,5719,8192,-2473,-30.18798828125
69,8,14,6472,16384,-9912,-60.498046875
69,8,15,47282,32768,14514,44.293212890625
69,9,1,0,2,-2,-100.0
69,9,2,1,4,-3,-75.0
69,9,3,5,8,-3,-37.5
69,9,4,34,16,18,112.5
69,9,5,6,32,-26,-81.25
69,9,6,120,64,56,87.5
69,9,7,12,128,-116,-90.625
69,9,8,17,256,-239,-93.359375
69,9,9,870,512,358,69.921875
69,9,10,484,1024,-540,-52.734375
69,9,11,972,2048,-1076,-52.5390625
69,9,12,6685,4096,2589,63.2080078125
69,9,13,5452,8192,-2740,-33.447265625
69,9,14,10098,16384,-6286,-38.36669921875
69,9,15,17833,32768,-14935,-45.5780029296875
69,10,1,0,2,-2,-100.0
69,10,2,1,4,-3,-75.0
69,10,3,3,8,-5,-62.5
69,10,4,31,16,15,93.75
69,10,5,42,32,10,31.25
69,10,6,12,64,-52,-81.25
69,10,7,63,128,-65,-50.78125
69,10,8,584,256,328,128.125
69,10,9,587,512,75,14.6484375
69,10,10,341,1024,-683,-66.69921875
69,10,11,388,2048,-1660,-81.0546875
69,10,12,3548,4096,-548,-13.37890625
69,10,13,3591,8192,-4601,-56.16455078125
69,10,14,12260,16384,-4124,-25.1708984375
69,10,15,9419,32768,-23349,-71.2554931640625
69,11,1,0,2,-2,-100.0
69,11,2,1,4,-3,-75.0
69,11,3,7,8,-1,-12.5
69,11,4,14,16,-2,-12.5
69,11,5,10,32,-22,-68.75
69,11,6,6,64,-58,-90.625
69,11,7,6,128,-122,-95.3125
69,11,8,249,256,-7,-2.734375
69,11,9,25,512,-487,-95.1171875
69,11,10,768,1024,-256,-25.0
69,11,11,480,2048,-1568,-76.5625
69,11,12,754,4096,-3342,-81.591796875
69,11,13,10383,8192,2191,26.74560546875
69,11,14,6327,16384,-10057,-61.383056640625
69,11,15,23302,32768,-9466,-28.887939453125
69,12,1,0,2,-2,-100.0
69,12,2,2,4,-2,-50.0
69,12,3,2,8,-6,-75.0
69,12,4,9,16,-7,-43.75
69,12,5,23,32,-9,-28.125
69,12,6,479,64,415,648.4375
69,12,7,31,128,-97,-75.78125
69,12,8,261,256,5,1.953125
69,12,9,40,512,-472,-92.1875
69,12,10,521,1024,-503,-49.12109375
69,12,11,516,2048,-1532,-74.8046875
69,12,12,12501,4096,8405,205.2001953125
69,12,13,9427,8192,1235,15.07568359375
69,12,14,17437,16384,1053,6.427001953125
69,12,15,24901,32768,-7867,-24.0081787109375
69,13,1,0,2,-2,-100.0
69,13,2,1,4,-3,-75.0
69,13,3,2,8,-6,-75.0
69,13,4,7,16,-9,-56.25
69,13,5,25,32,-7,-21.875
69,13,6,86,64,22,34.375
69,13,7,207,128,79,61.71875
69,13,8,71,256,-185,-72.265625
69,13,9,595,512,83,16.2109375
69,13,10,793,1024,-231,-22.55859375
69,13,11,790,2048,-1258,-61.42578125
69,13,12,2475,4096,-1621,-39.5751953125
69,13,13,4161,8192,-4031,-49.20654296875
69,13,14,18959,16384,2575,15.716552734375
69,13,15,74957,32768,42189,128.7506103515625
69,14,1,0,2,-2,-100.0
69,14,2,3,4,-1,-25.0
69,14,3,4,8,-4,-50.0
69,14,4,21,16,5,31.25
69,14,5,11,32,-21,-65.625
69,14,6,229,64,165,257.8125
69,14,7,114,128,-14,-10.9375
69,14,8,107,256,-149,-58.203125
69,14,9,385,512,-127,-24.8046875
69,14,10,2887,1024,1863,181.93359375
69,14,11,759,2048,-1289,-62.939453125
69,14,12,3666,4096,-430,-10.498046875
69,14,13,6949,8192,-1243,-15.17333984375
69,14,14,347,16384,-16037,-97.882080078125
69,14,15,43896,32768,11128,33.9599609375
69,15,1,0,2,-2,-100.0
69,15,2,1,4,-3,-75.0
69,15,3,4,8,-4,-50.0
69,15,4,9,16,-7,-43.75
69,15,5,10,32,-22,-68.75
69,15,6,52,64,-12,-18.75
69,15,7,244,128,116,90.625
69,15,8,579,256,323,126.171875
69,15,9,915,512,403,78.7109375
69,15,10,290,1024,-734,-71.6796875
69,15,11,540,2048,-1508,-73.6328125
69,15,12,2689,4096,-1407,-34.3505859375
69,15,13,14921,8192,6729,82.14111328125
69,15,14,6331,16384,-10053,-61.358642578125
69,15,15,16247,32768,-16521,-50.4180908203125
69,16,1,0,2,-2,-100.0
69,16,2,1,4,-3,-75.0
69,16,3,3,8,-5,-62.5
69,16,4,18,16,2,12.5
69,16,5,38,32,6,18.75
69,16,6,10,64,-54,-84.375
69,16,7,19,128,-109,-85.15625
69,16,8,291,256,35,13.671875
69,16,9,330,512,-182,-35.546875
69,16,10,944,1024,-80,-7.8125
69,16,11,7410,2048,5362,261.81640625
69,16,12,712,4096,-3384,-82.6171875
69,16,13,3926,8192,-4266,-52.0751953125
69,16,14,24559,16384,8175,49.896240234375
69,16,15,34037,32768,1269,3.8726806640625
69,17,1,0,2,-2,-100.0
69,17,2,1,4,-3,-75.0
69,17,3,2,8,-6,-75.0
69,17,4,18,16,2,12.5
69,17,5,38,32,6,18.75
69,17,6,33,64,-31,-48.4375
69,17,7,26,128,-102,-79.6875
69,17,8,119,256,-137,-53.515625
69,17,9,877,512,365,71.2890625
69,17,10,695,1024,-329,-32.12890625
69,17,11,686,2048,-1362,-66.50390625
69,17,12,541,4096,-3555,-86.7919921875
69,17,13,5368,8192,-2824,-34.47265625
69,17,14,1760,16384,-14624,-89.2578125
69,17,15,48791,32768,16023,48.8983154296875
69,18,1,0,2,-2,-100.0
69,18,2,5,4,1,25.0
69,18,3,4,8,-4,-50.0
69,18,4,18,16,2,12.5
69,18,5,56,32,24,75.0
69,18,6,13,64,-51,-79.6875
69,18,7,129,128,1,0.78125
69,18,8,94,256,-162,-63.28125
69,18,9,273,512,-239,-46.6796875
69,18,10,817,1024,-207,-20.21484375
69,18,11,3141,2048,1093,53.369140625
69,18,12,610,4096,-3486,-85.107421875
69,18,13,2779,8192,-5413,-66.07666015625
69,18,14,2456,16384,-13928,-85.009765625
69,18,15,699,32768,-32069,-97.8668212890625
69,19,1,0,2,-2,-100.0
69,19,2,1,4,-3,-75.0
69,19,3,11,8,3,37.5
69,19,4,6,16,-10,-62.5
69,19,5,35,32,3,9.375
69,19,6,53,64,-11,-17.1875
69,19,7,452,128,324,253.125
69,19,8,299,256,43,16.796875
69,19,9,1402,512,890,173.828125
69,19,10,121,1024,-903,-88.18359375
69,19,11,529,2048,-1519,-74.169921875
69,19,12,4470,4096,374,9.130859375
69,19,13,5613,8192,-2579,-31.48193359375
69,19,14,3594,16384,-12790,-78.06396484375
69,19,15,7545,32768,-25223,-76.9744873046875
69,20,1,0,2,-2,-100.0
69,20,2,2,4,-2,-50.0
69,20,3,3,8,-5,-62.5
69,20,4,22,16,6,37.5
69,20,5,9,32,-23,-71.875
69,20,6,18,64,-46,-71.875
69,20,7,257,128,129,100.78125
69,20,8,181,256,-75,-29.296875
69,20,9,705,512,193,37.6953125
69,20,10,1057,1024,33,3.22265625
69,20,11,492,2048,-1556,-75.9765625
69,20,12,1542,4096,-2554,-62.353515625
69,20,13,3392,8192,-4800,-58.59375
69,20,14,12232,16384,-4152,-25.341796875
69,20,15,36557,32768,3789,11.5631103515625
69,21,1,0,2,-2,-100.0
69,21,2,1,4,-3,-75.0
69,21,3,6,8,-2,-25.0
69,21,4,28,16,12,75.0
69,21,5,12,32,-20,-62.5
69,21,6,13,64,-51,-79.6875
69,21,7,75,128,-53,-41.40625
69,21,8,204,256,-52,-20.3125
69,21,9,1190,512,678,132.421875
69,21,10,2545,1024,1521,148.53515625
69,21,11,142,2048,-1906,-93.06640625
69,21,12,6460,4096,2364,57.71484375
69,21,13,2070,8192,-6122,-74.7314453125
69,21,14,13513,16384,-2871,-17.523193359375
69,21,15,262,32768,-32506,-99.200439453125
69,22,1,0,2,-2,-100.0
69,22,2,1,4,-3,-75.0
69,22,3,2,8,-6,-75.0
69,22,4,11,16,-5,-31.25
69,22,5,13,32,-19,-59.375
69,22,6,60,64,-4,-6.25
69,22,7,70,128,-58,-45.3125
69,22,8,23,256,-233,-91.015625
69,22,9,25,512,-487,-95.1171875
69,22,10,131,1024,-893,-87.20703125
69,22,11,723,2048,-1325,-64.697265625
69,22,12,1164,4096,-2932,-71.58203125
69,22,13,5749,8192,-2443,-29.82177734375
69,22,14,6078,16384,-10306,-62.90283203125
69,22,15,5862,32768,-26906,-82.110595703125
69,23,1,0,2,-2,-100.0
69,23,2,1,4,-3,-75.0
69,23,3,3,8,-5,-62.5
69,23,4,8,16,-8,-50.0
69,23,5,41,32,9,28.125
69,23,6,129,64,65,101.5625
69,23,7,7,128,-121,-94.53125
69,23,8,388,256,132,51.5625
69,23,9,1088,512,576,112.5
69,23,10,210,1024,-814,-79.4921875
69,23,11,3219,2048,1171,57.177734375
69,23,12,9911,4096,5815,141.9677734375
69,23,13,21887,8192,13695,167.17529296875
69,23,14,12348,16384,-4036,-24.6337890625
69,23,15,5737,32768,-27031,-82.4920654296875
69,24,1,0,2,-2,-100.0
69,24,2,2,4,-2,-50.0
69,24,3,6,8,-2,-25.0
69,24,4,12,16,-4,-25.0
69,24,5,23,32,-9,-28.125
69,24,6,79,64,15,23.4375
69,24,7,710,128,582,454.6875
69,24,8,615,256,359,140.234375
69,24,9,313,512,-199,-38.8671875
69,24,10,1572,1024,548,53.515625
69,24,11,2634,2048,586,28.61328125
69,24,12,1001,4096,-3095,-75.5615234375
69,24,13,26726,8192,18534,226.2451171875
69,24,14,7930,16384,-8454,-51.59912109375
69,24,15,37492,32768,4724,14.41650390625
69,25,1,0,2,-2,-100.0
69,25,2,1,4,-3,-75.0
69,25,3,2,8,-6,-75.0
69,25,4,13,16,-3,-18.75
69,25,5,11,32,-21,-65.625
69,25,6,15,64,-49,-76.5625
69,25,7,22,128,-106,-82.8125
69,25,8,178,256,-78,-30.46875
69,25,9,111,512,-401,-78.3203125
69,25,10,58,1024,-966,-94.3359375
69,25,11,3182,2048,1134,55.37109375
69,25,12,235,4096,-3861,-94.2626953125
69,25,13,2528,8192,-5664,-69.140625
69,25,14,9278,16384,-7106,-43.37158203125
69,25,15,10606,32768,-22162,-67.633056640625
69,26,1,0,2,-2,-100.0
69,26,2,1,4,-3,-75.0
69,26,3,2,8,-6,-75.0
69,26,4,14,16,-2,-12.5
69,26,5,58,32,26,81.25
69,26,6,10,64,-54,-84.375
69,26,7,12,128,-116,-90.625
69,26,8,72,256,-184,-71.875
69,26,9,510,512,-2,-0.390625
69,26,10,639,1024,-385,-37.59765625
69,26,11,89,2048,-1959,-95.654296875
69,26,12,250,4096,-3846,-93.896484375
69,26,13,5467,8192,-2725,-33.26416015625
69,26,14,7788,16384,-8596,-52.4658203125
69,26,15,25603,32768,-7165,-21.8658447265625
69,27,1,0,2,-2,-100.0
69,27,2,1,4,-3,-75.0
69,27,3,5,8,-3,-37.5
69,27,4,12,16,-4,-25.0
69,27,5,8,32,-24,-75.0
69,27,6,14,64,-50,-78.125
69,27,7,162,128,34,26.5625
69,27,8,54,256,-202,-78.90625
69,27,9,94,512,-418,-81.640625
69,27,10,101,1024,-923,-90.13671875
69,27,11,16,2048,-2032,-99.21875
69,27,12,1851,4096,-2245,-54.8095703125
69,27,13,3518,8192,-4674,-57.0556640625
69,27,14,23723,16384,7339,44.793701171875
69,27,15,1023,32768,-31745,-96.8780517578125
69,28,1,0,2,-2,-100.0
69,28,2,1,4,-3,-75.0
69,28,3,6,8,-2,-25.0
69,28,4,10,16,-6,-37.5
69,28,5,14,32,-18,-56.25
69,28,6,20,64,-44,-68.75
69,28,7,40,128,-88,-68.75
69,28,8,266,256,10,3.90625
69,28,9,82,512,-430,-83.984375
69,28,10,1958,1024,934,91.2109375
69,28,11,372,2048,-1676,-81.8359375
69,28,12,427,4096,-3669,-89.5751953125
69,28,13,1036,8192,-7156,-87.353515625
69,28,14,7230,16384,-9154,-55.87158203125
69,28,15,23832,32768,-8936,-27.2705078125
69,29,1,0,2,-2,-100.0
69,29,2,2,4,-2,-50.0
69,29,3,4,8,-4,-50.0
69,29,4,3,16,-13,-81.25
69,29,5,99,32,67,209.375
69,29,6,75,64,11,17.1875
69,29,7,38,128,-90,-70.3125
69,29,8,92,256,-164,-64.0625
69,29,9,278,512,-234,-45.703125
69,29,10,575,1024,-449,-43.84765625
69,29,11,844,2048,-1204,-58.7890625
69,29,12,2396,4096,-1700,-41.50390625
69,29,13,3120,8192,-5072,-61.9140625
69,29,14,7116,16384,-9268,-56.5673828125
69,29,15,5020,32768,-27748,-84.68017578125
69,30,1,0,2,-2,-100.0
69,30,2,5,4,1,25.0
69,30,3,4,8,-4,-50.0
69,30,4,33,16,17,106.25
69,30,5,28,32,-4,-12.5
69,30,6,16,64,-48,-75.0
69,30,7,95,128,-33,-25.78125
69,30,8,271,256,15,5.859375
69,30,9,1449,512,937,183.0078125
69,30,10,420,1024,-604,-58.984375
69,30,11,1163,2048,-885,-43.212890625
69,30,12,7186,4096,3090,75.439453125
69,30,13,4821,8192,-3371,-41.14990234375
69,30,14,8119,16384,-8265,-50.445556640625
69,30,15,13800,32768,-18968,-57.8857421875
69,31,1,0,2,-2,-100.0
69,31,2,2,4,-2,-50.0
69,31,3,2,8,-6,-75.0
69,31,4,8,16,-8,-50.0
69,31,5,47,32,15,46.875
69,31,6,111,64,47,73.4375
69,31,7,73,128,-55,-42.96875
69,31,8,92,256,-164,-64.0625
69,31,9,807,512,295,57.6171875
69,31,10,49,1024,-975,-95.21484375
69,31,11,1062,2048,-986,-48.14453125
69,31,12,914,4096,-3182,-77.685546875
69,31,13,7454,8192,-738,-9.0087890625
69,31,14,19612,16384,3228,19.7021484375
69,31,15,3736,32768,-29032,-88.5986328125
69,32,1,0,2,-2,-100.0
69,32,2,2,4,-2,-50.0
69,32,3,2,8,-6,-75.0
69,32,4,4,16,-12,-75.0
69,32,5,35,32,3,9.375
69,32,6,37,64,-27,-42.1875
69,32,7,57,128,-71,-55.46875
69,32,8,78,256,-178,-69.53125
69,32,9,51,512,-461,-90.0390625
69,32,10,92,1024,-932,-91.015625
69,32,11,1196,2048,-852,-41.6015625
69,32,12,8004,4096,3908,95.41015625
69,32,13,13048,8192,4856,59.27734375
69,32,14,19027,16384,2643,16.131591796875
69,32,15,7731,32768,-25037,-76.4068603515625
69,33,1,0,2,-2,-100.0
69,33,2,1,4,-3,-75.0
69,33,3,3,8,-5,-62.5
69,33,4,26,16,10,62.5
69,33,5,8,32,-24,-75.0
69,33,6,52,64,-12,-18.75
69,33,7,119,128,-9,-7.03125
69,33,8,35,256,-221,-86.328125
69,33,9,689,512,177,34.5703125
69,33,10,987,1024,-37,-3.61328125
69,33,11,1848,2048,-200,-9.765625
69,33,12,2027,4096,-2069,-50.5126953125
69,33,13,20239,8192,12047,147.05810546875
69,33,14,20701,16384,4317,26.348876953125
69,33,15,41362,32768,8594,26.226806640625
69,34,1,0,2,-2,-100.0
69,34,2,2,4,-2,-50.0
69,34,3,2,8,-6,-75.0
69,34,4,4,16,-12,-75.0
69,34,5,77,32,45,140.625
69,34,6,10,64,-54,-84.375
69,34,7,217,128,89,69.53125
69,34,8,386,256,130,50.78125
69,34,9,150,512,-362,-70.703125
69,34,10,1557,1024,533,52.05078125
69,34,11,31,2048,-2017,-98.486328125
69,34,12,4255,4096,159,3.8818359375
69,34,13,8116,8192,-76,-0.927734375
69,34,14,9577,16384,-6807,-41.546630859375
69,34,15,2022,32768,-30746,-93.829345703125
69,35,1,0,2,-2,-100.0
69,35,2,1,4,-3,-75.0
69,35,3,3,8,-5,-62.5
69,35,4,7,16,-9,-56.25
69,35,5,66,32,34,106.25
69,35,6,66,64,2,3.125
69,35,7,205,128,77,60.15625
69,35,8,491,256,235,91.796875
69,35,9,179,512,-333,-65.0390625
69,35,10,41,1024,-983,-95.99609375
69,35,11,911,2048,-1137,-55.517578125
69,35,12,628,4096,-3468,-84.66796875
69,35,13,2896,8192,-5296,-64.6484375
69,35,14,16215,16384,-169,-1.031494140625
69,35,15,32985,32768,217,0.6622314453125
69,36,1,0,2,-2,-100.0
69,36,2,2,4,-2,-50.0
69,36,3,8,8,0,0.0
69,36,4,19,16,3,18.75
69,36,5,10,32,-22,-68.75
69,36,6,167,64,103,160.9375
69,36,7,27,128,-101,-78.90625
69,36,8,63,256,-193,-75.390625
69,36,9,551,512,39,7.6171875
69,36,10,3942,1024,2918,284.9609375
69,36,11,1433,2048,-615,-30.029296875
69,36,12,7070,4096,2974,72.607421875
69,36,13,5531,8192,-2661,-32.48291015625
69,36,14,4913,16384,-11471,-70.013427734375
69,36,15,31344,32768,-1424,-4.345703125
69,37,1,0,2,-2,-100.0
69,37,2,2,4,-2,-50.0
69,37,3,10,8,2,25.0
69,37,4,25,16,9,56.25
69,37,5,34,32,2,6.25
69,37,6,77,64,13,20.3125
69,37,7,15,128,-113,-88.28125
69,37,8,132,256,-124,-48.4375
69,37,9,133,512,-379,-74.0234375
69,37,10,2760,1024,1736,169.53125
69,37,11,1630,2048,-418,-20.41015625
69,37,12,1819,4096,-2277,-55.5908203125
69,37,13,2621,8192,-5571,-68.00537109375
69,37,14,14349,16384,-2035,-12.420654296875
69,37,15,29588,32768,-3180,-9.70458984375
69,38,1,0,2,-2,-100.0
69,38,2,1,4,-3,-75.0
69,38,3,9,8,1,12.5
69,38,4,18,16,2,12.5
69,38,5,16,32,-16,-50.0
69,38,6,5,64,-59,-92.1875
69,38,7,12,128,-116,-90.625
69,38,8,18,256,-238,-92.96875
69,38,9,83,512,-429,-83.7890625
69,38,10,675,1024,-349,-34.08203125
69,38,11,3049,2048,1001,48.876953125
69,38,12,2306,4096,-1790,-43.701171875
69,38,13,8859,8192,667,8.14208984375
69,38,14,13059,16384,-3325,-20.294189453125
69,38,15,111817,32768,79049,241.2384033203125
69,39,1,0,2,-2,-100.0
69,39,2,7,4,3,75.0
69,39,3,2,8,-6,-75.0
69,39,4,20,16,4,25.0
69,39,5,22,32,-10,-31.25
69,39,6,47,64,-17,-26.5625
69,39,7,7,128,-121,-94.53125
69,39,8,659,256,403,157.421875
69,39,9,65,512,-447,-87.3046875
69,39,10,486,1024,-538,-52.5390625
69,39,11,1185,2048,-863,-42.138671875
69,39,12,2346,4096,-1750,-42.724609375
69,39,13,16424,8192,8232,100.48828125
69,39,14,9948,16384,-6436,-39.2822265625
69,39,15,55558,32768,22790,69.549560546875
69,40,1,0,2,-2,-100.0
69,40,2,1,4,-3,-75.0
69,40,3,16,8,8,100.0
69,40,4,9,16,-7,-43.75
69,40,5,4,32,-28,-87.5
69,40,6,23,64,-41,-64.0625
69,40,7,48,128,-80,-62.5
69,40,8,570,256,314,122.65625
69,40,9,780,512,268,52.34375
69,40,10,818,1024,-206,-20.1171875
69,40,11,4942,2048,2894,141.30859375
69,40,12,639,4096,-3457,-84.3994140625
69,40,13,12018,8192,3826,46.7041015625
69,40,14,54567,16384,38183,233.050537109375
69,40,15,7181,32768,-25587,-78.0853271484375
69,41,1,0,2,-2,-100.0
69,41,2,2,4,-2,-50.0
69,41,3,4,8,-4,-50.0
69,41,4,3,16,-13,-81.25
69,41,5,30,32,-2,-6.25
69,41,6,28,64,-36,-56.25
69,41,7,12,128,-116,-90.625
69,41,8,15,256,-241,-94.140625
69,41,9,14,512,-498,-97.265625
69,41,10,798,1024,-226,-22.0703125
69,41,11,5553,2048,3505,171.142578125
69,41,12,13457,4096,9361,228.5400390625
69,41,13,17411,8192,9219,112.53662109375
69,41,14,24623,16384,8239,50.286865234375
69,41,15,50401,32768,17633,53.8116455078125
69,42,1,0,2,-2,-100.0
69,42,2,5,4,1,25.0
69,42,3,7,8,-1,-12.5
69,42,4,5,16,-11,-68.75
69,42,5,55,32,23,71.875
69,42,6,12,64,-52,-81.25
69,42,7,315,128,187,146.09375
69,42,8,30,256,-226,-88.28125
69,42,9,477,512,-35,-6.8359375
69,42,10,944,1024,-80,-7.8125
69,42,11,616,2048,-1432,-69.921875
69,42,12,1922,4096,-2174,-53.076171875
69,42,13,3582,8192,-4610,-56.2744140625
69,42,14,13308,16384,-3076,-18.7744140625
69,42,15,23590,32768,-9178,-28.009033203125
69,43,1,0,2,-2,-100.0
69,43,2,3,4,-1,-25.0
69,43,3,2,8,-6,-75.0
69,43,4,3,16,-13,-81.25
69,43,5,23,32,-9,-28.125
69,43,6,59,64,-5,-7.8125
69,43,7,156,128,28,21.875
69,43,8,18,256,-238,-92.96875
69,43,9,67,512,-445,-86.9140625
69,43,10,159,1024,-865,-84.47265625
69,43,11,3502,2048,1454,70.99609375
69,43,12,1045,4096,-3051,-74.4873046875
69,43,13,17565,8192,9373,114.41650390625
69,43,14,6075,16384,-10309,-62.921142578125
69,43,15,47015,32768,14247,43.4783935546875
69,44,1,0,2,-2,-100.0
69,44,2,2,4,-2,-50.0
69,44,3,8,8,0,0.0
69,44,4,5,16,-11,-68.75
69,44,5,19,32,-13,-40.625
69,44,6,13,64,-51,-79.6875
69,44,7,24,128,-104,-81.25
69,44,8,184,256,-72,-28.125
69,44,9,495,512,-17,-3.3203125
69,44,10,67,1024,-957,-93.45703125
69,44,11,3891,2048,1843,89.990234375
69,44,12,5179,4096,1083,26.4404296875
69,44,13,13507,8192,5315,64.88037109375
69,44,14,1713,16384,-14671,-89.544677734375
69,44,15,10576,32768,-22192,-67.724609375
69,45,1,0,2,-2,-100.0
69,45,2,1,4,-3,-75.0
69,45,3,7,8,-1,-12.5
69,45,4,4,16,-12,-75.0
69,45,5,6,32,-26,-81.25
69,45,6,42,64,-22,-34.375
69,45,7,314,128,186,145.3125
69,45,8,668,256,412,160.9375
69,45,9,258,512,-254,-49.609375
69,45,10,1821,1024,797,77.83203125
69,45,11,585,2048,-1463,-71.435546875
69,45,12,596,4096,-3500,-85.44921875
69,45,13,5461,8192,-2731,-33.33740234375
69,45,14,1340,16384,-15044,-91.8212890625
69,45,15,72813,32768,40045,122.2076416015625
69,46,1,0,2,-2,-100.0
69,46,2,6,4,2,50.0
69,46,3,12,8,4,50.0
69,46,4,3,16,-13,-81.25
69,46,5,81,32,49,153.125
69,46,6,65,64,1,1.5625
69,46,7,316,128,188,146.875
69,46,8,22,256,-234,-91.40625
69,46,9,1052,512,540,105.46875
69,46,10,1988,1024,964,94.140625
69,46,11,2189,2048,141,6.884765625
69,46,12,8248,4096,4152,101.3671875
69,46,13,11394,8192,3202,39.0869140625
69,46,14,15945,16384,-439,-2.679443359375
69,46,15,29491,32768,-3277,-10.0006103515625
69,47,1,0,2,-2,-100.0
69,47,2,2,4,-2,-50.0
69,47,3,8,8,0,0.0
69,47,4,3,16,-13,-81.25
69,47,5,59,32,27,84.375
69,47,6,41,64,-23,-35.9375
69,47,7,200,128,72,56.25
69,47,8,76,256,-180,-70.3125
69,47,9,321,512,-191,-37.3046875
69,47,10,685,1024,-339,-33.10546875
69,47,11,8973,2048,6925,338.134765625
69,47,12,15055,4096,10959,267.5537109375
69,47,13,8451,8192,259,3.16162109375
69,47,14,25916,16384,9532,58.1787109375
69,47,15,45584,32768,12816,39.111328125
69,48,1,0,2,-2,-100.0
69,48,2,1,4,-3,-75.0
69,48,3,3,8,-5,-62.5
69,48,4,11,16,-5,-31.25
69,48,5,7,32,-25,-78.125
69,48,6,44,64,-20,-31.25
69,48,7,107,128,-21,-16.40625
69,48,8,288,256,32,12.5
69,48,9,1239,512,727,141.9921875
69,48,10,2599,1024,1575,153.80859375
69,48,11,1616,2048,-432,-21.09375
69,48,12,3616,4096,-480,-11.71875
69,48,13,4397,8192,-3795,-46.32568359375
69,48,14,17371,16384,987,6.024169921875
69,48,15,13757,32768,-19011,-58.0169677734375
69,49,1,0,2,-2,-100.0
69,49,2,6,4,2,50.0
69,49,3,2,8,-6,-75.0
69,49,4,18,16,2,12.5
69,49,5,33,32,1,3.125
69,49,6,218,64,154,240.625
69,49,7,144,128,16,12.5
69,49,8,20,256,-236,-92.1875
69,49,9,18,512,-494,-96.484375
69,49,10,246,1024,-778,-75.9765625
69,49,11,1897,2048,-151,-7.373046875
69,49,12,3603,4096,-493,-12.0361328125
69,49,13,58429,8192,50237,613.24462890625
69,49,14,13731,16384,-2653,-16.192626953125
69,49,15,20225,32768,-12543,-38.2781982421875
69,50,1,0,2,-2,-100.0
69,50,2,1,4,-3,-75.0
69,50,3,4,8,-4,-50.0
69,50,4,6,16,-10,-62.5
69,50,5,36,32,4,12.5
69,50,6,5,64,-59,-92.1875
69,50,7,73,128,-55,-42.96875
69,50,8,42,256,-214,-83.59375
69,50,9,145,512,-367,-71.6796875
69,50,10,418,1024,-606,-59.1796875
69,50,11,2382,2048,334,16.30859375
69,50,12,4721,4096,625,15.2587890625
69,50,13,261,8192,-7931,-96.81396484375
69,50,14,14534,16384,-1850,-11.29150390625
69,50,15,8428,32768,-24340,-74.27978515625
69,51,1,0,2,-2,-100.0
69,51,2,1,4,-3,-75.0
69,51,3,18,8,10,125.0
69,51,4,19,16,3,18.75
69,51,5,15,32,-17,-53.125
69,51,6,19,64,-45,-70.3125
69,51,7,159,128,31,24.21875
69,51,8,113,256,-143,-55.859375
69,51,9,254,512,-258,-50.390625
69,51,10,306,1024,-718,-70.1171875
69,51,11,3101,2048,1053,51.416015625
69,51,12,7176,4096,3080,75.1953125
69,51,13,4419,8192,-3773,-46.05712890625
69,51,14,43132,16384,26748,163.2568359375
69,51,15,6773,32768,-25995,-79.3304443359375
69,52,1,0,2,-2,-100.0
69,52,2,3,4,-1,-25.0
69,52,3,18,8,10,125.0
69,52,4,41,16,25,156.25
69,52,5,5,32,-27,-84.375
69,52,6,8,64,-56,-87.5
69,52,7,194,128,66,51.5625
69,52,8,106,256,-150,-58.59375
69,52,9,216,512,-296,-57.8125
69,52,10,465,1024,-559,-54.58984375
69,52,11,229,2048,-1819,-88.818359375
69,52,12,11799,4096,7703,188.0615234375
69,52,13,171,8192,-8021,-97.91259765625
69,52,14,16623,16384,239,1.458740234375
69,52,15,65947,32768,33179,101.2542724609375
69,53,1,0,2,-2,-100.0
69,53,2,1,4,-3,-75.0
69,53,3,2,8,-6,-75.0
69,53,4,73,16,57,356.25
69,53,5,20,32,-12,-37.5
69,53,6,269,64,205,320.3125
69,53,7,145,128,17,13.28125
69,53,8,592,256,336,131.25
69,53,9,727,512,215,41.9921875
69,53,10,479,1024,-545,-53.22265625
69,53,11,1058,2048,-990,-48.33984375
69,53,12,4743,4096,647,15.7958984375
69,53,13,2207,8192,-5985,-73.05908203125
69,53,14,21659,16384,5275,32.196044921875
69,53,15,46682,32768,13914,42.462158203125
69,54,1,0,2,-2,-100.0
69,54,2,5,4,1,25.0
69,54,3,6,8,-2,-25.0
69,54,4,25,16,9,56.25
69,54,5,7,32,-25,-78.125
69,54,6,16,64,-48,-75.0
69,54,7,11,128,-117,-91.40625
69,54,8,132,256,-124,-48.4375
69,54,9,47,512,-465,-90.8203125
69,54,10,369,1024,-655,-63.96484375
69,54,11,2432,2048,384,18.75
69,54,12,6044,4096,1948,47.55859375
69,54,13,10242,8192,2050,25.0244140625
69,54,14,1073,16384,-15311,-93.450927734375
69,54,15,89853,32768,57085,174.2095947265625
69,55,1,0,2,-2,-100.0
69,55,2,2,4,-2,-50.0
69,55,3,20,8,12,150.0
69,55,4,4,16,-12,-75.0
69,55,5,32,32,0,0.0
69,55,6,135,64,71,110.9375
69,55,7,149,128,21,16.40625
69,55,8,18,256,-238,-92.96875
69,55,9,327,512,-185,-36.1328125
69,55,10,603,1024,-421,-41.11328125
69,55,11,1444,2048,-604,-29.4921875
69,55,12,497,4096,-3599,-87.8662109375
69,55,13,5335,8192,-2857,-34.87548828125
69,55,14,23450,16384,7066,43.12744140625
69,55,15,41122,32768,8354,25.494384765625
69,56,1,0,2,-2,-100.0
69,56,2,6,4,2,50.0
69,56,3,3,8,-5,-62.5
69,56,4,3,16,-13,-81.25
69,56,5,81,32,49,153.125
69,56,6,85,64,21,32.8125
69,56,7,164,128,36,28.125
69,56,8,530,256,274,107.03125
69,56,9,1216,512,704,137.5
69,56,10,1639,1024,615,60.05859375
69,56,11,2607,2048,559,27.294921875
69,56,12,9452,4096,5356,130.76171875
69,56,13,987,8192,-7205,-87.95166015625
69,56,14,62562,16384,46178,281.84814453125
69,56,15,3780,32768,-28988,-88.46435546875
69,57,1,0,2,-2,-100.0
69,57,2,1,4,-3,-75.0
69,57,3,2,8,-6,-75.0
69,57,4,47,16,31,193.75
69,57,5,20,32,-12,-37.5
69,57,6,41,64,-23,-35.9375
69,57,7,659,128,531,414.84375
69,57,8,49,256,-207,-80.859375
69,57,9,907,512,395,77.1484375
69,57,10,536,1024,-488,-47.65625
69,57,11,627,2048,-1421,-69.384765625
69,57,12,4096,4096,0,0.0
69,57,13,585,8192,-7607,-92.85888671875
69,57,14,5632,16384,-10752,-65.625
69,57,15,40886,32768,8118,24.774169921875
69,58,1,0,2,-2,-100.0
69,58,2,2,4,-2,-50.0
69,58,3,2,8,-6,-75.0
69,58,4,21,16,5,31.25
69,58,5,57,32,25,78.125
69,58,6,40,64,-24,-37.5
69,58,7,55,128,-73,-57.03125
69,58,8,592,256,336,131.25
69,58,9,580,512,68,13.28125
69,58,10,216,1024,-808,-78.90625
69,58,11,796,2048,-1252,-61.1328125
69,58,12,1023,4096,-3073,-75.0244140625
69,58,13,5810,8192,-2382,-29.0771484375
69,58,14,43924,16384,27540,168.0908203125
69,58,15,14656,32768,-18112,-55.2734375
69,59,1,0,2,-2,-100.0
69,59,2,1,4,-3,-75.0
69,59,3,4,8,-4,-50.0
69,59,4,10,16,-6,-37.5
69,59,5,124,32,92,287.5
69,59,6,31,64,-33,-51.5625
69,59,7,70,128,-58,-45.3125
69,59,8,827,256,571,223.046875
69,59,9,202,512,-310,-60.546875
69,59,10,499,1024,-525,-51.26953125
69,59,11,393,2048,-1655,-80.810546875
69,59,12,339,4096,-3757,-91.7236328125
69,59,13,9428,8192,1236,15.087890625
69,59,14,16043,16384,-341,-2.081298828125
69,59,15,21248,32768,-11520,-35.15625
69,60,1,0,2,-2,-100.0
69,60,2,1,4,-3,-75.0
69,60,3,6,8,-2,-25.0
69,60,4,13,16,-3,-18.75
69,60,5,26,32,-6,-18.75
69,60,6,37,64,-27,-42.1875
69,60,7,155,128,27,21.09375
69,60,8,125,256,-131,-51.171875
69,60,9,186,512,-326,-63.671875
69,60,10,35,1024,-989,-96.58203125
69,60,11,68,2048,-1980,-96.6796875
69,60,12,10878,4096,6782,165.576171875
69,60,13,11730,8192,3538,43.1884765625
69,60,14,18551,16384,2167,13.226318359375
69,60,15,39983,32768,7215,22.0184326171875
69,61,1,0,2,-2,-100.0
69,61,2,1,4,-3,-75.0
69,61,3,16,8,8,100.0
69,61,4,15,16,-1,-6.25
69,61,5,13,32,-19,-59.375
69,61,6,41,64,-23,-35.9375
69,61,7,176,128,48,37.5
69,61,8,45,256,-211,-82.421875
69,61,9,254,512,-258,-50.390625
69,61,10,1016,1024,-8,-0.78125
69,61,11,2076,2048,28,1.3671875
69,61,12,5014,4096,918,22.412109375
69,61,13,2793,8192,-5399,-65.90576171875
69,61,14,26759,16384,10375,63.323974609375
69,61,15,2036,32768,-30732,-93.78662109375
69,62,1,0,2,-2,-100.0
69,62,2,1,4,-3,-75.0
69,62,3,3,8,-5,-62.5
69,62,4,33,16,17,106.25
69,62,5,8,32,-24,-75.0
69,62,6,16,64,-48,-75.0
69,62,7,108,128,-20,-15.625
69,62,8,131,256,-125,-48.828125
69,62,9,163,512,-349,-68.1640625
69,62,10,2111,1024,1087,106.15234375
69,62,11,1265,2048,-783,-38.232421875
69,62,12,919,4096,-3177,-77.5634765625
69,62,13,1693,8192,-6499,-79.33349609375
69,62,14,30995,16384,14611,89.178466796875
69,62,15,1941,32768,-30827,-94.0765380859375
69,63,1,0,2,-2,-100.0
69,63,2,1,4,-3,-75.0
69,63,3,2,8,-6,-75.0
69,63,4,10,16,-6,-37.5
69,63,5,56,32,24,75.0
69,63,6,69,64,5,7.8125
69,63,7,43,128,-85,-66.40625
69,63,8,364,256,108,42.1875
69,63,9,149,512,-363,-70.8984375
69,63,10,223,1024,-801,-78.22265625
69,63,11,1897,2048,-151,-7.373046875
69,63,12,3272,4096,-824,-20.1171875
69,63,13,859,8192,-7333,-89.51416015625
69,63,14,4548,16384,-11836,-72.2412109375
69,63,15,10542,32768,-22226,-67.828369140625
69,64,1,0,2,-2,-100.0
69,64,2,2,4,-2,-50.0
69,64,3,10,8,2,25.0
69,64,4,19,16,3,18.75
69,64,5,34,32,2,6.25
69,64,6,59,64,-5,-7.8125
69,64,7,75,128,-53,-41.40625
69,64,8,142,256,-114,-44.53125
69,64,9,269,512,-243,-47.4609375
69,64,10,579,1024,-445,-43.45703125
69,64,11,1169,2048,-879,-42.919921875
69,64,12,5063,4096,967,23.6083984375
69,64,13,937,8192,-7255,-88.56201171875
69,64,14,2051,16384,-14333,-87.481689453125
69,64,15,1464,32768,-31304,-95.5322265625
69,65,1,0,2,-2,-100.0
69,65,2,4,4,0,0.0
69,65,3,2,8,-6,-75.0
69,65,4,14,16,-2,-12.5
69,65,5,8,32,-24,-75.0
69,65,6,63,64,-1,-1.5625
69,65,7,64,128,-64,-50.0
69,65,8,329,256,73,28.515625
69,65,9,157,512,-355,-69.3359375
69,65,10,586,1024,-438,-42.7734375
69,65,11,1497,2048,-551,-26.904296875
69,65,12,113,4096,-3983,-97.2412109375
69,65,13,9616,8192,1424,17.3828125
69,65,14,9819,16384,-6565,-40.069580078125
69,65,15,86258,32768,53490,163.238525390625
69,66,1,0,2,-2,-100.0
69,66,2,2,4,-2,-50.0
69,66,3,10,8,2,25.0
69,66,4,4,16,-12,-75.0
69,66,5,12,32,-20,-62.5
69,66,6,127,64,63,98.4375
69,66,7,64,128,-64,-50.0
69,66,8,136,256,-120,-46.875
69,66,9,1149,512,637,124.4140625
69,66,10,188,1024,-836,-81.640625
69,66,11,1602,2048,-446,-21.77734375
69,66,12,8392,4096,4296,104.8828125
69,66,13,2714,8192,-5478,-66.8701171875
69,66,14,2503,16384,-13881,-84.722900390625
69,66,15,24007,32768,-8761,-26.7364501953125
69,67,1,0,2,-2,-100.0
69,67,2,1,4,-3,-75.0
69,67,3,3,8,-5,-62.5
69,67,4,17,16,1,6.25
69,67,5,11,32,-21,-65.625
69,67,6,5,64,-59,-92.1875
69,67,7,211,128,83,64.84375
69,67,8,448,256,192,75.0
69,67,9,243,512,-269,-52.5390625
69,67,10,1019,1024,-5,-0.48828125
69,67,11,583,2048,-1465,-71.533203125
69,67,12,4158,4096,62,1.513671875
69,67,13,3690,8192,-4502,-54.9560546875
69,67,14,4431,16384,-11953,-72.955322265625
69,67,15,22667,32768,-10101,-30.8258056640625
69,68,1,0,2,-2,-100.0
69,68,2,2,4,-2,-50.0
69,68,3,3,8,-5,-62.5
69,68,4,4,16,-12,-75.0
69,68,5,35,32,3,9.375
69,68,6,32,64,-32,-50.0
69,68,7,155,128,27,21.09375
69,68,8,14,256,-242,-94.53125
69,68,9,211,512,-301,-58.7890625
69,68,10,4200,1024,3176,310.15625
69,68,11,2704,2048,656,32.03125
69,68,12,9751,4096,5655,138.0615234375
69,68,13,6864,8192,-1328,-16.2109375
69,68,14,23049,16384,6665,40.679931640625
69,68,15,16261,32768,-16507,-50.3753662109375
69,69,1,0,2,-2,-100.0
69,69,2,1,4,-3,-75.0
69,69,3,2,8,-6,-75.0
69,69,4,24,16,8,50.0
69,69,5,41,32,9,28.125
69,69,6,127,64,63,98.4375
69,69,7,118,128,-10,-7.8125
69,69,8,135,256,-121,-47.265625
69,69,9,758,512,246,48.046875
69,69,10,361,1024,-663,-64.74609375
69,69,11,1235,2048,-813,-39.697265625
69,69,12,3947,4096,-149,-3.6376953125
69,69,13,3565,8192,-4627,-56.48193359375
69,69,14,80779,16384,64395,393.035888671875
69,69,15,3265,32768,-29503,-90.0360107421875
70,1,1,0,2,-2,-100.0
70,1,2,2,4,-2,-50.0
70,1,3,5,8,-3,-37.5
70,1,4,18,16,2,12.5
70,1,5,39,32,7,21.875
70,1,6,75,64,11,17.1875
70,1,7,11,128,-117,-91.40625
70,1,8,150,256,-106,-41.40625
70,1,9,964,512,452,88.28125
70,1,10,1351,1024,327,31.93359375
70,1,11,2070,2048,22,1.07421875
70,1,12,931,4096,-3165,-77.2705078125
70,1,13,8894,8192,702,8.5693359375
70,1,14,14373,16384,-2011,-12.274169921875
70,1,15,8691,32768,-24077,-73.4771728515625
70,2,1,0,2,-2,-100.0
70,2,2,1,4,-3,-75.0
70,2,3,14,8,6,75.0
70,2,4,19,16,3,18.75
70,2,5,31,32,-1,-3.125
70,2,6,23,64,-41,-64.0625
70,2,7,132,128,4,3.125
70,2,8,480,256,224,87.5
70,2,9,484,512,-28,-5.46875
70,2,10,789,1024,-235,-22.94921875
70,2,11,579,2048,-1469,-71.728515625
70,2,12,5188,4096,1092,26.66015625
70,2,13,5095,8192,-3097,-37.80517578125
70,2,14,2945,16384,-13439,-82.025146484375
70,2,15,31968,32768,-800,-2.44140625
70,3,1,0,2,-2,-100.0
70,3,2,4,4,0,0.0
70,3,3,2,8,-6,-75.0
70,3,4,3,16,-13,-81.25
70,3,5,51,32,19,59.375
70,3,6,54,64,-10,-15.625
70,3,7,42,128,-86,-67.1875
70,3,8,344,256,88,34.375
70,3,9,324,512,-188,-36.71875
70,3,10,225,1024,-799,-78.02734375
70,3,11,1134,2048,-914,-44.62890625
70,3,12,466,4096,-3630,-88.623046875
70,3,13,3003,8192,-5189,-63.34228515625
70,3,14,41050,16384,24666,150.54931640625
70,3,15,36038,32768,3270,9.979248046875
70,4,1,0,2,-2,-100.0
70,4,2,1,4,-3,-75.0
70,4,3,8,8,0,0.0
70,4,4,37,16,21,131.25
70,4,5,6,32,-26,-81.25
70,4,6,6,64,-58,-90.625
70,4,7,426,128,298,232.8125
70,4,8,68,256,-188,-73.4375
70,4,9,405,512,-107,-20.8984375
70,4,10,89,1024,-935,-91.30859375
70,4,11,1716,2048,-332,-16.2109375
70,4,12,4714,4096,618,15.087890625
70,4,13,7557,8192,-635,-7.75146484375
70,4,14,9054,16384,-7330,-44.73876953125
70,4,15,20824,32768,-11944,-36.4501953125
70,5,1,0,2,-2,-100.0
70,5,2,2,4,-2,-50.0
70,5,3,4,8,-4,-50.0
70,5,4,6,16,-10,-62.5
70,5,5,5,32,-27,-84.375
70,5,6,271,64,207,323.4375
70,5,7,122,128,-6,-4.6875
70,5,8,78,256,-178,-69.53125
70,5,9,218,512,-294,-57.421875
70,5,10,1958,1024,934,91.2109375
70,5,11,1921,2048,-127,-6.201171875
70,5,12,3225,4096,-871,-21.2646484375
70,5,13,18238,8192,10046,122.6318359375
70,5,14,13887,16384,-2497,-15.240478515625
70,5,15,1590,32768,-31178,-95.147705078125
70,6,1,0,2,-2,-100.0
70,6,2,1,4,-3,-75.0
70,6,3,5,8,-3,-37.5
70,6,4,8,16,-8,-50.0
70,6,5,10,32,-22,-68.75
70,6,6,101,64,37,57.8125
70,6,7,166,128,38,29.6875
70,6,8,130,256,-126,-49.21875
70,6,9,197,512,-315,-61.5234375
70,6,10,87,1024,-937,-91.50390625
70,6,11,1220,2048,-828,-40.4296875
70,6,12,9780,4096,5684,138.76953125
70,6,13,22704,8192,14512,177.1484375
70,6,14,23498,16384,7114,43.42041015625
70,6,15,14065,32768,-18703,-57.0770263671875
70,7,1,0,2,-2,-100.0
70,7,2,1,4,-3,-75.0
70,7,3,9,8,1,12.5
70,7,4,4,16,-12,-75.0
70,7,5,31,32,-1,-3.125
70,7,6,78,64,14,21.875
70,7,7,544,128,416,325.0
70,7,8,74,256,-182,-71.09375
70,7,9,253,512,-259,-50.5859375
70,7,10,509,1024,-515,-50.29296875
70,7,11,6657,2048,4609,225.048828125
70,7,12,2453,4096,-1643,-40.1123046875
70,7,13,9376,8192,1184,14.453125
70,7,14,17763,16384,1379,8.416748046875
70,7,15,108934,32768,76166,232.440185546875
70,8,1,0,2,-2,-100.0
70,8,2,1,4,-3,-75.0
70,8,3,2,8,-6,-75.0
70,8,4,10,16,-6,-37.5
70,8,5,17,32,-15,-46.875
70,8,6,41,64,-23,-35.9375
70,8,7,70,128,-58,-45.3125
70,8,8,229,256,-27,-10.546875
70,8,9,571,512,59,11.5234375
70,8,10,244,1024,-780,-76.171875
70,8,11,636,2048,-1412,-68.9453125
70,8,12,9654,4096,5558,135.693359375
70,8,13,7310,8192,-882,-10.7666015625
70,8,14,7192,16384,-9192,-56.103515625
70,8,15,5504,32768,-27264,-83.203125
70,9,1,0,2,-2,-100.0
70,9,2,1,4,-3,-75.0
70,9,3,5,8,-3,-37.5
70,9,4,6,16,-10,-62.5
70,9,5,61,32,29,90.625
70,9,6,32,64,-32,-50.0
70,9,7,36,128,-92,-71.875
70,9,8,114,256,-142,-55.46875
70,9,9,238,512,-274,-53.515625
70,9,10,110,1024,-914,-89.2578125
70,9,11,474,2048,-1574,-76.85546875
70,9,12,2260,4096,-1836,-44.82421875
70,9,13,11588,8192,3396,41.455078125
70,9,14,12255,16384,-4129,-25.201416015625
70,9,15,37297,32768,4529,13.8214111328125
70,10,1,0,2,-2,-100.0
70,10,2,4,4,0,0.0
70,10,3,2,8,-6,-75.0
70,10,4,6,16,-10,-62.5
70,10,5,7,32,-25,-78.125
70,10,6,45,64,-19,-29.6875
70,10,7,14,128,-114,-89.0625
70,10,8,284,256,28,10.9375
70,10,9,465,512,-47,-9.1796875
70,10,10,377,1024,-647,-63.18359375
70,10,11,2461,2048,413,20.166015625
70,10,12,4390,4096,294,7.177734375
70,10,13,2225,8192,-5967,-72.83935546875
70,10,14,20346,16384,3962,24.18212890625
70,10,15,210308,32768,177540,541.80908203125
70,11,1,0,2,-2,-100.0
70,11,2,2,4,-2,-50.0
70,11,3,15,8,7,87.5
70,11,4,3,16,-13,-81.25
70,11,5,8,32,-24,-75.0
70,11,6,131,64,67,104.6875
70,11,7,35,128,-93,-72.65625
70,11,8,350,256,94,36.71875
70,11,9,622,512,110,21.484375
70,11,10,1327,1024,303,29.58984375
70,11,11,2262,2048,214,10.44921875
70,11,12,38,4096,-4058,-99.072265625
70,11,13,92,8192,-8100,-98.876953125
70,11,14,12439,16384,-3945,-24.078369140625
70,11,15,17863,32768,-14905,-45.4864501953125
70,12,1,0,2,-2,-100.0
70,12,2,4,4,0,0.0
70,12,3,8,8,0,0.0
70,12,4,8,16,-8,-50.0
70,12,5,10,32,-22,-68.75
70,12,6,43,64,-21,-32.8125
70,12,7,52,128,-76,-59.375
70,12,8,238,256,-18,-7.03125
70,12,9,117,512,-395,-77.1484375
70,12,10,775,1024,-249,-24.31640625
70,12,11,2336,2048,288,14.0625
70,12,12,16091,4096,11995,292.8466796875
70,12,13,5661,8192,-2531,-30.89599609375
70,12,14,3679,16384,-12705,-77.545166015625
70,12,15,24254,32768,-8514,-25.982666015625
70,13,1,0,2,-2,-100.0
70,13,2,2,4,-2,-50.0
70,13,3,2,8,-6,-75.0
70,13,4,5,16,-11,-68.75
70,13,5,40,32,8,25.0
70,13,6,118,64,54,84.375
70,13,7,67,128,-61,-47.65625
70,13,8,530,256,274,107.03125
70,13,9,509,512,-3,-0.5859375
70,13,10,18,1024,-1006,-98.2421875
70,13,11,2064,2048,16,0.78125
70,13,12,3848,4096,-248,-6.0546875
70,13,13,3108,8192,-5084,-62.060546875
70,13,14,10078,16384,-6306,-38.48876953125
70,13,15,2538,32768,-30230,-92.254638671875
70,14,1,0,2,-2,-100.0
70,14,2,1,4,-3,-75.0
70,14,3,7,8,-1,-12.5
70,14,4,3,16,-13,-81.25
70,14,5,8,32,-24,-75.0
70,14,6,20,64,-44,-68.75
70,14,7,142,128,14,10.9375
70,14,8,208,256,-48,-18.75
70,14,9,256,512,-256,-50.0
70,14,10,1619,1024,595,58.10546875
70,14,11,1815,2048,-233,-11.376953125
70,14,12,4709,4096,613,14.9658203125
70,14,13,4149,8192,-4043,-49.35302734375
70,14,14,21658,16384,5274,32.18994140625
70,14,15,19100,32768,-13668,-41.71142578125
70,15,1,0,2,-2,-100.0
70,15,2,2,4,-2,-50.0
70,15,3,2,8,-6,-75.0
70,15,4,38,16,22,137.5
70,15,5,44,32,12,37.5
70,15,6,19,64,-45,-70.3125
70,15,7,66,128,-62,-48.4375
70,15,8,519,256,263,102.734375
70,15,9,360,512,-152,-29.6875
70,15,10,985,1024,-39,-3.80859375
70,15,11,5535,2048,3487,170.263671875
70,15,12,87,4096,-4009,-97.8759765625
70,15,13,23940,8192,15748,192.236328125
70,15,14,20599,16384,4215,25.726318359375
70,15,15,8420,32768,-24348,-74.30419921875
70,16,1,0,2,-2,-100.0
70,16,2,1,4,-3,-75.0
70,16,3,10,8,2,25.0
70,16,4,37,16,21,131.25
70,16,5,32,32,0,0.0
70,16,6,103,64,39,60.9375
70,16,7,29,128,-99,-77.34375
70,16,8,87,256,-169,-66.015625
70,16,9,483,512,-29,-5.6640625
70,16,10,451,1024,-573,-55.95703125
70,16,11,2417,2048,369,18.017578125
70,16,12,1857,4096,-2239,-54.6630859375
70,16,13,12677,8192,4485,54.74853515625
70,16,14,17532,16384,1148,7.0068359375
70,16,15,11044,32768,-21724,-66.29638671875
70,17,1,0,2,-2,-100.0
70,17,2,2,4,-2,-50.0
70,17,3,2,8,-6,-75.0
70,17,4,18,16,2,12.5
70,17,5,23,32,-9,-28.125
70,17,6,90,64,26,40.625
70,17,7,47,128,-81,-63.28125
70,17,8,137,256,-119,-46.484375
70,17,9,138,512,-374,-73.046875
70,17,10,108,1024,-916,-89.453125
70,17,11,4119,2048,2071,101.123046875
70,17,12,3170,4096,-926,-22.607421875
70,17,13,2877,8192,-5315,-64.88037109375
70,17,14,24326,16384,7942,48.47412109375
70,17,15,20507,32768,-12261,-37.4176025390625
70,18,1,0,2,-2,-100.0
70,18,2,1,4,-3,-75.0
70,18,3,8,8,0,0.0
70,18,4,12,16,-4,-25.0
70,18,5,27,32,-5,-15.625
70,18,6,23,64,-41,-64.0625
70,18,7,155,128,27,21.09375
70,18,8,142,256,-114,-44.53125
70,18,9,243,512,-269,-52.5390625
70,18,10,327,1024,-697,-68.06640625
70,18,11,1068,2048,-980,-47.8515625
70,18,12,21470,4096,17374,424.169921875
70,18,13,7595,8192,-597,-7.28759765625
70,18,14,4524,16384,-11860,-72.3876953125
70,18,15,9941,32768,-22827,-69.6624755859375
70,19,1,0,2,-2,-100.0
70,19,2,3,4,-1,-25.0
70,19,3,5,8,-3,-37.5
70,19,4,35,16,19,118.75
70,19,5,13,32,-19,-59.375
70,19,6,41,64,-23,-35.9375
70,19,7,14,128,-114,-89.0625
70,19,8,169,256,-87,-33.984375
70,19,9,1179,512,667,130.2734375
70,19,10,3101,1024,2077,202.83203125
70,19,11,1063,2048,-985,-48.095703125
70,19,12,1939,4096,-2157,-52.6611328125
70,19,13,1084,8192,-7108,-86.767578125
70,19,14,25998,16384,9614,58.67919921875
70,19,15,12458,32768,-20310,-61.981201171875
70,20,1,0,2,-2,-100.0
70,20,2,8,4,4,100.0
70,20,3,10,8,2,25.0
70,20,4,3,16,-13,-81.25
70,20,5,11,32,-21,-65.625
70,20,6,13,64,-51,-79.6875
70,20,7,30,128,-98,-76.5625
70,20,8,77,256,-179,-69.921875
70,20,9,14,512,-498,-97.265625
70,20,10,181,1024,-843,-82.32421875
70,20,11,6748,2048,4700,229.4921875
70,20,12,14213,4096,10117,246.9970703125
70,20,13,11220,8192,3028,36.962890625
70,20,14,12621,16384,-3763,-22.967529296875
70,20,15,23397,32768,-9371,-28.5980224609375
70,21,1,0,2,-2,-100.0
70,21,2,1,4,-3,-75.0
70,21,3,5,8,-3,-37.5
70,21,4,9,16,-7,-43.75
70,21,5,28,32,-4,-12.5
70,21,6,16,64,-48,-75.0
70,21,7,340,128,212,165.625
70,21,8,295,256,39,15.234375
70,21,9,555,512,43,8.3984375
70,21,10,280,1024,-744,-72.65625
70,21,11,213,2048,-1835,-89.599609375
70,21,12,12741,4096,8645,211.0595703125
70,21,13,888,8192,-7304,-89.16015625
70,21,14,47612,16384,31228,190.6005859375
70,21,15,16844,32768,-15924,-48.59619140625
70,22,1,0,2,-2,-100.0
70,22,2,3,4,-1,-25.0
70,22,3,13,8,5,62.5
70,22,4,9,16,-7,-43.75
70,22,5,39,32,7,21.875
70,22,6,60,64,-4,-6.25
70,22,7,162,128,34,26.5625
70,22,8,938,256,682,266.40625
70,22,9,259,512,-253,-49.4140625
70,22,10,458,1024,-566,-55.2734375
70,22,11,1663,2048,-385,-18.798828125
70,22,12,5677,4096,1581,38.5986328125
70,22,13,9192,8192,1000,12.20703125
70,22,14,23427,16384,7043,42.987060546875
70,22,15,144190,32768,111422,340.032958984375
70,23,1,0,2,-2,-100.0
70,23,2,2,4,-2,-50.0
70,23,3,2,8,-6,-75.0
70,23,4,9,16,-7,-43.75
70,23,5,51,32,19,59.375
70,23,6,79,64,15,23.4375
70,23,7,58,128,-70,-54.6875
70,23,8,257,256,1,0.390625
70,23,9,374,512,-138,-26.953125
70,23,10,739,1024,-285,-27.83203125
70,23,11,928,2048,-1120,-54.6875
70,23,12,470,4096,-3626,-88.525390625
70,23,13,3899,8192,-4293,-52.40478515625
70,23,14,22793,16384,6409,39.117431640625
70,23,15,139993,32768,107225,327.2247314453125
70,24,1,0,2,-2,-100.0
70,24,2,1,4,-3,-75.0
70,24,3,9,8,1,12.5
70,24,4,7,16,-9,-56.25
70,24,5,37,32,5,15.625
70,24,6,30,64,-34,-53.125
70,24,7,132,128,4,3.125
70,24,8,8,256,-248,-96.875
70,24,9,121,512,-391,-76.3671875
70,24,10,1646,1024,622,60.7421875
70,24,11,1320,2048,-728,-35.546875
70,24,12,1813,4096,-2283,-55.7373046875
70,24,13,23997,8192,15805,192.93212890625
70,24,14,22988,16384,6604,40.3076171875
70,24,15,4109,32768,-28659,-87.4603271484375
70,25,1,0,2,-2,-100.0
70,25,2,1,4,-3,-75.0
70,25,3,18,8,10,125.0
70,25,4,9,16,-7,-43.75
70,25,5,42,32,10,31.25
70,25,6,89,64,25,39.0625
70,25,7,119,128,-9,-7.03125
70,25,8,10,256,-246,-96.09375
70,25,9,130,512,-382,-74.609375
70,25,10,503,1024,-521,-50.87890625
70,25,11,271,2048,-1777,-86.767578125
70,25,12,2997,4096,-1099,-26.8310546875
70,25,13,7665,8192,-527,-6.43310546875
70,25,14,9030,16384,-7354,-44.88525390625
70,25,15,13770,32768,-18998,-57.977294921875
70,26,1,0,2,-2,-100.0
70,26,2,6,4,2,50.0
70,26,3,3,8,-5,-62.5
70,26,4,4,16,-12,-75.0
70,26,5,51,32,19,59.375
70,26,6,53,64,-11,-17.1875
70,26,7,30,128,-98,-76.5625
70,26,8,23,256,-233,-91.015625
70,26,9,1241,512,729,142.3828125
70,26,10,1239,1024,215,20.99609375
70,26,11,2671,2048,623,30.419921875
70,26,12,3615,4096,-481,-11.7431640625
70,26,13,809,8192,-7383,-90.12451171875
70,26,14,5572,16384,-10812,-65.9912109375
70,26,15,30627,32768,-2141,-6.5338134765625
70,27,1,0,2,-2,-100.0
70,27,2,1,4,-3,-75.0
70,27,3,4,8,-4,-50.0
70,27,4,10,16,-6,-37.5
70,27,5,37,32,5,15.625
70,27,6,20,64,-44,-68.75
70,27,7,52,128,-76,-59.375
70,27,8,75,256,-181,-70.703125
70,27,9,500,512,-12,-2.34375
70,27,10,5619,1024,4595,448.73046875
70,27,11,836,2048,-1212,-59.1796875
70,27,12,48,4096,-4048,-98.828125
70,27,13,6613,8192,-1579,-19.27490234375
70,27,14,9699,16384,-6685,-40.802001953125
70,27,15,39906,32768,7138,21.783447265625
70,28,1,0,2,-2,-100.0
70,28,2,2,4,-2,-50.0
70,28,3,2,8,-6,-75.0
70,28,4,3,16,-13,-81.25
70,28,5,18,32,-14,-43.75
70,28,6,151,64,87,135.9375
70,28,7,754,128,626,489.0625
70,28,8,164,256,-92,-35.9375
70,28,9,1089,512,577,112.6953125
70,28,10,40,1024,-984,-96.09375
70,28,11,503,2048,-1545,-75.439453125
70,28,12,1340,4096,-2756,-67.28515625
70,28,13,11735,8192,3543,43.24951171875
70,28,14,2807,16384,-13577,-82.867431640625
70,28,15,414,32768,-32354,-98.736572265625
70,29,1,0,2,-2,-100.0
70,29,2,2,4,-2,-50.0
70,29,3,10,8,2,25.0
70,29,4,20,16,4,25.0
70,29,5,40,32,8,25.0
70,29,6,22,64,-42,-65.625
70,29,7,233,128,105,82.03125
70,29,8,166,256,-90,-35.15625
70,29,9,252,512,-260,-50.78125
70,29,10,43,1024,-981,-95.80078125
70,29,11,227,2048,-1821,-88.916015625
70,29,12,3437,4096,-659,-16.0888671875
70,29,13,3318,8192,-4874,-59.4970703125
70,29,14,11422,16384,-4962,-30.28564453125
70,29,15,1345,32768,-31423,-95.8953857421875
70,30,1,0,2,-2,-100.0
70,30,2,2,4,-2,-50.0
70,30,3,11,8,3,37.5
70,30,4,25,16,9,56.25
70,30,5,108,32,76,237.5
70,30,6,123,64,59,92.1875
70,30,7,108,128,-20,-15.625
70,30,8,343,256,87,33.984375
70,30,9,820,512,308,60.15625
70,30,10,793,1024,-231,-22.55859375
70,30,11,3846,2048,1798,87.79296875
70,30,12,6249,4096,2153,52.5634765625
70,30,13,3798,8192,-4394,-53.6376953125
70,30,14,1857,16384,-14527,-88.665771484375
70,30,15,31185,32768,-1583,-4.8309326171875
70,31,1,0,2,-2,-100.0
70,31,2,1,4,-3,-75.0
70,31,3,12,8,4,50.0
70,31,4,6,16,-10,-62.5
70,31,5,97,32,65,203.125
70,31,6,167,64,103,160.9375
70,31,7,34,128,-94,-73.4375
70,31,8,58,256,-198,-77.34375
70,31,9,84,512,-428,-83.59375
70,31,10,562,1024,-462,-45.1171875
70,31,11,1508,2048,-540,-26.3671875
70,31,12,1519,4096,-2577,-62.9150390625
70,31,13,4439,8192,-3753,-45.81298828125
70,31,14,7941,16384,-8443,-51.531982421875
70,31,15,325,32768,-32443,-99.0081787109375
70,32,1,0,2,-2,-100.0
70,32,2,1,4,-3,-75.0
70,32,3,3,8,-5,-62.5
70,32,4,16,16,0,0.0
70,32,5,4,32,-28,-87.5
70,32,6,50,64,-14,-21.875
70,32,7,99,128,-29,-22.65625
70,32,8,71,256,-185,-72.265625
70,32,9,987,512,475,92.7734375
70,32,10,3274,1024,2250,219.7265625
70,32,11,1121,2048,-927,-45.263671875
70,32,12,3701,4096,-395,-9.6435546875
70,32,13,991,8192,-7201,-87.90283203125
70,32,14,16099,16384,-285,-1.739501953125
70,32,15,27584,32768,-5184,-15.8203125
70,33,1,0,2,-2,-100.0
70,33,2,3,4,-1,-25.0
70,33,3,5,8,-3,-37.5
70,33,4,6,16,-10,-62.5
70,33,5,39,32,7,21.875
70,33,6,5,64,-59,-92.1875
70,33,7,140,128,12,9.375
70,33,8,191,256,-65,-25.390625
70,33,9,725,512,213,41.6015625
70,33,10,194,1024,-830,-81.0546875
70,33,11,79,2048,-1969,-96.142578125
70,33,12,4350,4096,254,6.201171875
70,33,13,113,8192,-8079,-98.62060546875
70,33,14,33485,16384,17101,104.376220703125
70,33,15,70804,32768,38036,116.07666015625
70,34,1,0,2,-2,-100.0
70,34,2,2,4,-2,-50.0
70,34,3,2,8,-6,-75.0
70,34,4,3,16,-13,-81.25
70,34,5,38,32,6,18.75
70,34,6,14,64,-50,-78.125
70,34,7,48,128,-80,-62.5
70,34,8,143,256,-113,-44.140625
70,34,9,227,512,-285,-55.6640625
70,34,10,97,1024,-927,-90.52734375
70,34,11,4327,2048,2279,111.279296875
70,34,12,1402,4096,-2694,-65.771484375
70,34,13,5028,8192,-3164,-38.623046875
70,34,14,33485,16384,17101,104.376220703125
70,34,15,13221,32768,-19547,-59.6527099609375
70,35,1,0,2,-2,-100.0
70,35,2,2,4,-2,-50.0
70,35,3,4,8,-4,-50.0
70,35,4,9,16,-7,-43.75
70,35,5,38,32,6,18.75
70,35,6,11,64,-53,-82.8125
70,35,7,108,128,-20,-15.625
70,35,8,322,256,66,25.78125
70,35,9,600,512,88,17.1875
70,35,10,337,1024,-687,-67.08984375
70,35,11,18,2048,-2030,-99.12109375
70,35,12,1200,4096,-2896,-70.703125
70,35,13,1405,8192,-6787,-82.84912109375
70,35,14,24203,16384,7819,47.723388671875
70,35,15,14416,32768,-18352,-56.005859375
70,36,1,0,2,-2,-100.0
70,36,2,1,4,-3,-75.0
70,36,3,3,8,-5,-62.5
70,36,4,30,16,14,87.5
70,36,5,98,32,66,206.25
70,36,6,18,64,-46,-71.875
70,36,7,266,128,138,107.8125
70,36,8,226,256,-30,-11.71875
70,36,9,275,512,-237,-46.2890625
70,36,10,1070,1024,46,4.4921875
70,36,11,1126,2048,-922,-45.01953125
70,36,12,100,4096,-3996,-97.55859375
70,36,13,4562,8192,-3630,-44.3115234375
70,36,14,3592,16384,-12792,-78.076171875
70,36,15,18660,32768,-14108,-43.05419921875
70,37,1,0,2,-2,-100.0
70,37,2,2,4,-2,-50.0
70,37,3,2,8,-6,-75.0
70,37,4,33,16,17,106.25
70,37,5,41,32,9,28.125
70,37,6,31,64,-33,-51.5625
70,37,7,126,128,-2,-1.5625
70,37,8,433,256,177,69.140625
70,37,9,121,512,-391,-76.3671875
70,37,10,1497,1024,473,46.19140625
70,37,11,741,2048,-1307,-63.818359375
70,37,12,1470,4096,-2626,-64.111328125
70,37,13,18464,8192,10272,125.390625
70,37,14,13289,16384,-3095,-18.890380859375
70,37,15,2222,32768,-30546,-93.218994140625
70,38,1,0,2,-2,-100.0
70,38,2,1,4,-3,-75.0
70,38,3,2,8,-6,-75.0
70,38,4,11,16,-5,-31.25
70,38,5,15,32,-17,-53.125
70,38,6,73,64,9,14.0625
70,38,7,21,128,-107,-83.59375
70,38,8,118,256,-138,-53.90625
70,38,9,24,512,-488,-95.3125
70,38,10,829,1024,-195,-19.04296875
70,38,11,2241,2048,193,9.423828125
70,38,12,4986,4096,890,21.728515625
70,38,13,11465,8192,3273,39.95361328125
70,38,14,17298,16384,914,5.57861328125
70,38,15,53454,32768,20686,63.128662109375
70,39,1,0,2,-2,-100.0
70,39,2,1,4,-3,-75.0
70,39,3,4,8,-4,-50.0
70,39,4,7,16,-9,-56.25
70,39,5,29,32,-3,-9.375
70,39,6,73,64,9,14.0625
70,39,7,87,128,-41,-32.03125
70,39,8,355,256,99,38.671875
70,39,9,28,512,-484,-94.53125
70,39,10,602,1024,-422,-41.2109375
70,39,11,357,2048,-1691,-82.568359375
70,39,12,112,4096,-3984,-97.265625
70,39,13,4386,8192,-3806,-46.4599609375
70,39,14,30829,16384,14445,88.165283203125
70,39,15,22323,32768,-10445,-31.8756103515625
70,40,1,0,2,-2,-100.0
70,40,2,1,4,-3,-75.0
70,40,3,5,8,-3,-37.5
70,40,4,11,16,-5,-31.25
70,40,5,72,32,40,125.0
70,40,6,22,64,-42,-65.625
70,40,7,660,128,532,415.625
70,40,8,699,256,443,173.046875
70,40,9,525,512,13,2.5390625
70,40,10,1428,1024,404,39.453125
70,40,11,2503,2048,455,22.216796875
70,40,12,753,4096,-3343,-81.6162109375
70,40,13,14213,8192,6021,73.49853515625
70,40,14,28395,16384,12011,73.309326171875
70,40,15,5549,32768,-27219,-83.0657958984375
70,41,1,0,2,-2,-100.0
70,41,2,1,4,-3,-75.0
70,41,3,6,8,-2,-25.0
70,41,4,6,16,-10,-62.5
70,41,5,32,32,0,0.0
70,41,6,7,64,-57,-89.0625
70,41,7,38,128,-90,-70.3125
70,41,8,151,256,-105,-41.015625
70,41,9,38,512,-474,-92.578125
70,41,10,637,1024,-387,-37.79296875
70,41,11,2862,2048,814,39.74609375
70,41,12,715,4096,-3381,-82.5439453125
70,41,13,605,8192,-7587,-92.61474609375
70,41,14,763,16384,-15621,-95.343017578125
70,41,15,5244,32768,-27524,-83.99658203125
70,42,1,0,2,-2,-100.0
70,42,2,2,4,-2,-50.0
70,42,3,2,8,-6,-75.0
70,42,4,9,16,-7,-43.75
70,42,5,114,32,82,256.25
70,42,6,35,64,-29,-45.3125
70,42,7,153,128,25,19.53125
70,42,8,690,256,434,169.53125
70,42,9,304,512,-208,-40.625
70,42,10,1771,1024,747,72.94921875
70,42,11,4412,2048,2364,115.4296875
70,42,12,1406,4096,-2690,-65.673828125
70,42,13,617,8192,-7575,-92.46826171875
70,42,14,12186,16384,-4198,-25.62255859375
70,42,15,6874,32768,-25894,-79.022216796875
70,43,1,0,2,-2,-100.0
70,43,2,3,4,-1,-25.0
70,43,3,9,8,1,12.5
70,43,4,28,16,12,75.0
70,43,5,20,32,-12,-37.5
70,43,6,107,64,43,67.1875
70,43,7,138,128,10,7.8125
70,43,8,209,256,-47,-18.359375
70,43,9,668,512,156,30.46875
70,43,10,812,1024,-212,-20.703125
70,43,11,4028,2048,1980,96.6796875
70,43,12,829,4096,-3267,-79.7607421875
70,43,13,39843,8192,31651,386.36474609375
70,43,14,15986,16384,-398,-2.42919921875
70,43,15,49742,32768,16974,51.800537109375
70,44,1,0,2,-2,-100.0
70,44,2,1,4,-3,-75.0
70,44,3,7,8,-1,-12.5
70,44,4,8,16,-8,-50.0
70,44,5,27,32,-5,-15.625
70,44,6,49,64,-15,-23.4375
70,44,7,136,128,8,6.25
70,44,8,36,256,-220,-85.9375
70,44,9,608,512,96,18.75
70,44,10,294,1024,-730,-71.2890625
70,44,11,1288,2048,-760,-37.109375
70,44,12,7124,4096,3028,73.92578125
70,44,13,18190,8192,9998,122.0458984375
70,44,14,5765,16384,-10619,-64.813232421875
70,44,15,61709,32768,28941,88.3209228515625
70,45,1,0,2,-2,-100.0
70,45,2,2,4,-2,-50.0
70,45,3,2,8,-6,-75.0
70,45,4,26,16,10,62.5
70,45,5,19,32,-13,-40.625
70,45,6,5,64,-59,-92.1875
70,45,7,85,128,-43,-33.59375
70,45,8,131,256,-125,-48.828125
70,45,9,349,512,-163,-31.8359375
70,45,10,810,1024,-214,-20.8984375
70,45,11,6457,2048,4409,215.283203125
70,45,12,4487,4096,391,9.5458984375
70,45,13,3544,8192,-4648,-56.73828125
70,45,14,19693,16384,3309,20.196533203125
70,45,15,5202,32768,-27566,-84.124755859375
70,46,1,0,2,-2,-100.0
70,46,2,5,4,1,25.0
70,46,3,4,8,-4,-50.0
70,46,4,9,16,-7,-43.75
70,46,5,62,32,30,93.75
70,46,6,127,64,63,98.4375
70,46,7,129,128,1,0.78125
70,46,8,42,256,-214,-83.59375
70,46,9,325,512,-187,-36.5234375
70,46,10,2432,1024,1408,137.5
70,46,11,195,2048,-1853,-90.478515625
70,46,12,4546,4096,450,10.986328125
70,46,13,4319,8192,-3873,-47.27783203125
70,46,14,3985,16384,-12399,-75.677490234375
70,46,15,45156,32768,12388,37.80517578125
70,47,1,0,2,-2,-100.0
70,47,2,1,4,-3,-75.0
70,47,3,12,8,4,50.0
70,47,4,3,16,-13,-81.25
70,47,5,26,32,-6,-18.75
70,47,6,66,64,2,3.125
70,47,7,74,128,-54,-42.1875
70,47,8,92,256,-164,-64.0625
70,47,9,255,512,-257,-50.1953125
70,47,10,574,1024,-450,-43.9453125
70,47,11,1578,2048,-470,-22.94921875
70,47,12,4290,4096,194,4.736328125
70,47,13,4487,8192,-3705,-45.22705078125
70,47,14,22695,16384,6311,38.519287109375
70,47,15,6427,32768,-26341,-80.3863525390625
70,48,1,0,2,-2,-100.0
70,48,2,1,4,-3,-75.0
70,48,3,3,8,-5,-62.5
70,48,4,10,16,-6,-37.5
70,48,5,29,32,-3,-9.375
70,48,6,61,64,-3,-4.6875
70,48,7,14,128,-114,-89.0625
70,48,8,242,256,-14,-5.46875
70,48,9,1142,512,630,123.046875
70,48,10,1372,1024,348,33.984375
70,48,11,1276,2048,-772,-37.6953125
70,48,12,4693,4096,597,14.5751953125
70,48,13,22735,8192,14543,177.52685546875
70,48,14,4858,16384,-11526,-70.34912109375
70,48,15,16621,32768,-16147,-49.2767333984375
70,49,1,0,2,-2,-100.0
70,49,2,1,4,-3,-75.0
70,49,3,2,8,-6,-75.0
70,49,4,3,16,-13,-81.25
70,49,5,6,32,-26,-81.25
70,49,6,32,64,-32,-50.0
70,49,7,108,128,-20,-15.625
70,49,8,39,256,-217,-84.765625
70,49,9,972,512,460,89.84375
70,49,10,372,1024,-652,-63.671875
70,49,11,768,2048,-1280,-62.5
70,49,12,531,4096,-3565,-87.0361328125
70,49,13,2944,8192,-5248,-64.0625
70,49,14,3657,16384,-12727,-77.679443359375
70,49,15,77761,32768,44993,137.3077392578125
70,50,1,0,2,-2,-100.0
70,50,2,2,4,-2,-50.0
70,50,3,13,8,5,62.5
70,50,4,10,16,-6,-37.5
70,50,5,13,32,-19,-59.375
70,50,6,156,64,92,143.75
70,50,7,51,128,-77,-60.15625
70,50,8,82,256,-174,-67.96875
70,50,9,929,512,417,81.4453125
70,50,10,594,1024,-430,-41.9921875
70,50,11,1564,2048,-484,-23.6328125
70,50,12,6926,4096,2830,69.091796875
70,50,13,1938,8192,-6254,-76.3427734375
70,50,14,14719,16384,-1665,-10.162353515625
70,50,15,45578,32768,12810,39.093017578125
70,51,1,0,2,-2,-100.0
70,51,2,1,4,-3,-75.0
70,51,3,5,8,-3,-37.5
70,51,4,3,16,-13,-81.25
70,51,5,4,32,-28,-87.5
70,51,6,28,64,-36,-56.25
70,51,7,88,128,-40,-31.25
70,51,8,71,256,-185,-72.265625
70,51,9,123,512,-389,-75.9765625
70,51,10,233,1024,-791,-77.24609375
70,51,11,427,2048,-1621,-79.150390625
70,51,12,9551,4096,5455,133.1787109375
70,51,13,275,8192,-7917,-96.64306640625
70,51,14,18826,16384,2442,14.90478515625
70,51,15,8709,32768,-24059,-73.4222412109375
70,52,1,0,2,-2,-100.0
70,52,2,3,4,-1,-25.0
70,52,3,2,8,-6,-75.0
70,52,4,10,16,-6,-37.5
70,52,5,14,32,-18,-56.25
70,52,6,130,64,66,103.125
70,52,7,15,128,-113,-88.28125
70,52,8,13,256,-243,-94.921875
70,52,9,364,512,-148,-28.90625
70,52,10,2588,1024,1564,152.734375
70,52,11,1058,2048,-990,-48.33984375
70,52,12,5427,4096,1331,32.4951171875
70,52,13,33588,8192,25396,310.009765625
70,52,14,25909,16384,9525,58.135986328125
70,52,15,6113,32768,-26655,-81.3446044921875
70,53,1,0,2,-2,-100.0
70,53,2,1,4,-3,-75.0
70,53,3,7,8,-1,-12.5
70,53,4,14,16,-2,-12.5
70,53,5,11,32,-21,-65.625
70,53,6,37,64,-27,-42.1875
70,53,7,82,128,-46,-35.9375
70,53,8,108,256,-148,-57.8125
70,53,9,43,512,-469,-91.6015625
70,53,10,1313,1024,289,28.22265625
70,53,11,4945,2048,2897,141.455078125
70,53,12,946,4096,-3150,-76.904296875
70,53,13,8887,8192,695,8.48388671875
70,53,14,7332,16384,-9052,-55.2490234375
70,53,15,7367,32768,-25401,-77.5177001953125
70,54,1,0,2,-2,-100.0
70,54,2,1,4,-3,-75.0
70,54,3,9,8,1,12.5
70,54,4,6,16,-10,-62.5
70,54,5,11,32,-21,-65.625
70,54,6,175,64,111,173.4375
70,54,7,157,128,29,22.65625
70,54,8,250,256,-6,-2.34375
70,54,9,1051,512,539,105.2734375
70,54,10,1188,1024,164,16.015625
70,54,11,2703,2048,655,31.982421875
70,54,12,1971,4096,-2125,-51.8798828125
70,54,13,53,8192,-8139,-99.35302734375
70,54,14,18879,16384,2495,15.228271484375
70,54,15,39382,32768,6614,20.184326171875
70,55,1,0,2,-2,-100.0
70,55,2,1,4,-3,-75.0
70,55,3,2,8,-6,-75.0
70,55,4,11,16,-5,-31.25
70,55,5,11,32,-21,-65.625
70,55,6,52,64,-12,-18.75
70,55,7,54,128,-74,-57.8125
70,55,8,62,256,-194,-75.78125
70,55,9,57,512,-455,-88.8671875
70,55,10,60,1024,-964,-94.140625
70,55,11,2567,2048,519,25.341796875
70,55,12,6116,4096,2020,49.31640625
70,55,13,4156,8192,-4036,-49.267578125
70,55,14,1476,16384,-14908,-90.9912109375
70,55,15,28540,32768,-4228,-12.90283203125
70,56,1,0,2,-2,-100.0
70,56,2,2,4,-2,-50.0
70,56,3,9,8,1,12.5
70,56,4,47,16,31,193.75
70,56,5,43,32,11,34.375
70,56,6,134,64,70,109.375
70,56,7,37,128,-91,-71.09375
70,56,8,60,256,-196,-76.5625
70,56,9,497,512,-15,-2.9296875
70,56,10,453,1024,-571,-55.76171875
70,56,11,355,2048,-1693,-82.666015625
70,56,12,2224,4096,-1872,-45.703125
70,56,13,15138,8192,6946,84.7900390625
70,56,14,16247,16384,-137,-0.836181640625
70,56,15,1451,32768,-31317,-95.5718994140625
70,57,1,0,2,-2,-100.0
70,57,2,1,4,-3,-75.0
70,57,3,4,8,-4,-50.0
70,57,4,16,16,0,0.0
70,57,5,109,32,77,240.625
70,57,6,38,64,-26,-40.625
70,57,7,670,128,542,423.4375
70,57,8,144,256,-112,-43.75
70,57,9,123,512,-389,-75.9765625
70,57,10,287,1024,-737,-71.97265625
70,57,11,4615,2048,2567,125.341796875
70,57,12,1431,4096,-2665,-65.0634765625
70,57,13,1547,8192,-6645,-81.11572265625
70,57,14,22363,16384,5979,36.492919921875
70,57,15,59187,32768,26419,80.6243896484375
70,58,1,0,2,-2,-100.0
70,58,2,1,4,-3,-75.0
70,58,3,4,8,-4,-50.0
70,58,4,6,16,-10,-62.5
70,58,5,48,32,16,50.0
70,58,6,24,64,-40,-62.5
70,58,7,320,128,192,150.0
70,58,8,40,256,-216,-84.375
70,58,9,639,512,127,24.8046875
70,58,10,172,1024,-852,-83.203125
70,58,11,2447,2048,399,19.482421875
70,58,12,1596,4096,-2500,-61.03515625
70,58,13,629,8192,-7563,-92.32177734375
70,58,14,9428,16384,-6956,-42.4560546875
70,58,15,11864,32768,-20904,-63.7939453125
70,59,1,0,2,-2,-100.0
70,59,2,3,4,-1,-25.0
70,59,3,9,8,1,12.5
70,59,4,15,16,-1,-6.25
70,59,5,25,32,-7,-21.875
70,59,6,92,64,28,43.75
70,59,7,299,128,171,133.59375
70,59,8,350,256,94,36.71875
70,59,9,41,512,-471,-91.9921875
70,59,10,444,1024,-580,-56.640625
70,59,11,139,2048,-1909,-93.212890625
70,59,12,462,4096,-3634,-88.720703125
70,59,13,21015,8192,12823,156.53076171875
70,59,14,56994,16384,40610,247.86376953125
70,59,15,35451,32768,2683,8.1878662109375
70,60,1,0,2,-2,-100.0
70,60,2,1,4,-3,-75.0
70,60,3,6,8,-2,-25.0
70,60,4,9,16,-7,-43.75
70,60,5,31,32,-1,-3.125
70,60,6,24,64,-40,-62.5
70,60,7,312,128,184,143.75
70,60,8,97,256,-159,-62.109375
70,60,9,218,512,-294,-57.421875
70,60,10,196,1024,-828,-80.859375
70,60,11,4599,2048,2551,124.560546875
70,60,12,9670,4096,5574,136.083984375
70,60,13,4087,8192,-4105,-50.10986328125
70,60,14,30947,16384,14563,88.885498046875
70,60,15,4584,32768,-28184,-86.0107421875
70,61,1,0,2,-2,-100.0
70,61,2,3,4,-1,-25.0
70,61,3,3,8,-5,-62.5
70,61,4,5,16,-11,-68.75
70,61,5,6,32,-26,-81.25
70,61,6,199,64,135,210.9375
70,61,7,75,128,-53,-41.40625
70,61,8,162,256,-94,-36.71875
70,61,9,208,512,-304,-59.375
70,61,10,2357,1024,1333,130.17578125
70,61,11,994,2048,-1054,-51.46484375
70,61,12,869,4096,-3227,-78.7841796875
70,61,13,237,8192,-7955,-97.10693359375
70,61,14,4098,16384,-12286,-74.98779296875
70,61,15,23465,32768,-9303,-28.3905029296875
70,62,1,0,2,-2,-100.0
70,62,2,2,4,-2,-50.0
70,62,3,13,8,5,62.5
70,62,4,11,16,-5,-31.25
70,62,5,45,32,13,40.625
70,62,6,39,64,-25,-39.0625
70,62,7,78,128,-50,-39.0625
70,62,8,331,256,75,29.296875
70,62,9,13,512,-499,-97.4609375
70,62,10,244,1024,-780,-76.171875
70,62,11,150,2048,-1898,-92.67578125
70,62,12,5857,4096,1761,42.9931640625
70,62,13,13744,8192,5552,67.7734375
70,62,14,61530,16384,45146,275.54931640625
70,62,15,19601,32768,-13167,-40.1824951171875
70,63,1,0,2,-2,-100.0
70,63,2,2,4,-2,-50.0
70,63,3,4,8,-4,-50.0
70,63,4,16,16,0,0.0
70,63,5,38,32,6,18.75
70,63,6,99,64,35,54.6875
70,63,7,132,128,4,3.125
70,63,8,100,256,-156,-60.9375
70,63,9,753,512,241,47.0703125
70,63,10,25,1024,-999,-97.55859375
70,63,11,1345,2048,-703,-34.326171875
70,63,12,228,4096,-3868,-94.43359375
70,63,13,32610,8192,24418,298.0712890625
70,63,14,4043,16384,-12341,-75.323486328125
70,63,15,4261,32768,-28507,-86.9964599609375
70,64,1,0,2,-2,-100.0
70,64,2,1,4,-3,-75.0
70,64,3,5,8,-3,-37.5
70,64,4,4,16,-12,-75.0
70,64,5,4,32,-28,-87.5
70,64,6,7,64,-57,-89.0625
70,64,7,141,128,13,10.15625
70,64,8,38,256,-218,-85.15625
70,64,9,356,512,-156,-30.46875
70,64,10,127,1024,-897,-87.59765625
70,64,11,143,2048,-1905,-93.017578125
70,64,12,5464,4096,1368,33.3984375
70,64,13,18862,8192,10670,130.2490234375
70,64,14,33197,16384,16813,102.618408203125
70,64,15,24449,32768,-8319,-25.3875732421875
70,65,1,0,2,-2,-100.0
70,65,2,2,4,-2,-50.0
70,65,3,2,8,-6,-75.0
70,65,4,11,16,-5,-31.25
70,65,5,22,32,-10,-31.25
70,65,6,12,64,-52,-81.25
70,65,7,280,128,152,118.75
70,65,8,477,256,221,86.328125
70,65,9,2730,512,2218,433.203125
70,65,10,1056,1024,32,3.125
70,65,11,3052,2048,1004,49.0234375
70,65,12,5514,4096,1418,34.619140625
70,65,13,5673,8192,-2519,-30.74951171875
70,65,14,3029,16384,-13355,-81.512451171875
70,65,15,48227,32768,15459,47.1771240234375
70,66,1,0,2,-2,-100.0
70,66,2,4,4,0,0.0
70,66,3,11,8,3,37.5
70,66,4,11,16,-5,-31.25
70,66,5,36,32,4,12.5
70,66,6,120,64,56,87.5
70,66,7,52,128,-76,-59.375
70,66,8,36,256,-220,-85.9375
70,66,9,717,512,205,40.0390625
70,66,10,600,1024,-424,-41.40625
70,66,11,4789,2048,2741,133.837890625
70,66,12,10528,4096,6432,157.03125
70,66,13,427,8192,-7765,-94.78759765625
70,66,14,30901,16384,14517,88.604736328125
70,66,15,46283,32768,13515,41.2445068359375
70,67,1,0,2,-2,-100.0
70,67,2,1,4,-3,-75.0
70,67,3,6,8,-2,-25.0
70,67,4,4,16,-12,-75.0
70,67,5,9,32,-23,-71.875
70,67,6,7,64,-57,-89.0625
70,67,7,179,128,51,39.84375
70,67,8,281,256,25,9.765625
70,67,9,413,512,-99,-19.3359375
70,67,10,810,1024,-214,-20.8984375
70,67,11,1790,2048,-258,-12.59765625
70,67,12,3550,4096,-546,-13.330078125
70,67,13,1895,8192,-6297,-76.86767578125
70,67,14,22503,16384,6119,37.347412109375
70,67,15,34394,32768,1626,4.962158203125
70,68,1,0,2,-2,-100.0
70,68,2,4,4,0,0.0
70,68,3,3,8,-5,-62.5
70,68,4,7,16,-9,-56.25
70,68,5,39,32,7,21.875
70,68,6,172,64,108,168.75
70,68,7,18,128,-110,-85.9375
70,68,8,394,256,138,53.90625
70,68,9,188,512,-324,-63.28125
70,68,10,931,1024,-93,-9.08203125
70,68,11,1202,2048,-846,-41.30859375
70,68,12,6585,4096,2489,60.7666015625
70,68,13,7357,8192,-835,-10.19287109375
70,68,14,12475,16384,-3909,-23.858642578125
70,68,15,6831,32768,-25937,-79.1534423828125
70,69,1,0,2,-2,-100.0
70,69,2,2,4,-2,-50.0
70,69,3,10,8,2,25.0
70,69,4,4,16,-12,-75.0
70,69,5,20,32,-12,-37.5
70,69,6,42,64,-22,-34.375
70,69,7,368,128,240,187.5
70,69,8,725,256,469,183.203125
70,69,9,63,512,-449,-87.6953125
70,69,10,567,1024,-457,-44.62890625
70,69,11,1176,2048,-872,-42.578125
70,69,12,727,4096,-3369,-82.2509765625
70,69,13,2386,8192,-5806,-70.8740234375
70,69,14,23558,16384,7174,43.78662109375
70,69,15,26139,32768,-6629,-20.2301025390625
70,70,1,0,2,-2,-100.0
70,70,2,3,4,-1,-25.0
70,70,3,7,8,-1,-12.5
70,70,4,6,16,-10,-62.5
70,70,5,33,32,1,3.125
70,70,6,5,64,-59,-92.1875
70,70,7,18,128,-110,-85.9375
70,70,8,186,256,-70,-27.34375
70,70,9,2020,512,1508,294.53125
70,70,10,197,1024,-827,-80.76171875
70,70,11,2600,2048,552,26.953125
70,70,12,19225,4096,15129,369.3603515625
70,70,13,656,8192,-7536,-91.9921875
70,70,14,97,16384,-16287,-99.407958984375
70,70,15,70723,32768,37955,115.8294677734375
71,1,1,0,2,-2,-100.0
71,1,2,2,4,-2,-50.0
71,1,3,5,8,-3,-37.5
71,1,4,17,16,1,6.25
71,1,5,47,32,15,46.875
71,1,6,76,64,12,18.75
71,1,7,247,128,119,92.96875
71,1,8,575,256,319,124.609375
71,1,9,127,512,-385,-75.1953125
71,1,10,1590,1024,566,55.2734375
71,1,11,1593,2048,-455,-22.216796875
71,1,12,2995,4096,-1101,-26.8798828125
71,1,13,15580,8192,7388,90.185546875
71,1,14,1719,16384,-14665,-89.508056640625
71,1,15,4829,32768,-27939,-85.2630615234375
71,2,1,0,2,-2,-100.0
71,2,2,2,4,-2,-50.0
71,2,3,4,8,-4,-50.0
71,2,4,18,16,2,12.5
71,2,5,105,32,73,228.125
71,2,6,54,64,-10,-15.625
71,2,7,221,128,93,72.65625
71,2,8,266,256,10,3.90625
71,2,9,26,512,-486,-94.921875
71,2,10,414,1024,-610,-59.5703125
71,2,11,1447,2048,-601,-29.345703125
71,2,12,1083,4096,-3013,-73.5595703125
71,2,13,2157,8192,-6035,-73.66943359375
71,2,14,14346,16384,-2038,-12.43896484375
71,2,15,19204,32768,-13564,-41.39404296875
71,3,1,0,2,-2,-100.0
71,3,2,1,4,-3,-75.0
71,3,3,8,8,0,0.0
71,3,4,6,16,-10,-62.5
71,3,5,16,32,-16,-50.0
71,3,6,6,64,-58,-90.625
71,3,7,54,128,-74,-57.8125
71,3,8,322,256,66,25.78125
71,3,9,108,512,-404,-78.90625
71,3,10,1282,1024,258,25.1953125
71,3,11,2498,2048,450,21.97265625
71,3,12,1179,4096,-2917,-71.2158203125
71,3,13,10977,8192,2785,33.99658203125
71,3,14,51754,16384,35370,215.88134765625
71,3,15,76451,32768,43683,133.3099365234375
71,4,1,0,2,-2,-100.0
71,4,2,3,4,-1,-25.0
71,4,3,2,8,-6,-75.0
71,4,4,14,16,-2,-12.5
71,4,5,9,32,-23,-71.875
71,4,6,25,64,-39,-60.9375
71,4,7,259,128,131,102.34375
71,4,8,62,256,-194,-75.78125
71,4,9,1061,512,549,107.2265625
71,4,10,601,1024,-423,-41.30859375
71,4,11,1186,2048,-862,-42.08984375
71,4,12,7376,4096,3280,80.078125
71,4,13,30331,8192,22139,270.25146484375
71,4,14,42399,16384,26015,158.782958984375
71,4,15,130162,32768,97394,297.222900390625
71,5,1,0,2,-2,-100.0
71,5,2,1,4,-3,-75.0
71,5,3,3,8,-5,-62.5
71,5,4,9,16,-7,-43.75
71,5,5,5,32,-27,-84.375
71,5,6,12,64,-52,-81.25
71,5,7,222,128,94,73.4375
71,5,8,200,256,-56,-21.875
71,5,9,892,512,380,74.21875
71,5,10,153,1024,-871,-85.05859375
71,5,11,1096,2048,-952,-46.484375
71,5,12,7456,4096,3360,82.03125
71,5,13,4970,8192,-3222,-39.3310546875
71,5,14,13069,16384,-3315,-20.233154296875
71,5,15,65942,32768,33174,101.239013671875
71,6,1,0,2,-2,-100.0
71,6,2,2,4,-2,-50.0
71,6,3,5,8,-3,-37.5
71,6,4,3,16,-13,-81.25
71,6,5,15,32,-17,-53.125
71,6,6,9,64,-55,-85.9375
71,6,7,82,128,-46,-35.9375
71,6,8,13,256,-243,-94.921875
71,6,9,128,512,-384,-75.0
71,6,10,4260,1024,3236,316.015625
71,6,11,566,2048,-1482,-72.36328125
71,6,12,3024,4096,-1072,-26.171875
71,6,13,11601,8192,3409,41.61376953125
71,6,14,2237,16384,-14147,-86.346435546875
71,6,15,16649,32768,-16119,-49.1912841796875
71,7,1,0,2,-2,-100.0
71,7,2,1,4,-3,-75.0
71,7,3,25,8,17,212.5
71,7,4,62,16,46,287.5
71,7,5,40,32,8,25.0
71,7,6,37,64,-27,-42.1875
71,7,7,39,128,-89,-69.53125
71,7,8,15,256,-241,-94.140625
71,7,9,492,512,-20,-3.90625
71,7,10,617,1024,-407,-39.74609375
71,7,11,5446,2048,3398,165.91796875
71,7,12,72,4096,-4024,-98.2421875
71,7,13,110,8192,-8082,-98.6572265625
71,7,14,39108,16384,22724,138.6962890625
71,7,15,7334,32768,-25434,-77.618408203125
71,8,1,0,2,-2,-100.0
71,8,2,3,4,-1,-25.0
71,8,3,13,8,5,62.5
71,8,4,20,16,4,25.0
71,8,5,55,32,23,71.875
71,8,6,95,64,31,48.4375
71,8,7,15,128,-113,-88.28125
71,8,8,395,256,139,54.296875
71,8,9,282,512,-230,-44.921875
71,8,10,1047,1024,23,2.24609375
71,8,11,2290,2048,242,11.81640625
71,8,12,4864,4096,768,18.75
71,8,13,5858,8192,-2334,-28.4912109375
71,8,14,1509,16384,-14875,-90.789794921875
71,8,15,16533,32768,-16235,-49.5452880859375
71,9,1,0,2,-2,-100.0
71,9,2,1,4,-3,-75.0
71,9,3,12,8,4,50.0
71,9,4,22,16,6,37.5
71,9,5,15,32,-17,-53.125
71,9,6,40,64,-24,-37.5
71,9,7,58,128,-70,-54.6875
71,9,8,523,256,267,104.296875
71,9,9,588,512,76,14.84375
71,9,10,2356,1024,1332,130.078125
71,9,11,460,2048,-1588,-77.5390625
71,9,12,563,4096,-3533,-86.2548828125
71,9,13,8207,8192,15,0.18310546875
71,9,14,661,16384,-15723,-95.965576171875
71,9,15,19485,32768,-13283,-40.5364990234375
71,10,1,0,2,-2,-100.0
71,10,2,3,4,-1,-25.0
71,10,3,10,8,2,25.0
71,10,4,15,16,-1,-6.25
71,10,5,16,32,-16,-50.0
71,10,6,99,64,35,54.6875
71,10,7,268,128,140,109.375
71,10,8,124,256,-132,-51.5625
71,10,9,1004,512,492,96.09375
71,10,10,5989,1024,4965,484.86328125
71,10,11,1632,2048,-416,-20.3125
71,10,12,1581,4096,-2515,-61.4013671875
71,10,13,4064,8192,-4128,-50.390625
71,10,14,18527,16384,2143,13.079833984375
71,10,15,105884,32768,73116,223.13232421875
71,11,1,0,2,-2,-100.0
71,11,2,3,4,-1,-25.0
71,11,3,4,8,-4,-50.0
71,11,4,15,16,-1,-6.25
71,11,5,20,32,-12,-37.5
71,11,6,87,64,23,35.9375
71,11,7,6,128,-122,-95.3125
71,11,8,1224,256,968,378.125
71,11,9,288,512,-224,-43.75
71,11,10,405,1024,-619,-60.44921875
71,11,11,3822,2048,1774,86.62109375
71,11,12,1693,4096,-2403,-58.6669921875
71,11,13,3099,8192,-5093,-62.17041015625
71,11,14,36091,16384,19707,120.281982421875
71,11,15,12600,32768,-20168,-61.5478515625
71,12,1,0,2,-2,-100.0
71,12,2,5,4,1,25.0
71,12,3,2,8,-6,-75.0
71,12,4,14,16,-2,-12.5
71,12,5,27,32,-5,-15.625
71,12,6,25,64,-39,-60.9375
71,12,7,29,128,-99,-77.34375
71,12,8,155,256,-101,-39.453125
71,12,9,748,512,236,46.09375
71,12,10,1218,1024,194,18.9453125
71,12,11,2860,2048,812,39.6484375
71,12,12,361,4096,-3735,-91.1865234375
71,12,13,5289,8192,-2903,-35.43701171875
71,12,14,1170,16384,-15214,-92.85888671875
71,12,15,35288,32768,2520,7.6904296875
71,13,1,0,2,-2,-100.0
71,13,2,4,4,0,0.0
71,13,3,4,8,-4,-50.0
71,13,4,11,16,-5,-31.25
71,13,5,4,32,-28,-87.5
71,13,6,113,64,49,76.5625
71,13,7,18,128,-110,-85.9375
71,13,8,105,256,-151,-58.984375
71,13,9,325,512,-187,-36.5234375
71,13,10,270,1024,-754,-73.6328125
71,13,11,233,2048,-1815,-88.623046875
71,13,12,342,4096,-3754,-91.650390625
71,13,13,23068,8192,14876,181.591796875
71,13,14,42173,16384,25789,157.403564453125
71,13,15,15993,32768,-16775,-51.1932373046875
71,14,1,0,2,-2,-100.0
71,14,2,1,4,-3,-75.0
71,14,3,2,8,-6,-75.0
71,14,4,3,16,-13,-81.25
71,14,5,5,32,-27,-84.375
71,14,6,9,64,-55,-85.9375
71,14,7,67,128,-61,-47.65625
71,14,8,17,256,-239,-93.359375
71,14,9,1188,512,676,132.03125
71,14,10,274,1024,-750,-73.2421875
71,14,11,765,2048,-1283,-62.646484375
71,14,12,3265,4096,-831,-20.2880859375
71,14,13,17475,8192,9283,113.31787109375
71,14,14,16302,16384,-82,-0.50048828125
71,14,15,24050,32768,-8718,-26.605224609375
71,15,1,0,2,-2,-100.0
71,15,2,1,4,-3,-75.0
71,15,3,6,8,-2,-25.0
71,15,4,3,16,-13,-81.25
71,15,5,38,32,6,18.75
71,15,6,23,64,-41,-64.0625
71,15,7,50,128,-78,-60.9375
71,15,8,373,256,117,45.703125
71,15,9,384,512,-128,-25.0
71,15,10,3289,1024,2265,221.19140625
71,15,11,73,2048,-1975,-96.435546875
71,15,12,2468,4096,-1628,-39.74609375
71,15,13,2964,8192,-5228,-63.818359375
71,15,14,17759,16384,1375,8.392333984375
71,15,15,22139,32768,-10629,-32.4371337890625
71,16,1,0,2,-2,-100.0
71,16,2,1,4,-3,-75.0
71,16,3,3,8,-5,-62.5
71,16,4,16,16,0,0.0
71,16,5,20,32,-12,-37.5
71,16,6,289,64,225,351.5625
71,16,7,75,128,-53,-41.40625
71,16,8,676,256,420,164.0625
71,16,9,112,512,-400,-78.125
71,16,10,1740,1024,716,69.921875
71,16,11,681,2048,-1367,-66.748046875
71,16,12,11630,4096,7534,183.935546875
71,16,13,716,8192,-7476,-91.259765625
71,16,14,10152,16384,-6232,-38.037109375
71,16,15,20580,32768,-12188,-37.19482421875
71,17,1,0,2,-2,-100.0
71,17,2,4,4,0,0.0
71,17,3,11,8,3,37.5
71,17,4,5,16,-11,-68.75
71,17,5,30,32,-2,-6.25
71,17,6,39,64,-25,-39.0625
71,17,7,127,128,-1,-0.78125
71,17,8,163,256,-93,-36.328125
71,17,9,148,512,-364,-71.09375
71,17,10,143,1024,-881,-86.03515625
71,17,11,2191,2048,143,6.982421875
71,17,12,8390,4096,4294,104.833984375
71,17,13,1630,8192,-6562,-80.1025390625
71,17,14,32834,16384,16450,100.40283203125
71,17,15,62361,32768,29593,90.3106689453125
71,18,1,0,2,-2,-100.0
71,18,2,2,4,-2,-50.0
71,18,3,3,8,-5,-62.5
71,18,4,44,16,28,175.0
71,18,5,111,32,79,246.875
71,18,6,6,64,-58,-90.625
71,18,7,498,128,370,289.0625
71,18,8,532,256,276,107.8125
71,18,9,52,512,-460,-89.84375
71,18,10,1218,1024,194,18.9453125
71,18,11,3544,2048,1496,73.046875
71,18,12,1846,4096,-2250,-54.931640625
71,18,13,3411,8192,-4781,-58.36181640625
71,18,14,20615,16384,4231,25.823974609375
71,18,15,9484,32768,-23284,-71.05712890625
71,19,1,0,2,-2,-100.0
71,19,2,1,4,-3,-75.0
71,19,3,14,8,6,75.0
71,19,4,20,16,4,25.0
71,19,5,16,32,-16,-50.0
71,19,6,65,64,1,1.5625
71,19,7,350,128,222,173.4375
71,19,8,41,256,-215,-83.984375
71,19,9,1140,512,628,122.65625
71,19,10,104,1024,-920,-89.84375
71,19,11,887,2048,-1161,-56.689453125
71,19,12,2245,4096,-1851,-45.1904296875
71,19,13,29882,8192,21690,264.7705078125
71,19,14,12756,16384,-3628,-22.1435546875
71,19,15,3113,32768,-29655,-90.4998779296875
71,20,1,0,2,-2,-100.0
71,20,2,1,4,-3,-75.0
71,20,3,4,8,-4,-50.0
71,20,4,13,16,-3,-18.75
71,20,5,43,32,11,34.375
71,20,6,30,64,-34,-53.125
71,20,7,81,128,-47,-36.71875
71,20,8,236,256,-20,-7.8125
71,20,9,221,512,-291,-56.8359375
71,20,10,54,1024,-970,-94.7265625
71,20,11,1867,2048,-181,-8.837890625
71,20,12,12424,4096,8328,203.3203125
71,20,13,1529,8192,-6663,-81.33544921875
71,20,14,9482,16384,-6902,-42.12646484375
71,20,15,50687,32768,17919,54.6844482421875
71,21,1,0,2,-2,-100.0
71,21,2,1,4,-3,-75.0
71,21,3,3,8,-5,-62.5
71,21,4,26,16,10,62.5
71,21,5,19,32,-13,-40.625
71,21,6,23,64,-41,-64.0625
71,21,7,62,128,-66,-51.5625
71,21,8,287,256,31,12.109375
71,21,9,740,512,228,44.53125
71,21,10,895,1024,-129,-12.59765625
71,21,11,488,2048,-1560,-76.171875
71,21,12,9077,4096,4981,121.6064453125
71,21,13,14441,8192,6249,76.28173828125
71,21,14,25895,16384,9511,58.050537109375
71,21,15,699,32768,-32069,-97.8668212890625
71,22,1,0,2,-2,-100.0
71,22,2,1,4,-3,-75.0
71,22,3,7,8,-1,-12.5
71,22,4,4,16,-12,-75.0
71,22,5,9,32,-23,-71.875
71,22,6,170,64,106,165.625
71,22,7,442,128,314,245.3125
71,22,8,326,256,70,27.34375
71,22,9,380,512,-132,-25.78125
71,22,10,792,1024,-232,-22.65625
71,22,11,1745,2048,-303,-14.794921875
71,22,12,2521,4096,-1575,-38.4521484375
71,22,13,7033,8192,-1159,-14.14794921875
71,22,14,6037,16384,-10347,-63.153076171875
71,22,15,146676,32768,113908,347.61962890625
71,23,1,0,2,-2,-100.0
71,23,2,1,4,-3,-75.0
71,23,3,2,8,-6,-75.0
71,23,4,7,16,-9,-56.25
71,23,5,6,32,-26,-81.25
71,23,6,20,64,-44,-68.75
71,23,7,59,128,-69,-53.90625
71,23,8,109,256,-147,-57.421875
71,23,9,52,512,-460,-89.84375
71,23,10,362,1024,-662,-64.6484375
71,23,11,588,2048,-1460,-71.2890625
71,23,12,6917,4096,2821,68.8720703125
71,23,13,11678,8192,3486,42.5537109375
71,23,14,19621,16384,3237,19.757080078125
71,23,15,715,32768,-32053,-97.8179931640625
71,24,1,0,2,-2,-100.0
71,24,2,1,4,-3,-75.0
71,24,3,16,8,8,100.0
71,24,4,60,16,44,275.0
71,24,5,14,32,-18,-56.25
71,24,6,48,64,-16,-25.0
71,24,7,40,128,-88,-68.75
71,24,8,354,256,98,38.28125
71,24,9,155,512,-357,-69.7265625
71,24,10,730,1024,-294,-28.7109375
71,24,11,1487,2048,-561,-27.392578125
71,24,12,5810,4096,1714,41.845703125
71,24,13,5686,8192,-2506,-30.5908203125
71,24,14,18877,16384,2493,15.216064453125
71,24,15,10551,32768,-22217,-67.8009033203125
71,25,1,0,2,-2,-100.0
71,25,2,2,4,-2,-50.0
71,25,3,5,8,-3,-37.5
71,25,4,23,16,7,43.75
71,25,5,16,32,-16,-50.0
71,25,6,11,64,-53,-82.8125
71,25,7,66,128,-62,-48.4375
71,25,8,418,256,162,63.28125
71,25,9,514,512,2,0.390625
71,25,10,304,1024,-720,-70.3125
71,25,11,1333,2048,-715,-34.912109375
71,25,12,1210,4096,-2886,-70.458984375
71,25,13,5160,8192,-3032,-37.01171875
71,25,14,3710,16384,-12674,-77.35595703125
71,25,15,17376,32768,-15392,-46.97265625
71,26,1,0,2,-2,-100.0
71,26,2,2,4,-2,-50.0
71,26,3,2,8,-6,-75.0
71,26,4,9,16,-7,-43.75
71,26,5,42,32,10,31.25
71,26,6,72,64,8,12.5
71,26,7,484,128,356,278.125
71,26,8,776,256,520,203.125
71,26,9,149,512,-363,-70.8984375
71,26,10,219,1024,-805,-78.61328125
71,26,11,689,2048,-1359,-66.357421875
71,26,12,3307,4096,-789,-19.2626953125
71,26,13,6042,8192,-2150,-26.2451171875
71,26,14,10990,16384,-5394,-32.92236328125
71,26,15,32142,32768,-626,-1.910400390625
71,27,1,0,2,-2,-100.0
71,27,2,3,4,-1,-25.0
71,27,3,7,8,-1,-12.5
71,27,4,3,16,-13,-81.25
71,27,5,10,32,-22,-68.75
71,27,6,114,64,50,78.125
71,27,7,121,128,-7,-5.46875
71,27,8,424,256,168,65.625
71,27,9,185,512,-327,-63.8671875
71,27,10,1616,1024,592,57.8125
71,27,11,2901,2048,853,41.650390625
71,27,12,6617,4096,2521,61.5478515625
71,27,13,1457,8192,-6735,-82.21435546875
71,27,14,4263,16384,-12121,-73.980712890625
71,27,15,9651,32768,-23117,-70.5474853515625
71,28,1,0,2,-2,-100.0
71,28,2,1,4,-3,-75.0
71,28,3,3,8,-5,-62.5
71,28,4,8,16,-8,-50.0
71,28,5,22,32,-10,-31.25
71,28,6,141,64,77,120.3125
71,28,7,114,128,-14,-10.9375
71,28,8,63,256,-193,-75.390625
71,28,9,1639,512,1127,220.1171875
71,28,10,241,1024,-783,-76.46484375
71,28,11,26,2048,-2022,-98.73046875
71,28,12,1018,4096,-3078,-75.146484375
71,28,13,266,8192,-7926,-96.7529296875
71,28,14,21884,16384,5500,33.5693359375
71,28,15,69989,32768,37221,113.5894775390625
71,29,1,0,2,-2,-100.0
71,29,2,3,4,-1,-25.0
71,29,3,20,8,12,150.0
71,29,4,4,16,-12,-75.0
71,29,5,25,32,-7,-21.875
71,29,6,27,64,-37,-57.8125
71,29,7,49,128,-79,-61.71875
71,29,8,7,256,-249,-97.265625
71,29,9,520,512,8,1.5625
71,29,10,949,1024,-75,-7.32421875
71,29,11,1109,2048,-939,-45.849609375
71,29,12,18419,4096,14323,349.6826171875
71,29,13,10222,8192,2030,24.7802734375
71,29,14,23951,16384,7567,46.185302734375
71,29,15,5864,32768,-26904,-82.1044921875
71,30,1,0,2,-2,-100.0
71,30,2,2,4,-2,-50.0
71,30,3,13,8,5,62.5
71,30,4,4,16,-12,-75.0
71,30,5,7,32,-25,-78.125
71,30,6,70,64,6,9.375
71,30,7,95,128,-33,-25.78125
71,30,8,7,256,-249,-97.265625
71,30,9,2219,512,1707,333.3984375
71,30,10,602,1024,-422,-41.2109375
71,30,11,3202,2048,1154,56.34765625
71,30,12,3339,4096,-757,-18.4814453125
71,30,13,12433,8192,4241,51.77001953125
71,30,14,12642,16384,-3742,-22.83935546875
71,30,15,65544,32768,32776,100.0244140625
71,31,1,0,2,-2,-100.0
71,31,2,1,4,-3,-75.0
71,31,3,12,8,4,50.0
71,31,4,6,16,-10,-62.5
71,31,5,7,32,-25,-78.125
71,31,6,107,64,43,67.1875
71,31,7,79,128,-49,-38.28125
71,31,8,722,256,466,182.03125
71,31,9,30,512,-482,-94.140625
71,31,10,253,1024,-771,-75.29296875
71,31,11,5935,2048,3887,189.794921875
71,31,12,7424,4096,3328,81.25
71,31,13,2631,8192,-5561,-67.88330078125
71,31,14,7324,16384,-9060,-55.2978515625
71,31,15,48753,32768,15985,48.7823486328125
71,32,1,0,2,-2,-100.0
71,32,2,1,4,-3,-75.0
71,32,3,7,8,-1,-12.5
71,32,4,5,16,-11,-68.75
71,32,5,12,32,-20,-62.5
71,32,6,10,64,-54,-84.375
71,32,7,35,128,-93,-72.65625
71,32,8,281,256,25,9.765625
71,32,9,60,512,-452,-88.28125
71,32,10,1701,1024,677,66.11328125
71,32,11,13574,2048,11526,562.79296875
71,32,12,3044,4096,-1052,-25.68359375
71,32,13,20347,8192,12155,148.37646484375
71,32,14,3638,16384,-12746,-77.79541015625
71,32,15,33059,32768,291,0.8880615234375
71,33,1,0,2,-2,-100.0
71,33,2,2,4,-2,-50.0
71,33,3,2,8,-6,-75.0
71,33,4,22,16,6,37.5
71,33,5,15,32,-17,-53.125
71,33,6,63,64,-1,-1.5625
71,33,7,998,128,870,679.6875
71,33,8,45,256,-211,-82.421875
71,33,9,328,512,-184,-35.9375
71,33,10,1551,1024,527,51.46484375
71,33,11,149,2048,-1899,-92.724609375
71,33,12,1066,4096,-3030,-73.974609375
71,33,13,10557,8192,2365,28.86962890625
71,33,14,20962,16384,4578,27.94189453125
71,33,15,79683,32768,46915,143.1732177734375
71,34,1,0,2,-2,-100.0
71,34,2,1,4,-3,-75.0
71,34,3,2,8,-6,-75.0
71,34,4,9,16,-7,-43.75
71,34,5,29,32,-3,-9.375
71,34,6,28,64,-36,-56.25
71,34,7,30,128,-98,-76.5625
71,34,8,377,256,121,47.265625
71,34,9,574,512,62,12.109375
71,34,10,175,1024,-849,-82.91015625
71,34,11,926,2048,-1122,-54.78515625
71,34,12,1869,4096,-2227,-54.3701171875
71,34,13,2904,8192,-5288,-64.55078125
71,34,14,72130,16384,55746,340.24658203125
71,34,15,10291,32768,-22477,-68.5943603515625
71,35,1,0,2,-2,-100.0
71,35,2,1,4,-3,-75.0
71,35,3,2,8,-6,-75.0
71,35,4,70,16,54,337.5
71,35,5,7,32,-25,-78.125
71,35,6,288,64,224,350.0
71,35,7,501,128,373,291.40625
71,35,8,99,256,-157,-61.328125
71,35,9,1594,512,1082,211.328125
71,35,10,2716,1024,1692,165.234375
71,35,11,3139,2048,1091,53.271484375
71,35,12,960,4096,-3136,-76.5625
71,35,13,23661,8192,15469,188.83056640625
71,35,14,12766,16384,-3618,-22.08251953125
71,35,15,35109,32768,2341,7.1441650390625
71,36,1,0,2,-2,-100.0
71,36,2,2,4,-2,-50.0
71,36,3,8,8,0,0.0
71,36,4,3,16,-13,-81.25
71,36,5,42,32,10,31.25
71,36,6,25,64,-39,-60.9375
71,36,7,51,128,-77,-60.15625
71,36,8,498,256,242,94.53125
71,36,9,1143,512,631,123.2421875
71,36,10,1581,1024,557,54.39453125
71,36,11,1315,2048,-733,-35.791015625
71,36,12,2615,4096,-1481,-36.1572265625
71,36,13,5770,8192,-2422,-29.5654296875
71,36,14,6423,16384,-9961,-60.797119140625
71,36,15,13363,32768,-19405,-59.2193603515625
71,37,1,0,2,-2,-100.0
71,37,2,5,4,1,25.0
71,37,3,3,8,-5,-62.5
71,37,4,39,16,23,143.75
71,37,5,48,32,16,50.0
71,37,6,13,64,-51,-79.6875
71,37,7,141,128,13,10.15625
71,37,8,231,256,-25,-9.765625
71,37,9,253,512,-259,-50.5859375
71,37,10,1367,1024,343,33.49609375
71,37,11,1368,2048,-680,-33.203125
71,37,12,10780,4096,6684,163.18359375
71,37,13,10319,8192,2127,25.96435546875
71,37,14,21947,16384,5563,33.953857421875
71,37,15,36659,32768,3891,11.8743896484375
71,38,1,0,2,-2,-100.0
71,38,2,4,4,0,0.0
71,38,3,3,8,-5,-62.5
71,38,4,9,16,-7,-43.75
71,38,5,40,32,8,25.0
71,38,6,144,64,80,125.0
71,38,7,170,128,42,32.8125
71,38,8,1026,256,770,300.78125
71,38,9,289,512,-223,-43.5546875
71,38,10,542,1024,-482,-47.0703125
71,38,11,1465,2048,-583,-28.466796875
71,38,12,10964,4096,6868,167.67578125
71,38,13,40236,8192,32044,391.162109375
71,38,14,5256,16384,-11128,-67.919921875
71,38,15,39876,32768,7108,21.69189453125
71,39,1,0,2,-2,-100.0
71,39,2,2,4,-2,-50.0
71,39,3,6,8,-2,-25.0
71,39,4,8,16,-8,-50.0
71,39,5,11,32,-21,-65.625
71,39,6,51,64,-13,-20.3125
71,39,7,32,128,-96,-75.0
71,39,8,274,256,18,7.03125
71,39,9,809,512,297,58.0078125
71,39,10,635,1024,-389,-37.98828125
71,39,11,2530,2048,482,23.53515625
71,39,12,456,4096,-3640,-88.8671875
71,39,13,3670,8192,-4522,-55.2001953125
71,39,14,22762,16384,6378,38.92822265625
71,39,15,46211,32768,13443,41.0247802734375
71,40,1,0,2,-2,-100.0
71,40,2,1,4,-3,-75.0
71,40,3,5,8,-3,-37.5
71,40,4,3,16,-13,-81.25
71,40,5,15,32,-17,-53.125
71,40,6,137,64,73,114.0625
71,40,7,77,128,-51,-39.84375
71,40,8,561,256,305,119.140625
71,40,9,2848,512,2336,456.25
71,40,10,1502,1024,478,46.6796875
71,40,11,130,2048,-1918,-93.65234375
71,40,12,2144,4096,-1952,-47.65625
71,40,13,8723,8192,531,6.48193359375
71,40,14,59,16384,-16325,-99.639892578125
71,40,15,64350,32768,31582,96.380615234375
71,41,1,0,2,-2,-100.0
71,41,2,1,4,-3,-75.0
71,41,3,2,8,-6,-75.0
71,41,4,4,16,-12,-75.0
71,41,5,17,32,-15,-46.875
71,41,6,309,64,245,382.8125
71,41,7,28,128,-100,-78.125
71,41,8,898,256,642,250.78125
71,41,9,15,512,-497,-97.0703125
71,41,10,1563,1024,539,52.63671875
71,41,11,2387,2048,339,16.552734375
71,41,12,3215,4096,-881,-21.5087890625
71,41,13,5320,8192,-2872,-35.05859375
71,41,14,6992,16384,-9392,-57.32421875
71,41,15,8515,32768,-24253,-74.0142822265625
71,42,1,0,2,-2,-100.0
71,42,2,1,4,-3,-75.0
71,42,3,10,8,2,25.0
71,42,4,3,16,-13,-81.25
71,42,5,10,32,-22,-68.75
71,42,6,10,64,-54,-84.375
71,42,7,153,128,25,19.53125
71,42,8,72,256,-184,-71.875
71,42,9,432,512,-80,-15.625
71,42,10,352,1024,-672,-65.625
71,42,11,1777,2048,-271,-13.232421875
71,42,12,1381,4096,-2715,-66.2841796875
71,42,13,10294,8192,2102,25.6591796875
71,42,14,3914,16384,-12470,-76.11083984375
71,42,15,124785,32768,92017,280.8135986328125
71,43,1,0,2,-2,-100.0
71,43,2,1,4,-3,-75.0
71,43,3,16,8,8,100.0
71,43,4,10,16,-6,-37.5
71,43,5,27,32,-5,-15.625
71,43,6,60,64,-4,-6.25
71,43,7,55,128,-73,-57.03125
71,43,8,78,256,-178,-69.53125
71,43,9,1173,512,661,129.1015625
71,43,10,1797,1024,773,75.48828125
71,43,11,4193,2048,2145,104.736328125
71,43,12,9612,4096,5516,134.66796875
71,43,13,8213,8192,21,0.25634765625
71,43,14,8268,16384,-8116,-49.5361328125
71,43,15,35085,32768,2317,7.0709228515625
71,44,1,0,2,-2,-100.0
71,44,2,1,4,-3,-75.0
71,44,3,11,8,3,37.5
71,44,4,4,16,-12,-75.0
71,44,5,55,32,23,71.875
71,44,6,190,64,126,196.875
71,44,7,164,128,36,28.125
71,44,8,311,256,55,21.484375
71,44,9,670,512,158,30.859375
71,44,10,332,1024,-692,-67.578125
71,44,11,1553,2048,-495,-24.169921875
71,44,12,2655,4096,-1441,-35.1806640625
71,44,13,11891,8192,3699,45.15380859375
71,44,14,5291,16384,-11093,-67.706298828125
71,44,15,16313,32768,-16455,-50.2166748046875
71,45,1,0,2,-2,-100.0
71,45,2,4,4,0,0.0
71,45,3,11,8,3,37.5
71,45,4,10,16,-6,-37.5
71,45,5,4,32,-28,-87.5
71,45,6,21,64,-43,-67.1875
71,45,7,15,128,-113,-88.28125
71,45,8,502,256,246,96.09375
71,45,9,70,512,-442,-86.328125
71,45,10,613,1024,-411,-40.13671875
71,45,11,2796,2048,748,36.5234375
71,45,12,787,4096,-3309,-80.7861328125
71,45,13,20412,8192,12220,149.169921875
71,45,14,38532,16384,22148,135.1806640625
71,45,15,2739,32768,-30029,-91.6412353515625
71,46,1,0,2,-2,-100.0
71,46,2,1,4,-3,-75.0
71,46,3,7,8,-1,-12.5
71,46,4,3,16,-13,-81.25
71,46,5,4,32,-28,-87.5
71,46,6,262,64,198,309.375
71,46,7,23,128,-105,-82.03125
71,46,8,459,256,203,79.296875
71,46,9,97,512,-415,-81.0546875
71,46,10,1829,1024,805,78.61328125
71,46,11,2940,2048,892,43.5546875
71,46,12,572,4096,-3524,-86.03515625
71,46,13,1325,8192,-6867,-83.82568359375
71,46,14,20736,16384,4352,26.5625
71,46,15,30020,32768,-2748,-8.38623046875
71,47,1,0,2,-2,-100.0
71,47,2,3,4,-1,-25.0
71,47,3,6,8,-2,-25.0
71,47,4,4,16,-12,-75.0
71,47,5,5,32,-27,-84.375
71,47,6,41,64,-23,-35.9375
71,47,7,37,128,-91,-71.09375
71,47,8,366,256,110,42.96875
71,47,9,424,512,-88,-17.1875
71,47,10,253,1024,-771,-75.29296875
71,47,11,1174,2048,-874,-42.67578125
71,47,12,9732,4096,5636,137.59765625
71,47,13,1387,8192,-6805,-83.06884765625
71,47,14,22445,16384,6061,36.993408203125
71,47,15,11871,32768,-20897,-63.7725830078125
71,48,1,0,2,-2,-100.0
71,48,2,4,4,0,0.0
71,48,3,2,8,-6,-75.0
71,48,4,6,16,-10,-62.5
71,48,5,53,32,21,65.625
71,48,6,23,64,-41,-64.0625
71,48,7,267,128,139,108.59375
71,48,8,106,256,-150,-58.59375
71,48,9,737,512,225,43.9453125
71,48,10,608,1024,-416,-40.625
71,48,11,2336,2048,288,14.0625
71,48,12,1661,4096,-2435,-59.4482421875
71,48,13,15890,8192,7698,93.9697265625
71,48,14,398,16384,-15986,-97.57080078125
71,48,15,12860,32768,-19908,-60.75439453125
71,49,1,0,2,-2,-100.0
71,49,2,1,4,-3,-75.0
71,49,3,9,8,1,12.5
71,49,4,11,16,-5,-31.25
71,49,5,10,32,-22,-68.75
71,49,6,30,64,-34,-53.125
71,49,7,29,128,-99,-77.34375
71,49,8,123,256,-133,-51.953125
71,49,9,51,512,-461,-90.0390625
71,49,10,799,1024,-225,-21.97265625
71,49,11,324,2048,-1724,-84.1796875
71,49,12,2511,4096,-1585,-38.6962890625
71,49,13,8348,8192,156,1.904296875
71,49,14,27918,16384,11534,70.39794921875
71,49,15,48126,32768,15358,46.868896484375
71,50,1,0,2,-2,-100.0
71,50,2,1,4,-3,-75.0
71,50,3,5,8,-3,-37.5
71,50,4,3,16,-13,-81.25
71,50,5,43,32,11,34.375
71,50,6,24,64,-40,-62.5
71,50,7,20,128,-108,-84.375
71,50,8,153,256,-103,-40.234375
71,50,9,312,512,-200,-39.0625
71,50,10,766,1024,-258,-25.1953125
71,50,11,3354,2048,1306,63.76953125
71,50,12,3468,4096,-628,-15.33203125
71,50,13,5046,8192,-3146,-38.4033203125
71,50,14,2468,16384,-13916,-84.9365234375
71,50,15,10075,32768,-22693,-69.2535400390625
71,51,1,0,2,-2,-100.0
71,51,2,4,4,0,0.0
71,51,3,17,8,9,112.5
71,51,4,23,16,7,43.75
71,51,5,13,32,-19,-59.375
71,51,6,11,64,-53,-82.8125
71,51,7,196,128,68,53.125
71,51,8,23,256,-233,-91.015625
71,51,9,772,512,260,50.78125
71,51,10,774,1024,-250,-24.4140625
71,51,11,1362,2048,-686,-33.49609375
71,51,12,4956,4096,860,20.99609375
71,51,13,304,8192,-7888,-96.2890625
71,51,14,4409,16384,-11975,-73.089599609375
71,51,15,16585,32768,-16183,-49.3865966796875
71,52,1,0,2,-2,-100.0
71,52,2,1,4,-3,-75.0
71,52,3,5,8,-3,-37.5
71,52,4,12,16,-4,-25.0
71,52,5,33,32,1,3.125
71,52,6,19,64,-45,-70.3125
71,52,7,38,128,-90,-70.3125
71,52,8,798,256,542,211.71875
71,52,9,120,512,-392,-76.5625
71,52,10,1246,1024,222,21.6796875
71,52,11,405,2048,-1643,-80.224609375
71,52,12,1057,4096,-3039,-74.1943359375
71,52,13,1770,8192,-6422,-78.3935546875
71,52,14,10148,16384,-6236,-38.0615234375
71,52,15,73525,32768,40757,124.3804931640625
71,53,1,0,2,-2,-100.0
71,53,2,1,4,-3,-75.0
71,53,3,10,8,2,25.0
71,53,4,16,16,0,0.0
71,53,5,37,32,5,15.625
71,53,6,91,64,27,42.1875
71,53,7,16,128,-112,-87.5
71,53,8,220,256,-36,-14.0625
71,53,9,20,512,-492,-96.09375
71,53,10,798,1024,-226,-22.0703125
71,53,11,2944,2048,896,43.75
71,53,12,2983,4096,-1113,-27.1728515625
71,53,13,3523,8192,-4669,-56.99462890625
71,53,14,11408,16384,-4976,-30.37109375
71,53,15,140511,32768,107743,328.8055419921875
71,54,1,0,2,-2,-100.0
71,54,2,2,4,-2,-50.0
71,54,3,2,8,-6,-75.0
71,54,4,7,16,-9,-56.25
71,54,5,15,32,-17,-53.125
71,54,6,158,64,94,146.875
71,54,7,182,128,54,42.1875
71,54,8,15,256,-241,-94.140625
71,54,9,607,512,95,18.5546875
71,54,10,1075,1024,51,4.98046875
71,54,11,5298,2048,3250,158.69140625
71,54,12,700,4096,-3396,-82.91015625
71,54,13,3718,8192,-4474,-54.6142578125
71,54,14,22506,16384,6122,37.36572265625
71,54,15,56225,32768,23457,71.5850830078125
71,55,1,0,2,-2,-100.0
71,55,2,1,4,-3,-75.0
71,55,3,5,8,-3,-37.5
71,55,4,8,16,-8,-50.0
71,55,5,6,32,-26,-81.25
71,55,6,46,64,-18,-28.125
71,55,7,77,128,-51,-39.84375
71,55,8,814,256,558,217.96875
71,55,9,1006,512,494,96.484375
71,55,10,628,1024,-396,-38.671875
71,55,11,975,2048,-1073,-52.392578125
71,55,12,694,4096,-3402,-83.056640625
71,55,13,5287,8192,-2905,-35.46142578125
71,55,14,59192,16384,42808,261.279296875
71,55,15,17603,32768,-15165,-46.2799072265625
71,56,1,0,2,-2,-100.0
71,56,2,1,4,-3,-75.0
71,56,3,2,8,-6,-75.0
71,56,4,5,16,-11,-68.75
71,56,5,52,32,20,62.5
71,56,6,65,64,1,1.5625
71,56,7,228,128,100,78.125
71,56,8,313,256,57,22.265625
71,56,9,405,512,-107,-20.8984375
71,56,10,883,1024,-141,-13.76953125
71,56,11,1388,2048,-660,-32.2265625
71,56,12,508,4096,-3588,-87.59765625
71,56,13,3666,8192,-4526,-55.2490234375
71,56,14,10427,16384,-5957,-36.358642578125
71,56,15,127714,32768,94946,289.752197265625
71,57,1,0,2,-2,-100.0
71,57,2,2,4,-2,-50.0
71,57,3,4,8,-4,-50.0
71,57,4,3,16,-13,-81.25
71,57,5,26,32,-6,-18.75
71,57,6,21,64,-43,-67.1875
71,57,7,60,128,-68,-53.125
71,57,8,141,256,-115,-44.921875
71,57,9,1130,512,618,120.703125
71,57,10,1156,1024,132,12.890625
71,57,11,1082,2048,-966,-47.16796875
71,57,12,98,4096,-3998,-97.607421875
71,57,13,12820,8192,4628,56.494140625
71,57,14,11435,16384,-4949,-30.206298828125
71,57,15,29481,32768,-3287,-10.0311279296875
71,58,1,0,2,-2,-100.0
71,58,2,6,4,2,50.0
71,58,3,2,8,-6,-75.0
71,58,4,4,16,-12,-75.0
71,58,5,83,32,51,159.375
71,58,6,25,64,-39,-60.9375
71,58,7,13,128,-115,-89.84375
71,58,8,154,256,-102,-39.84375
71,58,9,1423,512,911,177.9296875
71,58,10,1674,1024,650,63.4765625
71,58,11,3908,2048,1860,90.8203125
71,58,12,5153,4096,1057,25.8056640625
71,58,13,5653,8192,-2539,-30.99365234375
71,58,14,426,16384,-15958,-97.39990234375
71,58,15,5692,32768,-27076,-82.62939453125
71,59,1,0,2,-2,-100.0
71,59,2,1,4,-3,-75.0
71,59,3,4,8,-4,-50.0
71,59,4,3,16,-13,-81.25
71,59,5,21,32,-11,-34.375
71,59,6,29,64,-35,-54.6875
71,59,7,148,128,20,15.625
71,59,8,38,256,-218,-85.15625
71,59,9,535,512,23,4.4921875
71,59,10,536,1024,-488,-47.65625
71,59,11,2234,2048,186,9.08203125
71,59,12,2685,4096,-1411,-34.4482421875
71,59,13,416,8192,-7776,-94.921875
71,59,14,233,16384,-16151,-98.577880859375
71,59,15,120416,32768,87648,267.48046875
71,60,1,0,2,-2,-100.0
71,60,2,1,4,-3,-75.0
71,60,3,2,8,-6,-75.0
71,60,4,5,16,-11,-68.75
71,60,5,56,32,24,75.0
71,60,6,34,64,-30,-46.875
71,60,7,43,128,-85,-66.40625
71,60,8,13,256,-243,-94.921875
71,60,9,378,512,-134,-26.171875
71,60,10,4712,1024,3688,360.15625
71,60,11,526,2048,-1522,-74.31640625
71,60,12,2094,4096,-2002,-48.876953125
71,60,13,7885,8192,-307,-3.74755859375
71,60,14,21825,16384,5441,33.209228515625
71,60,15,10784,32768,-21984,-67.08984375
71,61,1,0,2,-2,-100.0
71,61,2,2,4,-2,-50.0
71,61,3,4,8,-4,-50.0
71,61,4,10,16,-6,-37.5
71,61,5,14,32,-18,-56.25
71,61,6,31,64,-33,-51.5625
71,61,7,152,128,24,18.75
71,61,8,842,256,586,228.90625
71,61,9,120,512,-392,-76.5625
71,61,10,1910,1024,886,86.5234375
71,61,11,4409,2048,2361,115.283203125
71,61,12,2191,4096,-1905,-46.5087890625
71,61,13,6024,8192,-2168,-26.46484375
71,61,14,15860,16384,-524,-3.1982421875
71,61,15,153856,32768,121088,369.53125
71,62,1,0,2,-2,-100.0
71,62,2,4,4,0,0.0
71,62,3,4,8,-4,-50.0
71,62,4,6,16,-10,-62.5
71,62,5,63,32,31,96.875
71,62,6,5,64,-59,-92.1875
71,62,7,147,128,19,14.84375
71,62,8,90,256,-166,-64.84375
71,62,9,97,512,-415,-81.0546875
71,62,10,1423,1024,399,38.96484375
71,62,11,2834,2048,786,38.37890625
71,62,12,5329,4096,1233,30.1025390625
71,62,13,4281,8192,-3911,-47.74169921875
71,62,14,934,16384,-15450,-94.29931640625
71,62,15,53558,32768,20790,63.446044921875
71,63,1,0,2,-2,-100.0
71,63,2,3,4,-1,-25.0
71,63,3,5,8,-3,-37.5
71,63,4,10,16,-6,-37.5
71,63,5,37,32,5,15.625
71,63,6,15,64,-49,-76.5625
71,63,7,102,128,-26,-20.3125
71,63,8,101,256,-155,-60.546875
71,63,9,611,512,99,19.3359375
71,63,10,770,1024,-254,-24.8046875
71,63,11,1618,2048,-430,-20.99609375
71,63,12,1375,4096,-2721,-66.4306640625
71,63,13,3033,8192,-5159,-62.97607421875
71,63,14,19896,16384,3512,21.435546875
71,63,15,681,32768,-32087,-97.9217529296875
71,64,1,0,2,-2,-100.0
71,64,2,1,4,-3,-75.0
71,64,3,6,8,-2,-25.0
71,64,4,3,16,-13,-81.25
71,64,5,35,32,3,9.375
71,64,6,20,64,-44,-68.75
71,64,7,216,128,88,68.75
71,64,8,53,256,-203,-79.296875
71,64,9,1818,512,1306,255.078125
71,64,10,191,1024,-833,-81.34765625
71,64,11,80,2048,-1968,-96.09375
71,64,12,4419,4096,323,7.8857421875
71,64,13,20153,8192,11961,146.00830078125
71,64,14,15170,16384,-1214,-7.40966796875
71,64,15,44399,32768,11631,35.4949951171875
71,65,1,0,2,-2,-100.0
71,65,2,1,4,-3,-75.0
71,65,3,19,8,11,137.5
71,65,4,14,16,-2,-12.5
71,65,5,49,32,17,53.125
71,65,6,69,64,5,7.8125
71,65,7,99,128,-29,-22.65625
71,65,8,225,256,-31,-12.109375
71,65,9,104,512,-408,-79.6875
71,65,10,2388,1024,1364,133.203125
71,65,11,801,2048,-1247,-60.888671875
71,65,12,5173,4096,1077,26.2939453125
71,65,13,421,8192,-7771,-94.86083984375
71,65,14,16045,16384,-339,-2.069091796875
71,65,15,22685,32768,-10083,-30.7708740234375
71,66,1,0,2,-2,-100.0
71,66,2,3,4,-1,-25.0
71,66,3,2,8,-6,-75.0
71,66,4,7,16,-9,-56.25
71,66,5,11,32,-21,-65.625
71,66,6,9,64,-55,-85.9375
71,66,7,245,128,117,91.40625
71,66,8,121,256,-135,-52.734375
71,66,9,427,512,-85,-16.6015625
71,66,10,866,1024,-158,-15.4296875
71,66,11,2616,2048,568,27.734375
71,66,12,3316,4096,-780,-19.04296875
71,66,13,12924,8192,4732,57.763671875
71,66,14,12458,16384,-3926,-23.96240234375
71,66,15,21823,32768,-10945,-33.4014892578125
71,67,1,0,2,-2,-100.0
71,67,2,1,4,-3,-75.0
71,67,3,2,8,-6,-75.0
71,67,4,15,16,-1,-6.25
71,67,5,4,32,-28,-87.5
71,67,6,182,64,118,184.375
71,67,7,159,128,31,24.21875
71,67,8,82,256,-174,-67.96875
71,67,9,91,512,-421,-82.2265625
71,67,10,475,1024,-549,-53.61328125
71,67,11,867,2048,-1181,-57.666015625
71,67,12,1080,4096,-3016,-73.6328125
71,67,13,4808,8192,-3384,-41.30859375
71,67,14,3908,16384,-12476,-76.1474609375
71,67,15,1065,32768,-31703,-96.7498779296875
71,68,1,0,2,-2,-100.0
71,68,2,1,4,-3,-75.0
71,68,3,3,8,-5,-62.5
71,68,4,3,16,-13,-81.25
71,68,5,12,32,-20,-62.5
71,68,6,66,64,2,3.125
71,68,7,107,128,-21,-16.40625
71,68,8,228,256,-28,-10.9375
71,68,9,273,512,-239,-46.6796875
71,68,10,1092,1024,68,6.640625
71,68,11,493,2048,-1555,-75.927734375
71,68,12,5310,4096,1214,29.638671875
71,68,13,9988,8192,1796,21.923828125
71,68,14,23985,16384,7601,46.392822265625
71,68,15,27610,32768,-5158,-15.740966796875
71,69,1,0,2,-2,-100.0
71,69,2,1,4,-3,-75.0
71,69,3,8,8,0,0.0
71,69,4,34,16,18,112.5
71,69,5,24,32,-8,-25.0
71,69,6,18,64,-46,-71.875
71,69,7,68,128,-60,-46.875
71,69,8,36,256,-220,-85.9375
71,69,9,147,512,-365,-71.2890625
71,69,10,1906,1024,882,86.1328125
71,69,11,4033,2048,1985,96.923828125
71,69,12,3233,4096,-863,-21.0693359375
71,69,13,6397,8192,-1795,-21.91162109375
71,69,14,1747,16384,-14637,-89.337158203125
71,69,15,41923,32768,9155,27.9388427734375
71,70,1,0,2,-2,-100.0
71,70,2,4,4,0,0.0
71,70,3,3,8,-5,-62.5
71,70,4,3,16,-13,-81.25
71,70,5,4,32,-28,-87.5
71,70,6,78,64,14,21.875
71,70,7,77,128,-51,-39.84375
71,70,8,204,256,-52,-20.3125
71,70,9,221,512,-291,-56.8359375
71,70,10,305,1024,-719,-70.21484375
71,70,11,7887,2048,5839,285.107421875
71,70,12,43,4096,-4053,-98.9501953125
71,70,13,2561,8192,-5631,-68.73779296875
71,70,14,4866,16384,-11518,-70.30029296875
71,70,15,19393,32768,-13375,-40.8172607421875
71,71,1,0,2,-2,-100.0
71,71,2,1,4,-3,-75.0
71,71,3,3,8,-5,-62.5
71,71,4,18,16,2,12.5
71,71,5,144,32,112,350.0
71,71,6,51,64,-13,-20.3125
71,71,7,25,128,-103,-80.46875
71,71,8,144,256,-112,-43.75
71,71,9,294,512,-218,-42.578125
71,71,10,30,1024,-994,-97.0703125
71,71,11,314,2048,-1734,-84.66796875
71,71,12,3033,4096,-1063,-25.9521484375
71,71,13,897,8192,-7295,-89.05029296875
71,71,14,34325,16384,17941,109.503173828125
71,71,15,48499,32768,15731,48.0072021484375
72,1,1,0,2,-2,-100.0
72,1,2,1,4,-3,-75.0
72,1,3,7,8,-1,-12.5
72,1,4,18,16,2,12.5
72,1,5,6,32,-26,-81.25
72,1,6,26,64,-38,-59.375
72,1,7,86,128,-42,-32.8125
72,1,8,488,256,232,90.625
72,1,9,424,512,-88,-17.1875
72,1,10,918,1024,-106,-10.3515625
72,1,11,2276,2048,228,11.1328125
72,1,12,4109,4096,13,0.3173828125
72,1,13,13666,8192,5474,66.8212890625
72,1,14,421,16384,-15963,-97.430419921875
72,1,15,3895,32768,-28873,-88.1134033203125
72,2,1,0,2,-2,-100.0
72,2,2,1,4,-3,-75.0
72,2,3,8,8,0,0.0
72,2,4,3,16,-13,-81.25
72,2,5,51,32,19,59.375
72,2,6,49,64,-15,-23.4375
72,2,7,539,128,411,321.09375
72,2,8,172,256,-84,-32.8125
72,2,9,238,512,-274,-53.515625
72,2,10,2412,1024,1388,135.546875
72,2,11,637,2048,-1411,-68.896484375
72,2,12,379,4096,-3717,-90.7470703125
72,2,13,816,8192,-7376,-90.0390625
72,2,14,17455,16384,1071,6.536865234375
72,2,15,61703,32768,28935,88.3026123046875
72,3,1,0,2,-2,-100.0
72,3,2,1,4,-3,-75.0
72,3,3,7,8,-1,-12.5
72,3,4,15,16,-1,-6.25
72,3,5,95,32,63,196.875
72,3,6,53,64,-11,-17.1875
72,3,7,127,128,-1,-0.78125
72,3,8,21,256,-235,-91.796875
72,3,9,312,512,-200,-39.0625
72,3,10,693,1024,-331,-32.32421875
72,3,11,1683,2048,-365,-17.822265625
72,3,12,1366,4096,-2730,-66.650390625
72,3,13,17186,8192,8994,109.7900390625
72,3,14,662,16384,-15722,-95.95947265625
72,3,15,15553,32768,-17215,-52.5360107421875
72,4,1,0,2,-2,-100.0
72,4,2,7,4,3,75.0
72,4,3,5,8,-3,-37.5
72,4,4,3,16,-13,-81.25
72,4,5,33,32,1,3.125
72,4,6,70,64,6,9.375
72,4,7,328,128,200,156.25
72,4,8,136,256,-120,-46.875
72,4,9,124,512,-388,-75.78125
72,4,10,428,1024,-596,-58.203125
72,4,11,2106,2048,58,2.83203125
72,4,12,2084,4096,-2012,-49.12109375
72,4,13,21417,8192,13225,161.43798828125
72,4,14,3666,16384,-12718,-77.62451171875
72,4,15,53056,32768,20288,61.9140625
72,5,1,0,2,-2,-100.0
72,5,2,2,4,-2,-50.0
72,5,3,5,8,-3,-37.5
72,5,4,3,16,-13,-81.25
72,5,5,4,32,-28,-87.5
72,5,6,82,64,18,28.125
72,5,7,20,128,-108,-84.375
72,5,8,359,256,103,40.234375
72,5,9,1138,512,626,122.265625
72,5,10,47,1024,-977,-95.41015625
72,5,11,845,2048,-1203,-58.740234375
72,5,12,1760,4096,-2336,-57.03125
72,5,13,3020,8192,-5172,-63.134765625
72,5,14,10922,16384,-5462,-33.33740234375
72,5,15,27464,32768,-5304,-16.1865234375
72,6,1,0,2,-2,-100.0
72,6,2,3,4,-1,-25.0
72,6,3,2,8,-6,-75.0
72,6,4,6,16,-10,-62.5
72,6,5,36,32,4,12.5
72,6,6,113,64,49,76.5625
72,6,7,51,128,-77,-60.15625
72,6,8,56,256,-200,-78.125
72,6,9,283,512,-229,-44.7265625
72,6,10,270,1024,-754,-73.6328125
72,6,11,3385,2048,1337,65.283203125
72,6,12,6476,4096,2380,58.10546875
72,6,13,1243,8192,-6949,-84.82666015625
72,6,14,754,16384,-15630,-95.39794921875
72,6,15,6824,32768,-25944,-79.1748046875
72,7,1,0,2,-2,-100.0
72,7,2,1,4,-3,-75.0
72,7,3,4,8,-4,-50.0
72,7,4,31,16,15,93.75
72,7,5,21,32,-11,-34.375
72,7,6,10,64,-54,-84.375
72,7,7,216,128,88,68.75
72,7,8,861,256,605,236.328125
72,7,9,541,512,29,5.6640625
72,7,10,9,1024,-1015,-99.12109375
72,7,11,595,2048,-1453,-70.947265625
72,7,12,2397,4096,-1699,-41.4794921875
72,7,13,4773,8192,-3419,-41.73583984375
72,7,14,10062,16384,-6322,-38.58642578125
72,7,15,90041,32768,57273,174.7833251953125
72,8,1,0,2,-2,-100.0
72,8,2,1,4,-3,-75.0
72,8,3,16,8,8,100.0
72,8,4,9,16,-7,-43.75
72,8,5,20,32,-12,-37.5
72,8,6,248,64,184,287.5
72,8,7,176,128,48,37.5
72,8,8,306,256,50,19.53125
72,8,9,381,512,-131,-25.5859375
72,8,10,1106,1024,82,8.0078125
72,8,11,231,2048,-1817,-88.720703125
72,8,12,203,4096,-3893,-95.0439453125
72,8,13,10437,8192,2245,27.40478515625
72,8,14,13219,16384,-3165,-19.317626953125
72,8,15,24045,32768,-8723,-26.6204833984375
72,9,1,0,2,-2,-100.0
72,9,2,1,4,-3,-75.0
72,9,3,7,8,-1,-12.5
72,9,4,5,16,-11,-68.75
72,9,5,38,32,6,18.75
72,9,6,7,64,-57,-89.0625
72,9,7,142,128,14,10.9375
72,9,8,502,256,246,96.09375
72,9,9,61,512,-451,-88.0859375
72,9,10,1488,1024,464,45.3125
72,9,11,2503,2048,455,22.216796875
72,9,12,3212,4096,-884,-21.58203125
72,9,13,22156,8192,13964,170.458984375
72,9,14,14692,16384,-1692,-10.3271484375
72,9,15,23044,32768,-9724,-29.67529296875
72,10,1,0,2,-2,-100.0
72,10,2,3,4,-1,-25.0
72,10,3,7,8,-1,-12.5
72,10,4,27,16,11,68.75
72,10,5,4,32,-28,-87.5
72,10,6,73,64,9,14.0625
72,10,7,136,128,8,6.25
72,10,8,336,256,80,31.25
72,10,9,208,512,-304,-59.375
72,10,10,138,1024,-886,-86.5234375
72,10,11,148,2048,-1900,-92.7734375
72,10,12,8996,4096,4900,119.62890625
72,10,13,697,8192,-7495,-91.49169921875
72,10,14,1183,16384,-15201,-92.779541015625
72,10,15,17250,32768,-15518,-47.357177734375
72,11,1,0,2,-2,-100.0
72,11,2,1,4,-3,-75.0
72,11,3,5,8,-3,-37.5
72,11,4,14,16,-2,-12.5
72,11,5,75,32,43,134.375
72,11,6,92,64,28,43.75
72,11,7,59,128,-69,-53.90625
72,11,8,83,256,-173,-67.578125
72,11,9,1965,512,1453,283.7890625
72,11,10,770,1024,-254,-24.8046875
72,11,11,4744,2048,2696,131.640625
72,11,12,3629,4096,-467,-11.4013671875
72,11,13,1923,8192,-6269,-76.52587890625
72,11,14,22734,16384,6350,38.75732421875
72,11,15,3298,32768,-29470,-89.935302734375
72,12,1,0,2,-2,-100.0
72,12,2,1,4,-3,-75.0
72,12,3,2,8,-6,-75.0
72,12,4,17,16,1,6.25
72,12,5,68,32,36,112.5
72,12,6,51,64,-13,-20.3125
72,12,7,18,128,-110,-85.9375
72,12,8,10,256,-246,-96.09375
72,12,9,972,512,460,89.84375
72,12,10,274,1024,-750,-73.2421875
72,12,11,2624,2048,576,28.125
72,12,12,3778,4096,-318,-7.763671875
72,12,13,7069,8192,-1123,-13.70849609375
72,12,14,16738,16384,354,2.16064453125
72,12,15,569,32768,-32199,-98.2635498046875
72,13,1,0,2,-2,-100.0
72,13,2,1,4,-3,-75.0
72,13,3,7,8,-1,-12.5
72,13,4,18,16,2,12.5
72,13,5,4,32,-28,-87.5
72,13,6,11,64,-53,-82.8125
72,13,7,412,128,284,221.875
72,13,8,41,256,-215,-83.984375
72,13,9,196,512,-316,-61.71875
72,13,10,831,1024,-193,-18.84765625
72,13,11,6438,2048,4390,214.35546875
72,13,12,4263,4096,167,4.0771484375
72,13,13,21880,8192,13688,167.08984375
72,13,14,1123,16384,-15261,-93.145751953125
72,13,15,5263,32768,-27505,-83.9385986328125
72,14,1,0,2,-2,-100.0
72,14,2,7,4,3,75.0
72,14,3,20,8,12,150.0
72,14,4,5,16,-11,-68.75
72,14,5,14,32,-18,-56.25
72,14,6,58,64,-6,-9.375
72,14,7,78,128,-50,-39.0625
72,14,8,57,256,-199,-77.734375
72,14,9,438,512,-74,-14.453125
72,14,10,180,1024,-844,-82.421875
72,14,11,79,2048,-1969,-96.142578125
72,14,12,1683,4096,-2413,-58.9111328125
72,14,13,1291,8192,-6901,-84.24072265625
72,14,14,14073,16384,-2311,-14.105224609375
72,14,15,5384,32768,-27384,-83.5693359375
72,15,1,0,2,-2,-100.0
72,15,2,1,4,-3,-75.0
72,15,3,7,8,-1,-12.5
72,15,4,5,16,-11,-68.75
72,15,5,6,32,-26,-81.25
72,15,6,100,64,36,56.25
72,15,7,29,128,-99,-77.34375
72,15,8,355,256,99,38.671875
72,15,9,35,512,-477,-93.1640625
72,15,10,338,1024,-686,-66.9921875
72,15,11,1661,2048,-387,-18.896484375
72,15,12,3866,4096,-230,-5.615234375
72,15,13,3992,8192,-4200,-51.26953125
72,15,14,26001,16384,9617,58.697509765625
72,15,15,72478,32768,39710,121.185302734375
72,16,1,0,2,-2,-100.0
72,16,2,3,4,-1,-25.0
72,16,3,5,8,-3,-37.5
72,16,4,3,16,-13,-81.25
72,16,5,5,32,-27,-84.375
72,16,6,79,64,15,23.4375
72,16,7,338,128,210,164.0625
72,16,8,91,256,-165,-64.453125
72,16,9,331,512,-181,-35.3515625
72,16,10,748,1024,-276,-26.953125
72,16,11,4885,2048,2837,138.525390625
72,16,12,1428,4096,-2668,-65.13671875
72,16,13,7481,8192,-711,-8.67919921875
72,16,14,18117,16384,1733,10.577392578125
72,16,15,89556,32768,56788,173.30322265625
72,17,1,0,2,-2,-100.0
72,17,2,2,4,-2,-50.0
72,17,3,2,8,-6,-75.0
72,17,4,3,16,-13,-81.25
72,17,5,7,32,-25,-78.125
72,17,6,54,64,-10,-15.625
72,17,7,47,128,-81,-63.28125
72,17,8,142,256,-114,-44.53125
72,17,9,53,512,-459,-89.6484375
72,17,10,1110,1024,86,8.3984375
72,17,11,1090,2048,-958,-46.77734375
72,17,12,13,4096,-4083,-99.6826171875
72,17,13,4622,8192,-3570,-43.5791015625
72,17,14,1016,16384,-15368,-93.798828125
72,17,15,1508,32768,-31260,-95.39794921875
72,18,1,0,2,-2,-100.0
72,18,2,1,4,-3,-75.0
72,18,3,3,8,-5,-62.5
72,18,4,31,16,15,93.75
72,18,5,8,32,-24,-75.0
72,18,6,92,64,28,43.75
72,18,7,48,128,-80,-62.5
72,18,8,165,256,-91,-35.546875
72,18,9,647,512,135,26.3671875
72,18,10,1469,1024,445,43.45703125
72,18,11,4712,2048,2664,130.078125
72,18,12,4616,4096,520,12.6953125
72,18,13,4496,8192,-3696,-45.1171875
72,18,14,3896,16384,-12488,-76.220703125
72,18,15,32362,32768,-406,-1.239013671875
72,19,1,0,2,-2,-100.0
72,19,2,1,4,-3,-75.0
72,19,3,5,8,-3,-37.5
72,19,4,30,16,14,87.5
72,19,5,59,32,27,84.375
72,19,6,115,64,51,79.6875
72,19,7,258,128,130,101.5625
72,19,8,537,256,281,109.765625
72,19,9,595,512,83,16.2109375
72,19,10,997,1024,-27,-2.63671875
72,19,11,1827,2048,-221,-10.791015625
72,19,12,7693,4096,3597,87.8173828125
72,19,13,14533,8192,6341,77.40478515625
72,19,14,2562,16384,-13822,-84.36279296875
72,19,15,29602,32768,-3166,-9.661865234375
72,20,1,0,2,-2,-100.0
72,20,2,1,4,-3,-75.0
72,20,3,9,8,1,12.5
72,20,4,9,16,-7,-43.75
72,20,5,24,32,-8,-25.0
72,20,6,20,64,-44,-68.75
72,20,7,22,128,-106,-82.8125
72,20,8,355,256,99,38.671875
72,20,9,502,512,-10,-1.953125
72,20,10,1316,1024,292,28.515625
72,20,11,2036,2048,-12,-0.5859375
72,20,12,3041,4096,-1055,-25.7568359375
72,20,13,5361,8192,-2831,-34.55810546875
72,20,14,13623,16384,-2761,-16.851806640625
72,20,15,9828,32768,-22940,-70.00732421875
72,21,1,0,2,-2,-100.0
72,21,2,1,4,-3,-75.0
72,21,3,3,8,-5,-62.5
72,21,4,14,16,-2,-12.5
72,21,5,43,32,11,34.375
72,21,6,6,64,-58,-90.625
72,21,7,31,128,-97,-75.78125
72,21,8,717,256,461,180.078125
72,21,9,181,512,-331,-64.6484375
72,21,10,55,1024,-969,-94.62890625
72,21,11,1620,2048,-428,-20.8984375
72,21,12,3248,4096,-848,-20.703125
72,21,13,8775,8192,583,7.11669921875
72,21,14,10672,16384,-5712,-34.86328125
72,21,15,33646,32768,878,2.679443359375
72,22,1,0,2,-2,-100.0
72,22,2,1,4,-3,-75.0
72,22,3,9,8,1,12.5
72,22,4,22,16,6,37.5
72,22,5,21,32,-11,-34.375
72,22,6,28,64,-36,-56.25
72,22,7,301,128,173,135.15625
72,22,8,92,256,-164,-64.0625
72,22,9,1434,512,922,180.078125
72,22,10,2684,1024,1660,162.109375
72,22,11,2244,2048,196,9.5703125
72,22,12,562,4096,-3534,-86.279296875
72,22,13,3711,8192,-4481,-54.69970703125
72,22,14,51181,16384,34797,212.384033203125
72,22,15,114528,32768,81760,249.51171875
72,23,1,0,2,-2,-100.0
72,23,2,1,4,-3,-75.0
72,23,3,2,8,-6,-75.0
72,23,4,10,16,-6,-37.5
72,23,5,8,32,-24,-75.0
72,23,6,26,64,-38,-59.375
72,23,7,182,128,54,42.1875
72,23,8,144,256,-112,-43.75
72,23,9,1229,512,717,140.0390625
72,23,10,1344,1024,320,31.25
72,23,11,2799,2048,751,36.669921875
72,23,12,6472,4096,2376,58.0078125
72,23,13,11973,8192,3781,46.15478515625
72,23,14,9108,16384,-7276,-44.4091796875
72,23,15,50372,32768,17604,53.72314453125
72,24,1,0,2,-2,-100.0
72,24,2,1,4,-3,-75.0
72,24,3,12,8,4,50.0
72,24,4,6,16,-10,-62.5
72,24,5,8,32,-24,-75.0
72,24,6,131,64,67,104.6875
72,24,7,291,128,163,127.34375
72,24,8,170,256,-86,-33.59375
72,24,9,830,512,318,62.109375
72,24,10,470,1024,-554,-54.1015625
72,24,11,1554,2048,-494,-24.12109375
72,24,12,105,4096,-3991,-97.4365234375
72,24,13,9345,8192,1153,14.07470703125
72,24,14,1703,16384,-14681,-89.605712890625
72,24,15,32829,32768,61,0.1861572265625
72,25,1,0,2,-2,-100.0
72,25,2,1,4,-3,-75.0
72,25,3,3,8,-5,-62.5
72,25,4,6,16,-10,-62.5
72,25,5,5,32,-27,-84.375
72,25,6,193,64,129,201.5625
72,25,7,319,128,191,149.21875
72,25,8,272,256,16,6.25
72,25,9,89,512,-423,-82.6171875
72,25,10,495,1024,-529,-51.66015625
72,25,11,1176,2048,-872,-42.578125
72,25,12,397,4096,-3699,-90.3076171875
72,25,13,12935,8192,4743,57.89794921875
72,25,14,296,16384,-16088,-98.193359375
72,25,15,8654,32768,-24114,-73.590087890625
72,26,1,0,2,-2,-100.0
72,26,2,3,4,-1,-25.0
72,26,3,2,8,-6,-75.0
72,26,4,15,16,-1,-6.25
72,26,5,38,32,6,18.75
72,26,6,19,64,-45,-70.3125
72,26,7,116,128,-12,-9.375
72,26,8,139,256,-117,-45.703125
72,26,9,126,512,-386,-75.390625
72,26,10,2050,1024,1026,100.1953125
72,26,11,802,2048,-1246,-60.83984375
72,26,12,874,4096,-3222,-78.662109375
72,26,13,9742,8192,1550,18.9208984375
72,26,14,3471,16384,-12913,-78.814697265625
72,26,15,19133,32768,-13635,-41.6107177734375
72,27,1,0,2,-2,-100.0
72,27,2,6,4,2,50.0
72,27,3,5,8,-3,-37.5
72,27,4,4,16,-12,-75.0
72,27,5,25,32,-7,-21.875
72,27,6,34,64,-30,-46.875
72,27,7,20,128,-108,-84.375
72,27,8,146,256,-110,-42.96875
72,27,9,132,512,-380,-74.21875
72,27,10,3462,1024,2438,238.0859375
72,27,11,1323,2048,-725,-35.400390625
72,27,12,179,4096,-3917,-95.6298828125
72,27,13,8229,8192,37,0.45166015625
72,27,14,27743,16384,11359,69.329833984375
72,27,15,9978,32768,-22790,-69.549560546875
72,28,1,0,2,-2,-100.0
72,28,2,1,4,-3,-75.0
72,28,3,11,8,3,37.5
72,28,4,22,16,6,37.5
72,28,5,27,32,-5,-15.625
72,28,6,5,64,-59,-92.1875
72,28,7,25,128,-103,-80.46875
72,28,8,235,256,-21,-8.203125
72,28,9,1353,512,841,164.2578125
72,28,10,2108,1024,1084,105.859375
72,28,11,883,2048,-1165,-56.884765625
72,28,12,6941,4096,2845,69.4580078125
72,28,13,841,8192,-7351,-89.73388671875
72,28,14,8206,16384,-8178,-49.91455078125
72,28,15,29,32768,-32739,-99.9114990234375
72,29,1,0,2,-2,-100.0
72,29,2,1,4,-3,-75.0
72,29,3,3,8,-5,-62.5
72,29,4,3,16,-13,-81.25
72,29,5,4,32,-28,-87.5
72,29,6,42,64,-22,-34.375
72,29,7,163,128,35,27.34375
72,29,8,481,256,225,87.890625
72,29,9,221,512,-291,-56.8359375
72,29,10,824,1024,-200,-19.53125
72,29,11,1002,2048,-1046,-51.07421875
72,29,12,1353,4096,-2743,-66.9677734375
72,29,13,5657,8192,-2535,-30.94482421875
72,29,14,2005,16384,-14379,-87.762451171875
72,29,15,47998,32768,15230,46.478271484375
72,30,1,0,2,-2,-100.0
72,30,2,1,4,-3,-75.0
72,30,3,2,8,-6,-75.0
72,30,4,12,16,-4,-25.0
72,30,5,17,32,-15,-46.875
72,30,6,109,64,45,70.3125
72,30,7,72,128,-56,-43.75
72,30,8,68,256,-188,-73.4375
72,30,9,47,512,-465,-90.8203125
72,30,10,243,1024,-781,-76.26953125
72,30,11,537,2048,-1511,-73.779296875
72,30,12,3588,4096,-508,-12.40234375
72,30,13,10455,8192,2263,27.62451171875
72,30,14,14702,16384,-1682,-10.26611328125
72,30,15,54451,32768,21683,66.1712646484375
72,31,1,0,2,-2,-100.0
72,31,2,1,4,-3,-75.0
72,31,3,3,8,-5,-62.5
72,31,4,3,16,-13,-81.25
72,31,5,19,32,-13,-40.625
72,31,6,58,64,-6,-9.375
72,31,7,190,128,62,48.4375
72,31,8,48,256,-208,-81.25
72,31,9,161,512,-351,-68.5546875
72,31,10,1032,1024,8,0.78125
72,31,11,1149,2048,-899,-43.896484375
72,31,12,750,4096,-3346,-81.689453125
72,31,13,755,8192,-7437,-90.78369140625
72,31,14,46057,16384,29673,181.109619140625
72,31,15,41097,32768,8329,25.4180908203125
72,32,1,0,2,-2,-100.0
72,32,2,1,4,-3,-75.0
72,32,3,9,8,1,12.5
72,32,4,6,16,-10,-62.5
72,32,5,5,32,-27,-84.375
72,32,6,24,64,-40,-62.5
72,32,7,33,128,-95,-74.21875
72,32,8,159,256,-97,-37.890625
72,32,9,989,512,477,93.1640625
72,32,10,136,1024,-888,-86.71875
72,32,11,629,2048,-1419,-69.287109375
72,32,12,3874,4096,-222,-5.419921875
72,32,13,5933,8192,-2259,-27.57568359375
72,32,14,16515,16384,131,0.799560546875
72,32,15,26318,32768,-6450,-19.683837890625
72,33,1,0,2,-2,-100.0
72,33,2,2,4,-2,-50.0
72,33,3,13,8,5,62.5
72,33,4,12,16,-4,-25.0
72,33,5,63,32,31,96.875
72,33,6,5,64,-59,-92.1875
72,33,7,236,128,108,84.375
72,33,8,11,256,-245,-95.703125
72,33,9,22,512,-490,-95.703125
72,33,10,1282,1024,258,25.1953125
72,33,11,276,2048,-1772,-86.5234375
72,33,12,1100,4096,-2996,-73.14453125
72,33,13,4082,8192,-4110,-50.1708984375
72,33,14,26804,16384,10420,63.5986328125
72,33,15,28822,32768,-3946,-12.042236328125
72,34,1,0,2,-2,-100.0
72,34,2,2,4,-2,-50.0
72,34,3,2,8,-6,-75.0
72,34,4,16,16,0,0.0
72,34,5,7,32,-25,-78.125
72,34,6,25,64,-39,-60.9375
72,34,7,78,128,-50,-39.0625
72,34,8,148,256,-108,-42.1875
72,34,9,139,512,-373,-72.8515625
72,34,10,239,1024,-785,-76.66015625
72,34,11,806,2048,-1242,-60.64453125
72,34,12,1718,4096,-2378,-58.056640625
72,34,13,12524,8192,4332,52.880859375
72,34,14,9650,16384,-6734,-41.10107421875
72,34,15,24145,32768,-8623,-26.3153076171875
72,35,1,0,2,-2,-100.0
72,35,2,1,4,-3,-75.0
72,35,3,2,8,-6,-75.0
72,35,4,3,16,-13,-81.25
72,35,5,5,32,-27,-84.375
72,35,6,22,64,-42,-65.625
72,35,7,41,128,-87,-67.96875
72,35,8,265,256,9,3.515625
72,35,9,367,512,-145,-28.3203125
72,35,10,105,1024,-919,-89.74609375
72,35,11,6474,2048,4426,216.11328125
72,35,12,7691,4096,3595,87.7685546875
72,35,13,16800,8192,8608,105.078125
72,35,14,3908,16384,-12476,-76.1474609375
72,35,15,26354,32768,-6414,-19.573974609375
72,36,1,0,2,-2,-100.0
72,36,2,3,4,-1,-25.0
72,36,3,4,8,-4,-50.0
72,36,4,10,16,-6,-37.5
72,36,5,45,32,13,40.625
72,36,6,66,64,2,3.125
72,36,7,191,128,63,49.21875
72,36,8,554,256,298,116.40625
72,36,9,578,512,66,12.890625
72,36,10,641,1024,-383,-37.40234375
72,36,11,2388,2048,340,16.6015625
72,36,12,2341,4096,-1755,-42.8466796875
72,36,13,876,8192,-7316,-89.306640625
72,36,14,873,16384,-15511,-94.671630859375
72,36,15,2059,32768,-30709,-93.7164306640625
72,37,1,0,2,-2,-100.0
72,37,2,1,4,-3,-75.0
72,37,3,5,8,-3,-37.5
72,37,4,13,16,-3,-18.75
72,37,5,59,32,27,84.375
72,37,6,106,64,42,65.625
72,37,7,30,128,-98,-76.5625
72,37,8,26,256,-230,-89.84375
72,37,9,170,512,-342,-66.796875
72,37,10,55,1024,-969,-94.62890625
72,37,11,1452,2048,-596,-29.1015625
72,37,12,11362,4096,7266,177.392578125
72,37,13,1229,8192,-6963,-84.99755859375
72,37,14,53554,16384,37170,226.86767578125
72,37,15,139219,32768,106451,324.8626708984375
72,38,1,0,2,-2,-100.0
72,38,2,1,4,-3,-75.0
72,38,3,3,8,-5,-62.5
72,38,4,11,16,-5,-31.25
72,38,5,25,32,-7,-21.875
72,38,6,26,64,-38,-59.375
72,38,7,147,128,19,14.84375
72,38,8,119,256,-137,-53.515625
72,38,9,282,512,-230,-44.921875
72,38,10,2039,1024,1015,99.12109375
72,38,11,1097,2048,-951,-46.435546875
72,38,12,9309,4096,5213,127.2705078125
72,38,13,27018,8192,18826,229.8095703125
72,38,14,22162,16384,5778,35.26611328125
72,38,15,9022,32768,-23746,-72.467041015625
72,39,1,0,2,-2,-100.0
72,39,2,3,4,-1,-25.0
72,39,3,5,8,-3,-37.5
72,39,4,7,16,-9,-56.25
72,39,5,18,32,-14,-43.75
72,39,6,36,64,-28,-43.75
72,39,7,141,128,13,10.15625
72,39,8,69,256,-187,-73.046875
72,39,9,277,512,-235,-45.8984375
72,39,10,125,1024,-899,-87.79296875
72,39,11,936,2048,-1112,-54.296875
72,39,12,467,4096,-3629,-88.5986328125
72,39,13,3772,8192,-4420,-53.955078125
72,39,14,39194,16384,22810,139.22119140625
72,39,15,7209,32768,-25559,-77.9998779296875
72,40,1,0,2,-2,-100.0
72,40,2,1,4,-3,-75.0
72,40,3,5,8,-3,-37.5
72,40,4,4,16,-12,-75.0
72,40,5,22,32,-10,-31.25
72,40,6,126,64,62,96.875
72,40,7,130,128,2,1.5625
72,40,8,30,256,-226,-88.28125
72,40,9,1300,512,788,153.90625
72,40,10,213,1024,-811,-79.19921875
72,40,11,3396,2048,1348,65.8203125
72,40,12,2373,4096,-1723,-42.0654296875
72,40,13,5681,8192,-2511,-30.65185546875
72,40,14,14386,16384,-1998,-12.19482421875
72,40,15,8495,32768,-24273,-74.0753173828125
72,41,1,0,2,-2,-100.0
72,41,2,3,4,-1,-25.0
72,41,3,8,8,0,0.0
72,41,4,21,16,5,31.25
72,41,5,5,32,-27,-84.375
72,41,6,78,64,14,21.875
72,41,7,42,128,-86,-67.1875
72,41,8,604,256,348,135.9375
72,41,9,111,512,-401,-78.3203125
72,41,10,503,1024,-521,-50.87890625
72,41,11,675,2048,-1373,-67.041015625
72,41,12,3697,4096,-399,-9.7412109375
72,41,13,16790,8192,8598,104.9560546875
72,41,14,5810,16384,-10574,-64.53857421875
72,41,15,21775,32768,-10993,-33.5479736328125
72,42,1,0,2,-2,-100.0
72,42,2,1,4,-3,-75.0
72,42,3,8,8,0,0.0
72,42,4,28,16,12,75.0
72,42,5,54,32,22,68.75
72,42,6,67,64,3,4.6875
72,42,7,115,128,-13,-10.15625
72,42,8,28,256,-228,-89.0625
72,42,9,589,512,77,15.0390625
72,42,10,987,1024,-37,-3.61328125
72,42,11,746,2048,-1302,-63.57421875
72,42,12,2987,4096,-1109,-27.0751953125
72,42,13,21585,8192,13393,163.48876953125
72,42,14,9700,16384,-6684,-40.7958984375
72,42,15,10313,32768,-22455,-68.5272216796875
72,43,1,0,2,-2,-100.0
72,43,2,1,4,-3,-75.0
72,43,3,2,8,-6,-75.0
72,43,4,29,16,13,81.25
72,43,5,45,32,13,40.625
72,43,6,60,64,-4,-6.25
72,43,7,9,128,-119,-92.96875
72,43,8,37,256,-219,-85.546875
72,43,9,539,512,27,5.2734375
72,43,10,128,1024,-896,-87.5
72,43,11,2944,2048,896,43.75
72,43,12,2953,4096,-1143,-27.9052734375
72,43,13,12306,8192,4114,50.2197265625
72,43,14,2861,16384,-13523,-82.537841796875
72,43,15,4376,32768,-28392,-86.6455078125
72,44,1,0,2,-2,-100.0
72,44,2,1,4,-3,-75.0
72,44,3,6,8,-2,-25.0
72,44,4,37,16,21,131.25
72,44,5,66,32,34,106.25
72,44,6,5,64,-59,-92.1875
72,44,7,44,128,-84,-65.625
72,44,8,390,256,134,52.34375
72,44,9,254,512,-258,-50.390625
72,44,10,65,1024,-959,-93.65234375
72,44,11,1067,2048,-981,-47.900390625
72,44,12,6658,4096,2562,62.548828125
72,44,13,18650,8192,10458,127.6611328125
72,44,14,4429,16384,-11955,-72.967529296875
72,44,15,35732,32768,2964,9.04541015625
72,45,1,0,2,-2,-100.0
72,45,2,1,4,-3,-75.0
72,45,3,2,8,-6,-75.0
72,45,4,3,16,-13,-81.25
72,45,5,50,32,18,56.25
72,45,6,98,64,34,53.125
72,45,7,156,128,28,21.875
72,45,8,10,256,-246,-96.09375
72,45,9,17,512,-495,-96.6796875
72,45,10,948,1024,-76,-7.421875
72,45,11,1291,2048,-757,-36.962890625
72,45,12,6489,4096,2393,58.4228515625
72,45,13,6329,8192,-1863,-22.74169921875
72,45,14,70494,16384,54110,330.26123046875
72,45,15,320,32768,-32448,-99.0234375
72,46,1,0,2,-2,-100.0
72,46,2,3,4,-1,-25.0
72,46,3,2,8,-6,-75.0
72,46,4,7,16,-9,-56.25
72,46,5,15,32,-17,-53.125
72,46,6,18,64,-46,-71.875
72,46,7,148,128,20,15.625
72,46,8,59,256,-197,-76.953125
72,46,9,705,512,193,37.6953125
72,46,10,803,1024,-221,-21.58203125
72,46,11,4312,2048,2264,110.546875
72,46,12,795,4096,-3301,-80.5908203125
72,46,13,13408,8192,5216,63.671875
72,46,14,7068,16384,-9316,-56.8603515625
72,46,15,38583,32768,5815,17.7459716796875
72,47,1,0,2,-2,-100.0
72,47,2,2,4,-2,-50.0
72,47,3,2,8,-6,-75.0
72,47,4,7,16,-9,-56.25
72,47,5,23,32,-9,-28.125
72,47,6,41,64,-23,-35.9375
72,47,7,164,128,36,28.125
72,47,8,245,256,-11,-4.296875
72,47,9,157,512,-355,-69.3359375
72,47,10,16,1024,-1008,-98.4375
72,47,11,422,2048,-1626,-79.39453125
72,47,12,5820,4096,1724,42.08984375
72,47,13,129,8192,-8063,-98.42529296875
72,47,14,6128,16384,-10256,-62.59765625
72,47,15,8881,32768,-23887,-72.8973388671875
72,48,1,0,2,-2,-100.0
72,48,2,1,4,-3,-75.0
72,48,3,7,8,-1,-12.5
72,48,4,3,16,-13,-81.25
72,48,5,26,32,-6,-18.75
72,48,6,118,64,54,84.375
72,48,7,28,128,-100,-78.125
72,48,8,86,256,-170,-66.40625
72,48,9,713,512,201,39.2578125
72,48,10,454,1024,-570,-55.6640625
72,48,11,1011,2048,-1037,-50.634765625
72,48,12,5646,4096,1550,37.841796875
72,48,13,7451,8192,-741,-9.04541015625
72,48,14,12374,16384,-4010,-24.47509765625
72,48,15,7840,32768,-24928,-76.07421875
72,49,1,0,2,-2,-100.0
72,49,2,1,4,-3,-75.0
72,49,3,6,8,-2,-25.0
72,49,4,9,16,-7,-43.75
72,49,5,9,32,-23,-71.875
72,49,6,28,64,-36,-56.25
72,49,7,22,128,-106,-82.8125
72,49,8,43,256,-213,-83.203125
72,49,9,478,512,-34,-6.640625
72,49,10,547,1024,-477,-46.58203125
72,49,11,773,2048,-1275,-62.255859375
72,49,12,2693,4096,-1403,-34.2529296875
72,49,13,12497,8192,4305,52.55126953125
72,49,14,14598,16384,-1786,-10.90087890625
72,49,15,41518,32768,8750,26.702880859375
72,50,1,0,2,-2,-100.0
72,50,2,1,4,-3,-75.0
72,50,3,7,8,-1,-12.5
72,50,4,68,16,52,325.0
72,50,5,6,32,-26,-81.25
72,50,6,24,64,-40,-62.5
72,50,7,19,128,-109,-85.15625
72,50,8,192,256,-64,-25.0
72,50,9,220,512,-292,-57.03125
72,50,10,1483,1024,459,44.82421875
72,50,11,78,2048,-1970,-96.19140625
72,50,12,10139,4096,6043,147.5341796875
72,50,13,36876,8192,28684,350.146484375
72,50,14,146,16384,-16238,-99.10888671875
72,50,15,26325,32768,-6443,-19.6624755859375
72,51,1,0,2,-2,-100.0
72,51,2,1,4,-3,-75.0
72,51,3,4,8,-4,-50.0
72,51,4,3,16,-13,-81.25
72,51,5,14,32,-18,-56.25
72,51,6,69,64,5,7.8125
72,51,7,16,128,-112,-87.5
72,51,8,748,256,492,192.1875
72,51,9,317,512,-195,-38.0859375
72,51,10,310,1024,-714,-69.7265625
72,51,11,3079,2048,1031,50.341796875
72,51,12,2049,4096,-2047,-49.9755859375
72,51,13,18453,8192,10261,125.25634765625
72,51,14,2852,16384,-13532,-82.5927734375
72,51,15,60584,32768,27816,84.8876953125
72,52,1,0,2,-2,-100.0
72,52,2,2,4,-2,-50.0
72,52,3,8,8,0,0.0
72,52,4,12,16,-4,-25.0
72,52,5,10,32,-22,-68.75
72,52,6,9,64,-55,-85.9375
72,52,7,57,128,-71,-55.46875
72,52,8,70,256,-186,-72.65625
72,52,9,15,512,-497,-97.0703125
72,52,10,323,1024,-701,-68.45703125
72,52,11,179,2048,-1869,-91.259765625
72,52,12,3996,4096,-100,-2.44140625
72,52,13,7028,8192,-1164,-14.208984375
72,52,14,104,16384,-16280,-99.365234375
72,52,15,69404,32768,36636,111.80419921875
72,53,1,0,2,-2,-100.0
72,53,2,2,4,-2,-50.0
72,53,3,2,8,-6,-75.0
72,53,4,13,16,-3,-18.75
72,53,5,29,32,-3,-9.375
72,53,6,9,64,-55,-85.9375
72,53,7,127,128,-1,-0.78125
72,53,8,21,256,-235,-91.796875
72,53,9,1203,512,691,134.9609375
72,53,10,2678,1024,1654,161.5234375
72,53,11,1859,2048,-189,-9.228515625
72,53,12,1967,4096,-2129,-51.9775390625
72,53,13,6732,8192,-1460,-17.822265625
72,53,14,3345,16384,-13039,-79.583740234375
72,53,15,21680,32768,-11088,-33.837890625
72,54,1,0,2,-2,-100.0
72,54,2,1,4,-3,-75.0
72,54,3,5,8,-3,-37.5
72,54,4,3,16,-13,-81.25
72,54,5,9,32,-23,-71.875
72,54,6,38,64,-26,-40.625
72,54,7,64,128,-64,-50.0
72,54,8,623,256,367,143.359375
72,54,9,1129,512,617,120.5078125
72,54,10,3392,1024,2368,231.25
72,54,11,533,2048,-1515,-73.974609375
72,54,12,9782,4096,5686,138.818359375
72,54,13,11697,8192,3505,42.78564453125
72,54,14,8659,16384,-7725,-47.149658203125
72,54,15,10787,32768,-21981,-67.0806884765625
72,55,1,0,2,-2,-100.0
72,55,2,1,4,-3,-75.0
72,55,3,7,8,-1,-12.5
72,55,4,4,16,-12,-75.0
72,55,5,44,32,12,37.5
72,55,6,263,64,199,310.9375
72,55,7,93,128,-35,-27.34375
72,55,8,112,256,-144,-56.25
72,55,9,142,512,-370,-72.265625
72,55,10,1057,1024,33,3.22265625
72,55,11,5488,2048,3440,167.96875
72,55,12,2310,4096,-1786,-43.603515625
72,55,13,11501,8192,3309,40.39306640625
72,55,14,35512,16384,19128,116.748046875
72,55,15,28219,32768,-4549,-13.8824462890625
72,56,1,0,2,-2,-100.0
72,56,2,3,4,-1,-25.0
72,56,3,4,8,-4,-50.0
72,56,4,13,16,-3,-18.75
72,56,5,37,32,5,15.625
72,56,6,74,64,10,15.625
72,56,7,40,128,-88,-68.75
72,56,8,45,256,-211,-82.421875
72,56,9,1139,512,627,122.4609375
72,56,10,1179,1024,155,15.13671875
72,56,11,1747,2048,-301,-14.697265625
72,56,12,20820,4096,16724,408.30078125
72,56,13,8766,8192,574,7.0068359375
72,56,14,8354,16384,-8030,-49.01123046875
72,56,15,5656,32768,-27112,-82.7392578125
72,57,1,0,2,-2,-100.0
72,57,2,1,4,-3,-75.0
72,57,3,3,8,-5,-62.5
72,57,4,4,16,-12,-75.0
72,57,5,16,32,-16,-50.0
72,57,6,154,64,90,140.625
72,57,7,196,128,68,53.125
72,57,8,215,256,-41,-16.015625
72,57,9,1209,512,697,136.1328125
72,57,10,1077,1024,53,5.17578125
72,57,11,1160,2048,-888,-43.359375
72,57,12,1499,4096,-2597,-63.4033203125
72,57,13,478,8192,-7714,-94.1650390625
72,57,14,2426,16384,-13958,-85.19287109375
72,57,15,25118,32768,-7650,-23.345947265625
72,58,1,0,2,-2,-100.0
72,58,2,1,4,-3,-75.0
72,58,3,4,8,-4,-50.0
72,58,4,18,16,2,12.5
72,58,5,38,32,6,18.75
72,58,6,152,64,88,137.5
72,58,7,35,128,-93,-72.65625
72,58,8,121,256,-135,-52.734375
72,58,9,654,512,142,27.734375
72,58,10,410,1024,-614,-59.9609375
72,58,11,473,2048,-1575,-76.904296875
72,58,12,480,4096,-3616,-88.28125
72,58,13,4602,8192,-3590,-43.8232421875
72,58,14,12041,16384,-4343,-26.507568359375
72,58,15,67587,32768,34819,106.2591552734375
72,59,1,0,2,-2,-100.0
72,59,2,7,4,3,75.0
72,59,3,10,8,2,25.0
72,59,4,6,16,-10,-62.5
72,59,5,48,32,16,50.0
72,59,6,11,64,-53,-82.8125
72,59,7,127,128,-1,-0.78125
72,59,8,118,256,-138,-53.90625
72,59,9,350,512,-162,-31.640625
72,59,10,234,1024,-790,-77.1484375
72,59,11,705,2048,-1343,-65.576171875
72,59,12,2091,4096,-2005,-48.9501953125
72,59,13,2970,8192,-5222,-63.7451171875
72,59,14,722,16384,-15662,-95.59326171875
72,59,15,277,32768,-32491,-99.1546630859375
72,60,1,0,2,-2,-100.0
72,60,2,1,4,-3,-75.0
72,60,3,9,8,1,12.5
72,60,4,26,16,10,62.5
72,60,5,4,32,-28,-87.5
72,60,6,53,64,-11,-17.1875
72,60,7,126,128,-2,-1.5625
72,60,8,166,256,-90,-35.15625
72,60,9,561,512,49,9.5703125
72,60,10,1382,1024,358,34.9609375
72,60,11,1070,2048,-978,-47.75390625
72,60,12,5873,4096,1777,43.3837890625
72,60,13,2260,8192,-5932,-72.412109375
72,60,14,3903,16384,-12481,-76.177978515625
72,60,15,7141,32768,-25627,-78.2073974609375
72,61,1,0,2,-2,-100.0
72,61,2,3,4,-1,-25.0
72,61,3,4,8,-4,-50.0
72,61,4,17,16,1,6.25
72,61,5,4,32,-28,-87.5
72,61,6,164,64,100,156.25
72,61,7,109,128,-19,-14.84375
72,61,8,152,256,-104,-40.625
72,61,9,45,512,-467,-91.2109375
72,61,10,1242,1024,218,21.2890625
72,61,11,5462,2048,3414,166.69921875
72,61,12,91,4096,-4005,-97.7783203125
72,61,13,6923,8192,-1269,-15.49072265625
72,61,14,9142,16384,-7242,-44.20166015625
72,61,15,81,32768,-32687,-99.7528076171875
72,62,1,0,2,-2,-100.0
72,62,2,2,4,-2,-50.0
72,62,3,9,8,1,12.5
72,62,4,7,16,-9,-56.25
72,62,5,29,32,-3,-9.375
72,62,6,77,64,13,20.3125
72,62,7,32,128,-96,-75.0
72,62,8,153,256,-103,-40.234375
72,62,9,68,512,-444,-86.71875
72,62,10,9,1024,-1015,-99.12109375
72,62,11,1510,2048,-538,-26.26953125
72,62,12,1398,4096,-2698,-65.869140625
72,62,13,6185,8192,-2007,-24.49951171875
72,62,14,3747,16384,-12637,-77.130126953125
72,62,15,2373,32768,-30395,-92.7581787109375
72,63,1,0,2,-2,-100.0
72,63,2,1,4,-3,-75.0
72,63,3,6,8,-2,-25.0
72,63,4,10,16,-6,-37.5
72,63,5,23,32,-9,-28.125
72,63,6,176,64,112,175.0
72,63,7,14,128,-114,-89.0625
72,63,8,129,256,-127,-49.609375
72,63,9,93,512,-419,-81.8359375
72,63,10,460,1024,-564,-55.078125
72,63,11,5107,2048,3059,149.365234375
72,63,12,4717,4096,621,15.1611328125
72,63,13,2160,8192,-6032,-73.6328125
72,63,14,5113,16384,-11271,-68.792724609375
72,63,15,64940,32768,32172,98.18115234375
72,64,1,0,2,-2,-100.0
72,64,2,2,4,-2,-50.0
72,64,3,4,8,-4,-50.0
72,64,4,25,16,9,56.25
72,64,5,49,32,17,53.125
72,64,6,44,64,-20,-31.25
72,64,7,130,128,2,1.5625
72,64,8,108,256,-148,-57.8125
72,64,9,1709,512,1197,233.7890625
72,64,10,3585,1024,2561,250.09765625
72,64,11,773,2048,-1275,-62.255859375
72,64,12,707,4096,-3389,-82.7392578125
72,64,13,17796,8192,9604,117.236328125
72,64,14,13630,16384,-2754,-16.80908203125
72,64,15,43,32768,-32725,-99.8687744140625
72,65,1,0,2,-2,-100.0
72,65,2,1,4,-3,-75.0
72,65,3,6,8,-2,-25.0
72,65,4,41,16,25,156.25
72,65,5,35,32,3,9.375
72,65,6,54,64,-10,-15.625
72,65,7,57,128,-71,-55.46875
72,65,8,60,256,-196,-76.5625
72,65,9,1598,512,1086,212.109375
72,65,10,748,1024,-276,-26.953125
72,65,11,1095,2048,-953,-46.533203125
72,65,12,534,4096,-3562,-86.962890625
72,65,13,896,8192,-7296,-89.0625
72,65,14,30783,16384,14399,87.884521484375
72,65,15,21407,32768,-11361,-34.6710205078125
72,66,1,0,2,-2,-100.0
72,66,2,2,4,-2,-50.0
72,66,3,3,8,-5,-62.5
72,66,4,3,16,-13,-81.25
72,66,5,17,32,-15,-46.875
72,66,6,88,64,24,37.5
72,66,7,40,128,-88,-68.75
72,66,8,310,256,54,21.09375
72,66,9,224,512,-288,-56.25
72,66,10,1028,1024,4,0.390625
72,66,11,3946,2048,1898,92.67578125
72,66,12,417,4096,-3679,-89.8193359375
72,66,13,1005,8192,-7187,-87.73193359375
72,66,14,1614,16384,-14770,-90.14892578125
72,66,15,42218,32768,9450,28.839111328125
72,67,1,0,2,-2,-100.0
72,67,2,1,4,-3,-75.0
72,67,3,4,8,-4,-50.0
72,67,4,4,16,-12,-75.0
72,67,5,8,32,-24,-75.0
72,67,6,42,64,-22,-34.375
72,67,7,114,128,-14,-10.9375
72,67,8,15,256,-241,-94.140625
72,67,9,70,512,-442,-86.328125
72,67,10,343,1024,-681,-66.50390625
72,67,11,1960,2048,-88,-4.296875
72,67,12,4457,4096,361,8.8134765625
72,67,13,3732,8192,-4460,-54.443359375
72,67,14,3823,16384,-12561,-76.666259765625
72,67,15,135076,32768,102308,312.21923828125
72,68,1,0,2,-2,-100.0
72,68,2,2,4,-2,-50.0
72,68,3,4,8,-4,-50.0
72,68,4,5,16,-11,-68.75
72,68,5,75,32,43,134.375
72,68,6,109,64,45,70.3125
72,68,7,21,128,-107,-83.59375
72,68,8,24,256,-232,-90.625
72,68,9,72,512,-440,-85.9375
72,68,10,365,1024,-659,-64.35546875
72,68,11,1390,2048,-658,-32.12890625
72,68,12,6966,4096,2870,70.068359375
72,68,13,20680,8192,12488,152.44140625
72,68,14,7718,16384,-8666,-52.89306640625
72,68,15,6897,32768,-25871,-78.9520263671875
72,69,1,0,2,-2,-100.0
72,69,2,1,4,-3,-75.0
72,69,3,4,8,-4,-50.0
72,69,4,13,16,-3,-18.75
72,69,5,52,32,20,62.5
72,69,6,135,64,71,110.9375
72,69,7,49,128,-79,-61.71875
72,69,8,31,256,-225,-87.890625
72,69,9,192,512,-320,-62.5
72,69,10,159,1024,-865,-84.47265625
72,69,11,1035,2048,-1013,-49.462890625
72,69,12,8397,4096,4301,105.0048828125
72,69,13,2156,8192,-6036,-73.681640625
72,69,14,4645,16384,-11739,-71.649169921875
72,69,15,2525,32768,-30243,-92.2943115234375
72,70,1,0,2,-2,-100.0
72,70,2,5,4,1,25.0
72,70,3,4,8,-4,-50.0
72,70,4,20,16,4,25.0
72,70,5,4,32,-28,-87.5
72,70,6,101,64,37,57.8125
72,70,7,165,128,37,28.90625
72,70,8,141,256,-115,-44.921875
72,70,9,55,512,-457,-89.2578125
72,70,10,135,1024,-889,-86.81640625
72,70,11,2486,2048,438,21.38671875
72,70,12,2512,4096,-1584,-38.671875
72,70,13,2531,8192,-5661,-69.10400390625
72,70,14,13437,16384,-2947,-17.987060546875
72,70,15,23266,32768,-9502,-28.997802734375
72,71,1,0,2,-2,-100.0
72,71,2,1,4,-3,-75.0
72,71,3,6,8,-2,-25.0
72,71,4,9,16,-7,-43.75
72,71,5,22,32,-10,-31.25
72,71,6,15,64,-49,-76.5625
72,71,7,62,128,-66,-51.5625
72,71,8,85,256,-171,-66.796875
72,71,9,267,512,-245,-47.8515625
72,71,10,256,1024,-768,-75.0
72,71,11,11090,2048,9042,441.50390625
72,71,12,13635,4096,9539,232.8857421875
72,71,13,4882,8192,-3310,-40.4052734375
72,71,14,42220,16384,25836,157.6904296875
72,71,15,34653,32768,1885,5.7525634765625
72,72,1,0,2,-2,-100.0
72,72,2,1,4,-3,-75.0
72,72,3,8,8,0,0.0
72,72,4,4,16,-12,-75.0
72,72,5,4,32,-28,-87.5
72,72,6,91,64,27,42.1875
72,72,7,138,128,10,7.8125
72,72,8,233,256,-23,-8.984375
72,72,9,2322,512,1810,353.515625
72,72,10,1248,1024,224,21.875
72,72,11,2187,2048,139,6.787109375
72,72,12,3560,4096,-536,-13.0859375
72,72,13,526,8192,-7666,-93.5791015625
72,72,14,10037,16384,-6347,-38.739013671875
72,72,15,10143,32768,-22625,-69.0460205078125
73,1,1,0,2,-2,-100.0
73,1,2,1,4,-3,-75.0
73,1,3,22,8,14,175.0
73,1,4,15,16,-1,-6.25
73,1,5,43,32,11,34.375
73,1,6,50,64,-14,-21.875
73,1,7,256,128,128,100.0
73,1,8,335,256,79,30.859375
73,1,9,787,512,275,53.7109375
73,1,10,4867,1024,3843,375.29296875
73,1,11,31,2048,-2017,-98.486328125
73,1,12,2680,4096,-1416,-34.5703125
73,1,13,10138,8192,1946,23.7548828125
73,1,14,25333,16384,8949,54.620361328125
73,1,15,135093,32768,102325,312.2711181640625
73,2,1,0,2,-2,-100.0
73,2,2,1,4,-3,-75.0
73,2,3,15,8,7,87.5
73,2,4,6,16,-10,-62.5
73,2,5,17,32,-15,-46.875
73,2,6,34,64,-30,-46.875
73,2,7,11,128,-117,-91.40625
73,2,8,148,256,-108,-42.1875
73,2,9,106,512,-406,-79.296875
73,2,10,396,1024,-628,-61.328125
73,2,11,3188,2048,1140,55.6640625
73,2,12,2681,4096,-1415,-34.5458984375
73,2,13,5915,8192,-2277,-27.79541015625
73,2,14,7069,16384,-9315,-56.854248046875
73,2,15,7333,32768,-25435,-77.6214599609375
73,3,1,0,2,-2,-100.0
73,3,2,2,4,-2,-50.0
73,3,3,7,8,-1,-12.5
73,3,4,3,16,-13,-81.25
73,3,5,46,32,14,43.75
73,3,6,99,64,35,54.6875
73,3,7,37,128,-91,-71.09375
73,3,8,732,256,476,185.9375
73,3,9,448,512,-64,-12.5
73,3,10,475,1024,-549,-53.61328125
73,3,11,1448,2048,-600,-29.296875
73,3,12,1254,4096,-2842,-69.384765625
73,3,13,872,8192,-7320,-89.35546875
73,3,14,29262,16384,12878,78.60107421875
73,3,15,68,32768,-32700,-99.79248046875
73,4,1,0,2,-2,-100.0
73,4,2,1,4,-3,-75.0
73,4,3,9,8,1,12.5
73,4,4,8,16,-8,-50.0
73,4,5,55,32,23,71.875
73,4,6,40,64,-24,-37.5
73,4,7,102,128,-26,-20.3125
73,4,8,20,256,-236,-92.1875
73,4,9,293,512,-219,-42.7734375
73,4,10,1873,1024,849,82.91015625
73,4,11,4216,2048,2168,105.859375
73,4,12,18607,4096,14511,354.2724609375
73,4,13,6267,8192,-1925,-23.49853515625
73,4,14,4646,16384,-11738,-71.64306640625
73,4,15,49869,32768,17101,52.1881103515625
73,5,1,0,2,-2,-100.0
73,5,2,2,4,-2,-50.0
73,5,3,5,8,-3,-37.5
73,5,4,43,16,27,168.75
73,5,5,32,32,0,0.0
73,5,6,15,64,-49,-76.5625
73,5,7,183,128,55,42.96875
73,5,8,27,256,-229,-89.453125
73,5,9,330,512,-182,-35.546875
73,5,10,335,1024,-689,-67.28515625
73,5,11,999,2048,-1049,-51.220703125
73,5,12,5681,4096,1585,38.6962890625
73,5,13,2012,8192,-6180,-75.439453125
73,5,14,4384,16384,-12000,-73.2421875
73,5,15,11953,32768,-20815,-63.5223388671875
73,6,1,0,2,-2,-100.0
73,6,2,1,4,-3,-75.0
73,6,3,4,8,-4,-50.0
73,6,4,12,16,-4,-25.0
73,6,5,15,32,-17,-53.125
73,6,6,104,64,40,62.5
73,6,7,93,128,-35,-27.34375
73,6,8,215,256,-41,-16.015625
73,6,9,862,512,350,68.359375
73,6,10,888,1024,-136,-13.28125
73,6,11,2034,2048,-14,-0.68359375
73,6,12,2378,4096,-1718,-41.943359375
73,6,13,13534,8192,5342,65.2099609375
73,6,14,10875,16384,-5509,-33.624267578125
73,6,15,72120,32768,39352,120.0927734375
73,7,1,0,2,-2,-100.0
73,7,2,1,4,-3,-75.0
73,7,3,5,8,-3,-37.5
73,7,4,3,16,-13,-81.25
73,7,5,40,32,8,25.0
73,7,6,10,64,-54,-84.375
73,7,7,14,128,-114,-89.0625
73,7,8,12,256,-244,-95.3125
73,7,9,45,512,-467,-91.2109375
73,7,10,1226,1024,202,19.7265625
73,7,11,5571,2048,3523,172.021484375
73,7,12,247,4096,-3849,-93.9697265625
73,7,13,17623,8192,9431,115.12451171875
73,7,14,9439,16384,-6945,-42.388916015625
73,7,15,22266,32768,-10502,-32.049560546875
73,8,1,0,2,-2,-100.0
73,8,2,2,4,-2,-50.0
73,8,3,2,8,-6,-75.0
73,8,4,3,16,-13,-81.25
73,8,5,27,32,-5,-15.625
73,8,6,32,64,-32,-50.0
73,8,7,7,128,-121,-94.53125
73,8,8,693,256,437,170.703125
73,8,9,994,512,482,94.140625
73,8,10,394,1024,-630,-61.5234375
73,8,11,3682,2048,1634,79.78515625
73,8,12,822,4096,-3274,-79.931640625
73,8,13,14538,8192,6346,77.4658203125
73,8,14,37501,16384,21117,128.887939453125
73,8,15,14522,32768,-18246,-55.682373046875
73,9,1,0,2,-2,-100.0
73,9,2,2,4,-2,-50.0
73,9,3,7,8,-1,-12.5
73,9,4,3,16,-13,-81.25
73,9,5,8,32,-24,-75.0
73,9,6,40,64,-24,-37.5
73,9,7,183,128,55,42.96875
73,9,8,296,256,40,15.625
73,9,9,572,512,60,11.71875
73,9,10,455,1024,-569,-55.56640625
73,9,11,111,2048,-1937,-94.580078125
73,9,12,9840,4096,5744,140.234375
73,9,13,9189,8192,997,12.17041015625
73,9,14,611,16384,-15773,-96.270751953125
73,9,15,5696,32768,-27072,-82.6171875
73,10,1,0,2,-2,-100.0
73,10,2,1,4,-3,-75.0
73,10,3,3,8,-5,-62.5
73,10,4,23,16,7,43.75
73,10,5,38,32,6,18.75
73,10,6,70,64,6,9.375
73,10,7,198,128,70,54.6875
73,10,8,209,256,-47,-18.359375
73,10,9,809,512,297,58.0078125
73,10,10,4454,1024,3430,334.9609375
73,10,11,2103,2048,55,2.685546875
73,10,12,1764,4096,-2332,-56.93359375
73,10,13,2589,8192,-5603,-68.39599609375
73,10,14,16421,16384,37,0.225830078125
73,10,15,31880,32768,-888,-2.7099609375
73,11,1,0,2,-2,-100.0
73,11,2,4,4,0,0.0
73,11,3,8,8,0,0.0
73,11,4,6,16,-10,-62.5
73,11,5,12,32,-20,-62.5
73,11,6,103,64,39,60.9375
73,11,7,432,128,304,237.5
73,11,8,130,256,-126,-49.21875
73,11,9,501,512,-11,-2.1484375
73,11,10,483,1024,-541,-52.83203125
73,11,11,4242,2048,2194,107.12890625
73,11,12,3167,4096,-929,-22.6806640625
73,11,13,757,8192,-7435,-90.75927734375
73,11,14,9038,16384,-7346,-44.83642578125
73,11,15,40712,32768,7944,24.2431640625
73,12,1,0,2,-2,-100.0
73,12,2,1,4,-3,-75.0
73,12,3,8,8,0,0.0
73,12,4,18,16,2,12.5
73,12,5,10,32,-22,-68.75
73,12,6,103,64,39,60.9375
73,12,7,50,128,-78,-60.9375
73,12,8,315,256,59,23.046875
73,12,9,2167,512,1655,323.2421875
73,12,10,1026,1024,2,0.1953125
73,12,11,3457,2048,1409,68.798828125
73,12,12,2810,4096,-1286,-31.396484375
73,12,13,13357,8192,5165,63.04931640625
73,12,14,15555,16384,-829,-5.059814453125
73,12,15,83209,32768,50441,153.9337158203125
73,13,1,0,2,-2,-100.0
73,13,2,2,4,-2,-50.0
73,13,3,7,8,-1,-12.5
73,13,4,35,16,19,118.75
73,13,5,6,32,-26,-81.25
73,13,6,172,64,108,168.75
73,13,7,104,128,-24,-18.75
73,13,8,67,256,-189,-73.828125
73,13,9,134,512,-378,-73.828125
73,13,10,2901,1024,1877,183.30078125
73,13,11,654,2048,-1394,-68.06640625
73,13,12,1249,4096,-2847,-69.5068359375
73,13,13,1946,8192,-6246,-76.2451171875
73,13,14,38357,16384,21973,134.112548828125
73,13,15,34827,32768,2059,6.2835693359375
73,14,1,0,2,-2,-100.0
73,14,2,1,4,-3,-75.0
73,14,3,13,8,5,62.5
73,14,4,5,16,-11,-68.75
73,14,5,4,32,-28,-87.5
73,14,6,44,64,-20,-31.25
73,14,7,48,128,-80,-62.5
73,14,8,117,256,-139,-54.296875
73,14,9,717,512,205,40.0390625
73,14,10,592,1024,-432,-42.1875
73,14,11,3137,2048,1089,53.173828125
73,14,12,1442,4096,-2654,-64.794921875
73,14,13,16103,8192,7911,96.56982421875
73,14,14,12394,16384,-3990,-24.35302734375
73,14,15,8625,32768,-24143,-73.6785888671875
73,15,1,0,2,-2,-100.0
73,15,2,1,4,-3,-75.0
73,15,3,19,8,11,137.5
73,15,4,13,16,-3,-18.75
73,15,5,20,32,-12,-37.5
73,15,6,56,64,-8,-12.5
73,15,7,62,128,-66,-51.5625
73,15,8,54,256,-202,-78.90625
73,15,9,48,512,-464,-90.625
73,15,10,407,1024,-617,-60.25390625
73,15,11,1129,2048,-919,-44.873046875
73,15,12,401,4096,-3695,-90.2099609375
73,15,13,2928,8192,-5264,-64.2578125
73,15,14,1274,16384,-15110,-92.22412109375
73,15,15,16829,32768,-15939,-48.6419677734375
73,16,1,0,2,-2,-100.0
73,16,2,2,4,-2,-50.0
73,16,3,3,8,-5,-62.5
73,16,4,30,16,14,87.5
73,16,5,7,32,-25,-78.125
73,16,6,64,64,0,0.0
73,16,7,88,128,-40,-31.25
73,16,8,842,256,586,228.90625
73,16,9,483,512,-29,-5.6640625
73,16,10,532,1024,-492,-48.046875
73,16,11,97,2048,-1951,-95.263671875
73,16,12,6189,4096,2093,51.0986328125
73,16,13,4566,8192,-3626,-44.2626953125
73,16,14,51238,16384,34854,212.73193359375
73,16,15,64959,32768,32191,98.2391357421875
73,17,1,0,2,-2,-100.0
73,17,2,2,4,-2,-50.0
73,17,3,3,8,-5,-62.5
73,17,4,3,16,-13,-81.25
73,17,5,59,32,27,84.375
73,17,6,10,64,-54,-84.375
73,17,7,96,128,-32,-25.0
73,17,8,93,256,-163,-63.671875
73,17,9,1943,512,1431,279.4921875
73,17,10,636,1024,-388,-37.890625
73,17,11,1783,2048,-265,-12.939453125
73,17,12,6618,4096,2522,61.572265625
73,17,13,7791,8192,-401,-4.89501953125
73,17,14,18199,16384,1815,11.077880859375
73,17,15,45521,32768,12753,38.9190673828125
73,18,1,0,2,-2,-100.0
73,18,2,3,4,-1,-25.0
73,18,3,12,8,4,50.0
73,18,4,23,16,7,43.75
73,18,5,49,32,17,53.125
73,18,6,314,64,250,390.625
73,18,7,20,128,-108,-84.375
73,18,8,189,256,-67,-26.171875
73,18,9,163,512,-349,-68.1640625
73,18,10,323,1024,-701,-68.45703125
73,18,11,1727,2048,-321,-15.673828125
73,18,12,634,4096,-3462,-84.521484375
73,18,13,8376,8192,184,2.24609375
73,18,14,9159,16384,-7225,-44.097900390625
73,18,15,30380,32768,-2388,-7.28759765625
73,19,1,0,2,-2,-100.0
73,19,2,2,4,-2,-50.0
73,19,3,14,8,6,75.0
73,19,4,14,16,-2,-12.5
73,19,5,7,32,-25,-78.125
73,19,6,109,64,45,70.3125
73,19,7,22,128,-106,-82.8125
73,19,8,120,256,-136,-53.125
73,19,9,79,512,-433,-84.5703125
73,19,10,764,1024,-260,-25.390625
73,19,11,674,2048,-1374,-67.08984375
73,19,12,4418,4096,322,7.861328125
73,19,13,9884,8192,1692,20.654296875
73,19,14,28066,16384,11682,71.30126953125
73,19,15,18513,32768,-14255,-43.5028076171875
73,20,1,0,2,-2,-100.0
73,20,2,3,4,-1,-25.0
73,20,3,2,8,-6,-75.0
73,20,4,20,16,4,25.0
73,20,5,44,32,12,37.5
73,20,6,134,64,70,109.375
73,20,7,60,128,-68,-53.125
73,20,8,91,256,-165,-64.453125
73,20,9,500,512,-12,-2.34375
73,20,10,127,1024,-897,-87.59765625
73,20,11,3328,2048,1280,62.5
73,20,12,2222,4096,-1874,-45.751953125
73,20,13,11519,8192,3327,40.61279296875
73,20,14,6136,16384,-10248,-62.548828125
73,20,15,31747,32768,-1021,-3.1158447265625
73,21,1,0,2,-2,-100.0
73,21,2,1,4,-3,-75.0
73,21,3,4,8,-4,-50.0
73,21,4,35,16,19,118.75
73,21,5,23,32,-9,-28.125
73,21,6,48,64,-16,-25.0
73,21,7,19,128,-109,-85.15625
73,21,8,83,256,-173,-67.578125
73,21,9,177,512,-335,-65.4296875
73,21,10,28,1024,-996,-97.265625
73,21,11,3855,2048,1807,88.232421875
73,21,12,5296,4096,1200,29.296875
73,21,13,2678,8192,-5514,-67.3095703125
73,21,14,46677,16384,30293,184.893798828125
73,21,15,1392,32768,-31376,-95.751953125
73,22,1,0,2,-2,-100.0
73,22,2,2,4,-2,-50.0
73,22,3,7,8,-1,-12.5
73,22,4,7,16,-9,-56.25
73,22,5,17,32,-15,-46.875
73,22,6,111,64,47,73.4375
73,22,7,103,128,-25,-19.53125
73,22,8,145,256,-111,-43.359375
73,22,9,694,512,182,35.546875
73,22,10,814,1024,-210,-20.5078125
73,22,11,360,2048,-1688,-82.421875
73,22,12,631,4096,-3465,-84.5947265625
73,22,13,10850,8192,2658,32.4462890625
73,22,14,8356,16384,-8028,-48.9990234375
73,22,15,2190,32768,-30578,-93.316650390625
73,23,1,0,2,-2,-100.0
73,23,2,4,4,0,0.0
73,23,3,5,8,-3,-37.5
73,23,4,6,16,-10,-62.5
73,23,5,48,32,16,50.0
73,23,6,93,64,29,45.3125
73,23,7,40,128,-88,-68.75
73,23,8,61,256,-195,-76.171875
73,23,9,867,512,355,69.3359375
73,23,10,288,1024,-736,-71.875
73,23,11,1644,2048,-404,-19.7265625
73,23,12,4737,4096,641,15.6494140625
73,23,13,17870,8192,9678,118.1396484375
73,23,14,15706,16384,-678,-4.13818359375
73,23,15,1963,32768,-30805,-94.0093994140625
73,24,1,0,2,-2,-100.0
73,24,2,1,4,-3,-75.0
73,24,3,4,8,-4,-50.0
73,24,4,6,16,-10,-62.5
73,24,5,7,32,-25,-78.125
73,24,6,29,64,-35,-54.6875
73,24,7,16,128,-112,-87.5
73,24,8,13,256,-243,-94.921875
73,24,9,625,512,113,22.0703125
73,24,10,394,1024,-630,-61.5234375
73,24,11,4020,2048,1972,96.2890625
73,24,12,11378,4096,7282,177.783203125
73,24,13,5446,8192,-2746,-33.5205078125
73,24,14,14091,16384,-2293,-13.995361328125
73,24,15,27809,32768,-4959,-15.1336669921875
73,25,1,0,2,-2,-100.0
73,25,2,1,4,-3,-75.0
73,25,3,2,8,-6,-75.0
73,25,4,3,16,-13,-81.25
73,25,5,41,32,9,28.125
73,25,6,5,64,-59,-92.1875
73,25,7,77,128,-51,-39.84375
73,25,8,402,256,146,57.03125
73,25,9,361,512,-151,-29.4921875
73,25,10,366,1024,-658,-64.2578125
73,25,11,1690,2048,-358,-17.48046875
73,25,12,4641,4096,545,13.3056640625
73,25,13,13325,8192,5133,62.65869140625
73,25,14,38490,16384,22106,134.92431640625
73,25,15,27404,32768,-5364,-16.36962890625
73,26,1,0,2,-2,-100.0
73,26,2,1,4,-3,-75.0
73,26,3,2,8,-6,-75.0
73,26,4,12,16,-4,-25.0
73,26,5,4,32,-28,-87.5
73,26,6,52,64,-12,-18.75
73,26,7,160,128,32,25.0
73,26,8,46,256,-210,-82.03125
73,26,9,882,512,370,72.265625
73,26,10,570,1024,-454,-44.3359375
73,26,11,2554,2048,506,24.70703125
73,26,12,7194,4096,3098,75.634765625
73,26,13,7323,8192,-869,-10.60791015625
73,26,14,15812,16384,-572,-3.4912109375
73,26,15,13961,32768,-18807,-57.3944091796875
73,27,1,0,2,-2,-100.0
73,27,2,1,4,-3,-75.0
73,27,3,2,8,-6,-75.0
73,27,4,20,16,4,25.0
73,27,5,40,32,8,25.0
73,27,6,45,64,-19,-29.6875
73,27,7,58,128,-70,-54.6875
73,27,8,102,256,-154,-60.15625
73,27,9,1050,512,538,105.078125
73,27,10,935,1024,-89,-8.69140625
73,27,11,375,2048,-1673,-81.689453125
73,27,12,1836,4096,-2260,-55.17578125
73,27,13,45179,8192,36987,451.50146484375
73,27,14,3542,16384,-12842,-78.38134765625
73,27,15,15232,32768,-17536,-53.515625
73,28,1,0,2,-2,-100.0
73,28,2,1,4,-3,-75.0
73,28,3,9,8,1,12.5
73,28,4,4,16,-12,-75.0
73,28,5,21,32,-11,-34.375
73,28,6,33,64,-31,-48.4375
73,28,7,218,128,90,70.3125
73,28,8,127,256,-129,-50.390625
73,28,9,524,512,12,2.34375
73,28,10,382,1024,-642,-62.6953125
73,28,11,1302,2048,-746,-36.42578125
73,28,12,2111,4096,-1985,-48.4619140625
73,28,13,5840,8192,-2352,-28.7109375
73,28,14,50599,16384,34215,208.831787109375
73,28,15,3662,32768,-29106,-88.824462890625
73,29,1,0,2,-2,-100.0
73,29,2,7,4,3,75.0
73,29,3,5,8,-3,-37.5
73,29,4,5,16,-11,-68.75
73,29,5,34,32,2,6.25
73,29,6,31,64,-33,-51.5625
73,29,7,401,128,273,213.28125
73,29,8,81,256,-175,-68.359375
73,29,9,1181,512,669,130.6640625
73,29,10,215,1024,-809,-79.00390625
73,29,11,3503,2048,1455,71.044921875
73,29,12,3591,4096,-505,-12.3291015625
73,29,13,19163,8192,10971,133.92333984375
73,29,14,9104,16384,-7280,-44.43359375
73,29,15,33490,32768,722,2.203369140625
73,30,1,0,2,-2,-100.0
73,30,2,2,4,-2,-50.0
73,30,3,6,8,-2,-25.0
73,30,4,8,16,-8,-50.0
73,30,5,21,32,-11,-34.375
73,30,6,76,64,12,18.75
73,30,7,155,128,27,21.09375
73,30,8,366,256,110,42.96875
73,30,9,1040,512,528,103.125
73,30,10,485,1024,-539,-52.63671875
73,30,11,4559,2048,2511,122.607421875
73,30,12,6315,4096,2219,54.1748046875
73,30,13,14175,8192,5983,73.03466796875
73,30,14,23688,16384,7304,44.580078125
73,30,15,14066,32768,-18702,-57.073974609375
73,31,1,0,2,-2,-100.0
73,31,2,1,4,-3,-75.0
73,31,3,3,8,-5,-62.5
73,31,4,6,16,-10,-62.5
73,31,5,24,32,-8,-25.0
73,31,6,57,64,-7,-10.9375
73,31,7,9,128,-119,-92.96875
73,31,8,172,256,-84,-32.8125
73,31,9,146,512,-366,-71.484375
73,31,10,633,1024,-391,-38.18359375
73,31,11,1216,2048,-832,-40.625
73,31,12,533,4096,-3563,-86.9873046875
73,31,13,2381,8192,-5811,-70.93505859375
73,31,14,25620,16384,9236,56.3720703125
73,31,15,48938,32768,16170,49.346923828125
73,32,1,0,2,-2,-100.0
73,32,2,2,4,-2,-50.0
73,32,3,2,8,-6,-75.0
73,32,4,3,16,-13,-81.25
73,32,5,85,32,53,165.625
73,32,6,81,64,17,26.5625
73,32,7,957,128,829,647.65625
73,32,8,284,256,28,10.9375
73,32,9,715,512,203,39.6484375
73,32,10,268,1024,-756,-73.828125
73,32,11,1486,2048,-562,-27.44140625
73,32,12,1062,4096,-3034,-74.072265625
73,32,13,24361,8192,16169,197.37548828125
73,32,14,25488,16384,9104,55.56640625
73,32,15,38813,32768,6045,18.4478759765625
73,33,1,0,2,-2,-100.0
73,33,2,1,4,-3,-75.0
73,33,3,10,8,2,25.0
73,33,4,12,16,-4,-25.0
73,33,5,94,32,62,193.75
73,33,6,33,64,-31,-48.4375
73,33,7,369,128,241,188.28125
73,33,8,150,256,-106,-41.40625
73,33,9,424,512,-88,-17.1875
73,33,10,959,1024,-65,-6.34765625
73,33,11,654,2048,-1394,-68.06640625
73,33,12,3690,4096,-406,-9.912109375
73,33,13,12203,8192,4011,48.96240234375
73,33,14,4788,16384,-11596,-70.7763671875
73,33,15,28028,32768,-4740,-14.46533203125
73,34,1,0,2,-2,-100.0
73,34,2,1,4,-3,-75.0
73,34,3,4,8,-4,-50.0
73,34,4,7,16,-9,-56.25
73,34,5,65,32,33,103.125
73,34,6,27,64,-37,-57.8125
73,34,7,30,128,-98,-76.5625
73,34,8,330,256,74,28.90625
73,34,9,237,512,-275,-53.7109375
73,34,10,333,1024,-691,-67.48046875
73,34,11,340,2048,-1708,-83.3984375
73,34,12,268,4096,-3828,-93.45703125
73,34,13,21369,8192,13177,160.85205078125
73,34,14,3082,16384,-13302,-81.18896484375
73,34,15,4993,32768,-27775,-84.7625732421875
73,35,1,0,2,-2,-100.0
73,35,2,3,4,-1,-25.0
73,35,3,2,8,-6,-75.0
73,35,4,11,16,-5,-31.25
73,35,5,18,32,-14,-43.75
73,35,6,44,64,-20,-31.25
73,35,7,64,128,-64,-50.0
73,35,8,291,256,35,13.671875
73,35,9,648,512,136,26.5625
73,35,10,156,1024,-868,-84.765625
73,35,11,3616,2048,1568,76.5625
73,35,12,13498,4096,9402,229.541015625
73,35,13,10389,8192,2197,26.81884765625
73,35,14,5388,16384,-10996,-67.1142578125
73,35,15,18692,32768,-14076,-42.95654296875
73,36,1,0,2,-2,-100.0
73,36,2,1,4,-3,-75.0
73,36,3,7,8,-1,-12.5
73,36,4,5,16,-11,-68.75
73,36,5,12,32,-20,-62.5
73,36,6,83,64,19,29.6875
73,36,7,11,128,-117,-91.40625
73,36,8,361,256,105,41.015625
73,36,9,702,512,190,37.109375
73,36,10,201,1024,-823,-80.37109375
73,36,11,463,2048,-1585,-77.392578125
73,36,12,313,4096,-3783,-92.3583984375
73,36,13,6150,8192,-2042,-24.9267578125
73,36,14,9774,16384,-6610,-40.34423828125
73,36,15,23824,32768,-8944,-27.294921875
73,37,1,0,2,-2,-100.0
73,37,2,3,4,-1,-25.0
73,37,3,9,8,1,12.5
73,37,4,12,16,-4,-25.0
73,37,5,6,32,-26,-81.25
73,37,6,50,64,-14,-21.875
73,37,7,33,128,-95,-74.21875
73,37,8,681,256,425,166.015625
73,37,9,523,512,11,2.1484375
73,37,10,253,1024,-771,-75.29296875
73,37,11,2701,2048,653,31.884765625
73,37,12,6133,4096,2037,49.7314453125
73,37,13,7118,8192,-1074,-13.1103515625
73,37,14,28101,16384,11717,71.514892578125
73,37,15,43489,32768,10721,32.7178955078125
73,38,1,0,2,-2,-100.0
73,38,2,1,4,-3,-75.0
73,38,3,3,8,-5,-62.5
73,38,4,8,16,-8,-50.0
73,38,5,24,32,-8,-25.0
73,38,6,7,64,-57,-89.0625
73,38,7,6,128,-122,-95.3125
73,38,8,207,256,-49,-19.140625
73,38,9,1191,512,679,132.6171875
73,38,10,558,1024,-466,-45.5078125
73,38,11,562,2048,-1486,-72.55859375
73,38,12,3732,4096,-364,-8.88671875
73,38,13,6472,8192,-1720,-20.99609375
73,38,14,9146,16384,-7238,-44.17724609375
73,38,15,27125,32768,-5643,-17.2210693359375
73,39,1,0,2,-2,-100.0
73,39,2,2,4,-2,-50.0
73,39,3,6,8,-2,-25.0
73,39,4,4,16,-12,-75.0
73,39,5,10,32,-22,-68.75
73,39,6,90,64,26,40.625
73,39,7,8,128,-120,-93.75
73,39,8,75,256,-181,-70.703125
73,39,9,59,512,-453,-88.4765625
73,39,10,1993,1024,969,94.62890625
73,39,11,3238,2048,1190,58.10546875
73,39,12,2128,4096,-1968,-48.046875
73,39,13,12547,8192,4355,53.16162109375
73,39,14,35649,16384,19265,117.584228515625
73,39,15,9596,32768,-23172,-70.71533203125
73,40,1,0,2,-2,-100.0
73,40,2,4,4,0,0.0
73,40,3,7,8,-1,-12.5
73,40,4,18,16,2,12.5
73,40,5,28,32,-4,-12.5
73,40,6,38,64,-26,-40.625
73,40,7,14,128,-114,-89.0625
73,40,8,223,256,-33,-12.890625
73,40,9,354,512,-158,-30.859375
73,40,10,38,1024,-986,-96.2890625
73,40,11,2511,2048,463,22.607421875
73,40,12,7097,4096,3001,73.2666015625
73,40,13,18685,8192,10493,128.08837890625
73,40,14,2390,16384,-13994,-85.41259765625
73,40,15,15249,32768,-17519,-53.4637451171875
73,41,1,0,2,-2,-100.0
73,41,2,2,4,-2,-50.0
73,41,3,3,8,-5,-62.5
73,41,4,19,16,3,18.75
73,41,5,9,32,-23,-71.875
73,41,6,71,64,7,10.9375
73,41,7,138,128,10,7.8125
73,41,8,243,256,-13,-5.078125
73,41,9,690,512,178,34.765625
73,41,10,1940,1024,916,89.453125
73,41,11,1558,2048,-490,-23.92578125
73,41,12,2643,4096,-1453,-35.4736328125
73,41,13,11854,8192,3662,44.7021484375
73,41,14,7058,16384,-9326,-56.92138671875
73,41,15,13326,32768,-19442,-59.332275390625
73,42,1,0,2,-2,-100.0
73,42,2,1,4,-3,-75.0
73,42,3,2,8,-6,-75.0
73,42,4,7,16,-9,-56.25
73,42,5,5,32,-27,-84.375
73,42,6,72,64,8,12.5
73,42,7,58,128,-70,-54.6875
73,42,8,537,256,281,109.765625
73,42,9,1064,512,552,107.8125
73,42,10,140,1024,-884,-86.328125
73,42,11,1360,2048,-688,-33.59375
73,42,12,859,4096,-3237,-79.0283203125
73,42,13,5447,8192,-2745,-33.50830078125
73,42,14,3834,16384,-12550,-76.59912109375
73,42,15,7953,32768,-24815,-75.7293701171875
73,43,1,0,2,-2,-100.0
73,43,2,3,4,-1,-25.0
73,43,3,13,8,5,62.5
73,43,4,23,16,7,43.75
73,43,5,13,32,-19,-59.375
73,43,6,54,64,-10,-15.625
73,43,7,89,128,-39,-30.46875
73,43,8,46,256,-210,-82.03125
73,43,9,398,512,-114,-22.265625
73,43,10,618,1024,-406,-39.6484375
73,43,11,4424,2048,2376,116.015625
73,43,12,2877,4096,-1219,-29.7607421875
73,43,13,1223,8192,-6969,-85.07080078125
73,43,14,3772,16384,-12612,-76.9775390625
73,43,15,56545,32768,23777,72.5616455078125
73,44,1,0,2,-2,-100.0
73,44,2,2,4,-2,-50.0
73,44,3,18,8,10,125.0
73,44,4,4,16,-12,-75.0
73,44,5,17,32,-15,-46.875
73,44,6,75,64,11,17.1875
73,44,7,93,128,-35,-27.34375
73,44,8,351,256,95,37.109375
73,44,9,114,512,-398,-77.734375
73,44,10,239,1024,-785,-76.66015625
73,44,11,411,2048,-1637,-79.931640625
73,44,12,4952,4096,856,20.8984375
73,44,13,5968,8192,-2224,-27.1484375
73,44,14,495,16384,-15889,-96.978759765625
73,44,15,25283,32768,-7485,-22.8424072265625
73,45,1,0,2,-2,-100.0
73,45,2,2,4,-2,-50.0
73,45,3,6,8,-2,-25.0
73,45,4,28,16,12,75.0
73,45,5,44,32,12,37.5
73,45,6,42,64,-22,-34.375
73,45,7,45,128,-83,-64.84375
73,45,8,316,256,60,23.4375
73,45,9,2077,512,1565,305.6640625
73,45,10,2342,1024,1318,128.7109375
73,45,11,2619,2048,571,27.880859375
73,45,12,162,4096,-3934,-96.044921875
73,45,13,6846,8192,-1346,-16.4306640625
73,45,14,3235,16384,-13149,-80.255126953125
73,45,15,24413,32768,-8355,-25.4974365234375
73,46,1,0,2,-2,-100.0
73,46,2,3,4,-1,-25.0
73,46,3,2,8,-6,-75.0
73,46,4,27,16,11,68.75
73,46,5,7,32,-25,-78.125
73,46,6,72,64,8,12.5
73,46,7,142,128,14,10.9375
73,46,8,47,256,-209,-81.640625
73,46,9,55,512,-457,-89.2578125
73,46,10,95,1024,-929,-90.72265625
73,46,11,3932,2048,1884,91.9921875
73,46,12,22140,4096,18044,440.52734375
73,46,13,5071,8192,-3121,-38.09814453125
73,46,14,15247,16384,-1137,-6.939697265625
73,46,15,21024,32768,-11744,-35.83984375
73,47,1,0,2,-2,-100.0
73,47,2,4,4,0,0.0
73,47,3,4,8,-4,-50.0
73,47,4,5,16,-11,-68.75
73,47,5,9,32,-23,-71.875
73,47,6,63,64,-1,-1.5625
73,47,7,84,128,-44,-34.375
73,47,8,1159,256,903,352.734375
73,47,9,263,512,-249,-48.6328125
73,47,10,166,1024,-858,-83.7890625
73,47,11,918,2048,-1130,-55.17578125
73,47,12,10155,4096,6059,147.9248046875
73,47,13,17316,8192,9124,111.376953125
73,47,14,3418,16384,-12966,-79.13818359375
73,47,15,75382,32768,42614,130.047607421875
73,48,1,0,2,-2,-100.0
73,48,2,2,4,-2,-50.0
73,48,3,5,8,-3,-37.5
73,48,4,3,16,-13,-81.25
73,48,5,24,32,-8,-25.0
73,48,6,76,64,12,18.75
73,48,7,31,128,-97,-75.78125
73,48,8,164,256,-92,-35.9375
73,48,9,25,512,-487,-95.1171875
73,48,10,1061,1024,37,3.61328125
73,48,11,109,2048,-1939,-94.677734375
73,48,12,6996,4096,2900,70.80078125
73,48,13,1681,8192,-6511,-79.47998046875
73,48,14,51983,16384,35599,217.279052734375
73,48,15,18972,32768,-13796,-42.10205078125
73,49,1,0,2,-2,-100.0
73,49,2,5,4,1,25.0
73,49,3,2,8,-6,-75.0
73,49,4,9,16,-7,-43.75
73,49,5,18,32,-14,-43.75
73,49,6,37,64,-27,-42.1875
73,49,7,147,128,19,14.84375
73,49,8,136,256,-120,-46.875
73,49,9,2193,512,1681,328.3203125
73,49,10,156,1024,-868,-84.765625
73,49,11,491,2048,-1557,-76.025390625
73,49,12,10455,4096,6359,155.2490234375
73,49,13,16167,8192,7975,97.35107421875
73,49,14,6497,16384,-9887,-60.345458984375
73,49,15,39417,32768,6649,20.2911376953125
73,50,1,0,2,-2,-100.0
73,50,2,2,4,-2,-50.0
73,50,3,4,8,-4,-50.0
73,50,4,13,16,-3,-18.75
73,50,5,13,32,-19,-59.375
73,50,6,53,64,-11,-17.1875
73,50,7,40,128,-88,-68.75
73,50,8,43,256,-213,-83.203125
73,50,9,239,512,-273,-53.3203125
73,50,10,609,1024,-415,-40.52734375
73,50,11,922,2048,-1126,-54.98046875
73,50,12,4622,4096,526,12.841796875
73,50,13,27040,8192,18848,230.078125
73,50,14,22904,16384,6520,39.794921875
73,50,15,7062,32768,-25706,-78.448486328125
73,51,1,0,2,-2,-100.0
73,51,2,1,4,-3,-75.0
73,51,3,2,8,-6,-75.0
73,51,4,7,16,-9,-56.25
73,51,5,26,32,-6,-18.75
73,51,6,118,64,54,84.375
73,51,7,29,128,-99,-77.34375
73,51,8,239,256,-17,-6.640625
73,51,9,145,512,-367,-71.6796875
73,51,10,289,1024,-735,-71.77734375
73,51,11,842,2048,-1206,-58.88671875
73,51,12,2454,4096,-1642,-40.087890625
73,51,13,13681,8192,5489,67.00439453125
73,51,14,6622,16384,-9762,-59.58251953125
73,51,15,18731,32768,-14037,-42.8375244140625
73,52,1,0,2,-2,-100.0
73,52,2,2,4,-2,-50.0
73,52,3,10,8,2,25.0
73,52,4,6,16,-10,-62.5
73,52,5,7,32,-25,-78.125
73,52,6,34,64,-30,-46.875
73,52,7,275,128,147,114.84375
73,52,8,696,256,440,171.875
73,52,9,230,512,-282,-55.078125
73,52,10,810,1024,-214,-20.8984375
73,52,11,3148,2048,1100,53.7109375
73,52,12,2542,4096,-1554,-37.939453125
73,52,13,3306,8192,-4886,-59.6435546875
73,52,14,14488,16384,-1896,-11.572265625
73,52,15,19581,32768,-13187,-40.2435302734375
73,53,1,0,2,-2,-100.0
73,53,2,1,4,-3,-75.0
73,53,3,7,8,-1,-12.5
73,53,4,11,16,-5,-31.25
73,53,5,24,32,-8,-25.0
73,53,6,5,64,-59,-92.1875
73,53,7,19,128,-109,-85.15625
73,53,8,922,256,666,260.15625
73,53,9,231,512,-281,-54.8828125
73,53,10,569,1024,-455,-44.43359375
73,53,11,4097,2048,2049,100.048828125
73,53,12,1665,4096,-2431,-59.3505859375
73,53,13,8346,8192,154,1.8798828125
73,53,14,13901,16384,-2483,-15.155029296875
73,53,15,7699,32768,-25069,-76.5045166015625
73,54,1,0,2,-2,-100.0
73,54,2,3,4,-1,-25.0
73,54,3,4,8,-4,-50.0
73,54,4,3,16,-13,-81.25
73,54,5,67,32,35,109.375
73,54,6,28,64,-36,-56.25
73,54,7,56,128,-72,-56.25
73,54,8,705,256,449,175.390625
73,54,9,240,512,-272,-53.125
73,54,10,1950,1024,926,90.4296875
73,54,11,4620,2048,2572,125.5859375
73,54,12,9711,4096,5615,137.0849609375
73,54,13,1103,8192,-7089,-86.53564453125
73,54,14,39207,16384,22823,139.300537109375
73,54,15,47719,32768,14951,45.6268310546875
73,55,1,0,2,-2,-100.0
73,55,2,1,4,-3,-75.0
73,55,3,11,8,3,37.5
73,55,4,16,16,0,0.0
73,55,5,15,32,-17,-53.125
73,55,6,116,64,52,81.25
73,55,7,222,128,94,73.4375
73,55,8,14,256,-242,-94.53125
73,55,9,48,512,-464,-90.625
73,55,10,33,1024,-991,-96.77734375
73,55,11,214,2048,-1834,-89.55078125
73,55,12,3081,4096,-1015,-24.7802734375
73,55,13,5714,8192,-2478,-30.2490234375
73,55,14,7096,16384,-9288,-56.689453125
73,55,15,10919,32768,-21849,-66.6778564453125
73,56,1,0,2,-2,-100.0
73,56,2,1,4,-3,-75.0
73,56,3,6,8,-2,-25.0
73,56,4,13,16,-3,-18.75
73,56,5,13,32,-19,-59.375
73,56,6,25,64,-39,-60.9375
73,56,7,17,128,-111,-86.71875
73,56,8,118,256,-138,-53.90625
73,56,9,355,512,-157,-30.6640625
73,56,10,505,1024,-519,-50.68359375
73,56,11,2486,2048,438,21.38671875
73,56,12,2740,4096,-1356,-33.10546875
73,56,13,4194,8192,-3998,-48.8037109375
73,56,14,13894,16384,-2490,-15.19775390625
73,56,15,13200,32768,-19568,-59.716796875
73,57,1,0,2,-2,-100.0
73,57,2,2,4,-2,-50.0
73,57,3,24,8,16,200.0
73,57,4,3,16,-13,-81.25
73,57,5,29,32,-3,-9.375
73,57,6,108,64,44,68.75
73,57,7,133,128,5,3.90625
73,57,8,195,256,-61,-23.828125
73,57,9,203,512,-309,-60.3515625
73,57,10,2398,1024,1374,134.1796875
73,57,11,389,2048,-1659,-81.005859375
73,57,12,10262,4096,6166,150.537109375
73,57,13,1064,8192,-7128,-87.01171875
73,57,14,29495,16384,13111,80.023193359375
73,57,15,11595,32768,-21173,-64.6148681640625
73,58,1,0,2,-2,-100.0
73,58,2,4,4,0,0.0
73,58,3,6,8,-2,-25.0
73,58,4,7,16,-9,-56.25
73,58,5,8,32,-24,-75.0
73,58,6,126,64,62,96.875
73,58,7,64,128,-64,-50.0
73,58,8,218,256,-38,-14.84375
73,58,9,31,512,-481,-93.9453125
73,58,10,3965,1024,2941,287.20703125
73,58,11,1971,2048,-77,-3.759765625
73,58,12,3809,4096,-287,-7.0068359375
73,58,13,8873,8192,681,8.31298828125
73,58,14,4665,16384,-11719,-71.527099609375
73,58,15,14608,32768,-18160,-55.419921875
73,59,1,0,2,-2,-100.0
73,59,2,2,4,-2,-50.0
73,59,3,2,8,-6,-75.0
73,59,4,12,16,-4,-25.0
73,59,5,31,32,-1,-3.125
73,59,6,11,64,-53,-82.8125
73,59,7,14,128,-114,-89.0625
73,59,8,183,256,-73,-28.515625
73,59,9,229,512,-283,-55.2734375
73,59,10,662,1024,-362,-35.3515625
73,59,11,1303,2048,-745,-36.376953125
73,59,12,2093,4096,-2003,-48.9013671875
73,59,13,1032,8192,-7160,-87.40234375
73,59,14,10790,16384,-5594,-34.14306640625
73,59,15,41167,32768,8399,25.6317138671875
73,60,1,0,2,-2,-100.0
73,60,2,3,4,-1,-25.0
73,60,3,2,8,-6,-75.0
73,60,4,6,16,-10,-62.5
73,60,5,40,32,8,25.0
73,60,6,67,64,3,4.6875
73,60,7,36,128,-92,-71.875
73,60,8,231,256,-25,-9.765625
73,60,9,73,512,-439,-85.7421875
73,60,10,5209,1024,4185,408.69140625
73,60,11,1656,2048,-392,-19.140625
73,60,12,780,4096,-3316,-80.95703125
73,60,13,15909,8192,7717,94.20166015625
73,60,14,1212,16384,-15172,-92.6025390625
73,60,15,112025,32768,79257,241.8731689453125
73,61,1,0,2,-2,-100.0
73,61,2,2,4,-2,-50.0
73,61,3,3,8,-5,-62.5
73,61,4,12,16,-4,-25.0
73,61,5,8,32,-24,-75.0
73,61,6,12,64,-52,-81.25
73,61,7,586,128,458,357.8125
73,61,8,175,256,-81,-31.640625
73,61,9,294,512,-218,-42.578125
73,61,10,540,1024,-484,-47.265625
73,61,11,5658,2048,3610,176.26953125
73,61,12,7033,4096,2937,71.7041015625
73,61,13,2269,8192,-5923,-72.30224609375
73,61,14,14350,16384,-2034,-12.41455078125
73,61,15,32197,32768,-571,-1.7425537109375
73,62,1,0,2,-2,-100.0
73,62,2,1,4,-3,-75.0
73,62,3,4,8,-4,-50.0
73,62,4,4,16,-12,-75.0
73,62,5,5,32,-27,-84.375
73,62,6,89,64,25,39.0625
73,62,7,44,128,-84,-65.625
73,62,8,602,256,346,135.15625
73,62,9,175,512,-337,-65.8203125
73,62,10,948,1024,-76,-7.421875
73,62,11,436,2048,-1612,-78.7109375
73,62,12,672,4096,-3424,-83.59375
73,62,13,17799,8192,9607,117.27294921875
73,62,14,5317,16384,-11067,-67.547607421875
73,62,15,6104,32768,-26664,-81.3720703125
73,63,1,0,2,-2,-100.0
73,63,2,1,4,-3,-75.0
73,63,3,4,8,-4,-50.0
73,63,4,5,16,-11,-68.75
73,63,5,71,32,39,121.875
73,63,6,14,64,-50,-78.125
73,63,7,616,128,488,381.25
73,63,8,127,256,-129,-50.390625
73,63,9,742,512,230,44.921875
73,63,10,1754,1024,730,71.2890625
73,63,11,2047,2048,-1,-0.048828125
73,63,12,5532,4096,1436,35.05859375
73,63,13,3251,8192,-4941,-60.31494140625
73,63,14,60639,16384,44255,270.111083984375
73,63,15,8632,32768,-24136,-73.6572265625
73,64,1,0,2,-2,-100.0
73,64,2,1,4,-3,-75.0
73,64,3,2,8,-6,-75.0
73,64,4,10,16,-6,-37.5
73,64,5,80,32,48,150.0
73,64,6,115,64,51,79.6875
73,64,7,114,128,-14,-10.9375
73,64,8,16,256,-240,-93.75
73,64,9,1277,512,765,149.4140625
73,64,10,114,1024,-910,-88.8671875
73,64,11,710,2048,-1338,-65.33203125
73,64,12,1760,4096,-2336,-57.03125
73,64,13,22223,8192,14031,171.27685546875
73,64,14,24647,16384,8263,50.433349609375
73,64,15,7590,32768,-25178,-76.837158203125
73,65,1,0,2,-2,-100.0
73,65,2,1,4,-3,-75.0
73,65,3,2,8,-6,-75.0
73,65,4,24,16,8,50.0
73,65,5,12,32,-20,-62.5
73,65,6,75,64,11,17.1875
73,65,7,112,128,-16,-12.5
73,65,8,24,256,-232,-90.625
73,65,9,209,512,-303,-59.1796875
73,65,10,1068,1024,44,4.296875
73,65,11,2571,2048,523,25.537109375
73,65,12,10820,4096,6724,164.16015625
73,65,13,1368,8192,-6824,-83.30078125
73,65,14,30248,16384,13864,84.619140625
73,65,15,972,32768,-31796,-97.03369140625
73,66,1,0,2,-2,-100.0
73,66,2,2,4,-2,-50.0
73,66,3,5,8,-3,-37.5
73,66,4,24,16,8,50.0
73,66,5,37,32,5,15.625
73,66,6,107,64,43,67.1875
73,66,7,161,128,33,25.78125
73,66,8,222,256,-34,-13.28125
73,66,9,487,512,-25,-4.8828125
73,66,10,5460,1024,4436,433.203125
73,66,11,308,2048,-1740,-84.9609375
73,66,12,14321,4096,10225,249.6337890625
73,66,13,6647,8192,-1545,-18.85986328125
73,66,14,25626,16384,9242,56.40869140625
73,66,15,30198,32768,-2570,-7.843017578125
73,67,1,0,2,-2,-100.0
73,67,2,2,4,-2,-50.0
73,67,3,4,8,-4,-50.0
73,67,4,13,16,-3,-18.75
73,67,5,38,32,6,18.75
73,67,6,93,64,29,45.3125
73,67,7,58,128,-70,-54.6875
73,67,8,441,256,185,72.265625
73,67,9,452,512,-60,-11.71875
73,67,10,1013,1024,-11,-1.07421875
73,67,11,856,2048,-1192,-58.203125
73,67,12,4382,4096,286,6.982421875
73,67,13,902,8192,-7290,-88.9892578125
73,67,14,23627,16384,7243,44.207763671875
73,67,15,20358,32768,-12410,-37.872314453125
73,68,1,0,2,-2,-100.0
73,68,2,6,4,2,50.0
73,68,3,14,8,6,75.0
73,68,4,19,16,3,18.75
73,68,5,6,32,-26,-81.25
73,68,6,54,64,-10,-15.625
73,68,7,138,128,10,7.8125
73,68,8,135,256,-121,-47.265625
73,68,9,259,512,-253,-49.4140625
73,68,10,897,1024,-127,-12.40234375
73,68,11,4178,2048,2130,104.00390625
73,68,12,1990,4096,-2106,-51.416015625
73,68,13,3419,8192,-4773,-58.26416015625
73,68,14,2736,16384,-13648,-83.30078125
73,68,15,12505,32768,-20263,-61.8377685546875
73,69,1,0,2,-2,-100.0
73,69,2,1,4,-3,-75.0
73,69,3,6,8,-2,-25.0
73,69,4,25,16,9,56.25
73,69,5,50,32,18,56.25
73,69,6,6,64,-58,-90.625
73,69,7,75,128,-53,-41.40625
73,69,8,11,256,-245,-95.703125
73,69,9,326,512,-186,-36.328125
73,69,10,355,1024,-669,-65.33203125
73,69,11,206,2048,-1842,-89.94140625
73,69,12,14524,4096,10428,254.58984375
73,69,13,19115,8192,10923,133.33740234375
73,69,14,36964,16384,20580,125.6103515625
73,69,15,29790,32768,-2978,-9.088134765625
73,70,1,0,2,-2,-100.0
73,70,2,1,4,-3,-75.0
73,70,3,7,8,-1,-12.5
73,70,4,4,16,-12,-75.0
73,70,5,34,32,2,6.25
73,70,6,20,64,-44,-68.75
73,70,7,211,128,83,64.84375
73,70,8,22,256,-234,-91.40625
73,70,9,95,512,-417,-81.4453125
73,70,10,4953,1024,3929,383.69140625
73,70,11,825,2048,-1223,-59.716796875
73,70,12,1419,4096,-2677,-65.3564453125
73,70,13,1301,8192,-6891,-84.11865234375
73,70,14,1625,16384,-14759,-90.081787109375
73,70,15,48593,32768,15825,48.2940673828125
73,71,1,0,2,-2,-100.0
73,71,2,1,4,-3,-75.0
73,71,3,4,8,-4,-50.0
73,71,4,18,16,2,12.5
73,71,5,18,32,-14,-43.75
73,71,6,23,64,-41,-64.0625
73,71,7,6,128,-122,-95.3125
73,71,8,954,256,698,272.65625
73,71,9,1870,512,1358,265.234375
73,71,10,48,1024,-976,-95.3125
73,71,11,6730,2048,4682,228.61328125
73,71,12,6837,4096,2741,66.9189453125
73,71,13,13099,8192,4907,59.89990234375
73,71,14,10338,16384,-6046,-36.90185546875
73,71,15,21359,32768,-11409,-34.8175048828125
73,72,1,0,2,-2,-100.0
73,72,2,2,4,-2,-50.0
73,72,3,4,8,-4,-50.0
73,72,4,3,16,-13,-81.25
73,72,5,41,32,9,28.125
73,72,6,30,64,-34,-53.125
73,72,7,239,128,111,86.71875
73,72,8,231,256,-25,-9.765625
73,72,9,514,512,2,0.390625
73,72,10,3051,1024,2027,197.94921875
73,72,11,1039,2048,-1009,-49.267578125
73,72,12,4383,4096,287,7.0068359375
73,72,13,17177,8192,8985,109.68017578125
73,72,14,7486,16384,-8898,-54.30908203125
73,72,15,6129,32768,-26639,-81.2957763671875
73,73,1,0,2,-2,-100.0
73,73,2,1,4,-3,-75.0
73,73,3,3,8,-5,-62.5
73,73,4,24,16,8,50.0
73,73,5,45,32,13,40.625
73,73,6,53,64,-11,-17.1875
73,73,7,39,128,-89,-69.53125
73,73,8,488,256,232,90.625
73,73,9,786,512,274,53.515625
73,73,10,2147,1024,1123,109.66796875
73,73,11,2929,2048,881,43.017578125
73,73,12,306,4096,-3790,-92.529296875
73,73,13,6814,8192,-1378,-16.8212890625
73,73,14,12436,16384,-3948,-24.0966796875
73,73,15,22768,32768,-10000,-30.517578125
74,1,1,0,2,-2,-100.0
74,1,2,3,4,-1,-25.0
74,1,3,2,8,-6,-75.0
74,1,4,11,16,-5,-31.25
74,1,5,21,32,-11,-34.375
74,1,6,24,64,-40,-62.5
74,1,7,97,128,-31,-24.21875
74,1,8,130,256,-126,-49.21875
74,1,9,206,512,-306,-59.765625
74,1,10,201,1024,-823,-80.37109375
74,1,11,2032,2048,-16,-0.78125
74,1,12,73,4096,-4023,-98.2177734375
74,1,13,3976,8192,-4216,-51.46484375
74,1,14,1312,16384,-15072,-91.9921875
74,1,15,32366,32768,-402,-1.226806640625
74,2,1,0,2,-2,-100.0
74,2,2,2,4,-2,-50.0
74,2,3,2,8,-6,-75.0
74,2,4,20,16,4,25.0
74,2,5,4,32,-28,-87.5
74,2,6,98,64,34,53.125
74,2,7,316,128,188,146.875
74,2,8,1045,256,789,308.203125
74,2,9,29,512,-483,-94.3359375
74,2,10,581,1024,-443,-43.26171875
74,2,11,782,2048,-1266,-61.81640625
74,2,12,997,4096,-3099,-75.6591796875
74,2,13,3093,8192,-5099,-62.24365234375
74,2,14,9892,16384,-6492,-39.6240234375
74,2,15,31462,32768,-1306,-3.985595703125
74,3,1,0,2,-2,-100.0
74,3,2,1,4,-3,-75.0
74,3,3,14,8,6,75.0
74,3,4,26,16,10,62.5
74,3,5,14,32,-18,-56.25
74,3,6,100,64,36,56.25
74,3,7,279,128,151,117.96875
74,3,8,672,256,416,162.5
74,3,9,69,512,-443,-86.5234375
74,3,10,1201,1024,177,17.28515625
74,3,11,697,2048,-1351,-65.966796875
74,3,12,13996,4096,9900,241.69921875
74,3,13,21022,8192,12830,156.6162109375
74,3,14,898,16384,-15486,-94.51904296875
74,3,15,35608,32768,2840,8.6669921875
74,4,1,0,2,-2,-100.0
74,4,2,2,4,-2,-50.0
74,4,3,6,8,-2,-25.0
74,4,4,8,16,-8,-50.0
74,4,5,42,32,10,31.25
74,4,6,45,64,-19,-29.6875
74,4,7,98,128,-30,-23.4375
74,4,8,685,256,429,167.578125
74,4,9,664,512,152,29.6875
74,4,10,334,1024,-690,-67.3828125
74,4,11,6015,2048,3967,193.701171875
74,4,12,1585,4096,-2511,-61.3037109375
74,4,13,2958,8192,-5234,-63.8916015625
74,4,14,28532,16384,12148,74.1455078125
74,4,15,20892,32768,-11876,-36.24267578125
74,5,1,0,2,-2,-100.0
74,5,2,1,4,-3,-75.0
74,5,3,3,8,-5,-62.5
74,5,4,16,16,0,0.0
74,5,5,12,32,-20,-62.5
74,5,6,45,64,-19,-29.6875
74,5,7,462,128,334,260.9375
74,5,8,322,256,66,25.78125
74,5,9,229,512,-283,-55.2734375
74,5,10,61,1024,-963,-94.04296875
74,5,11,938,2048,-1110,-54.19921875
74,5,12,935,4096,-3161,-77.1728515625
74,5,13,15194,8192,7002,85.4736328125
74,5,14,3687,16384,-12697,-77.496337890625
74,5,15,3695,32768,-29073,-88.7237548828125
74,6,1,0,2,-2,-100.0
74,6,2,1,4,-3,-75.0
74,6,3,2,8,-6,-75.0
74,6,4,15,16,-1,-6.25
74,6,5,23,32,-9,-28.125
74,6,6,23,64,-41,-64.0625
74,6,7,85,128,-43,-33.59375
74,6,8,75,256,-181,-70.703125
74,6,9,191,512,-321,-62.6953125
74,6,10,650,1024,-374,-36.5234375
74,6,11,863,2048,-1185,-57.861328125
74,6,12,1040,4096,-3056,-74.609375
74,6,13,5726,8192,-2466,-30.1025390625
74,6,14,9296,16384,-7088,-43.26171875
74,6,15,66440,32768,33672,102.7587890625
74,7,1,0,2,-2,-100.0
74,7,2,3,4,-1,-25.0
74,7,3,2,8,-6,-75.0
74,7,4,16,16,0,0.0
74,7,5,17,32,-15,-46.875
74,7,6,9,64,-55,-85.9375
74,7,7,183,128,55,42.96875
74,7,8,973,256,717,280.078125
74,7,9,2111,512,1599,312.3046875
74,7,10,3600,1024,2576,251.5625
74,7,11,1028,2048,-1020,-49.8046875
74,7,12,8592,4096,4496,109.765625
74,7,13,212,8192,-7980,-97.412109375
74,7,14,31830,16384,15446,94.27490234375
74,7,15,101633,32768,68865,210.1593017578125
74,8,1,0,2,-2,-100.0
74,8,2,2,4,-2,-50.0
74,8,3,7,8,-1,-12.5
74,8,4,22,16,6,37.5
74,8,5,20,32,-12,-37.5
74,8,6,12,64,-52,-81.25
74,8,7,328,128,200,156.25
74,8,8,320,256,64,25.0
74,8,9,1327,512,815,159.1796875
74,8,10,763,1024,-261,-25.48828125
74,8,11,537,2048,-1511,-73.779296875
74,8,12,3089,4096,-1007,-24.5849609375
74,8,13,4644,8192,-3548,-43.310546875
74,8,14,17510,16384,1126,6.87255859375
74,8,15,24472,32768,-8296,-25.3173828125
74,9,1,0,2,-2,-100.0
74,9,2,4,4,0,0.0
74,9,3,2,8,-6,-75.0
74,9,4,22,16,6,37.5
74,9,5,85,32,53,165.625
74,9,6,43,64,-21,-32.8125
74,9,7,62,128,-66,-51.5625
74,9,8,99,256,-157,-61.328125
74,9,9,522,512,10,1.953125
74,9,10,808,1024,-216,-21.09375
74,9,11,7214,2048,5166,252.24609375
74,9,12,11,4096,-4085,-99.7314453125
74,9,13,12486,8192,4294,52.4169921875
74,9,14,27440,16384,11056,67.48046875
74,9,15,119275,32768,86507,263.9984130859375
74,10,1,0,2,-2,-100.0
74,10,2,5,4,1,25.0
74,10,3,5,8,-3,-37.5
74,10,4,25,16,9,56.25
74,10,5,4,32,-28,-87.5
74,10,6,40,64,-24,-37.5
74,10,7,135,128,7,5.46875
74,10,8,457,256,201,78.515625
74,10,9,899,512,387,75.5859375
74,10,10,533,1024,-491,-47.94921875
74,10,11,520,2048,-1528,-74.609375
74,10,12,2923,4096,-1173,-28.6376953125
74,10,13,6535,8192,-1657,-20.22705078125
74,10,14,41134,16384,24750,151.06201171875
74,10,15,60421,32768,27653,84.3902587890625
74,11,1,0,2,-2,-100.0
74,11,2,2,4,-2,-50.0
74,11,3,2,8,-6,-75.0
74,11,4,10,16,-6,-37.5
74,11,5,12,32,-20,-62.5
74,11,6,98,64,34,53.125
74,11,7,79,128,-49,-38.28125
74,11,8,633,256,377,147.265625
74,11,9,443,512,-69,-13.4765625
74,11,10,259,1024,-765,-74.70703125
74,11,11,97,2048,-1951,-95.263671875
74,11,12,4978,4096,882,21.533203125
74,11,13,8517,8192,325,3.96728515625
74,11,14,6824,16384,-9560,-58.349609375
74,11,15,4186,32768,-28582,-87.225341796875
74,12,1,0,2,-2,-100.0
74,12,2,4,4,0,0.0
74,12,3,2,8,-6,-75.0
74,12,4,3,16,-13,-81.25
74,12,5,33,32,1,3.125
74,12,6,48,64,-16,-25.0
74,12,7,68,128,-60,-46.875
74,12,8,232,256,-24,-9.375
74,12,9,86,512,-426,-83.203125
74,12,10,618,1024,-406,-39.6484375
74,12,11,1354,2048,-694,-33.88671875
74,12,12,2595,4096,-1501,-36.6455078125
74,12,13,2745,8192,-5447,-66.49169921875
74,12,14,9852,16384,-6532,-39.8681640625
74,12,15,18021,32768,-14747,-45.0042724609375
74,13,1,0,2,-2,-100.0
74,13,2,1,4,-3,-75.0
74,13,3,4,8,-4,-50.0
74,13,4,8,16,-8,-50.0
74,13,5,4,32,-28,-87.5
74,13,6,10,64,-54,-84.375
74,13,7,112,128,-16,-12.5
74,13,8,8,256,-248,-96.875
74,13,9,47,512,-465,-90.8203125
74,13,10,1804,1024,780,76.171875
74,13,11,525,2048,-1523,-74.365234375
74,13,12,22302,4096,18206,444.482421875
74,13,13,9443,8192,1251,15.27099609375
74,13,14,3568,16384,-12816,-78.22265625
74,13,15,9600,32768,-23168,-70.703125
74,14,1,0,2,-2,-100.0
74,14,2,2,4,-2,-50.0
74,14,3,2,8,-6,-75.0
74,14,4,19,16,3,18.75
74,14,5,60,32,28,87.5
74,14,6,29,64,-35,-54.6875
74,14,7,74,128,-54,-42.1875
74,14,8,902,256,646,252.34375
74,14,9,1323,512,811,158.3984375
74,14,10,716,1024,-308,-30.078125
74,14,11,115,2048,-1933,-94.384765625
74,14,12,209,4096,-3887,-94.8974609375
74,14,13,18639,8192,10447,127.52685546875
74,14,14,12256,16384,-4128,-25.1953125
74,14,15,17342,32768,-15426,-47.076416015625
74,15,1,0,2,-2,-100.0
74,15,2,2,4,-2,-50.0
74,15,3,9,8,1,12.5
74,15,4,23,16,7,43.75
74,15,5,46,32,14,43.75
74,15,6,69,64,5,7.8125
74,15,7,244,128,116,90.625
74,15,8,116,256,-140,-54.6875
74,15,9,1589,512,1077,210.3515625
74,15,10,511,1024,-513,-50.09765625
74,15,11,1281,2048,-767,-37.451171875
74,15,12,297,4096,-3799,-92.7490234375
74,15,13,7869,8192,-323,-3.94287109375
74,15,14,16031,16384,-353,-2.154541015625
74,15,15,24431,32768,-8337,-25.4425048828125
74,16,1,0,2,-2,-100.0
74,16,2,4,4,0,0.0
74,16,3,6,8,-2,-25.0
74,16,4,6,16,-10,-62.5
74,16,5,44,32,12,37.5
74,16,6,53,64,-11,-17.1875
74,16,7,18,128,-110,-85.9375
74,16,8,528,256,272,106.25
74,16,9,2020,512,1508,294.53125
74,16,10,887,1024,-137,-13.37890625
74,16,11,2383,2048,335,16.357421875
74,16,12,1443,4096,-2653,-64.7705078125
74,16,13,5957,8192,-2235,-27.28271484375
74,16,14,11338,16384,-5046,-30.79833984375
74,16,15,26106,32768,-6662,-20.330810546875
74,17,1,0,2,-2,-100.0
74,17,2,1,4,-3,-75.0
74,17,3,10,8,2,25.0
74,17,4,11,16,-5,-31.25
74,17,5,29,32,-3,-9.375
74,17,6,213,64,149,232.8125
74,17,7,36,128,-92,-71.875
74,17,8,63,256,-193,-75.390625
74,17,9,453,512,-59,-11.5234375
74,17,10,77,1024,-947,-92.48046875
74,17,11,9575,2048,7527,367.529296875
74,17,12,10531,4096,6435,157.1044921875
74,17,13,8589,8192,397,4.84619140625
74,17,14,8500,16384,-7884,-48.1201171875
74,17,15,37806,32768,5038,15.374755859375
74,18,1,0,2,-2,-100.0
74,18,2,1,4,-3,-75.0
74,18,3,2,8,-6,-75.0
74,18,4,21,16,5,31.25
74,18,5,82,32,50,156.25
74,18,6,261,64,197,307.8125
74,18,7,30,128,-98,-76.5625
74,18,8,38,256,-218,-85.15625
74,18,9,1922,512,1410,275.390625
74,18,10,3467,1024,2443,238.57421875
74,18,11,614,2048,-1434,-70.01953125
74,18,12,2936,4096,-1160,-28.3203125
74,18,13,11875,8192,3683,44.95849609375
74,18,14,61492,16384,45108,275.3173828125
74,18,15,24243,32768,-8525,-26.0162353515625
74,19,1,0,2,-2,-100.0
74,19,2,3,4,-1,-25.0
74,19,3,5,8,-3,-37.5
74,19,4,8,16,-8,-50.0
74,19,5,4,32,-28,-87.5
74,19,6,16,64,-48,-75.0
74,19,7,78,128,-50,-39.0625
74,19,8,369,256,113,44.140625
74,19,9,368,512,-144,-28.125
74,19,10,1396,1024,372,36.328125
74,19,11,668,2048,-1380,-67.3828125
74,19,12,2523,4096,-1573,-38.4033203125
74,19,13,9968,8192,1776,21.6796875
74,19,14,472,16384,-15912,-97.119140625
74,19,15,62870,32768,30102,91.864013671875
74,20,1,0,2,-2,-100.0
74,20,2,1,4,-3,-75.0
74,20,3,8,8,0,0.0
74,20,4,3,16,-13,-81.25
74,20,5,7,32,-25,-78.125
74,20,6,34,64,-30,-46.875
74,20,7,105,128,-23,-17.96875
74,20,8,18,256,-238,-92.96875
74,20,9,512,512,0,0.0
74,20,10,3854,1024,2830,276.3671875
74,20,11,3367,2048,1319,64.404296875
74,20,12,5589,4096,1493,36.4501953125
74,20,13,3103,8192,-5089,-62.12158203125
74,20,14,19967,16384,3583,21.868896484375
74,20,15,35552,32768,2784,8.49609375
74,21,1,0,2,-2,-100.0
74,21,2,2,4,-2,-50.0
74,21,3,8,8,0,0.0
74,21,4,8,16,-8,-50.0
74,21,5,7,32,-25,-78.125
74,21,6,13,64,-51,-79.6875
74,21,7,11,128,-117,-91.40625
74,21,8,394,256,138,53.90625
74,21,9,519,512,7,1.3671875
74,21,10,453,1024,-571,-55.76171875
74,21,11,2450,2048,402,19.62890625
74,21,12,5780,4096,1684,41.11328125
74,21,13,7979,8192,-213,-2.60009765625
74,21,14,23267,16384,6883,42.010498046875
74,21,15,552,32768,-32216,-98.3154296875
74,22,1,0,2,-2,-100.0
74,22,2,1,4,-3,-75.0
74,22,3,14,8,6,75.0
74,22,4,41,16,25,156.25
74,22,5,42,32,10,31.25
74,22,6,93,64,29,45.3125
74,22,7,115,128,-13,-10.15625
74,22,8,61,256,-195,-76.171875
74,22,9,20,512,-492,-96.09375
74,22,10,722,1024,-302,-29.4921875
74,22,11,3426,2048,1378,67.28515625
74,22,12,9330,4096,5234,127.783203125
74,22,13,1449,8192,-6743,-82.31201171875
74,22,14,3080,16384,-13304,-81.201171875
74,22,15,31349,32768,-1419,-4.3304443359375
74,23,1,0,2,-2,-100.0
74,23,2,1,4,-3,-75.0
74,23,3,8,8,0,0.0
74,23,4,33,16,17,106.25
74,23,5,32,32,0,0.0
74,23,6,111,64,47,73.4375
74,23,7,45,128,-83,-64.84375
74,23,8,39,256,-217,-84.765625
74,23,9,105,512,-407,-79.4921875
74,23,10,637,1024,-387,-37.79296875
74,23,11,1638,2048,-410,-20.01953125
74,23,12,744,4096,-3352,-81.8359375
74,23,13,10689,8192,2497,30.48095703125
74,23,14,7484,16384,-8900,-54.3212890625
74,23,15,52918,32768,20150,61.492919921875
74,24,1,0,2,-2,-100.0
74,24,2,1,4,-3,-75.0
74,24,3,8,8,0,0.0
74,24,4,3,16,-13,-81.25
74,24,5,47,32,15,46.875
74,24,6,13,64,-51,-79.6875
74,24,7,357,128,229,178.90625
74,24,8,217,256,-39,-15.234375
74,24,9,453,512,-59,-11.5234375
74,24,10,666,1024,-358,-34.9609375
74,24,11,782,2048,-1266,-61.81640625
74,24,12,3892,4096,-204,-4.98046875
74,24,13,2614,8192,-5578,-68.0908203125
74,24,14,5098,16384,-11286,-68.88427734375
74,24,15,18185,32768,-14583,-44.5037841796875
74,25,1,0,2,-2,-100.0
74,25,2,1,4,-3,-75.0
74,25,3,3,8,-5,-62.5
74,25,4,14,16,-2,-12.5
74,25,5,90,32,58,181.25
74,25,6,62,64,-2,-3.125
74,25,7,23,128,-105,-82.03125
74,25,8,82,256,-174,-67.96875
74,25,9,555,512,43,8.3984375
74,25,10,428,1024,-596,-58.203125
74,25,11,704,2048,-1344,-65.625
74,25,12,17827,4096,13731,335.2294921875
74,25,13,4149,8192,-4043,-49.35302734375
74,25,14,22184,16384,5800,35.400390625
74,25,15,28728,32768,-4040,-12.3291015625
74,26,1,0,2,-2,-100.0
74,26,2,1,4,-3,-75.0
74,26,3,5,8,-3,-37.5
74,26,4,19,16,3,18.75
74,26,5,9,32,-23,-71.875
74,26,6,20,64,-44,-68.75
74,26,7,63,128,-65,-50.78125
74,26,8,296,256,40,15.625
74,26,9,126,512,-386,-75.390625
74,26,10,124,1024,-900,-87.890625
74,26,11,3338,2048,1290,62.98828125
74,26,12,6607,4096,2511,61.3037109375
74,26,13,5363,8192,-2829,-34.53369140625
74,26,14,1591,16384,-14793,-90.289306640625
74,26,15,31148,32768,-1620,-4.94384765625
74,27,1,0,2,-2,-100.0
74,27,2,1,4,-3,-75.0
74,27,3,5,8,-3,-37.5
74,27,4,9,16,-7,-43.75
74,27,5,12,32,-20,-62.5
74,27,6,5,64,-59,-92.1875
74,27,7,104,128,-24,-18.75
74,27,8,392,256,136,53.125
74,27,9,144,512,-368,-71.875
74,27,10,1188,1024,164,16.015625
74,27,11,2957,2048,909,44.384765625
74,27,12,6473,4096,2377,58.0322265625
74,27,13,6745,8192,-1447,-17.66357421875
74,27,14,81415,16384,65031,396.917724609375
74,27,15,72378,32768,39610,120.880126953125
74,28,1,0,2,-2,-100.0
74,28,2,2,4,-2,-50.0
74,28,3,3,8,-5,-62.5
74,28,4,5,16,-11,-68.75
74,28,5,15,32,-17,-53.125
74,28,6,207,64,143,223.4375
74,28,7,136,128,8,6.25
74,28,8,98,256,-158,-61.71875
74,28,9,93,512,-419,-81.8359375
74,28,10,352,1024,-672,-65.625
74,28,11,2797,2048,749,36.572265625
74,28,12,2545,4096,-1551,-37.8662109375
74,28,13,2440,8192,-5752,-70.21484375
74,28,14,5598,16384,-10786,-65.83251953125
74,28,15,120493,32768,87725,267.7154541015625
74,29,1,0,2,-2,-100.0
74,29,2,5,4,1,25.0
74,29,3,4,8,-4,-50.0
74,29,4,25,16,9,56.25
74,29,5,18,32,-14,-43.75
74,29,6,65,64,1,1.5625
74,29,7,232,128,104,81.25
74,29,8,87,256,-169,-66.015625
74,29,9,262,512,-250,-48.828125
74,29,10,514,1024,-510,-49.8046875
74,29,11,176,2048,-1872,-91.40625
74,29,12,591,4096,-3505,-85.5712890625
74,29,13,162,8192,-8030,-98.0224609375
74,29,14,15059,16384,-1325,-8.087158203125
74,29,15,31143,32768,-1625,-4.9591064453125
74,30,1,0,2,-2,-100.0
74,30,2,4,4,0,0.0
74,30,3,3,8,-5,-62.5
74,30,4,50,16,34,212.5
74,30,5,47,32,15,46.875
74,30,6,46,64,-18,-28.125
74,30,7,340,128,212,165.625
74,30,8,128,256,-128,-50.0
74,30,9,179,512,-333,-65.0390625
74,30,10,1764,1024,740,72.265625
74,30,11,1050,2048,-998,-48.73046875
74,30,12,1126,4096,-2970,-72.509765625
74,30,13,2910,8192,-5282,-64.4775390625
74,30,14,10711,16384,-5673,-34.625244140625
74,30,15,11415,32768,-21353,-65.1641845703125
74,31,1,0,2,-2,-100.0
74,31,2,1,4,-3,-75.0
74,31,3,2,8,-6,-75.0
74,31,4,4,16,-12,-75.0
74,31,5,24,32,-8,-25.0
74,31,6,22,64,-42,-65.625
74,31,7,198,128,70,54.6875
74,31,8,364,256,108,42.1875
74,31,9,383,512,-129,-25.1953125
74,31,10,1857,1024,833,81.34765625
74,31,11,2105,2048,57,2.783203125
74,31,12,3553,4096,-543,-13.2568359375
74,31,13,4983,8192,-3209,-39.17236328125
74,31,14,18467,16384,2083,12.713623046875
74,31,15,99643,32768,66875,204.0863037109375
74,32,1,0,2,-2,-100.0
74,32,2,1,4,-3,-75.0
74,32,3,3,8,-5,-62.5
74,32,4,14,16,-2,-12.5
74,32,5,61,32,29,90.625
74,32,6,19,64,-45,-70.3125
74,32,7,251,128,123,96.09375
74,32,8,41,256,-215,-83.984375
74,32,9,10,512,-502,-98.046875
74,32,10,650,1024,-374,-36.5234375
74,32,11,604,2048,-1444,-70.5078125
74,32,12,1877,4096,-2219,-54.1748046875
74,32,13,518,8192,-7674,-93.6767578125
74,32,14,1188,16384,-15196,-92.7490234375
74,32,15,454,32768,-32314,-98.614501953125
74,33,1,0,2,-2,-100.0
74,33,2,1,4,-3,-75.0
74,33,3,4,8,-4,-50.0
74,33,4,26,16,10,62.5
74,33,5,12,32,-20,-62.5
74,33,6,14,64,-50,-78.125
74,33,7,60,128,-68,-53.125
74,33,8,70,256,-186,-72.65625
74,33,9,297,512,-215,-41.9921875
74,33,10,241,1024,-783,-76.46484375
74,33,11,2457,2048,409,19.970703125
74,33,12,1574,4096,-2522,-61.572265625
74,33,13,7198,8192,-994,-12.1337890625
74,33,14,7391,16384,-8993,-54.888916015625
74,33,15,46434,32768,13666,41.705322265625
74,34,1,0,2,-2,-100.0
74,34,2,1,4,-3,-75.0
74,34,3,4,8,-4,-50.0
74,34,4,7,16,-9,-56.25
74,34,5,28,32,-4,-12.5
74,34,6,27,64,-37,-57.8125
74,34,7,26,128,-102,-79.6875
74,34,8,127,256,-129,-50.390625
74,34,9,40,512,-472,-92.1875
74,34,10,4725,1024,3701,361.42578125
74,34,11,265,2048,-1783,-87.060546875
74,34,12,2884,4096,-1212,-29.58984375
74,34,13,732,8192,-7460,-91.064453125
74,34,14,22047,16384,5663,34.564208984375
74,34,15,30653,32768,-2115,-6.4544677734375
74,35,1,0,2,-2,-100.0
74,35,2,3,4,-1,-25.0
74,35,3,8,8,0,0.0
74,35,4,3,16,-13,-81.25
74,35,5,29,32,-3,-9.375
74,35,6,75,64,11,17.1875
74,35,7,34,128,-94,-73.4375
74,35,8,23,256,-233,-91.015625
74,35,9,150,512,-362,-70.703125
74,35,10,204,1024,-820,-80.078125
74,35,11,4915,2048,2867,139.990234375
74,35,12,16179,4096,12083,294.9951171875
74,35,13,4329,8192,-3863,-47.15576171875
74,35,14,9214,16384,-7170,-43.76220703125
74,35,15,37375,32768,4607,14.0594482421875
74,36,1,0,2,-2,-100.0
74,36,2,2,4,-2,-50.0
74,36,3,7,8,-1,-12.5
74,36,4,15,16,-1,-6.25
74,36,5,8,32,-24,-75.0
74,36,6,45,64,-19,-29.6875
74,36,7,98,128,-30,-23.4375
74,36,8,27,256,-229,-89.453125
74,36,9,165,512,-347,-67.7734375
74,36,10,1339,1024,315,30.76171875
74,36,11,1585,2048,-463,-22.607421875
74,36,12,5591,4096,1495,36.4990234375
74,36,13,383,8192,-7809,-95.32470703125
74,36,14,15359,16384,-1025,-6.256103515625
74,36,15,42916,32768,10148,30.96923828125
74,37,1,0,2,-2,-100.0
74,37,2,1,4,-3,-75.0
74,37,3,3,8,-5,-62.5
74,37,4,5,16,-11,-68.75
74,37,5,63,32,31,96.875
74,37,6,6,64,-58,-90.625
74,37,7,219,128,91,71.09375
74,37,8,192,256,-64,-25.0
74,37,9,194,512,-318,-62.109375
74,37,10,594,1024,-430,-41.9921875
74,37,11,556,2048,-1492,-72.8515625
74,37,12,209,4096,-3887,-94.8974609375
74,37,13,7229,8192,-963,-11.75537109375
74,37,14,5061,16384,-11323,-69.110107421875
74,37,15,55832,32768,23064,70.3857421875
74,38,1,0,2,-2,-100.0
74,38,2,6,4,2,50.0
74,38,3,2,8,-6,-75.0
74,38,4,18,16,2,12.5
74,38,5,14,32,-18,-56.25
74,38,6,142,64,78,121.875
74,38,7,165,128,37,28.90625
74,38,8,265,256,9,3.515625
74,38,9,1292,512,780,152.34375
74,38,10,1328,1024,304,29.6875
74,38,11,458,2048,-1590,-77.63671875
74,38,12,3609,4096,-487,-11.8896484375
74,38,13,17138,8192,8946,109.2041015625
74,38,14,55890,16384,39506,241.12548828125
74,38,15,65212,32768,32444,99.01123046875
74,39,1,0,2,-2,-100.0
74,39,2,1,4,-3,-75.0
74,39,3,6,8,-2,-25.0
74,39,4,16,16,0,0.0
74,39,5,18,32,-14,-43.75
74,39,6,28,64,-36,-56.25
74,39,7,30,128,-98,-76.5625
74,39,8,225,256,-31,-12.109375
74,39,9,326,512,-186,-36.328125
74,39,10,938,1024,-86,-8.3984375
74,39,11,848,2048,-1200,-58.59375
74,39,12,816,4096,-3280,-80.078125
74,39,13,5680,8192,-2512,-30.6640625
74,39,14,30180,16384,13796,84.2041015625
74,39,15,96060,32768,63292,193.15185546875
74,40,1,0,2,-2,-100.0
74,40,2,7,4,3,75.0
74,40,3,2,8,-6,-75.0
74,40,4,20,16,4,25.0
74,40,5,8,32,-24,-75.0
74,40,6,64,64,0,0.0
74,40,7,23,128,-105,-82.03125
74,40,8,643,256,387,151.171875
74,40,9,483,512,-29,-5.6640625
74,40,10,3845,1024,2821,275.48828125
74,40,11,3578,2048,1530,74.70703125
74,40,12,3077,4096,-1019,-24.8779296875
74,40,13,13647,8192,5455,66.58935546875
74,40,14,6307,16384,-10077,-61.505126953125
74,40,15,4735,32768,-28033,-85.5499267578125
74,41,1,0,2,-2,-100.0
74,41,2,4,4,0,0.0
74,41,3,2,8,-6,-75.0
74,41,4,6,16,-10,-62.5
74,41,5,27,32,-5,-15.625
74,41,6,32,64,-32,-50.0
74,41,7,130,128,2,1.5625
74,41,8,202,256,-54,-21.09375
74,41,9,591,512,79,15.4296875
74,41,10,361,1024,-663,-64.74609375
74,41,11,1434,2048,-614,-29.98046875
74,41,12,1005,4096,-3091,-75.4638671875
74,41,13,6029,8192,-2163,-26.40380859375
74,41,14,15564,16384,-820,-5.0048828125
74,41,15,15116,32768,-17652,-53.86962890625
74,42,1,0,2,-2,-100.0
74,42,2,1,4,-3,-75.0
74,42,3,7,8,-1,-12.5
74,42,4,4,16,-12,-75.0
74,42,5,7,32,-25,-78.125
74,42,6,29,64,-35,-54.6875
74,42,7,193,128,65,50.78125
74,42,8,9,256,-247,-96.484375
74,42,9,297,512,-215,-41.9921875
74,42,10,372,1024,-652,-63.671875
74,42,11,3044,2048,996,48.6328125
74,42,12,1839,4096,-2257,-55.1025390625
74,42,13,15582,8192,7390,90.2099609375
74,42,14,12629,16384,-3755,-22.918701171875
74,42,15,9581,32768,-23187,-70.7611083984375
74,43,1,0,2,-2,-100.0
74,43,2,1,4,-3,-75.0
74,43,3,5,8,-3,-37.5
74,43,4,6,16,-10,-62.5
74,43,5,5,32,-27,-84.375
74,43,6,10,64,-54,-84.375
74,43,7,124,128,-4,-3.125
74,43,8,25,256,-231,-90.234375
74,43,9,389,512,-123,-24.0234375
74,43,10,238,1024,-786,-76.7578125
74,43,11,1563,2048,-485,-23.681640625
74,43,12,11966,4096,7870,192.138671875
74,43,13,1002,8192,-7190,-87.7685546875
74,43,14,816,16384,-15568,-95.01953125
74,43,15,46554,32768,13786,42.071533203125
74,44,1,0,2,-2,-100.0
74,44,2,2,4,-2,-50.0
74,44,3,3,8,-5,-62.5
74,44,4,6,16,-10,-62.5
74,44,5,17,32,-15,-46.875
74,44,6,38,64,-26,-40.625
74,44,7,19,128,-109,-85.15625
74,44,8,550,256,294,114.84375
74,44,9,133,512,-379,-74.0234375
74,44,10,2771,1024,1747,170.60546875
74,44,11,3143,2048,1095,53.466796875
74,44,12,1707,4096,-2389,-58.3251953125
74,44,13,212,8192,-7980,-97.412109375
74,44,14,2172,16384,-14212,-86.7431640625
74,44,15,5068,32768,-27700,-84.53369140625
74,45,1,0,2,-2,-100.0
74,45,2,1,4,-3,-75.0
74,45,3,3,8,-5,-62.5
74,45,4,27,16,11,68.75
74,45,5,12,32,-20,-62.5
74,45,6,271,64,207,323.4375
74,45,7,348,128,220,171.875
74,45,8,22,256,-234,-91.40625
74,45,9,194,512,-318,-62.109375
74,45,10,577,1024,-447,-43.65234375
74,45,11,5790,2048,3742,182.71484375
74,45,12,3989,4096,-107,-2.6123046875
74,45,13,5068,8192,-3124,-38.134765625
74,45,14,27750,16384,11366,69.37255859375
74,45,15,22495,32768,-10273,-31.3507080078125
74,46,1,0,2,-2,-100.0
74,46,2,4,4,0,0.0
74,46,3,6,8,-2,-25.0
74,46,4,13,16,-3,-18.75
74,46,5,22,32,-10,-31.25
74,46,6,7,64,-57,-89.0625
74,46,7,240,128,112,87.5
74,46,8,81,256,-175,-68.359375
74,46,9,376,512,-136,-26.5625
74,46,10,1033,1024,9,0.87890625
74,46,11,428,2048,-1620,-79.1015625
74,46,12,903,4096,-3193,-77.9541015625
74,46,13,9461,8192,1269,15.49072265625
74,46,14,5346,16384,-11038,-67.37060546875
74,46,15,109108,32768,76340,232.97119140625
74,47,1,0,2,-2,-100.0
74,47,2,3,4,-1,-25.0
74,47,3,11,8,3,37.5
74,47,4,3,16,-13,-81.25
74,47,5,12,32,-20,-62.5
74,47,6,28,64,-36,-56.25
74,47,7,67,128,-61,-47.65625
74,47,8,720,256,464,181.25
74,47,9,1059,512,547,106.8359375
74,47,10,1125,1024,101,9.86328125
74,47,11,1035,2048,-1013,-49.462890625
74,47,12,2597,4096,-1499,-36.5966796875
74,47,13,967,8192,-7225,-88.19580078125
74,47,14,45145,16384,28761,175.543212890625
74,47,15,20486,32768,-12282,-37.481689453125
74,48,1,0,2,-2,-100.0
74,48,2,1,4,-3,-75.0
74,48,3,10,8,2,25.0
74,48,4,36,16,20,125.0
74,48,5,26,32,-6,-18.75
74,48,6,53,64,-11,-17.1875
74,48,7,45,128,-83,-64.84375
74,48,8,377,256,121,47.265625
74,48,9,79,512,-433,-84.5703125
74,48,10,1001,1024,-23,-2.24609375
74,48,11,4716,2048,2668,130.2734375
74,48,12,1777,4096,-2319,-56.6162109375
74,48,13,1619,8192,-6573,-80.23681640625
74,48,14,2515,16384,-13869,-84.649658203125
74,48,15,71282,32768,38514,117.535400390625
74,49,1,0,2,-2,-100.0
74,49,2,2,4,-2,-50.0
74,49,3,10,8,2,25.0
74,49,4,11,16,-5,-31.25
74,49,5,18,32,-14,-43.75
74,49,6,21,64,-43,-67.1875
74,49,7,44,128,-84,-65.625
74,49,8,189,256,-67,-26.171875
74,49,9,137,512,-375,-73.2421875
74,49,10,1104,1024,80,7.8125
74,49,11,1805,2048,-243,-11.865234375
74,49,12,4416,4096,320,7.8125
74,49,13,5836,8192,-2356,-28.759765625
74,49,14,9720,16384,-6664,-40.673828125
74,49,15,15206,32768,-17562,-53.594970703125
74,50,1,0,2,-2,-100.0
74,50,2,1,4,-3,-75.0
74,50,3,12,8,4,50.0
74,50,4,9,16,-7,-43.75
74,50,5,70,32,38,118.75
74,50,6,6,64,-58,-90.625
74,50,7,39,128,-89,-69.53125
74,50,8,131,256,-125,-48.828125
74,50,9,265,512,-247,-48.2421875
74,50,10,67,1024,-957,-93.45703125
74,50,11,2150,2048,102,4.98046875
74,50,12,3487,4096,-609,-14.8681640625
74,50,13,3876,8192,-4316,-52.685546875
74,50,14,26555,16384,10171,62.078857421875
74,50,15,30304,32768,-2464,-7.51953125
74,51,1,0,2,-2,-100.0
74,51,2,3,4,-1,-25.0
74,51,3,6,8,-2,-25.0
74,51,4,6,16,-10,-62.5
74,51,5,4,32,-28,-87.5
74,51,6,20,64,-44,-68.75
74,51,7,10,128,-118,-92.1875
74,51,8,255,256,-1,-0.390625
74,51,9,181,512,-331,-64.6484375
74,51,10,1849,1024,825,80.56640625
74,51,11,503,2048,-1545,-75.439453125
74,51,12,5912,4096,1816,44.3359375
74,51,13,9120,8192,928,11.328125
74,51,14,3779,16384,-12605,-76.934814453125
74,51,15,28951,32768,-3817,-11.6485595703125
74,52,1,0,2,-2,-100.0
74,52,2,5,4,1,25.0
74,52,3,7,8,-1,-12.5
74,52,4,20,16,4,25.0
74,52,5,39,32,7,21.875
74,52,6,17,64,-47,-73.4375
74,52,7,525,128,397,310.15625
74,52,8,224,256,-32,-12.5
74,52,9,71,512,-441,-86.1328125
74,52,10,4316,1024,3292,321.484375
74,52,11,5765,2048,3717,181.494140625
74,52,12,9161,4096,5065,123.6572265625
74,52,13,3168,8192,-5024,-61.328125
74,52,14,364,16384,-16020,-97.7783203125
74,52,15,60666,32768,27898,85.137939453125
74,53,1,0,2,-2,-100.0
74,53,2,1,4,-3,-75.0
74,53,3,5,8,-3,-37.5
74,53,4,36,16,20,125.0
74,53,5,43,32,11,34.375
74,53,6,32,64,-32,-50.0
74,53,7,309,128,181,141.40625
74,53,8,247,256,-9,-3.515625
74,53,9,142,512,-370,-72.265625
74,53,10,2208,1024,1184,115.625
74,53,11,2357,2048,309,15.087890625
74,53,12,360,4096,-3736,-91.2109375
74,53,13,7007,8192,-1185,-14.46533203125
74,53,14,5320,16384,-11064,-67.529296875
74,53,15,14231,32768,-18537,-56.5704345703125
74,54,1,0,2,-2,-100.0
74,54,2,1,4,-3,-75.0
74,54,3,4,8,-4,-50.0
74,54,4,8,16,-8,-50.0
74,54,5,7,32,-25,-78.125
74,54,6,15,64,-49,-76.5625
74,54,7,60,128,-68,-53.125
74,54,8,190,256,-66,-25.78125
74,54,9,417,512,-95,-18.5546875
74,54,10,641,1024,-383,-37.40234375
74,54,11,5113,2048,3065,149.658203125
74,54,12,1905,4096,-2191,-53.4912109375
74,54,13,11843,8192,3651,44.56787109375
74,54,14,12974,16384,-3410,-20.81298828125
74,54,15,4698,32768,-28070,-85.662841796875
74,55,1,0,2,-2,-100.0
74,55,2,2,4,-2,-50.0
74,55,3,6,8,-2,-25.0
74,55,4,21,16,5,31.25
74,55,5,18,32,-14,-43.75
74,55,6,66,64,2,3.125
74,55,7,60,128,-68,-53.125
74,55,8,188,256,-68,-26.5625
74,55,9,875,512,363,70.8984375
74,55,10,1199,1024,175,17.08984375
74,55,11,4030,2048,1982,96.77734375
74,55,12,149,4096,-3947,-96.3623046875
74,55,13,340,8192,-7852,-95.849609375
74,55,14,22315,16384,5931,36.199951171875
74,55,15,9790,32768,-22978,-70.123291015625
74,56,1,0,2,-2,-100.0
74,56,2,1,4,-3,-75.0
74,56,3,8,8,0,0.0
74,56,4,6,16,-10,-62.5
74,56,5,5,32,-27,-84.375
74,56,6,63,64,-1,-1.5625
74,56,7,66,128,-62,-48.4375
74,56,8,418,256,162,63.28125
74,56,9,632,512,120,23.4375
74,56,10,1611,1024,587,57.32421875
74,56,11,514,2048,-1534,-74.90234375
74,56,12,506,4096,-3590,-87.646484375
74,56,13,397,8192,-7795,-95.15380859375
74,56,14,3509,16384,-12875,-78.582763671875
74,56,15,7881,32768,-24887,-75.9490966796875
74,57,1,0,2,-2,-100.0
74,57,2,4,4,0,0.0
74,57,3,6,8,-2,-25.0
74,57,4,19,16,3,18.75
74,57,5,31,32,-1,-3.125
74,57,6,25,64,-39,-60.9375
74,57,7,116,128,-12,-9.375
74,57,8,180,256,-76,-29.6875
74,57,9,274,512,-238,-46.484375
74,57,10,536,1024,-488,-47.65625
74,57,11,74,2048,-1974,-96.38671875
74,57,12,3128,4096,-968,-23.6328125
74,57,13,3098,8192,-5094,-62.1826171875
74,57,14,26031,16384,9647,58.880615234375
74,57,15,19224,32768,-13544,-41.3330078125
74,58,1,0,2,-2,-100.0
74,58,2,1,4,-3,-75.0
74,58,3,4,8,-4,-50.0
74,58,4,6,16,-10,-62.5
74,58,5,58,32,26,81.25
74,58,6,195,64,131,204.6875
74,58,7,81,128,-47,-36.71875
74,58,8,245,256,-11,-4.296875
74,58,9,1830,512,1318,257.421875
74,58,10,1280,1024,256,25.0
74,58,11,2113,2048,65,3.173828125
74,58,12,4517,4096,421,10.2783203125
74,58,13,7017,8192,-1175,-14.34326171875
74,58,14,4631,16384,-11753,-71.734619140625
74,58,15,538,32768,-32230,-98.358154296875
74,59,1,0,2,-2,-100.0
74,59,2,2,4,-2,-50.0
74,59,3,5,8,-3,-37.5
74,59,4,3,16,-13,-81.25
74,59,5,24,32,-8,-25.0
74,59,6,224,64,160,250.0
74,59,7,32,128,-96,-75.0
74,59,8,57,256,-199,-77.734375
74,59,9,172,512,-340,-66.40625
74,59,10,417,1024,-607,-59.27734375
74,59,11,794,2048,-1254,-61.23046875
74,59,12,1749,4096,-2347,-57.2998046875
74,59,13,7862,8192,-330,-4.0283203125
74,59,14,15563,16384,-821,-5.010986328125
74,59,15,155066,32768,122298,373.223876953125
74,60,1,0,2,-2,-100.0
74,60,2,1,4,-3,-75.0
74,60,3,4,8,-4,-50.0
74,60,4,14,16,-2,-12.5
74,60,5,8,32,-24,-75.0
74,60,6,36,64,-28,-43.75
74,60,7,60,128,-68,-53.125
74,60,8,54,256,-202,-78.90625
74,60,9,661,512,149,29.1015625
74,60,10,753,1024,-271,-26.46484375
74,60,11,613,2048,-1435,-70.068359375
74,60,12,7846,4096,3750,91.552734375
74,60,13,2348,8192,-5844,-71.337890625
74,60,14,32639,16384,16255,99.212646484375
74,60,15,15945,32768,-16823,-51.3397216796875
74,61,1,0,2,-2,-100.0
74,61,2,1,4,-3,-75.0
74,61,3,2,8,-6,-75.0
74,61,4,11,16,-5,-31.25
74,61,5,4,32,-28,-87.5
74,61,6,8,64,-56,-87.5
74,61,7,45,128,-83,-64.84375
74,61,8,336,256,80,31.25
74,61,9,675,512,163,31.8359375
74,61,10,249,1024,-775,-75.68359375
74,61,11,779,2048,-1269,-61.962890625
74,61,12,2054,4096,-2042,-49.853515625
74,61,13,21738,8192,13546,165.3564453125
74,61,14,7260,16384,-9124,-55.6884765625
74,61,15,75163,32768,42395,129.3792724609375
74,62,1,0,2,-2,-100.0
74,62,2,1,4,-3,-75.0
74,62,3,5,8,-3,-37.5
74,62,4,10,16,-6,-37.5
74,62,5,38,32,6,18.75
74,62,6,16,64,-48,-75.0
74,62,7,13,128,-115,-89.84375
74,62,8,184,256,-72,-28.125
74,62,9,492,512,-20,-3.90625
74,62,10,828,1024,-196,-19.140625
74,62,11,529,2048,-1519,-74.169921875
74,62,12,6906,4096,2810,68.603515625
74,62,13,1818,8192,-6374,-77.8076171875
74,62,14,17775,16384,1391,8.489990234375
74,62,15,45833,32768,13065,39.8712158203125
74,63,1,0,2,-2,-100.0
74,63,2,4,4,0,0.0
74,63,3,9,8,1,12.5
74,63,4,9,16,-7,-43.75
74,63,5,6,32,-26,-81.25
74,63,6,42,64,-22,-34.375
74,63,7,75,128,-53,-41.40625
74,63,8,387,256,131,51.171875
74,63,9,38,512,-474,-92.578125
74,63,10,1075,1024,51,4.98046875
74,63,11,398,2048,-1650,-80.56640625
74,63,12,2225,4096,-1871,-45.6787109375
74,63,13,7564,8192,-628,-7.666015625
74,63,14,4934,16384,-11450,-69.88525390625
74,63,15,50056,32768,17288,52.7587890625
74,64,1,0,2,-2,-100.0
74,64,2,2,4,-2,-50.0
74,64,3,15,8,7,87.5
74,64,4,18,16,2,12.5
74,64,5,17,32,-15,-46.875
74,64,6,20,64,-44,-68.75
74,64,7,213,128,85,66.40625
74,64,8,42,256,-214,-83.59375
74,64,9,393,512,-119,-23.2421875
74,64,10,322,1024,-702,-68.5546875
74,64,11,611,2048,-1437,-70.166015625
74,64,12,1311,4096,-2785,-67.9931640625
74,64,13,69596,8192,61404,749.560546875
74,64,14,15994,16384,-390,-2.38037109375
74,64,15,92553,32768,59785,182.4493408203125
74,65,1,0,2,-2,-100.0
74,65,2,4,4,0,0.0
74,65,3,3,8,-5,-62.5
74,65,4,8,16,-8,-50.0
74,65,5,40,32,8,25.0
74,65,6,52,64,-12,-18.75
74,65,7,256,128,128,100.0
74,65,8,151,256,-105,-41.015625
74,65,9,180,512,-332,-64.84375
74,65,10,2490,1024,1466,143.1640625
74,65,11,1506,2048,-542,-26.46484375
74,65,12,6025,4096,1929,47.0947265625
74,65,13,6344,8192,-1848,-22.55859375
74,65,14,45559,16384,29175,178.070068359375
74,65,15,18273,32768,-14495,-44.2352294921875
74,66,1,0,2,-2,-100.0
74,66,2,1,4,-3,-75.0
74,66,3,3,8,-5,-62.5
74,66,4,6,16,-10,-62.5
74,66,5,70,32,38,118.75
74,66,6,94,64,30,46.875
74,66,7,135,128,7,5.46875
74,66,8,82,256,-174,-67.96875
74,66,9,34,512,-478,-93.359375
74,66,10,1075,1024,51,4.98046875
74,66,11,589,2048,-1459,-71.240234375
74,66,12,5976,4096,1880,45.8984375
74,66,13,2656,8192,-5536,-67.578125
74,66,14,19712,16384,3328,20.3125
74,66,15,50957,32768,18189,55.5084228515625
74,67,1,0,2,-2,-100.0
74,67,2,2,4,-2,-50.0
74,67,3,4,8,-4,-50.0
74,67,4,33,16,17,106.25
74,67,5,8,32,-24,-75.0
74,67,6,106,64,42,65.625
74,67,7,31,128,-97,-75.78125
74,67,8,304,256,48,18.75
74,67,9,71,512,-441,-86.1328125
74,67,10,82,1024,-942,-91.9921875
74,67,11,3419,2048,1371,66.943359375
74,67,12,3519,4096,-577,-14.0869140625
74,67,13,69,8192,-8123,-99.15771484375
74,67,14,23833,16384,7449,45.465087890625
74,67,15,26853,32768,-5915,-18.0511474609375
74,68,1,0,2,-2,-100.0
74,68,2,2,4,-2,-50.0
74,68,3,7,8,-1,-12.5
74,68,4,15,16,-1,-6.25
74,68,5,76,32,44,137.5
74,68,6,35,64,-29,-45.3125
74,68,7,11,128,-117,-91.40625
74,68,8,75,256,-181,-70.703125
74,68,9,181,512,-331,-64.6484375
74,68,10,1449,1024,425,41.50390625
74,68,11,486,2048,-1562,-76.26953125
74,68,12,348,4096,-3748,-91.50390625
74,68,13,18298,8192,10106,123.3642578125
74,68,14,34325,16384,17941,109.503173828125
74,68,15,32906,32768,138,0.421142578125
74,69,1,0,2,-2,-100.0
74,69,2,1,4,-3,-75.0
74,69,3,2,8,-6,-75.0
74,69,4,3,16,-13,-81.25
74,69,5,50,32,18,56.25
74,69,6,30,64,-34,-53.125
74,69,7,43,128,-85,-66.40625
74,69,8,570,256,314,122.65625
74,69,9,331,512,-181,-35.3515625
74,69,10,218,1024,-806,-78.7109375
74,69,11,1032,2048,-1016,-49.609375
74,69,12,3738,4096,-358,-8.740234375
74,69,13,10628,8192,2436,29.736328125
74,69,14,6301,16384,-10083,-61.541748046875
74,69,15,8817,32768,-23951,-73.0926513671875
74,70,1,0,2,-2,-100.0
74,70,2,1,4,-3,-75.0
74,70,3,2,8,-6,-75.0
74,70,4,11,16,-5,-31.25
74,70,5,23,32,-9,-28.125
74,70,6,149,64,85,132.8125
74,70,7,75,128,-53,-41.40625
74,70,8,146,256,-110,-42.96875
74,70,9,628,512,116,22.65625
74,70,10,1004,1024,-20,-1.953125
74,70,11,789,2048,-1259,-61.474609375
74,70,12,11154,4096,7058,172.314453125
74,70,13,3581,8192,-4611,-56.28662109375
74,70,14,53970,16384,37586,229.40673828125
74,70,15,81075,32768,48307,147.4212646484375
74,71,1,0,2,-2,-100.0
74,71,2,3,4,-1,-25.0
74,71,3,8,8,0,0.0
74,71,4,32,16,16,100.0
74,71,5,9,32,-23,-71.875
74,71,6,27,64,-37,-57.8125
74,71,7,25,128,-103,-80.46875
74,71,8,211,256,-45,-17.578125
74,71,9,540,512,28,5.46875
74,71,10,5764,1024,4740,462.890625
74,71,11,1502,2048,-546,-26.66015625
74,71,12,11971,4096,7875,192.2607421875
74,71,13,21513,8192,13321,162.60986328125
74,71,14,2127,16384,-14257,-87.017822265625
74,71,15,102900,32768,70132,214.02587890625
74,72,1,0,2,-2,-100.0
74,72,2,1,4,-3,-75.0
74,72,3,5,8,-3,-37.5
74,72,4,27,16,11,68.75
74,72,5,48,32,16,50.0
74,72,6,159,64,95,148.4375
74,72,7,107,128,-21,-16.40625
74,72,8,113,256,-143,-55.859375
74,72,9,1492,512,980,191.40625
74,72,10,6075,1024,5051,493.26171875
74,72,11,527,2048,-1521,-74.267578125
74,72,12,840,4096,-3256,-79.4921875
74,72,13,1419,8192,-6773,-82.67822265625
74,72,14,13581,16384,-2803,-17.108154296875
74,72,15,14056,32768,-18712,-57.1044921875
74,73,1,0,2,-2,-100.0
74,73,2,1,4,-3,-75.0
74,73,3,5,8,-3,-37.5
74,73,4,14,16,-2,-12.5
74,73,5,10,32,-22,-68.75
74,73,6,137,64,73,114.0625
74,73,7,135,128,7,5.46875
74,73,8,290,256,34,13.28125
74,73,9,215,512,-297,-58.0078125
74,73,10,4177,1024,3153,307.91015625
74,73,11,4543,2048,2495,121.826171875
74,73,12,10215,4096,6119,149.3896484375
74,73,13,3189,8192,-5003,-61.07177734375
74,73,14,969,16384,-15415,-94.085693359375
74,73,15,19310,32768,-13458,-41.070556640625
74,74,1,0,2,-2,-100.0
74,74,2,1,4,-3,-75.0
74,74,3,2,8,-6,-75.0
74,74,4,8,16,-8,-50.0
74,74,5,10,32,-22,-68.75
74,74,6,34,64,-30,-46.875
74,74,7,67,128,-61,-47.65625
74,74,8,136,256,-120,-46.875
74,74,9,232,512,-280,-54.6875
74,74,10,99,1024,-925,-90.33203125
74,74,11,609,2048,-1439,-70.263671875
74,74,12,135,4096,-3961,-96.7041015625
74,74,13,4049,8192,-4143,-50.57373046875
74,74,14,2833,16384,-13551,-82.708740234375
74,74,15,1440,32768,-31328,-95.60546875
75,1,1,0,2,-2,-100.0
75,1,2,1,4,-3,-75.0
75,1,3,2,8,-6,-75.0
75,1,4,25,16,9,56.25
75,1,5,84,32,52,162.5
75,1,6,200,64,136,212.5
75,1,7,48,128,-80,-62.5
75,1,8,26,256,-230,-89.84375
75,1,9,556,512,44,8.59375
75,1,10,2805,1024,1781,173.92578125
75,1,11,2576,2048,528,25.78125
75,1,12,8742,4096,4646,113.427734375
75,1,13,4254,8192,-3938,-48.0712890625
75,1,14,7759,16384,-8625,-52.642822265625
75,1,15,48580,32768,15812,48.25439453125
75,2,1,0,2,-2,-100.0
75,2,2,3,4,-1,-25.0
75,2,3,7,8,-1,-12.5
75,2,4,6,16,-10,-62.5
75,2,5,21,32,-11,-34.375
75,2,6,94,64,30,46.875
75,2,7,57,128,-71,-55.46875
75,2,8,303,256,47,18.359375
75,2,9,627,512,115,22.4609375
75,2,10,139,1024,-885,-86.42578125
75,2,11,4389,2048,2341,114.306640625
75,2,12,916,4096,-3180,-77.63671875
75,2,13,5417,8192,-2775,-33.87451171875
75,2,14,24106,16384,7722,47.13134765625
75,2,15,59390,32768,26622,81.243896484375
75,3,1,0,2,-2,-100.0
75,3,2,2,4,-2,-50.0
75,3,3,3,8,-5,-62.5
75,3,4,38,16,22,137.5
75,3,5,25,32,-7,-21.875
75,3,6,14,64,-50,-78.125
75,3,7,361,128,233,182.03125
75,3,8,510,256,254,99.21875
75,3,9,120,512,-392,-76.5625
75,3,10,603,1024,-421,-41.11328125
75,3,11,1886,2048,-162,-7.91015625
75,3,12,2288,4096,-1808,-44.140625
75,3,13,2845,8192,-5347,-65.27099609375
75,3,14,3379,16384,-13005,-79.376220703125
75,3,15,10162,32768,-22606,-68.988037109375
75,4,1,0,2,-2,-100.0
75,4,2,2,4,-2,-50.0
75,4,3,14,8,6,75.0
75,4,4,3,16,-13,-81.25
75,4,5,11,32,-21,-65.625
75,4,6,59,64,-5,-7.8125
75,4,7,19,128,-109,-85.15625
75,4,8,58,256,-198,-77.34375
75,4,9,33,512,-479,-93.5546875
75,4,10,152,1024,-872,-85.15625
75,4,11,20,2048,-2028,-99.0234375
75,4,12,1907,4096,-2189,-53.4423828125
75,4,13,12781,8192,4589,56.01806640625
75,4,14,9650,16384,-6734,-41.10107421875
75,4,15,29788,32768,-2980,-9.09423828125
75,5,1,0,2,-2,-100.0
75,5,2,2,4,-2,-50.0
75,5,3,2,8,-6,-75.0
75,5,4,40,16,24,150.0
75,5,5,14,32,-18,-56.25
75,5,6,134,64,70,109.375
75,5,7,421,128,293,228.90625
75,5,8,164,256,-92,-35.9375
75,5,9,410,512,-102,-19.921875
75,5,10,909,1024,-115,-11.23046875
75,5,11,2655,2048,607,29.638671875
75,5,12,4587,4096,491,11.9873046875
75,5,13,11290,8192,3098,37.8173828125
75,5,14,242,16384,-16142,-98.52294921875
75,5,15,115721,32768,82953,253.1524658203125
75,6,1,0,2,-2,-100.0
75,6,2,1,4,-3,-75.0
75,6,3,2,8,-6,-75.0
75,6,4,6,16,-10,-62.5
75,6,5,10,32,-22,-68.75
75,6,6,33,64,-31,-48.4375
75,6,7,33,128,-95,-74.21875
75,6,8,568,256,312,121.875
75,6,9,223,512,-289,-56.4453125
75,6,10,623,1024,-401,-39.16015625
75,6,11,5476,2048,3428,167.3828125
75,6,12,4363,4096,267,6.5185546875
75,6,13,4741,8192,-3451,-42.12646484375
75,6,14,1155,16384,-15229,-92.950439453125
75,6,15,4842,32768,-27926,-85.223388671875
75,7,1,0,2,-2,-100.0
75,7,2,2,4,-2,-50.0
75,7,3,8,8,0,0.0
75,7,4,18,16,2,12.5
75,7,5,4,32,-28,-87.5
75,7,6,82,64,18,28.125
75,7,7,31,128,-97,-75.78125
75,7,8,55,256,-201,-78.515625
75,7,9,247,512,-265,-51.7578125
75,7,10,1901,1024,877,85.64453125
75,7,11,6231,2048,4183,204.248046875
75,7,12,5834,4096,1738,42.431640625
75,7,13,15273,8192,7081,86.43798828125
75,7,14,2175,16384,-14209,-86.724853515625
75,7,15,24354,32768,-8414,-25.677490234375
75,8,1,0,2,-2,-100.0
75,8,2,7,4,3,75.0
75,8,3,14,8,6,75.0
75,8,4,35,16,19,118.75
75,8,5,23,32,-9,-28.125
75,8,6,18,64,-46,-71.875
75,8,7,257,128,129,100.78125
75,8,8,340,256,84,32.8125
75,8,9,107,512,-405,-79.1015625
75,8,10,2604,1024,1580,154.296875
75,8,11,9071,2048,7023,342.919921875
75,8,12,902,4096,-3194,-77.978515625
75,8,13,3085,8192,-5107,-62.34130859375
75,8,14,19192,16384,2808,17.138671875
75,8,15,44892,32768,12124,36.99951171875
75,9,1,0,2,-2,-100.0
75,9,2,1,4,-3,-75.0
75,9,3,4,8,-4,-50.0
75,9,4,3,16,-13,-81.25
75,9,5,4,32,-28,-87.5
75,9,6,26,64,-38,-59.375
75,9,7,323,128,195,152.34375
75,9,8,182,256,-74,-28.90625
75,9,9,192,512,-320,-62.5
75,9,10,1651,1024,627,61.23046875
75,9,11,775,2048,-1273,-62.158203125
75,9,12,2535,4096,-1561,-38.1103515625
75,9,13,766,8192,-7426,-90.6494140625
75,9,14,27652,16384,11268,68.7744140625
75,9,15,16637,32768,-16131,-49.2279052734375
75,10,1,0,2,-2,-100.0
75,10,2,1,4,-3,-75.0
75,10,3,5,8,-3,-37.5
75,10,4,6,16,-10,-62.5
75,10,5,66,32,34,106.25
75,10,6,17,64,-47,-73.4375
75,10,7,163,128,35,27.34375
75,10,8,85,256,-171,-66.796875
75,10,9,173,512,-339,-66.2109375
75,10,10,1358,1024,334,32.6171875
75,10,11,2393,2048,345,16.845703125
75,10,12,522,4096,-3574,-87.255859375
75,10,13,9149,8192,957,11.68212890625
75,10,14,48663,16384,32279,197.015380859375
75,10,15,21572,32768,-11196,-34.16748046875
75,11,1,0,2,-2,-100.0
75,11,2,1,4,-3,-75.0
75,11,3,2,8,-6,-75.0
75,11,4,14,16,-2,-12.5
75,11,5,45,32,13,40.625
75,11,6,38,64,-26,-40.625
75,11,7,30,128,-98,-76.5625
75,11,8,376,256,120,46.875
75,11,9,58,512,-454,-88.671875
75,11,10,1172,1024,148,14.453125
75,11,11,2694,2048,646,31.54296875
75,11,12,58,4096,-4038,-98.583984375
75,11,13,3180,8192,-5012,-61.181640625
75,11,14,8625,16384,-7759,-47.357177734375
75,11,15,31209,32768,-1559,-4.7576904296875
75,12,1,0,2,-2,-100.0
75,12,2,2,4,-2,-50.0
75,12,3,3,8,-5,-62.5
75,12,4,9,16,-7,-43.75
75,12,5,25,32,-7,-21.875
75,12,6,5,64,-59,-92.1875
75,12,7,87,128,-41,-32.03125
75,12,8,1275,256,1019,398.046875
75,12,9,314,512,-198,-38.671875
75,12,10,1575,1024,551,53.80859375
75,12,11,552,2048,-1496,-73.046875
75,12,12,4134,4096,38,0.927734375
75,12,13,7615,8192,-577,-7.04345703125
75,12,14,4078,16384,-12306,-75.10986328125
75,12,15,30002,32768,-2766,-8.441162109375
75,13,1,0,2,-2,-100.0
75,13,2,1,4,-3,-75.0
75,13,3,4,8,-4,-50.0
75,13,4,12,16,-4,-25.0
75,13,5,33,32,1,3.125
75,13,6,54,64,-10,-15.625
75,13,7,188,128,60,46.875
75,13,8,21,256,-235,-91.796875
75,13,9,243,512,-269,-52.5390625
75,13,10,731,1024,-293,-28.61328125
75,13,11,5846,2048,3798,185.44921875
75,13,12,1142,4096,-2954,-72.119140625
75,13,13,16750,8192,8558,104.4677734375
75,13,14,27177,16384,10793,65.875244140625
75,13,15,10599,32768,-22169,-67.6544189453125
75,14,1,0,2,-2,-100.0
75,14,2,1,4,-3,-75.0
75,14,3,4,8,-4,-50.0
75,14,4,5,16,-11,-68.75
75,14,5,4,32,-28,-87.5
75,14,6,55,64,-9,-14.0625
75,14,7,164,128,36,28.125
75,14,8,44,256,-212,-82.8125
75,14,9,1006,512,494,96.484375
75,14,10,67,1024,-957,-93.45703125
75,14,11,596,2048,-1452,-70.8984375
75,14,12,8746,4096,4650,113.525390625
75,14,13,7956,8192,-236,-2.880859375
75,14,14,23294,16384,6910,42.17529296875
75,14,15,650,32768,-32118,-98.016357421875
75,15,1,0,2,-2,-100.0
75,15,2,1,4,-3,-75.0
75,15,3,4,8,-4,-50.0
75,15,4,17,16,1,6.25
75,15,5,23,32,-9,-28.125
75,15,6,250,64,186,290.625
75,15,7,393,128,265,207.03125
75,15,8,91,256,-165,-64.453125
75,15,9,216,512,-296,-57.8125
75,15,10,302,1024,-722,-70.5078125
75,15,11,738,2048,-1310,-63.96484375
75,15,12,19292,4096,15196,370.99609375
75,15,13,9757,8192,1565,19.10400390625
75,15,14,624,16384,-15760,-96.19140625
75,15,15,8960,32768,-23808,-72.65625
75,16,1,0,2,-2,-100.0
75,16,2,2,4,-2,-50.0
75,16,3,5,8,-3,-37.5
75,16,4,7,16,-9,-56.25
75,16,5,22,32,-10,-31.25
75,16,6,111,64,47,73.4375
75,16,7,80,128,-48,-37.5
75,16,8,161,256,-95,-37.109375
75,16,9,160,512,-352,-68.75
75,16,10,45,1024,-979,-95.60546875
75,16,11,2387,2048,339,16.552734375
75,16,12,466,4096,-3630,-88.623046875
75,16,13,12286,8192,4094,49.9755859375
75,16,14,30491,16384,14107,86.102294921875
75,16,15,35150,32768,2382,7.269287109375
75,17,1,0,2,-2,-100.0
75,17,2,3,4,-1,-25.0
75,17,3,4,8,-4,-50.0
75,17,4,9,16,-7,-43.75
75,17,5,17,32,-15,-46.875
75,17,6,119,64,55,85.9375
75,17,7,56,128,-72,-56.25
75,17,8,156,256,-100,-39.0625
75,17,9,156,512,-356,-69.53125
75,17,10,3142,1024,2118,206.8359375
75,17,11,964,2048,-1084,-52.9296875
75,17,12,16552,4096,12456,304.1015625
75,17,13,1943,8192,-6249,-76.28173828125
75,17,14,87,16384,-16297,-99.468994140625
75,17,15,24026,32768,-8742,-26.678466796875
75,18,1,0,2,-2,-100.0
75,18,2,2,4,-2,-50.0
75,18,3,3,8,-5,-62.5
75,18,4,24,16,8,50.0
75,18,5,87,32,55,171.875
75,18,6,13,64,-51,-79.6875
75,18,7,46,128,-82,-64.0625
75,18,8,940,256,684,267.1875
75,18,9,693,512,181,35.3515625
75,18,10,33,1024,-991,-96.77734375
75,18,11,2817,2048,769,37.548828125
75,18,12,978,4096,-3118,-76.123046875
75,18,13,9915,8192,1723,21.03271484375
75,18,14,5509,16384,-10875,-66.375732421875
75,18,15,5099,32768,-27669,-84.4390869140625
75,19,1,0,2,-2,-100.0
75,19,2,2,4,-2,-50.0
75,19,3,4,8,-4,-50.0
75,19,4,3,16,-13,-81.25
75,19,5,56,32,24,75.0
75,19,6,25,64,-39,-60.9375
75,19,7,168,128,40,31.25
75,19,8,166,256,-90,-35.15625
75,19,9,107,512,-405,-79.1015625
75,19,10,378,1024,-646,-63.0859375
75,19,11,1242,2048,-806,-39.35546875
75,19,12,2301,4096,-1795,-43.8232421875
75,19,13,2359,8192,-5833,-71.20361328125
75,19,14,3466,16384,-12918,-78.84521484375
75,19,15,5459,32768,-27309,-83.3404541015625
75,20,1,0,2,-2,-100.0
75,20,2,8,4,4,100.0
75,20,3,4,8,-4,-50.0
75,20,4,14,16,-2,-12.5
75,20,5,25,32,-7,-21.875
75,20,6,58,64,-6,-9.375
75,20,7,269,128,141,110.15625
75,20,8,359,256,103,40.234375
75,20,9,596,512,84,16.40625
75,20,10,609,1024,-415,-40.52734375
75,20,11,3877,2048,1829,89.306640625
75,20,12,1794,4096,-2302,-56.201171875
75,20,13,431,8192,-7761,-94.73876953125
75,20,14,11346,16384,-5038,-30.74951171875
75,20,15,8686,32768,-24082,-73.492431640625
75,21,1,0,2,-2,-100.0
75,21,2,2,4,-2,-50.0
75,21,3,32,8,24,300.0
75,21,4,14,16,-2,-12.5
75,21,5,6,32,-26,-81.25
75,21,6,120,64,56,87.5
75,21,7,30,128,-98,-76.5625
75,21,8,143,256,-113,-44.140625
75,21,9,359,512,-153,-29.8828125
75,21,10,2868,1024,1844,180.078125
75,21,11,3872,2048,1824,89.0625
75,21,12,1384,4096,-2712,-66.2109375
75,21,13,2559,8192,-5633,-68.76220703125
75,21,14,2224,16384,-14160,-86.42578125
75,21,15,27285,32768,-5483,-16.7327880859375
75,22,1,0,2,-2,-100.0
75,22,2,1,4,-3,-75.0
75,22,3,8,8,0,0.0
75,22,4,6,16,-10,-62.5
75,22,5,6,32,-26,-81.25
75,22,6,126,64,62,96.875
75,22,7,242,128,114,89.0625
75,22,8,360,256,104,40.625
75,22,9,137,512,-375,-73.2421875
75,22,10,878,1024,-146,-14.2578125
75,22,11,442,2048,-1606,-78.41796875
75,22,12,127,4096,-3969,-96.8994140625
75,22,13,5630,8192,-2562,-31.2744140625
75,22,14,6107,16384,-10277,-62.725830078125
75,22,15,9587,32768,-23181,-70.7427978515625
75,23,1,0,2,-2,-100.0
75,23,2,2,4,-2,-50.0
75,23,3,2,8,-6,-75.0
75,23,4,4,16,-12,-75.0
75,23,5,21,32,-11,-34.375
75,23,6,81,64,17,26.5625
75,23,7,28,128,-100,-78.125
75,23,8,459,256,203,79.296875
75,23,9,176,512,-336,-65.625
75,23,10,408,1024,-616,-60.15625
75,23,11,1401,2048,-647,-31.591796875
75,23,12,8424,4096,4328,105.6640625
75,23,13,7861,8192,-331,-4.04052734375
75,23,14,25617,16384,9233,56.353759765625
75,23,15,10257,32768,-22511,-68.6981201171875
75,24,1,0,2,-2,-100.0
75,24,2,3,4,-1,-25.0
75,24,3,3,8,-5,-62.5
75,24,4,13,16,-3,-18.75
75,24,5,58,32,26,81.25
75,24,6,84,64,20,31.25
75,24,7,19,128,-109,-85.15625
75,24,8,121,256,-135,-52.734375
75,24,9,209,512,-303,-59.1796875
75,24,10,435,1024,-589,-57.51953125
75,24,11,1013,2048,-1035,-50.537109375
75,24,12,6517,4096,2421,59.1064453125
75,24,13,2439,8192,-5753,-70.22705078125
75,24,14,72448,16384,56064,342.1875
75,24,15,4659,32768,-28109,-85.7818603515625
75,25,1,0,2,-2,-100.0
75,25,2,3,4,-1,-25.0
75,25,3,15,8,7,87.5
75,25,4,35,16,19,118.75
75,25,5,33,32,1,3.125
75,25,6,5,64,-59,-92.1875
75,25,7,44,128,-84,-65.625
75,25,8,219,256,-37,-14.453125
75,25,9,145,512,-367,-71.6796875
75,25,10,440,1024,-584,-57.03125
75,25,11,549,2048,-1499,-73.193359375
75,25,12,97,4096,-3999,-97.6318359375
75,25,13,6299,8192,-1893,-23.10791015625
75,25,14,922,16384,-15462,-94.37255859375
75,25,15,7948,32768,-24820,-75.74462890625
75,26,1,0,2,-2,-100.0
75,26,2,1,4,-3,-75.0
75,26,3,4,8,-4,-50.0
75,26,4,5,16,-11,-68.75
75,26,5,52,32,20,62.5
75,26,6,5,64,-59,-92.1875
75,26,7,160,128,32,25.0
75,26,8,246,256,-10,-3.90625
75,26,9,223,512,-289,-56.4453125
75,26,10,1625,1024,601,58.69140625
75,26,11,3775,2048,1727,84.326171875
75,26,12,20078,4096,15982,390.185546875
75,26,13,5946,8192,-2246,-27.4169921875
75,26,14,13675,16384,-2709,-16.534423828125
75,26,15,8665,32768,-24103,-73.5565185546875
75,27,1,0,2,-2,-100.0
75,27,2,1,4,-3,-75.0
75,27,3,8,8,0,0.0
75,27,4,18,16,2,12.5
75,27,5,7,32,-25,-78.125
75,27,6,42,64,-22,-34.375
75,27,7,31,128,-97,-75.78125
75,27,8,163,256,-93,-36.328125
75,27,9,304,512,-208,-40.625
75,27,10,200,1024,-824,-80.46875
75,27,11,916,2048,-1132,-55.2734375
75,27,12,2022,4096,-2074,-50.634765625
75,27,13,4028,8192,-4164,-50.830078125
75,27,14,1351,16384,-15033,-91.754150390625
75,27,15,11838,32768,-20930,-63.873291015625
75,28,1,0,2,-2,-100.0
75,28,2,1,4,-3,-75.0
75,28,3,5,8,-3,-37.5
75,28,4,13,16,-3,-18.75
75,28,5,29,32,-3,-9.375
75,28,6,123,64,59,92.1875
75,28,7,34,128,-94,-73.4375
75,28,8,41,256,-215,-83.984375
75,28,9,55,512,-457,-89.2578125
75,28,10,708,1024,-316,-30.859375
75,28,11,560,2048,-1488,-72.65625
75,28,12,745,4096,-3351,-81.8115234375
75,28,13,2060,8192,-6132,-74.853515625
75,28,14,18698,16384,2314,14.12353515625
75,28,15,48752,32768,15984,48.779296875
75,29,1,0,2,-2,-100.0
75,29,2,4,4,0,0.0
75,29,3,7,8,-1,-12.5
75,29,4,8,16,-8,-50.0
75,29,5,43,32,11,34.375
75,29,6,69,64,5,7.8125
75,29,7,24,128,-104,-81.25
75,29,8,57,256,-199,-77.734375
75,29,9,564,512,52,10.15625
75,29,10,81,1024,-943,-92.08984375
75,29,11,1943,2048,-105,-5.126953125
75,29,12,7072,4096,2976,72.65625
75,29,13,671,8192,-7521,-91.80908203125
75,29,14,17533,16384,1149,7.012939453125
75,29,15,33067,32768,299,0.9124755859375
75,30,1,0,2,-2,-100.0
75,30,2,1,4,-3,-75.0
75,30,3,3,8,-5,-62.5
75,30,4,8,16,-8,-50.0
75,30,5,40,32,8,25.0
75,30,6,19,64,-45,-70.3125
75,30,7,36,128,-92,-71.875
75,30,8,73,256,-183,-71.484375
75,30,9,453,512,-59,-11.5234375
75,30,10,4218,1024,3194,311.9140625
75,30,11,94,2048,-1954,-95.41015625
75,30,12,3481,4096,-615,-15.0146484375
75,30,13,3932,8192,-4260,-52.001953125
75,30,14,1346,16384,-15038,-91.78466796875
75,30,15,2330,32768,-30438,-92.889404296875
75,31,1,0,2,-2,-100.0
75,31,2,1,4,-3,-75.0
75,31,3,8,8,0,0.0
75,31,4,9,16,-7,-43.75
75,31,5,43,32,11,34.375
75,31,6,7,64,-57,-89.0625
75,31,7,6,128,-122,-95.3125
75,31,8,106,256,-150,-58.59375
75,31,9,285,512,-227,-44.3359375
75,31,10,374,1024,-650,-63.4765625
75,31,11,11241,2048,9193,448.876953125
75,31,12,745,4096,-3351,-81.8115234375
75,31,13,4614,8192,-3578,-43.6767578125
75,31,14,9703,16384,-6681,-40.777587890625
75,31,15,66707,32768,33939,103.5736083984375
75,32,1,0,2,-2,-100.0
75,32,2,2,4,-2,-50.0
75,32,3,3,8,-5,-62.5
75,32,4,5,16,-11,-68.75
75,32,5,7,32,-25,-78.125
75,32,6,5,64,-59,-92.1875
75,32,7,90,128,-38,-29.6875
75,32,8,126,256,-130,-50.78125
75,32,9,208,512,-304,-59.375
75,32,10,2914,1024,1890,184.5703125
75,32,11,686,2048,-1362,-66.50390625
75,32,12,15368,4096,11272,275.1953125
75,32,13,15948,8192,7756,94.677734375
75,32,14,15022,16384,-1362,-8.31298828125
75,32,15,20798,32768,-11970,-36.529541015625
75,33,1,0,2,-2,-100.0
75,33,2,1,4,-3,-75.0
75,33,3,3,8,-5,-62.5
75,33,4,22,16,6,37.5
75,33,5,7,32,-25,-78.125
75,33,6,42,64,-22,-34.375
75,33,7,72,128,-56,-43.75
75,33,8,477,256,221,86.328125
75,33,9,582,512,70,13.671875
75,33,10,3875,1024,2851,278.41796875
75,33,11,2257,2048,209,10.205078125
75,33,12,3655,4096,-441,-10.7666015625
75,33,13,3140,8192,-5052,-61.669921875
75,33,14,8955,16384,-7429,-45.343017578125
75,33,15,41458,32768,8690,26.519775390625
75,34,1,0,2,-2,-100.0
75,34,2,4,4,0,0.0
75,34,3,7,8,-1,-12.5
75,34,4,28,16,12,75.0
75,34,5,54,32,22,68.75
75,34,6,37,64,-27,-42.1875
75,34,7,143,128,15,11.71875
75,34,8,133,256,-123,-48.046875
75,34,9,238,512,-274,-53.515625
75,34,10,149,1024,-875,-85.44921875
75,34,11,1380,2048,-668,-32.6171875
75,34,12,3304,4096,-792,-19.3359375
75,34,13,11115,8192,2923,35.68115234375
75,34,14,6030,16384,-10354,-63.19580078125
75,34,15,44058,32768,11290,34.454345703125
75,35,1,0,2,-2,-100.0
75,35,2,3,4,-1,-25.0
75,35,3,11,8,3,37.5
75,35,4,7,16,-9,-56.25
75,35,5,19,32,-13,-40.625
75,35,6,14,64,-50,-78.125
75,35,7,242,128,114,89.0625
75,35,8,226,256,-30,-11.71875
75,35,9,180,512,-332,-64.84375
75,35,10,216,1024,-808,-78.90625
75,35,11,180,2048,-1868,-91.2109375
75,35,12,1598,4096,-2498,-60.986328125
75,35,13,17759,8192,9567,116.78466796875
75,35,14,32449,16384,16065,98.052978515625
75,35,15,20306,32768,-12462,-38.031005859375
75,36,1,0,2,-2,-100.0
75,36,2,2,4,-2,-50.0
75,36,3,12,8,4,50.0
75,36,4,9,16,-7,-43.75
75,36,5,39,32,7,21.875
75,36,6,61,64,-3,-4.6875
75,36,7,35,128,-93,-72.65625
75,36,8,112,256,-144,-56.25
75,36,9,88,512,-424,-82.8125
75,36,10,1180,1024,156,15.234375
75,36,11,7308,2048,5260,256.8359375
75,36,12,5789,4096,1693,41.3330078125
75,36,13,10427,8192,2235,27.28271484375
75,36,14,41263,16384,24879,151.849365234375
75,36,15,8047,32768,-24721,-75.4425048828125
75,37,1,0,2,-2,-100.0
75,37,2,2,4,-2,-50.0
75,37,3,3,8,-5,-62.5
75,37,4,34,16,18,112.5
75,37,5,31,32,-1,-3.125
75,37,6,170,64,106,165.625
75,37,7,215,128,87,67.96875
75,37,8,306,256,50,19.53125
75,37,9,139,512,-373,-72.8515625
75,37,10,89,1024,-935,-91.30859375
75,37,11,2070,2048,22,1.07421875
75,37,12,2865,4096,-1231,-30.0537109375
75,37,13,3998,8192,-4194,-51.1962890625
75,37,14,35347,16384,18963,115.740966796875
75,37,15,9819,32768,-22949,-70.0347900390625
75,38,1,0,2,-2,-100.0
75,38,2,2,4,-2,-50.0
75,38,3,9,8,1,12.5
75,38,4,12,16,-4,-25.0
75,38,5,27,32,-5,-15.625
75,38,6,15,64,-49,-76.5625
75,38,7,12,128,-116,-90.625
75,38,8,151,256,-105,-41.015625
75,38,9,56,512,-456,-89.0625
75,38,10,195,1024,-829,-80.95703125
75,38,11,835,2048,-1213,-59.228515625
75,38,12,4973,4096,877,21.4111328125
75,38,13,1549,8192,-6643,-81.09130859375
75,38,14,6836,16384,-9548,-58.2763671875
75,38,15,99678,32768,66910,204.193115234375
75,39,1,0,2,-2,-100.0
75,39,2,3,4,-1,-25.0
75,39,3,9,8,1,12.5
75,39,4,3,16,-13,-81.25
75,39,5,34,32,2,6.25
75,39,6,90,64,26,40.625
75,39,7,53,128,-75,-58.59375
75,39,8,152,256,-104,-40.625
75,39,9,530,512,18,3.515625
75,39,10,2524,1024,1500,146.484375
75,39,11,6330,2048,4282,209.08203125
75,39,12,1137,4096,-2959,-72.2412109375
75,39,13,6549,8192,-1643,-20.05615234375
75,39,14,8321,16384,-8063,-49.212646484375
75,39,15,10860,32768,-21908,-66.85791015625
75,40,1,0,2,-2,-100.0
75,40,2,1,4,-3,-75.0
75,40,3,4,8,-4,-50.0
75,40,4,15,16,-1,-6.25
75,40,5,22,32,-10,-31.25
75,40,6,12,64,-52,-81.25
75,40,7,247,128,119,92.96875
75,40,8,15,256,-241,-94.140625
75,40,9,617,512,105,20.5078125
75,40,10,660,1024,-364,-35.546875
75,40,11,3637,2048,1589,77.587890625
75,40,12,1953,4096,-2143,-52.3193359375
75,40,13,9370,8192,1178,14.3798828125
75,40,14,13115,16384,-3269,-19.952392578125
75,40,15,34844,32768,2076,6.33544921875
75,41,1,0,2,-2,-100.0
75,41,2,3,4,-1,-25.0
75,41,3,6,8,-2,-25.0
75,41,4,32,16,16,100.0
75,41,5,17,32,-15,-46.875
75,41,6,21,64,-43,-67.1875
75,41,7,202,128,74,57.8125
75,41,8,287,256,31,12.109375
75,41,9,347,512,-165,-32.2265625
75,41,10,970,1024,-54,-5.2734375
75,41,11,1097,2048,-951,-46.435546875
75,41,12,125,4096,-3971,-96.9482421875
75,41,13,2084,8192,-6108,-74.560546875
75,41,14,1911,16384,-14473,-88.336181640625
75,41,15,34196,32768,1428,4.35791015625
75,42,1,0,2,-2,-100.0
75,42,2,1,4,-3,-75.0
75,42,3,7,8,-1,-12.5
75,42,4,39,16,23,143.75
75,42,5,5,32,-27,-84.375
75,42,6,95,64,31,48.4375
75,42,7,74,128,-54,-42.1875
75,42,8,28,256,-228,-89.0625
75,42,9,885,512,373,72.8515625
75,42,10,271,1024,-753,-73.53515625
75,42,11,1202,2048,-846,-41.30859375
75,42,12,1650,4096,-2446,-59.716796875
75,42,13,650,8192,-7542,-92.0654296875
75,42,14,30326,16384,13942,85.09521484375
75,42,15,2142,32768,-30626,-93.463134765625
75,43,1,0,2,-2,-100.0
75,43,2,1,4,-3,-75.0
75,43,3,2,8,-6,-75.0
75,43,4,29,16,13,81.25
75,43,5,4,32,-28,-87.5
75,43,6,177,64,113,176.5625
75,43,7,75,128,-53,-41.40625
75,43,8,28,256,-228,-89.0625
75,43,9,665,512,153,29.8828125
75,43,10,516,1024,-508,-49.609375
75,43,11,5437,2048,3389,165.478515625
75,43,12,2746,4096,-1350,-32.958984375
75,43,13,8998,8192,806,9.8388671875
75,43,14,2156,16384,-14228,-86.8408203125
75,43,15,11650,32768,-21118,-64.447021484375
75,44,1,0,2,-2,-100.0
75,44,2,1,4,-3,-75.0
75,44,3,3,8,-5,-62.5
75,44,4,14,16,-2,-12.5
75,44,5,18,32,-14,-43.75
75,44,6,5,64,-59,-92.1875
75,44,7,226,128,98,76.5625
75,44,8,451,256,195,76.171875
75,44,9,453,512,-59,-11.5234375
75,44,10,451,1024,-573,-55.95703125
75,44,11,3180,2048,1132,55.2734375
75,44,12,2632,4096,-1464,-35.7421875
75,44,13,1088,8192,-7104,-86.71875
75,44,14,5637,16384,-10747,-65.594482421875
75,44,15,926,32768,-31842,-97.174072265625
75,45,1,0,2,-2,-100.0
75,45,2,3,4,-1,-25.0
75,45,3,4,8,-4,-50.0
75,45,4,8,16,-8,-50.0
75,45,5,4,32,-28,-87.5
75,45,6,14,64,-50,-78.125
75,45,7,108,128,-20,-15.625
75,45,8,85,256,-171,-66.796875
75,45,9,69,512,-443,-86.5234375
75,45,10,405,1024,-619,-60.44921875
75,45,11,338,2048,-1710,-83.49609375
75,45,12,6280,4096,2184,53.3203125
75,45,13,13660,8192,5468,66.748046875
75,45,14,12381,16384,-4003,-24.432373046875
75,45,15,16626,32768,-16142,-49.261474609375
75,46,1,0,2,-2,-100.0
75,46,2,2,4,-2,-50.0
75,46,3,11,8,3,37.5
75,46,4,12,16,-4,-25.0
75,46,5,16,32,-16,-50.0
75,46,6,61,64,-3,-4.6875
75,46,7,77,128,-51,-39.84375
75,46,8,262,256,6,2.34375
75,46,9,922,512,410,80.078125
75,46,10,598,1024,-426,-41.6015625
75,46,11,1289,2048,-759,-37.060546875
75,46,12,3377,4096,-719,-17.5537109375
75,46,13,4437,8192,-3755,-45.83740234375
75,46,14,24,16384,-16360,-99.853515625
75,46,15,7752,32768,-25016,-76.3427734375
75,47,1,0,2,-2,-100.0
75,47,2,1,4,-3,-75.0
75,47,3,2,8,-6,-75.0
75,47,4,3,16,-13,-81.25
75,47,5,26,32,-6,-18.75
75,47,6,14,64,-50,-78.125
75,47,7,87,128,-41,-32.03125
75,47,8,146,256,-110,-42.96875
75,47,9,788,512,276,53.90625
75,47,10,1520,1024,496,48.4375
75,47,11,568,2048,-1480,-72.265625
75,47,12,6929,4096,2833,69.1650390625
75,47,13,14171,8192,5979,72.98583984375
75,47,14,491,16384,-15893,-97.003173828125
75,47,15,16501,32768,-16267,-49.6429443359375
75,48,1,0,2,-2,-100.0
75,48,2,2,4,-2,-50.0
75,48,3,4,8,-4,-50.0
75,48,4,26,16,10,62.5
75,48,5,33,32,1,3.125
75,48,6,134,64,70,109.375
75,48,7,86,128,-42,-32.8125
75,48,8,150,256,-106,-41.40625
75,48,9,1127,512,615,120.1171875
75,48,10,37,1024,-987,-96.38671875
75,48,11,3337,2048,1289,62.939453125
75,48,12,2058,4096,-2038,-49.755859375
75,48,13,18835,8192,10643,129.91943359375
75,48,14,3848,16384,-12536,-76.513671875
75,48,15,32943,32768,175,0.5340576171875
75,49,1,0,2,-2,-100.0
75,49,2,1,4,-3,-75.0
75,49,3,13,8,5,62.5
75,49,4,13,16,-3,-18.75
75,49,5,11,32,-21,-65.625
75,49,6,235,64,171,267.1875
75,49,7,74,128,-54,-42.1875
75,49,8,27,256,-229,-89.453125
75,49,9,242,512,-270,-52.734375
75,49,10,533,1024,-491,-47.94921875
75,49,11,5452,2048,3404,166.2109375
75,49,12,4177,4096,81,1.9775390625
75,49,13,4261,8192,-3931,-47.98583984375
75,49,14,10801,16384,-5583,-34.075927734375
75,49,15,9027,32768,-23741,-72.4517822265625
75,50,1,0,2,-2,-100.0
75,50,2,4,4,0,0.0
75,50,3,7,8,-1,-12.5
75,50,4,5,16,-11,-68.75
75,50,5,9,32,-23,-71.875
75,50,6,14,64,-50,-78.125
75,50,7,84,128,-44,-34.375
75,50,8,123,256,-133,-51.953125
75,50,9,48,512,-464,-90.625
75,50,10,53,1024,-971,-94.82421875
75,50,11,1158,2048,-890,-43.45703125
75,50,12,3412,4096,-684,-16.69921875
75,50,13,748,8192,-7444,-90.869140625
75,50,14,1944,16384,-14440,-88.134765625
75,50,15,31590,32768,-1178,-3.594970703125
75,51,1,0,2,-2,-100.0
75,51,2,3,4,-1,-25.0
75,51,3,11,8,3,37.5
75,51,4,11,16,-5,-31.25
75,51,5,29,32,-3,-9.375
75,51,6,134,64,70,109.375
75,51,7,129,128,1,0.78125
75,51,8,301,256,45,17.578125
75,51,9,27,512,-485,-94.7265625
75,51,10,128,1024,-896,-87.5
75,51,11,84,2048,-1964,-95.8984375
75,51,12,4569,4096,473,11.5478515625
75,51,13,5983,8192,-2209,-26.96533203125
75,51,14,41098,16384,24714,150.84228515625
75,51,15,1429,32768,-31339,-95.6390380859375
75,52,1,0,2,-2,-100.0
75,52,2,3,4,-1,-25.0
75,52,3,2,8,-6,-75.0
75,52,4,11,16,-5,-31.25
75,52,5,138,32,106,331.25
75,52,6,11,64,-53,-82.8125
75,52,7,15,128,-113,-88.28125
75,52,8,13,256,-243,-94.921875
75,52,9,137,512,-375,-73.2421875
75,52,10,167,1024,-857,-83.69140625
75,52,11,1578,2048,-470,-22.94921875
75,52,12,69,4096,-4027,-98.3154296875
75,52,13,6852,8192,-1340,-16.357421875
75,52,14,753,16384,-15631,-95.404052734375
75,52,15,9144,32768,-23624,-72.0947265625
75,53,1,0,2,-2,-100.0
75,53,2,2,4,-2,-50.0
75,53,3,21,8,13,162.5
75,53,4,5,16,-11,-68.75
75,53,5,36,32,4,12.5
75,53,6,82,64,18,28.125
75,53,7,106,128,-22,-17.1875
75,53,8,620,256,364,142.1875
75,53,9,268,512,-244,-47.65625
75,53,10,948,1024,-76,-7.421875
75,53,11,411,2048,-1637,-79.931640625
75,53,12,8096,4096,4000,97.65625
75,53,13,1278,8192,-6914,-84.3994140625
75,53,14,3590,16384,-12794,-78.08837890625
75,53,15,32649,32768,-119,-0.3631591796875
75,54,1,0,2,-2,-100.0
75,54,2,4,4,0,0.0
75,54,3,2,8,-6,-75.0
75,54,4,24,16,8,50.0
75,54,5,22,32,-10,-31.25
75,54,6,33,64,-31,-48.4375
75,54,7,188,128,60,46.875
75,54,8,162,256,-94,-36.71875
75,54,9,664,512,152,29.6875
75,54,10,115,1024,-909,-88.76953125
75,54,11,307,2048,-1741,-85.009765625
75,54,12,2198,4096,-1898,-46.337890625
75,54,13,5949,8192,-2243,-27.38037109375
75,54,14,997,16384,-15387,-93.914794921875
75,54,15,42228,32768,9460,28.86962890625
75,55,1,0,2,-2,-100.0
75,55,2,1,4,-3,-75.0
75,55,3,5,8,-3,-37.5
75,55,4,22,16,6,37.5
75,55,5,10,32,-22,-68.75
75,55,6,34,64,-30,-46.875
75,55,7,169,128,41,32.03125
75,55,8,74,256,-182,-71.09375
75,55,9,460,512,-52,-10.15625
75,55,10,92,1024,-932,-91.015625
75,55,11,2216,2048,168,8.203125
75,55,12,3017,4096,-1079,-26.3427734375
75,55,13,4240,8192,-3952,-48.2421875
75,55,14,7640,16384,-8744,-53.369140625
75,55,15,46827,32768,14059,42.9046630859375
75,56,1,0,2,-2,-100.0
75,56,2,5,4,1,25.0
75,56,3,2,8,-6,-75.0
75,56,4,8,16,-8,-50.0
75,56,5,46,32,14,43.75
75,56,6,53,64,-11,-17.1875
75,56,7,338,128,210,164.0625
75,56,8,146,256,-110,-42.96875
75,56,9,838,512,326,63.671875
75,56,10,237,1024,-787,-76.85546875
75,56,11,902,2048,-1146,-55.95703125
75,56,12,1589,4096,-2507,-61.2060546875
75,56,13,1471,8192,-6721,-82.04345703125
75,56,14,23496,16384,7112,43.408203125
75,56,15,28934,32768,-3834,-11.700439453125
75,57,1,0,2,-2,-100.0
75,57,2,2,4,-2,-50.0
75,57,3,12,8,4,50.0
75,57,4,5,16,-11,-68.75
75,57,5,10,32,-22,-68.75
75,57,6,123,64,59,92.1875
75,57,7,121,128,-7,-5.46875
75,57,8,47,256,-209,-81.640625
75,57,9,414,512,-98,-19.140625
75,57,10,129,1024,-895,-87.40234375
75,57,11,2332,2048,284,13.8671875
75,57,12,3016,4096,-1080,-26.3671875
75,57,13,18643,8192,10451,127.57568359375
75,57,14,27728,16384,11344,69.23828125
75,57,15,48497,32768,15729,48.0010986328125
75,58,1,0,2,-2,-100.0
75,58,2,7,4,3,75.0
75,58,3,7,8,-1,-12.5
75,58,4,4,16,-12,-75.0
75,58,5,30,32,-2,-6.25
75,58,6,67,64,3,4.6875
75,58,7,10,128,-118,-92.1875
75,58,8,25,256,-231,-90.234375
75,58,9,384,512,-128,-25.0
75,58,10,1587,1024,563,54.98046875
75,58,11,4684,2048,2636,128.7109375
75,58,12,3425,4096,-671,-16.3818359375
75,58,13,12391,8192,4199,51.25732421875
75,58,14,38707,16384,22323,136.248779296875
75,58,15,24020,32768,-8748,-26.69677734375
75,59,1,0,2,-2,-100.0
75,59,2,2,4,-2,-50.0
75,59,3,7,8,-1,-12.5
75,59,4,52,16,36,225.0
75,59,5,70,32,38,118.75
75,59,6,26,64,-38,-59.375
75,59,7,36,128,-92,-71.875
75,59,8,90,256,-166,-64.84375
75,59,9,733,512,221,43.1640625
75,59,10,1787,1024,763,74.51171875
75,59,11,422,2048,-1626,-79.39453125
75,59,12,260,4096,-3836,-93.65234375
75,59,13,13918,8192,5726,69.8974609375
75,59,14,74946,16384,58562,357.43408203125
75,59,15,6150,32768,-26618,-81.231689453125
75,60,1,0,2,-2,-100.0
75,60,2,1,4,-3,-75.0
75,60,3,4,8,-4,-50.0
75,60,4,9,16,-7,-43.75
75,60,5,45,32,13,40.625
75,60,6,33,64,-31,-48.4375
75,60,7,227,128,99,77.34375
75,60,8,219,256,-37,-14.453125
75,60,9,903,512,391,76.3671875
75,60,10,870,1024,-154,-15.0390625
75,60,11,261,2048,-1787,-87.255859375
75,60,12,2017,4096,-2079,-50.7568359375
75,60,13,5435,8192,-2757,-33.65478515625
75,60,14,17022,16384,638,3.89404296875
75,60,15,13882,32768,-18886,-57.635498046875
75,61,1,0,2,-2,-100.0
75,61,2,1,4,-3,-75.0
75,61,3,17,8,9,112.5
75,61,4,13,16,-3,-18.75
75,61,5,25,32,-7,-21.875
75,61,6,29,64,-35,-54.6875
75,61,7,29,128,-99,-77.34375
75,61,8,442,256,186,72.65625
75,61,9,591,512,79,15.4296875
75,61,10,2590,1024,1566,152.9296875
75,61,11,1766,2048,-282,-13.76953125
75,61,12,650,4096,-3446,-84.130859375
75,61,13,3038,8192,-5154,-62.9150390625
75,61,14,1256,16384,-15128,-92.333984375
75,61,15,23938,32768,-8830,-26.947021484375
75,62,1,0,2,-2,-100.0
75,62,2,2,4,-2,-50.0
75,62,3,10,8,2,25.0
75,62,4,9,16,-7,-43.75
75,62,5,12,32,-20,-62.5
75,62,6,87,64,23,35.9375
75,62,7,118,128,-10,-7.8125
75,62,8,145,256,-111,-43.359375
75,62,9,769,512,257,50.1953125
75,62,10,243,1024,-781,-76.26953125
75,62,11,8649,2048,6601,322.314453125
75,62,12,3272,4096,-824,-20.1171875
75,62,13,36391,8192,28199,344.22607421875
75,62,14,15277,16384,-1107,-6.756591796875
75,62,15,33117,32768,349,1.0650634765625
75,63,1,0,2,-2,-100.0
75,63,2,1,4,-3,-75.0
75,63,3,23,8,15,187.5
75,63,4,17,16,1,6.25
75,63,5,51,32,19,59.375
75,63,6,61,64,-3,-4.6875
75,63,7,35,128,-93,-72.65625
75,63,8,150,256,-106,-41.40625
75,63,9,118,512,-394,-76.953125
75,63,10,63,1024,-961,-93.84765625
75,63,11,791,2048,-1257,-61.376953125
75,63,12,8097,4096,4001,97.6806640625
75,63,13,1332,8192,-6860,-83.740234375
75,63,14,7164,16384,-9220,-56.2744140625
75,63,15,18823,32768,-13945,-42.5567626953125
75,64,1,0,2,-2,-100.0
75,64,2,1,4,-3,-75.0
75,64,3,2,8,-6,-75.0
75,64,4,3,16,-13,-81.25
75,64,5,61,32,29,90.625
75,64,6,11,64,-53,-82.8125
75,64,7,258,128,130,101.5625
75,64,8,142,256,-114,-44.53125
75,64,9,127,512,-385,-75.1953125
75,64,10,220,1024,-804,-78.515625
75,64,11,971,2048,-1077,-52.587890625
75,64,12,5532,4096,1436,35.05859375
75,64,13,10862,8192,2670,32.5927734375
75,64,14,39719,16384,23335,142.425537109375
75,64,15,10982,32768,-21786,-66.485595703125
75,65,1,0,2,-2,-100.0
75,65,2,2,4,-2,-50.0
75,65,3,5,8,-3,-37.5
75,65,4,13,16,-3,-18.75
75,65,5,28,32,-4,-12.5
75,65,6,109,64,45,70.3125
75,65,7,17,128,-111,-86.71875
75,65,8,427,256,171,66.796875
75,65,9,82,512,-430,-83.984375
75,65,10,961,1024,-63,-6.15234375
75,65,11,3385,2048,1337,65.283203125
75,65,12,5622,4096,1526,37.255859375
75,65,13,7480,8192,-712,-8.69140625
75,65,14,9038,16384,-7346,-44.83642578125
75,65,15,570,32768,-32198,-98.260498046875
75,66,1,0,2,-2,-100.0
75,66,2,1,4,-3,-75.0
75,66,3,2,8,-6,-75.0
75,66,4,5,16,-11,-68.75
75,66,5,71,32,39,121.875
75,66,6,43,64,-21,-32.8125
75,66,7,348,128,220,171.875
75,66,8,265,256,9,3.515625
75,66,9,89,512,-423,-82.6171875
75,66,10,1628,1024,604,58.984375
75,66,11,3693,2048,1645,80.322265625
75,66,12,3752,4096,-344,-8.3984375
75,66,13,6312,8192,-1880,-22.94921875
75,66,14,10428,16384,-5956,-36.3525390625
75,66,15,3999,32768,-28769,-87.7960205078125
75,67,1,0,2,-2,-100.0
75,67,2,1,4,-3,-75.0
75,67,3,2,8,-6,-75.0
75,67,4,4,16,-12,-75.0
75,67,5,81,32,49,153.125
75,67,6,152,64,88,137.5
75,67,7,51,128,-77,-60.15625
75,67,8,107,256,-149,-58.203125
75,67,9,600,512,88,17.1875
75,67,10,701,1024,-323,-31.54296875
75,67,11,649,2048,-1399,-68.310546875
75,67,12,18284,4096,14188,346.38671875
75,67,13,3129,8192,-5063,-61.80419921875
75,67,14,5876,16384,-10508,-64.1357421875
75,67,15,40254,32768,7486,22.845458984375
75,68,1,0,2,-2,-100.0
75,68,2,2,4,-2,-50.0
75,68,3,2,8,-6,-75.0
75,68,4,13,16,-3,-18.75
75,68,5,70,32,38,118.75
75,68,6,60,64,-4,-6.25
75,68,7,17,128,-111,-86.71875
75,68,8,343,256,87,33.984375
75,68,9,198,512,-314,-61.328125
75,68,10,990,1024,-34,-3.3203125
75,68,11,2795,2048,747,36.474609375
75,68,12,1463,4096,-2633,-64.2822265625
75,68,13,5941,8192,-2251,-27.47802734375
75,68,14,10411,16384,-5973,-36.456298828125
75,68,15,100266,32768,67498,205.987548828125
75,69,1,0,2,-2,-100.0
75,69,2,1,4,-3,-75.0
75,69,3,4,8,-4,-50.0
75,69,4,19,16,3,18.75
75,69,5,10,32,-22,-68.75
75,69,6,28,64,-36,-56.25
75,69,7,94,128,-34,-26.5625
75,69,8,29,256,-227,-88.671875
75,69,9,1193,512,681,133.0078125
75,69,10,3700,1024,2676,261.328125
75,69,11,5808,2048,3760,183.59375
75,69,12,5067,4096,971,23.7060546875
75,69,13,5802,8192,-2390,-29.1748046875
75,69,14,9221,16384,-7163,-43.719482421875
75,69,15,6241,32768,-26527,-80.9539794921875
75,70,1,0,2,-2,-100.0
75,70,2,1,4,-3,-75.0
75,70,3,12,8,4,50.0
75,70,4,6,16,-10,-62.5
75,70,5,9,32,-23,-71.875
75,70,6,21,64,-43,-67.1875
75,70,7,203,128,75,58.59375
75,70,8,163,256,-93,-36.328125
75,70,9,54,512,-458,-89.453125
75,70,10,1207,1024,183,17.87109375
75,70,11,123,2048,-1925,-93.994140625
75,70,12,570,4096,-3526,-86.083984375
75,70,13,3551,8192,-4641,-56.65283203125
75,70,14,33045,16384,16661,101.690673828125
75,70,15,29832,32768,-2936,-8.9599609375
75,71,1,0,2,-2,-100.0
75,71,2,1,4,-3,-75.0
75,71,3,5,8,-3,-37.5
75,71,4,11,16,-5,-31.25
75,71,5,12,32,-20,-62.5
75,71,6,91,64,27,42.1875
75,71,7,40,128,-88,-68.75
75,71,8,68,256,-188,-73.4375
75,71,9,823,512,311,60.7421875
75,71,10,331,1024,-693,-67.67578125
75,71,11,469,2048,-1579,-77.099609375
75,71,12,1230,4096,-2866,-69.970703125
75,71,13,6296,8192,-1896,-23.14453125
75,71,14,1594,16384,-14790,-90.27099609375
75,71,15,12230,32768,-20538,-62.677001953125
75,72,1,0,2,-2,-100.0
75,72,2,2,4,-2,-50.0
75,72,3,5,8,-3,-37.5
75,72,4,7,16,-9,-56.25
75,72,5,16,32,-16,-50.0
75,72,6,51,64,-13,-20.3125
75,72,7,69,128,-59,-46.09375
75,72,8,733,256,477,186.328125
75,72,9,255,512,-257,-50.1953125
75,72,10,396,1024,-628,-61.328125
75,72,11,5027,2048,2979,145.458984375
75,72,12,1058,4096,-3038,-74.169921875
75,72,13,16426,8192,8234,100.5126953125
75,72,14,35117,16384,18733,114.337158203125
75,72,15,60567,32768,27799,84.8358154296875
75,73,1,0,2,-2,-100.0
75,73,2,2,4,-2,-50.0
75,73,3,7,8,-1,-12.5
75,73,4,5,16,-11,-68.75
75,73,5,5,32,-27,-84.375
75,73,6,35,64,-29,-45.3125
75,73,7,31,128,-97,-75.78125
75,73,8,429,256,173,67.578125
75,73,9,109,512,-403,-78.7109375
75,73,10,393,1024,-631,-61.62109375
75,73,11,51,2048,-1997,-97.509765625
75,73,12,881,4096,-3215,-78.4912109375
75,73,13,7363,8192,-829,-10.11962890625
75,73,14,50,16384,-16334,-99.69482421875
75,73,15,87993,32768,55225,168.5333251953125
75,74,1,0,2,-2,-100.0
75,74,2,1,4,-3,-75.0
75,74,3,4,8,-4,-50.0
75,74,4,16,16,0,0.0
75,74,5,63,32,31,96.875
75,74,6,20,64,-44,-68.75
75,74,7,321,128,193,150.78125
75,74,8,39,256,-217,-84.765625
75,74,9,338,512,-174,-33.984375
75,74,10,2949,1024,1925,187.98828125
75,74,11,7876,2048,5828,284.5703125
75,74,12,3278,4096,-818,-19.970703125
75,74,13,8559,8192,367,4.47998046875
75,74,14,16745,16384,361,2.203369140625
75,74,15,16989,32768,-15779,-48.1536865234375
75,75,1,0,2,-2,-100.0
75,75,2,2,4,-2,-50.0
75,75,3,5,8,-3,-37.5
75,75,4,26,16,10,62.5
75,75,5,20,32,-12,-37.5
75,75,6,69,64,5,7.8125
75,75,7,57,128,-71,-55.46875
75,75,8,210,256,-46,-17.96875
75,75,9,234,512,-278,-54.296875
75,75,10,706,1024,-318,-31.0546875
75,75,11,730,2048,-1318,-64.35546875
75,75,12,4320,4096,224,5.46875
75,75,13,6373,8192,-1819,-22.20458984375
75,75,14,10424,16384,-5960,-36.376953125
75,75,15,43414,32768,10646,32.489013671875
76,1,1,0,2,-2,-100.0
76,1,2,1,4,-3,-75.0
76,1,3,3,8,-5,-62.5
76,1,4,3,16,-13,-81.25
76,1,5,30,32,-2,-6.25
76,1,6,110,64,46,71.875
76,1,7,57,128,-71,-55.46875
76,1,8,120,256,-136,-53.125
76,1,9,316,512,-196,-38.28125
76,1,10,832,1024,-192,-18.75
76,1,11,6713,2048,4665,227.783203125
76,1,12,2138,4096,-1958,-47.802734375
76,1,13,21772,8192,13580,165.771484375
76,1,14,1639,16384,-14745,-89.996337890625
76,1,15,4516,32768,-28252,-86.21826171875
76,2,1,0,2,-2,-100.0
76,2,2,2,4,-2,-50.0
76,2,3,12,8,4,50.0
76,2,4,8,16,-8,-50.0
76,2,5,20,32,-12,-37.5
76,2,6,8,64,-56,-87.5
76,2,7,271,128,143,111.71875
76,2,8,169,256,-87,-33.984375
76,2,9,1038,512,526,102.734375
76,2,10,1888,1024,864,84.375
76,2,11,2597,2048,549,26.806640625
76,2,12,470,4096,-3626,-88.525390625
76,2,13,11710,8192,3518,42.9443359375
76,2,14,1698,16384,-14686,-89.63623046875
76,2,15,6555,32768,-26213,-79.9957275390625
76,3,1,0,2,-2,-100.0
76,3,2,1,4,-3,-75.0
76,3,3,10,8,2,25.0
76,3,4,12,16,-4,-25.0
76,3,5,27,32,-5,-15.625
76,3,6,151,64,87,135.9375
76,3,7,123,128,-5,-3.90625
76,3,8,30,256,-226,-88.28125
76,3,9,86,512,-426,-83.203125
76,3,10,427,1024,-597,-58.30078125
76,3,11,2844,2048,796,38.8671875
76,3,12,5913,4096,1817,44.3603515625
76,3,13,34543,8192,26351,321.66748046875
76,3,14,10063,16384,-6321,-38.580322265625
76,3,15,2154,32768,-30614,-93.426513671875
76,4,1,0,2,-2,-100.0
76,4,2,2,4,-2,-50.0
76,4,3,2,8,-6,-75.0
76,4,4,15,16,-1,-6.25
76,4,5,19,32,-13,-40.625
76,4,6,72,64,8,12.5
76,4,7,319,128,191,149.21875
76,4,8,161,256,-95,-37.109375
76,4,9,150,512,-362,-70.703125
76,4,10,723,1024,-301,-29.39453125
76,4,11,144,2048,-1904,-92.96875
76,4,12,1023,4096,-3073,-75.0244140625
76,4,13,6091,8192,-2101,-25.64697265625
76,4,14,5478,16384,-10906,-66.56494140625
76,4,15,13144,32768,-19624,-59.8876953125
76,5,1,0,2,-2,-100.0
76,5,2,1,4,-3,-75.0
76,5,3,10,8,2,25.0
76,5,4,19,16,3,18.75
76,5,5,36,32,4,12.5
76,5,6,84,64,20,31.25
76,5,7,259,128,131,102.34375
76,5,8,257,256,1,0.390625
76,5,9,277,512,-235,-45.8984375
76,5,10,1002,1024,-22,-2.1484375
76,5,11,1918,2048,-130,-6.34765625
76,5,12,1444,4096,-2652,-64.74609375
76,5,13,19372,8192,11180,136.474609375
76,5,14,8102,16384,-8282,-50.54931640625
76,5,15,19055,32768,-13713,-41.8487548828125
76,6,1,0,2,-2,-100.0
76,6,2,4,4,0,0.0
76,6,3,2,8,-6,-75.0
76,6,4,10,16,-6,-37.5
76,6,5,25,32,-7,-21.875
76,6,6,21,64,-43,-67.1875
76,6,7,224,128,96,75.0
76,6,8,7,256,-249,-97.265625
76,6,9,120,512,-392,-76.5625
76,6,10,677,1024,-347,-33.88671875
76,6,11,6504,2048,4456,217.578125
76,6,12,13461,4096,9365,228.6376953125
76,6,13,24389,8192,16197,197.71728515625
76,6,14,6155,16384,-10229,-62.432861328125
76,6,15,43381,32768,10613,32.3883056640625
76,7,1,0,2,-2,-100.0
76,7,2,1,4,-3,-75.0
76,7,3,4,8,-4,-50.0
76,7,4,8,16,-8,-50.0
76,7,5,8,32,-24,-75.0
76,7,6,100,64,36,56.25
76,7,7,74,128,-54,-42.1875
76,7,8,338,256,82,32.03125
76,7,9,63,512,-449,-87.6953125
76,7,10,2705,1024,1681,164.16015625
76,7,11,282,2048,-1766,-86.23046875
76,7,12,3409,4096,-687,-16.7724609375
76,7,13,3697,8192,-4495,-54.87060546875
76,7,14,33724,16384,17340,105.8349609375
76,7,15,346343,32768,313575,956.9549560546875
76,8,1,0,2,-2,-100.0
76,8,2,1,4,-3,-75.0
76,8,3,9,8,1,12.5
76,8,4,32,16,16,100.0
76,8,5,14,32,-18,-56.25
76,8,6,6,64,-58,-90.625
76,8,7,98,128,-30,-23.4375
76,8,8,93,256,-163,-63.671875
76,8,9,1040,512,528,103.125
76,8,10,1641,1024,617,60.25390625
76,8,11,1796,2048,-252,-12.3046875
76,8,12,6625,4096,2529,61.7431640625
76,8,13,19872,8192,11680,142.578125
76,8,14,7439,16384,-8945,-54.595947265625
76,8,15,21068,32768,-11700,-35.70556640625
76,9,1,0,2,-2,-100.0
76,9,2,1,4,-3,-75.0
76,9,3,15,8,7,87.5
76,9,4,53,16,37,231.25
76,9,5,21,32,-11,-34.375
76,9,6,67,64,3,4.6875
76,9,7,300,128,172,134.375
76,9,8,529,256,273,106.640625
76,9,9,168,512,-344,-67.1875
76,9,10,2030,1024,1006,98.2421875
76,9,11,168,2048,-1880,-91.796875
76,9,12,2712,4096,-1384,-33.7890625
76,9,13,11829,8192,3637,44.39697265625
76,9,14,431,16384,-15953,-97.369384765625
76,9,15,5405,32768,-27363,-83.5052490234375
76,10,1,0,2,-2,-100.0
76,10,2,3,4,-1,-25.0
76,10,3,11,8,3,37.5
76,10,4,11,16,-5,-31.25
76,10,5,9,32,-23,-71.875
76,10,6,22,64,-42,-65.625
76,10,7,44,128,-84,-65.625
76,10,8,28,256,-228,-89.0625
76,10,9,443,512,-69,-13.4765625
76,10,10,690,1024,-334,-32.6171875
76,10,11,597,2048,-1451,-70.849609375
76,10,12,1226,4096,-2870,-70.068359375
76,10,13,10913,8192,2721,33.21533203125
76,10,14,20057,16384,3673,22.418212890625
76,10,15,41173,32768,8405,25.6500244140625
76,11,1,0,2,-2,-100.0
76,11,2,5,4,1,25.0
76,11,3,2,8,-6,-75.0
76,11,4,13,16,-3,-18.75
76,11,5,13,32,-19,-59.375
76,11,6,60,64,-4,-6.25
76,11,7,51,128,-77,-60.15625
76,11,8,153,256,-103,-40.234375
76,11,9,846,512,334,65.234375
76,11,10,135,1024,-889,-86.81640625
76,11,11,5231,2048,3183,155.419921875
76,11,12,101,4096,-3995,-97.5341796875
76,11,13,6730,8192,-1462,-17.8466796875
76,11,14,7449,16384,-8935,-54.534912109375
76,11,15,10863,32768,-21905,-66.8487548828125
76,12,1,0,2,-2,-100.0
76,12,2,1,4,-3,-75.0
76,12,3,3,8,-5,-62.5
76,12,4,11,16,-5,-31.25
76,12,5,35,32,3,9.375
76,12,6,27,64,-37,-57.8125
76,12,7,217,128,89,69.53125
76,12,8,26,256,-230,-89.84375
76,12,9,531,512,19,3.7109375
76,12,10,73,1024,-951,-92.87109375
76,12,11,3565,2048,1517,74.072265625
76,12,12,340,4096,-3756,-91.69921875
76,12,13,10685,8192,2493,30.43212890625
76,12,14,56686,16384,40302,245.98388671875
76,12,15,30866,32768,-1902,-5.804443359375
76,13,1,0,2,-2,-100.0
76,13,2,1,4,-3,-75.0
76,13,3,3,8,-5,-62.5
76,13,4,21,16,5,31.25
76,13,5,5,32,-27,-84.375
76,13,6,31,64,-33,-51.5625
76,13,7,113,128,-15,-11.71875
76,13,8,550,256,294,114.84375
76,13,9,873,512,361,70.5078125
76,13,10,221,1024,-803,-78.41796875
76,13,11,1817,2048,-231,-11.279296875
76,13,12,3982,4096,-114,-2.783203125
76,13,13,8806,8192,614,7.4951171875
76,13,14,34832,16384,18448,112.59765625
76,13,15,43265,32768,10497,32.0343017578125
76,14,1,0,2,-2,-100.0
76,14,2,1,4,-3,-75.0
76,14,3,2,8,-6,-75.0
76,14,4,15,16,-1,-6.25
76,14,5,19,32,-13,-40.625
76,14,6,39,64,-25,-39.0625
76,14,7,42,128,-86,-67.1875
76,14,8,218,256,-38,-14.84375
76,14,9,380,512,-132,-25.78125
76,14,10,752,1024,-272,-26.5625
76,14,11,568,2048,-1480,-72.265625
76,14,12,11349,4096,7253,177.0751953125
76,14,13,12525,8192,4333,52.89306640625
76,14,14,9805,16384,-6579,-40.155029296875
76,14,15,28570,32768,-4198,-12.811279296875
76,15,1,0,2,-2,-100.0
76,15,2,1,4,-3,-75.0
76,15,3,8,8,0,0.0
76,15,4,25,16,9,56.25
76,15,5,35,32,3,9.375
76,15,6,77,64,13,20.3125
76,15,7,63,128,-65,-50.78125
76,15,8,1184,256,928,362.5
76,15,9,116,512,-396,-77.34375
76,15,10,1127,1024,103,10.05859375
76,15,11,648,2048,-1400,-68.359375
76,15,12,28963,4096,24867,607.1044921875
76,15,13,16712,8192,8520,104.00390625
76,15,14,74822,16384,58438,356.67724609375
76,15,15,5745,32768,-27023,-82.4676513671875
76,16,1,0,2,-2,-100.0
76,16,2,2,4,-2,-50.0
76,16,3,4,8,-4,-50.0
76,16,4,39,16,23,143.75
76,16,5,13,32,-19,-59.375
76,16,6,100,64,36,56.25
76,16,7,44,128,-84,-65.625
76,16,8,255,256,-1,-0.390625
76,16,9,30,512,-482,-94.140625
76,16,10,609,1024,-415,-40.52734375
76,16,11,4976,2048,2928,142.96875
76,16,12,1927,4096,-2169,-52.9541015625
76,16,13,1273,8192,-6919,-84.46044921875
76,16,14,2337,16384,-14047,-85.736083984375
76,16,15,20309,32768,-12459,-38.0218505859375
76,17,1,0,2,-2,-100.0
76,17,2,2,4,-2,-50.0
76,17,3,5,8,-3,-37.5
76,17,4,6,16,-10,-62.5
76,17,5,13,32,-19,-59.375
76,17,6,73,64,9,14.0625
76,17,7,8,128,-120,-93.75
76,17,8,60,256,-196,-76.5625
76,17,9,503,512,-9,-1.7578125
76,17,10,77,1024,-947,-92.48046875
76,17,11,362,2048,-1686,-82.32421875
76,17,12,8151,4096,4055,98.9990234375
76,17,13,19973,8192,11781,143.81103515625
76,17,14,2149,16384,-14235,-86.883544921875
76,17,15,107832,32768,75064,229.0771484375
76,18,1,0,2,-2,-100.0
76,18,2,3,4,-1,-25.0
76,18,3,15,8,7,87.5
76,18,4,39,16,23,143.75
76,18,5,66,32,34,106.25
76,18,6,33,64,-31,-48.4375
76,18,7,63,128,-65,-50.78125
76,18,8,222,256,-34,-13.28125
76,18,9,23,512,-489,-95.5078125
76,18,10,742,1024,-282,-27.5390625
76,18,11,1003,2048,-1045,-51.025390625
76,18,12,3646,4096,-450,-10.986328125
76,18,13,2189,8192,-6003,-73.27880859375
76,18,14,57603,16384,41219,251.580810546875
76,18,15,17028,32768,-15740,-48.03466796875
76,19,1,0,2,-2,-100.0
76,19,2,1,4,-3,-75.0
76,19,3,7,8,-1,-12.5
76,19,4,11,16,-5,-31.25
76,19,5,12,32,-20,-62.5
76,19,6,36,64,-28,-43.75
76,19,7,72,128,-56,-43.75
76,19,8,117,256,-139,-54.296875
76,19,9,86,512,-426,-83.203125
76,19,10,1939,1024,915,89.35546875
76,19,11,2229,2048,181,8.837890625
76,19,12,489,4096,-3607,-88.0615234375
76,19,13,2515,8192,-5677,-69.29931640625
76,19,14,25351,16384,8967,54.730224609375
76,19,15,27695,32768,-5073,-15.4815673828125
76,20,1,0,2,-2,-100.0
76,20,2,1,4,-3,-75.0
76,20,3,2,8,-6,-75.0
76,20,4,3,16,-13,-81.25
76,20,5,4,32,-28,-87.5
76,20,6,76,64,12,18.75
76,20,7,191,128,63,49.21875
76,20,8,77,256,-179,-69.921875
76,20,9,618,512,106,20.703125
76,20,10,511,1024,-513,-50.09765625
76,20,11,3433,2048,1385,67.626953125
76,20,12,10123,4096,6027,147.1435546875
76,20,13,23414,8192,15222,185.8154296875
76,20,14,54481,16384,38097,232.525634765625
76,20,15,217260,32768,184492,563.02490234375
76,21,1,0,2,-2,-100.0
76,21,2,1,4,-3,-75.0
76,21,3,10,8,2,25.0
76,21,4,3,16,-13,-81.25
76,21,5,14,32,-18,-56.25
76,21,6,61,64,-3,-4.6875
76,21,7,49,128,-79,-61.71875
76,21,8,99,256,-157,-61.328125
76,21,9,619,512,107,20.8984375
76,21,10,2658,1024,1634,159.5703125
76,21,11,3554,2048,1506,73.53515625
76,21,12,1032,4096,-3064,-74.8046875
76,21,13,22054,8192,13862,169.2138671875
76,21,14,23011,16384,6627,40.447998046875
76,21,15,70523,32768,37755,115.2191162109375
76,22,1,0,2,-2,-100.0
76,22,2,2,4,-2,-50.0
76,22,3,8,8,0,0.0
76,22,4,8,16,-8,-50.0
76,22,5,21,32,-11,-34.375
76,22,6,17,64,-47,-73.4375
76,22,7,80,128,-48,-37.5
76,22,8,325,256,69,26.953125
76,22,9,519,512,7,1.3671875
76,22,10,1740,1024,716,69.921875
76,22,11,7168,2048,5120,250.0
76,22,12,5162,4096,1066,26.025390625
76,22,13,249,8192,-7943,-96.96044921875
76,22,14,11843,16384,-4541,-27.716064453125
76,22,15,58402,32768,25634,78.228759765625
76,23,1,0,2,-2,-100.0
76,23,2,1,4,-3,-75.0
76,23,3,4,8,-4,-50.0
76,23,4,3,16,-13,-81.25
76,23,5,63,32,31,96.875
76,23,6,69,64,5,7.8125
76,23,7,100,128,-28,-21.875
76,23,8,334,256,78,30.46875
76,23,9,499,512,-13,-2.5390625
76,23,10,1496,1024,472,46.09375
76,23,11,1035,2048,-1013,-49.462890625
76,23,12,464,4096,-3632,-88.671875
76,23,13,209,8192,-7983,-97.44873046875
76,23,14,3101,16384,-13283,-81.072998046875
76,23,15,51782,32768,19014,58.026123046875
76,24,1,0,2,-2,-100.0
76,24,2,1,4,-3,-75.0
76,24,3,3,8,-5,-62.5
76,24,4,3,16,-13,-81.25
76,24,5,6,32,-26,-81.25
76,24,6,81,64,17,26.5625
76,24,7,66,128,-62,-48.4375
76,24,8,415,256,159,62.109375
76,24,9,397,512,-115,-22.4609375
76,24,10,827,1024,-197,-19.23828125
76,24,11,1906,2048,-142,-6.93359375
76,24,12,11897,4096,7801,190.4541015625
76,24,13,2185,8192,-6007,-73.32763671875
76,24,14,36128,16384,19744,120.5078125
76,24,15,11166,32768,-21602,-65.924072265625
76,25,1,0,2,-2,-100.0
76,25,2,1,4,-3,-75.0
76,25,3,2,8,-6,-75.0
76,25,4,6,16,-10,-62.5
76,25,5,52,32,20,62.5
76,25,6,123,64,59,92.1875
76,25,7,140,128,12,9.375
76,25,8,438,256,182,71.09375
76,25,9,61,512,-451,-88.0859375
76,25,10,599,1024,-425,-41.50390625
76,25,11,577,2048,-1471,-71.826171875
76,25,12,121,4096,-3975,-97.0458984375
76,25,13,4216,8192,-3976,-48.53515625
76,25,14,7027,16384,-9357,-57.110595703125
76,25,15,12918,32768,-19850,-60.577392578125
76,26,1,0,2,-2,-100.0
76,26,2,1,4,-3,-75.0
76,26,3,2,8,-6,-75.0
76,26,4,4,16,-12,-75.0
76,26,5,58,32,26,81.25
76,26,6,48,64,-16,-25.0
76,26,7,65,128,-63,-49.21875
76,26,8,792,256,536,209.375
76,26,9,8,512,-504,-98.4375
76,26,10,1045,1024,21,2.05078125
76,26,11,53,2048,-1995,-97.412109375
76,26,12,712,4096,-3384,-82.6171875
76,26,13,507,8192,-7685,-93.81103515625
76,26,14,13534,16384,-2850,-17.39501953125
76,26,15,11948,32768,-20820,-63.53759765625
76,27,1,0,2,-2,-100.0
76,27,2,1,4,-3,-75.0
76,27,3,5,8,-3,-37.5
76,27,4,3,16,-13,-81.25
76,27,5,69,32,37,115.625
76,27,6,50,64,-14,-21.875
76,27,7,80,128,-48,-37.5
76,27,8,19,256,-237,-92.578125
76,27,9,35,512,-477,-93.1640625
76,27,10,4682,1024,3658,357.2265625
76,27,11,3249,2048,1201,58.642578125
76,27,12,1431,4096,-2665,-65.0634765625
76,27,13,685,8192,-7507,-91.63818359375
76,27,14,19338,16384,2954,18.02978515625
76,27,15,5807,32768,-26961,-82.2784423828125
76,28,1,0,2,-2,-100.0
76,28,2,3,4,-1,-25.0
76,28,3,6,8,-2,-25.0
76,28,4,3,16,-13,-81.25
76,28,5,6,32,-26,-81.25
76,28,6,50,64,-14,-21.875
76,28,7,23,128,-105,-82.03125
76,28,8,423,256,167,65.234375
76,28,9,657,512,145,28.3203125
76,28,10,407,1024,-617,-60.25390625
76,28,11,4130,2048,2082,101.66015625
76,28,12,6280,4096,2184,53.3203125
76,28,13,9123,8192,931,11.36474609375
76,28,14,1963,16384,-14421,-88.018798828125
76,28,15,7450,32768,-25318,-77.264404296875
76,29,1,0,2,-2,-100.0
76,29,2,1,4,-3,-75.0
76,29,3,2,8,-6,-75.0
76,29,4,6,16,-10,-62.5
76,29,5,16,32,-16,-50.0
76,29,6,121,64,57,89.0625
76,29,7,74,128,-54,-42.1875
76,29,8,562,256,306,119.53125
76,29,9,340,512,-172,-33.59375
76,29,10,386,1024,-638,-62.3046875
76,29,11,609,2048,-1439,-70.263671875
76,29,12,5636,4096,1540,37.59765625
76,29,13,16852,8192,8660,105.712890625
76,29,14,1439,16384,-14945,-91.217041015625
76,29,15,11491,32768,-21277,-64.9322509765625
76,30,1,0,2,-2,-100.0
76,30,2,1,4,-3,-75.0
76,30,3,4,8,-4,-50.0
76,30,4,11,16,-5,-31.25
76,30,5,8,32,-24,-75.0
76,30,6,22,64,-42,-65.625
76,30,7,56,128,-72,-56.25
76,30,8,58,256,-198,-77.34375
76,30,9,118,512,-394,-76.953125
76,30,10,660,1024,-364,-35.546875
76,30,11,695,2048,-1353,-66.064453125
76,30,12,9749,4096,5653,138.0126953125
76,30,13,4018,8192,-4174,-50.9521484375
76,30,14,17102,16384,718,4.38232421875
76,30,15,6630,32768,-26138,-79.766845703125
76,31,1,0,2,-2,-100.0
76,31,2,4,4,0,0.0
76,31,3,23,8,15,187.5
76,31,4,16,16,0,0.0
76,31,5,95,32,63,196.875
76,31,6,33,64,-31,-48.4375
76,31,7,12,128,-116,-90.625
76,31,8,211,256,-45,-17.578125
76,31,9,154,512,-358,-69.921875
76,31,10,5095,1024,4071,397.55859375
76,31,11,7212,2048,5164,252.1484375
76,31,12,2365,4096,-1731,-42.2607421875
76,31,13,4121,8192,-4071,-49.69482421875
76,31,14,26478,16384,10094,61.60888671875
76,31,15,19631,32768,-13137,-40.0909423828125
76,32,1,0,2,-2,-100.0
76,32,2,3,4,-1,-25.0
76,32,3,23,8,15,187.5
76,32,4,8,16,-8,-50.0
76,32,5,6,32,-26,-81.25
76,32,6,80,64,16,25.0
76,32,7,510,128,382,298.4375
76,32,8,214,256,-42,-16.40625
76,32,9,37,512,-475,-92.7734375
76,32,10,342,1024,-682,-66.6015625
76,32,11,177,2048,-1871,-91.357421875
76,32,12,73,4096,-4023,-98.2177734375
76,32,13,20227,8192,12035,146.91162109375
76,32,14,4610,16384,-11774,-71.86279296875
76,32,15,5745,32768,-27023,-82.4676513671875
76,33,1,0,2,-2,-100.0
76,33,2,1,4,-3,-75.0
76,33,3,16,8,8,100.0
76,33,4,31,16,15,93.75
76,33,5,15,32,-17,-53.125
76,33,6,106,64,42,65.625
76,33,7,87,128,-41,-32.03125
76,33,8,160,256,-96,-37.5
76,33,9,524,512,12,2.34375
76,33,10,568,1024,-456,-44.53125
76,33,11,2572,2048,524,25.5859375
76,33,12,5585,4096,1489,36.3525390625
76,33,13,1028,8192,-7164,-87.451171875
76,33,14,3146,16384,-13238,-80.79833984375
76,33,15,13357,32768,-19411,-59.2376708984375
76,34,1,0,2,-2,-100.0
76,34,2,5,4,1,25.0
76,34,3,3,8,-5,-62.5
76,34,4,32,16,16,100.0
76,34,5,51,32,19,59.375
76,34,6,41,64,-23,-35.9375
76,34,7,460,128,332,259.375
76,34,8,16,256,-240,-93.75
76,34,9,222,512,-290,-56.640625
76,34,10,1299,1024,275,26.85546875
76,34,11,812,2048,-1236,-60.3515625
76,34,12,5985,4096,1889,46.1181640625
76,34,13,9913,8192,1721,21.00830078125
76,34,14,8181,16384,-8203,-50.067138671875
76,34,15,5835,32768,-26933,-82.1929931640625
76,35,1,0,2,-2,-100.0
76,35,2,2,4,-2,-50.0
76,35,3,2,8,-6,-75.0
76,35,4,20,16,4,25.0
76,35,5,59,32,27,84.375
76,35,6,107,64,43,67.1875
76,35,7,91,128,-37,-28.90625
76,35,8,128,256,-128,-50.0
76,35,9,67,512,-445,-86.9140625
76,35,10,1267,1024,243,23.73046875
76,35,11,3648,2048,1600,78.125
76,35,12,65,4096,-4031,-98.4130859375
76,35,13,7931,8192,-261,-3.18603515625
76,35,14,32393,16384,16009,97.711181640625
76,35,15,62708,32768,29940,91.36962890625
76,36,1,0,2,-2,-100.0
76,36,2,2,4,-2,-50.0
76,36,3,14,8,6,75.0
76,36,4,31,16,15,93.75
76,36,5,4,32,-28,-87.5
76,36,6,52,64,-12,-18.75
76,36,7,31,128,-97,-75.78125
76,36,8,87,256,-169,-66.015625
76,36,9,73,512,-439,-85.7421875
76,36,10,649,1024,-375,-36.62109375
76,36,11,1744,2048,-304,-14.84375
76,36,12,3192,4096,-904,-22.0703125
76,36,13,19444,8192,11252,137.353515625
76,36,14,21959,16384,5575,34.027099609375
76,36,15,6952,32768,-25816,-78.7841796875
76,37,1,0,2,-2,-100.0
76,37,2,1,4,-3,-75.0
76,37,3,3,8,-5,-62.5
76,37,4,3,16,-13,-81.25
76,37,5,157,32,125,390.625
76,37,6,29,64,-35,-54.6875
76,37,7,81,128,-47,-36.71875
76,37,8,171,256,-85,-33.203125
76,37,9,1711,512,1199,234.1796875
76,37,10,858,1024,-166,-16.2109375
76,37,11,300,2048,-1748,-85.3515625
76,37,12,689,4096,-3407,-83.1787109375
76,37,13,2950,8192,-5242,-63.9892578125
76,37,14,7145,16384,-9239,-56.390380859375
76,37,15,84574,32768,51806,158.099365234375
76,38,1,0,2,-2,-100.0
76,38,2,4,4,0,0.0
76,38,3,9,8,1,12.5
76,38,4,7,16,-9,-56.25
76,38,5,62,32,30,93.75
76,38,6,46,64,-18,-28.125
76,38,7,250,128,122,95.3125
76,38,8,312,256,56,21.875
76,38,9,33,512,-479,-93.5546875
76,38,10,94,1024,-930,-90.8203125
76,38,11,3131,2048,1083,52.880859375
76,38,12,5095,4096,999,24.3896484375
76,38,13,1430,8192,-6762,-82.5439453125
76,38,14,30344,16384,13960,85.205078125
76,38,15,2139,32768,-30629,-93.4722900390625
76,39,1,0,2,-2,-100.0
76,39,2,4,4,0,0.0
76,39,3,7,8,-1,-12.5
76,39,4,11,16,-5,-31.25
76,39,5,21,32,-11,-34.375
76,39,6,5,64,-59,-92.1875
76,39,7,184,128,56,43.75
76,39,8,494,256,238,92.96875
76,39,9,574,512,62,12.109375
76,39,10,507,1024,-517,-50.48828125
76,39,11,3657,2048,1609,78.564453125
76,39,12,3244,4096,-852,-20.80078125
76,39,13,5630,8192,-2562,-31.2744140625
76,39,14,16056,16384,-328,-2.001953125
76,39,15,40620,32768,7852,23.96240234375
76,40,1,0,2,-2,-100.0
76,40,2,2,4,-2,-50.0
76,40,3,10,8,2,25.0
76,40,4,23,16,7,43.75
76,40,5,16,32,-16,-50.0
76,40,6,27,64,-37,-57.8125
76,40,7,213,128,85,66.40625
76,40,8,234,256,-22,-8.59375
76,40,9,1245,512,733,143.1640625
76,40,10,15,1024,-1009,-98.53515625
76,40,11,3566,2048,1518,74.12109375
76,40,12,6534,4096,2438,59.521484375
76,40,13,16476,8192,8284,101.123046875
76,40,14,20260,16384,3876,23.6572265625
76,40,15,4715,32768,-28053,-85.6109619140625
76,41,1,0,2,-2,-100.0
76,41,2,3,4,-1,-25.0
76,41,3,3,8,-5,-62.5
76,41,4,9,16,-7,-43.75
76,41,5,13,32,-19,-59.375
76,41,6,16,64,-48,-75.0
76,41,7,109,128,-19,-14.84375
76,41,8,173,256,-83,-32.421875
76,41,9,126,512,-386,-75.390625
76,41,10,195,1024,-829,-80.95703125
76,41,11,3843,2048,1795,87.646484375
76,41,12,449,4096,-3647,-89.0380859375
76,41,13,7441,8192,-751,-9.16748046875
76,41,14,6225,16384,-10159,-62.005615234375
76,41,15,64849,32768,32081,97.9034423828125
76,42,1,0,2,-2,-100.0
76,42,2,2,4,-2,-50.0
76,42,3,2,8,-6,-75.0
76,42,4,7,16,-9,-56.25
76,42,5,13,32,-19,-59.375
76,42,6,115,64,51,79.6875
76,42,7,164,128,36,28.125
76,42,8,36,256,-220,-85.9375
76,42,9,146,512,-366,-71.484375
76,42,10,554,1024,-470,-45.8984375
76,42,11,2721,2048,673,32.861328125
76,42,12,2476,4096,-1620,-39.55078125
76,42,13,8196,8192,4,0.048828125
76,42,14,11823,16384,-4561,-27.838134765625
76,42,15,31741,32768,-1027,-3.1341552734375
76,43,1,0,2,-2,-100.0
76,43,2,2,4,-2,-50.0
76,43,3,4,8,-4,-50.0
76,43,4,28,16,12,75.0
76,43,5,72,32,40,125.0
76,43,6,70,64,6,9.375
76,43,7,97,128,-31,-24.21875
76,43,8,337,256,81,31.640625
76,43,9,361,512,-151,-29.4921875
76,43,10,1031,1024,7,0.68359375
76,43,11,96,2048,-1952,-95.3125
76,43,12,1225,4096,-2871,-70.0927734375
76,43,13,51,8192,-8141,-99.37744140625
76,43,14,7555,16384,-8829,-53.887939453125
76,43,15,48892,32768,16124,49.20654296875
76,44,1,0,2,-2,-100.0
76,44,2,2,4,-2,-50.0
76,44,3,3,8,-5,-62.5
76,44,4,4,16,-12,-75.0
76,44,5,4,32,-28,-87.5
76,44,6,50,64,-14,-21.875
76,44,7,21,128,-107,-83.59375
76,44,8,22,256,-234,-91.40625
76,44,9,1449,512,937,183.0078125
76,44,10,57,1024,-967,-94.43359375
76,44,11,1399,2048,-649,-31.689453125
76,44,12,8703,4096,4607,112.4755859375
76,44,13,6143,8192,-2049,-25.01220703125
76,44,14,7056,16384,-9328,-56.93359375
76,44,15,838,32768,-31930,-97.442626953125
76,45,1,0,2,-2,-100.0
76,45,2,2,4,-2,-50.0
76,45,3,2,8,-6,-75.0
76,45,4,3,16,-13,-81.25
76,45,5,9,32,-23,-71.875
76,45,6,11,64,-53,-82.8125
76,45,7,11,128,-117,-91.40625
76,45,8,690,256,434,169.53125
76,45,9,220,512,-292,-57.03125
76,45,10,1216,1024,192,18.75
76,45,11,2041,2048,-7,-0.341796875
76,45,12,2033,4096,-2063,-50.3662109375
76,45,13,243,8192,-7949,-97.03369140625
76,45,14,12860,16384,-3524,-21.5087890625
76,45,15,2730,32768,-30038,-91.668701171875
76,46,1,0,2,-2,-100.0
76,46,2,2,4,-2,-50.0
76,46,3,3,8,-5,-62.5
76,46,4,8,16,-8,-50.0
76,46,5,19,32,-13,-40.625
76,46,6,41,64,-23,-35.9375
76,46,7,35,128,-93,-72.65625
76,46,8,12,256,-244,-95.3125
76,46,9,351,512,-161,-31.4453125
76,46,10,968,1024,-56,-5.46875
76,46,11,3433,2048,1385,67.626953125
76,46,12,2313,4096,-1783,-43.5302734375
76,46,13,6533,8192,-1659,-20.25146484375
76,46,14,301,16384,-16083,-98.162841796875
76,46,15,33840,32768,1072,3.271484375
76,47,1,0,2,-2,-100.0
76,47,2,4,4,0,0.0
76,47,3,2,8,-6,-75.0
76,47,4,4,16,-12,-75.0
76,47,5,17,32,-15,-46.875
76,47,6,130,64,66,103.125
76,47,7,65,128,-63,-49.21875
76,47,8,342,256,86,33.59375
76,47,9,505,512,-7,-1.3671875
76,47,10,1253,1024,229,22.36328125
76,47,11,801,2048,-1247,-60.888671875
76,47,12,22991,4096,18895,461.3037109375
76,47,13,5816,8192,-2376,-29.00390625
76,47,14,7233,16384,-9151,-55.853271484375
76,47,15,3373,32768,-29395,-89.7064208984375
76,48,1,0,2,-2,-100.0
76,48,2,5,4,1,25.0
76,48,3,5,8,-3,-37.5
76,48,4,18,16,2,12.5
76,48,5,52,32,20,62.5
76,48,6,106,64,42,65.625
76,48,7,6,128,-122,-95.3125
76,48,8,16,256,-240,-93.75
76,48,9,500,512,-12,-2.34375
76,48,10,919,1024,-105,-10.25390625
76,48,11,9371,2048,7323,357.568359375
76,48,12,1637,4096,-2459,-60.0341796875
76,48,13,3253,8192,-4939,-60.29052734375
76,48,14,18317,16384,1933,11.798095703125
76,48,15,4167,32768,-28601,-87.2833251953125
76,49,1,0,2,-2,-100.0
76,49,2,2,4,-2,-50.0
76,49,3,3,8,-5,-62.5
76,49,4,14,16,-2,-12.5
76,49,5,53,32,21,65.625
76,49,6,408,64,344,537.5
76,49,7,116,128,-12,-9.375
76,49,8,605,256,349,136.328125
76,49,9,86,512,-426,-83.203125
76,49,10,1414,1024,390,38.0859375
76,49,11,4988,2048,2940,143.5546875
76,49,12,4409,4096,313,7.6416015625
76,49,13,674,8192,-7518,-91.7724609375
76,49,14,22474,16384,6090,37.17041015625
76,49,15,6638,32768,-26130,-79.742431640625
76,50,1,0,2,-2,-100.0
76,50,2,1,4,-3,-75.0
76,50,3,6,8,-2,-25.0
76,50,4,3,16,-13,-81.25
76,50,5,13,32,-19,-59.375
76,50,6,5,64,-59,-92.1875
76,50,7,18,128,-110,-85.9375
76,50,8,712,256,456,178.125
76,50,9,36,512,-476,-92.96875
76,50,10,673,1024,-351,-34.27734375
76,50,11,1106,2048,-942,-45.99609375
76,50,12,2311,4096,-1785,-43.5791015625
76,50,13,180,8192,-8012,-97.802734375
76,50,14,23326,16384,6942,42.37060546875
76,50,15,5736,32768,-27032,-82.4951171875
76,51,1,0,2,-2,-100.0
76,51,2,1,4,-3,-75.0
76,51,3,4,8,-4,-50.0
76,51,4,5,16,-11,-68.75
76,51,5,8,32,-24,-75.0
76,51,6,59,64,-5,-7.8125
76,51,7,30,128,-98,-76.5625
76,51,8,332,256,76,29.6875
76,51,9,425,512,-87,-16.9921875
76,51,10,2055,1024,1031,100.68359375
76,51,11,3598,2048,1550,75.68359375
76,51,12,4143,4096,47,1.1474609375
76,51,13,5774,8192,-2418,-29.5166015625
76,51,14,3619,16384,-12765,-77.911376953125
76,51,15,10056,32768,-22712,-69.3115234375
76,52,1,0,2,-2,-100.0
76,52,2,5,4,1,25.0
76,52,3,2,8,-6,-75.0
76,52,4,3,16,-13,-81.25
76,52,5,110,32,78,243.75
76,52,6,30,64,-34,-53.125
76,52,7,149,128,21,16.40625
76,52,8,79,256,-177,-69.140625
76,52,9,684,512,172,33.59375
76,52,10,567,1024,-457,-44.62890625
76,52,11,447,2048,-1601,-78.173828125
76,52,12,1986,4096,-2110,-51.513671875
76,52,13,11626,8192,3434,41.9189453125
76,52,14,2992,16384,-13392,-81.73828125
76,52,15,8935,32768,-23833,-72.7325439453125
76,53,1,0,2,-2,-100.0
76,53,2,2,4,-2,-50.0
76,53,3,2,8,-6,-75.0
76,53,4,26,16,10,62.5
76,53,5,24,32,-8,-25.0
76,53,6,5,64,-59,-92.1875
76,53,7,317,128,189,147.65625
76,53,8,189,256,-67,-26.171875
76,53,9,195,512,-317,-61.9140625
76,53,10,1417,1024,393,38.37890625
76,53,11,1076,2048,-972,-47.4609375
76,53,12,1559,4096,-2537,-61.9384765625
76,53,13,26433,8192,18241,222.66845703125
76,53,14,20693,16384,4309,26.300048828125
76,53,15,7545,32768,-25223,-76.9744873046875
76,54,1,0,2,-2,-100.0
76,54,2,1,4,-3,-75.0
76,54,3,4,8,-4,-50.0
76,54,4,21,16,5,31.25
76,54,5,55,32,23,71.875
76,54,6,47,64,-17,-26.5625
76,54,7,42,128,-86,-67.1875
76,54,8,236,256,-20,-7.8125
76,54,9,1088,512,576,112.5
76,54,10,1186,1024,162,15.8203125
76,54,11,1161,2048,-887,-43.310546875
76,54,12,31,4096,-4065,-99.2431640625
76,54,13,5183,8192,-3009,-36.73095703125
76,54,14,13051,16384,-3333,-20.343017578125
76,54,15,9948,32768,-22820,-69.64111328125
76,55,1,0,2,-2,-100.0
76,55,2,2,4,-2,-50.0
76,55,3,11,8,3,37.5
76,55,4,3,16,-13,-81.25
76,55,5,49,32,17,53.125
76,55,6,25,64,-39,-60.9375
76,55,7,185,128,57,44.53125
76,55,8,51,256,-205,-80.078125
76,55,9,352,512,-160,-31.25
76,55,10,204,1024,-820,-80.078125
76,55,11,2346,2048,298,14.55078125
76,55,12,1662,4096,-2434,-59.423828125
76,55,13,3294,8192,-4898,-59.7900390625
76,55,14,4054,16384,-12330,-75.25634765625
76,55,15,14080,32768,-18688,-57.03125
76,56,1,0,2,-2,-100.0
76,56,2,1,4,-3,-75.0
76,56,3,3,8,-5,-62.5
76,56,4,6,16,-10,-62.5
76,56,5,15,32,-17,-53.125
76,56,6,411,64,347,542.1875
76,56,7,41,128,-87,-67.96875
76,56,8,120,256,-136,-53.125
76,56,9,1297,512,785,153.3203125
76,56,10,575,1024,-449,-43.84765625
76,56,11,914,2048,-1134,-55.37109375
76,56,12,7315,4096,3219,78.5888671875
76,56,13,3519,8192,-4673,-57.04345703125
76,56,14,14705,16384,-1679,-10.247802734375
76,56,15,15403,32768,-17365,-52.9937744140625
76,57,1,0,2,-2,-100.0
76,57,2,1,4,-3,-75.0
76,57,3,4,8,-4,-50.0
76,57,4,14,16,-2,-12.5
76,57,5,7,32,-25,-78.125
76,57,6,68,64,4,6.25
76,57,7,9,128,-119,-92.96875
76,57,8,173,256,-83,-32.421875
76,57,9,231,512,-281,-54.8828125
76,57,10,489,1024,-535,-52.24609375
76,57,11,1149,2048,-899,-43.896484375
76,57,12,404,4096,-3692,-90.13671875
76,57,13,15053,8192,6861,83.75244140625
76,57,14,8508,16384,-7876,-48.0712890625
76,57,15,25617,32768,-7151,-21.8231201171875
76,58,1,0,2,-2,-100.0
76,58,2,5,4,1,25.0
76,58,3,4,8,-4,-50.0
76,58,4,4,16,-12,-75.0
76,58,5,74,32,42,131.25
76,58,6,95,64,31,48.4375
76,58,7,92,128,-36,-28.125
76,58,8,105,256,-151,-58.984375
76,58,9,288,512,-224,-43.75
76,58,10,540,1024,-484,-47.265625
76,58,11,1087,2048,-961,-46.923828125
76,58,12,3072,4096,-1024,-25.0
76,58,13,8844,8192,652,7.958984375
76,58,14,5446,16384,-10938,-66.76025390625
76,58,15,18136,32768,-14632,-44.6533203125
76,59,1,0,2,-2,-100.0
76,59,2,2,4,-2,-50.0
76,59,3,2,8,-6,-75.0
76,59,4,8,16,-8,-50.0
76,59,5,11,32,-21,-65.625
76,59,6,16,64,-48,-75.0
76,59,7,80,128,-48,-37.5
76,59,8,40,256,-216,-84.375
76,59,9,112,512,-400,-78.125
76,59,10,137,1024,-887,-86.62109375
76,59,11,3714,2048,1666,81.34765625
76,59,12,3342,4096,-754,-18.408203125
76,59,13,1632,8192,-6560,-80.078125
76,59,14,32748,16384,16364,99.8779296875
76,59,15,1930,32768,-30838,-94.110107421875
76,60,1,0,2,-2,-100.0
76,60,2,1,4,-3,-75.0
76,60,3,2,8,-6,-75.0
76,60,4,18,16,2,12.5
76,60,5,47,32,15,46.875
76,60,6,91,64,27,42.1875
76,60,7,185,128,57,44.53125
76,60,8,44,256,-212,-82.8125
76,60,9,1046,512,534,104.296875
76,60,10,303,1024,-721,-70.41015625
76,60,11,169,2048,-1879,-91.748046875
76,60,12,4131,4096,35,0.8544921875
76,60,13,5419,8192,-2773,-33.85009765625
76,60,14,50940,16384,34556,210.9130859375
76,60,15,14405,32768,-18363,-56.0394287109375
76,61,1,0,2,-2,-100.0
76,61,2,1,4,-3,-75.0
76,61,3,3,8,-5,-62.5
76,61,4,3,16,-13,-81.25
76,61,5,49,32,17,53.125
76,61,6,232,64,168,262.5
76,61,7,21,128,-107,-83.59375
76,61,8,172,256,-84,-32.8125
76,61,9,357,512,-155,-30.2734375
76,61,10,532,1024,-492,-48.046875
76,61,11,392,2048,-1656,-80.859375
76,61,12,3926,4096,-170,-4.150390625
76,61,13,6424,8192,-1768,-21.58203125
76,61,14,259,16384,-16125,-98.419189453125
76,61,15,1745,32768,-31023,-94.6746826171875
76,62,1,0,2,-2,-100.0
76,62,2,1,4,-3,-75.0
76,62,3,4,8,-4,-50.0
76,62,4,58,16,42,262.5
76,62,5,25,32,-7,-21.875
76,62,6,27,64,-37,-57.8125
76,62,7,54,128,-74,-57.8125
76,62,8,67,256,-189,-73.828125
76,62,9,550,512,38,7.421875
76,62,10,599,1024,-425,-41.50390625
76,62,11,13,2048,-2035,-99.365234375
76,62,12,7756,4096,3660,89.35546875
76,62,13,749,8192,-7443,-90.85693359375
76,62,14,17914,16384,1530,9.33837890625
76,62,15,67629,32768,34861,106.3873291015625
76,63,1,0,2,-2,-100.0
76,63,2,7,4,3,75.0
76,63,3,5,8,-3,-37.5
76,63,4,36,16,20,125.0
76,63,5,16,32,-16,-50.0
76,63,6,176,64,112,175.0
76,63,7,19,128,-109,-85.15625
76,63,8,132,256,-124,-48.4375
76,63,9,1946,512,1434,280.078125
76,63,10,799,1024,-225,-21.97265625
76,63,11,1811,2048,-237,-11.572265625
76,63,12,3199,4096,-897,-21.8994140625
76,63,13,6208,8192,-1984,-24.21875
76,63,14,11180,16384,-5204,-31.7626953125
76,63,15,29254,32768,-3514,-10.723876953125
76,64,1,0,2,-2,-100.0
76,64,2,1,4,-3,-75.0
76,64,3,8,8,0,0.0
76,64,4,3,16,-13,-81.25
76,64,5,59,32,27,84.375
76,64,6,60,64,-4,-6.25
76,64,7,55,128,-73,-57.03125
76,64,8,582,256,326,127.34375
76,64,9,1328,512,816,159.375
76,64,10,262,1024,-762,-74.4140625
76,64,11,5303,2048,3255,158.935546875
76,64,12,2617,4096,-1479,-36.1083984375
76,64,13,9663,8192,1471,17.95654296875
76,64,14,20333,16384,3949,24.102783203125
76,64,15,34715,32768,1947,5.9417724609375
76,65,1,0,2,-2,-100.0
76,65,2,1,4,-3,-75.0
76,65,3,2,8,-6,-75.0
76,65,4,18,16,2,12.5
76,65,5,47,32,15,46.875
76,65,6,88,64,24,37.5
76,65,7,114,128,-14,-10.9375
76,65,8,49,256,-207,-80.859375
76,65,9,454,512,-58,-11.328125
76,65,10,309,1024,-715,-69.82421875
76,65,11,355,2048,-1693,-82.666015625
76,65,12,1320,4096,-2776,-67.7734375
76,65,13,5551,8192,-2641,-32.23876953125
76,65,14,25271,16384,8887,54.241943359375
76,65,15,40613,32768,7845,23.9410400390625
76,66,1,0,2,-2,-100.0
76,66,2,1,4,-3,-75.0
76,66,3,2,8,-6,-75.0
76,66,4,19,16,3,18.75
76,66,5,32,32,0,0.0
76,66,6,11,64,-53,-82.8125
76,66,7,295,128,167,130.46875
76,66,8,66,256,-190,-74.21875
76,66,9,284,512,-228,-44.53125
76,66,10,648,1024,-376,-36.71875
76,66,11,4031,2048,1983,96.826171875
76,66,12,2934,4096,-1162,-28.369140625
76,66,13,10910,8192,2718,33.1787109375
76,66,14,24851,16384,8467,51.678466796875
76,66,15,43936,32768,11168,34.08203125
76,67,1,0,2,-2,-100.0
76,67,2,5,4,1,25.0
76,67,3,4,8,-4,-50.0
76,67,4,10,16,-6,-37.5
76,67,5,109,32,77,240.625
76,67,6,145,64,81,126.5625
76,67,7,83,128,-45,-35.15625
76,67,8,117,256,-139,-54.296875
76,67,9,397,512,-115,-22.4609375
76,67,10,300,1024,-724,-70.703125
76,67,11,316,2048,-1732,-84.5703125
76,67,12,3897,4096,-199,-4.8583984375
76,67,13,339,8192,-7853,-95.86181640625
76,67,14,17364,16384,980,5.9814453125
76,67,15,8196,32768,-24572,-74.98779296875
76,68,1,0,2,-2,-100.0
76,68,2,1,4,-3,-75.0
76,68,3,2,8,-6,-75.0
76,68,4,24,16,8,50.0
76,68,5,18,32,-14,-43.75
76,68,6,162,64,98,153.125
76,68,7,40,128,-88,-68.75
76,68,8,70,256,-186,-72.65625
76,68,9,554,512,42,8.203125
76,68,10,45,1024,-979,-95.60546875
76,68,11,5200,2048,3152,153.90625
76,68,12,462,4096,-3634,-88.720703125
76,68,13,1989,8192,-6203,-75.72021484375
76,68,14,12807,16384,-3577,-21.832275390625
76,68,15,10249,32768,-22519,-68.7225341796875
76,69,1,0,2,-2,-100.0
76,69,2,3,4,-1,-25.0
76,69,3,2,8,-6,-75.0
76,69,4,8,16,-8,-50.0
76,69,5,26,32,-6,-18.75
76,69,6,148,64,84,131.25
76,69,7,223,128,95,74.21875
76,69,8,145,256,-111,-43.359375
76,69,9,594,512,82,16.015625
76,69,10,614,1024,-410,-40.0390625
76,69,11,662,2048,-1386,-67.67578125
76,69,12,1803,4096,-2293,-55.9814453125
76,69,13,15485,8192,7293,89.02587890625
76,69,14,4421,16384,-11963,-73.016357421875
76,69,15,16252,32768,-16516,-50.40283203125
76,70,1,0,2,-2,-100.0
76,70,2,6,4,2,50.0
76,70,3,5,8,-3,-37.5
76,70,4,23,16,7,43.75
76,70,5,9,32,-23,-71.875
76,70,6,6,64,-58,-90.625
76,70,7,103,128,-25,-19.53125
76,70,8,222,256,-34,-13.28125
76,70,9,1416,512,904,176.5625
76,70,10,1167,1024,143,13.96484375
76,70,11,1949,2048,-99,-4.833984375
76,70,12,5492,4096,1396,34.08203125
76,70,13,1826,8192,-6366,-77.7099609375
76,70,14,6044,16384,-10340,-63.1103515625
76,70,15,69752,32768,36984,112.8662109375
76,71,1,0,2,-2,-100.0
76,71,2,2,4,-2,-50.0
76,71,3,2,8,-6,-75.0
76,71,4,13,16,-3,-18.75
76,71,5,24,32,-8,-25.0
76,71,6,38,64,-26,-40.625
76,71,7,36,128,-92,-71.875
76,71,8,294,256,38,14.84375
76,71,9,217,512,-295,-57.6171875
76,71,10,1831,1024,807,78.80859375
76,71,11,74,2048,-1974,-96.38671875
76,71,12,9579,4096,5483,133.8623046875
76,71,13,7816,8192,-376,-4.58984375
76,71,14,1630,16384,-14754,-90.05126953125
76,71,15,4398,32768,-28370,-86.578369140625
76,72,1,0,2,-2,-100.0
76,72,2,1,4,-3,-75.0
76,72,3,3,8,-5,-62.5
76,72,4,8,16,-8,-50.0
76,72,5,13,32,-19,-59.375
76,72,6,45,64,-19,-29.6875
76,72,7,27,128,-101,-78.90625
76,72,8,89,256,-167,-65.234375
76,72,9,208,512,-304,-59.375
76,72,10,3097,1024,2073,202.44140625
76,72,11,3728,2048,1680,82.03125
76,72,12,1817,4096,-2279,-55.6396484375
76,72,13,23485,8192,15293,186.68212890625
76,72,14,14628,16384,-1756,-10.7177734375
76,72,15,11222,32768,-21546,-65.753173828125
76,73,1,0,2,-2,-100.0
76,73,2,1,4,-3,-75.0
76,73,3,4,8,-4,-50.0
76,73,4,6,16,-10,-62.5
76,73,5,18,32,-14,-43.75
76,73,6,50,64,-14,-21.875
76,73,7,363,128,235,183.59375
76,73,8,451,256,195,76.171875
76,73,9,328,512,-184,-35.9375
76,73,10,289,1024,-735,-71.77734375
76,73,11,236,2048,-1812,-88.4765625
76,73,12,2877,4096,-1219,-29.7607421875
76,73,13,871,8192,-7321,-89.36767578125
76,73,14,9761,16384,-6623,-40.423583984375
76,73,15,45865,32768,13097,39.9688720703125
76,74,1,0,2,-2,-100.0
76,74,2,3,4,-1,-25.0
76,74,3,2,8,-6,-75.0
76,74,4,3,16,-13,-81.25
76,74,5,19,32,-13,-40.625
76,74,6,55,64,-9,-14.0625
76,74,7,154,128,26,20.3125
76,74,8,8,256,-248,-96.875
76,74,9,452,512,-60,-11.71875
76,74,10,837,1024,-187,-18.26171875
76,74,11,393,2048,-1655,-80.810546875
76,74,12,348,4096,-3748,-91.50390625
76,74,13,6431,8192,-1761,-21.49658203125
76,74,14,21940,16384,5556,33.9111328125
76,74,15,1738,32768,-31030,-94.696044921875
76,75,1,0,2,-2,-100.0
76,75,2,2,4,-2,-50.0
76,75,3,4,8,-4,-50.0
76,75,4,3,16,-13,-81.25
76,75,5,4,32,-28,-87.5
76,75,6,180,64,116,181.25
76,75,7,109,128,-19,-14.84375
76,75,8,560,256,304,118.75
76,75,9,86,512,-426,-83.203125
76,75,10,1780,1024,756,73.828125
76,75,11,3490,2048,1442,70.41015625
76,75,12,520,4096,-3576,-87.3046875
76,75,13,1393,8192,-6799,-82.99560546875
76,75,14,59523,16384,43139,263.299560546875
76,75,15,65986,32768,33218,101.373291015625
76,76,1,0,2,-2,-100.0
76,76,2,1,4,-3,-75.0
76,76,3,10,8,2,25.0
76,76,4,6,16,-10,-62.5
76,76,5,28,32,-4,-12.5
76,76,6,10,64,-54,-84.375
76,76,7,93,128,-35,-27.34375
76,76,8,420,256,164,64.0625
76,76,9,930,512,418,81.640625
76,76,10,828,1024,-196,-19.140625
76,76,11,3585,2048,1537,75.048828125
76,76,12,1544,4096,-2552,-62.3046875
76,76,13,4648,8192,-3544,-43.26171875
76,76,14,74818,16384,58434,356.65283203125
76,76,15,64278,32768,31510,96.160888671875
77,1,1,0,2,-2,-100.0
77,1,2,2,4,-2,-50.0
77,1,3,4,8,-4,-50.0
77,1,4,11,16,-5,-31.25
77,1,5,44,32,12,37.5
77,1,6,49,64,-15,-23.4375
77,1,7,103,128,-25,-19.53125
77,1,8,92,256,-164,-64.0625
77,1,9,358,512,-154,-30.078125
77,1,10,1313,1024,289,28.22265625
77,1,11,153,2048,-1895,-92.529296875
77,1,12,1226,4096,-2870,-70.068359375
77,1,13,1055,8192,-7137,-87.12158203125
77,1,14,28719,16384,12335,75.286865234375
77,1,15,956,32768,-31812,-97.08251953125
77,2,1,0,2,-2,-100.0
77,2,2,1,4,-3,-75.0
77,2,3,9,8,1,12.5
77,2,4,12,16,-4,-25.0
77,2,5,4,32,-28,-87.5
77,2,6,68,64,4,6.25
77,2,7,11,128,-117,-91.40625
77,2,8,575,256,319,124.609375
77,2,9,776,512,264,51.5625
77,2,10,1041,1024,17,1.66015625
77,2,11,4146,2048,2098,102.44140625
77,2,12,270,4096,-3826,-93.408203125
77,2,13,6424,8192,-1768,-21.58203125
77,2,14,15992,16384,-392,-2.392578125
77,2,15,19714,32768,-13054,-39.837646484375
77,3,1,0,2,-2,-100.0
77,3,2,1,4,-3,-75.0
77,3,3,2,8,-6,-75.0
77,3,4,4,16,-12,-75.0
77,3,5,47,32,15,46.875
77,3,6,16,64,-48,-75.0
77,3,7,333,128,205,160.15625
77,3,8,178,256,-78,-30.46875
77,3,9,649,512,137,26.7578125
77,3,10,1383,1024,359,35.05859375
77,3,11,3228,2048,1180,57.6171875
77,3,12,4486,4096,390,9.521484375
77,3,13,1827,8192,-6365,-77.69775390625
77,3,14,10225,16384,-6159,-37.591552734375
77,3,15,1174,32768,-31594,-96.417236328125
77,4,1,0,2,-2,-100.0
77,4,2,1,4,-3,-75.0
77,4,3,3,8,-5,-62.5
77,4,4,43,16,27,168.75
77,4,5,35,32,3,9.375
77,4,6,62,64,-2,-3.125
77,4,7,104,128,-24,-18.75
77,4,8,189,256,-67,-26.171875
77,4,9,403,512,-109,-21.2890625
77,4,10,463,1024,-561,-54.78515625
77,4,11,2027,2048,-21,-1.025390625
77,4,12,10733,4096,6637,162.0361328125
77,4,13,1854,8192,-6338,-77.3681640625
77,4,14,18098,16384,1714,10.46142578125
77,4,15,38026,32768,5258,16.046142578125
77,5,1,0,2,-2,-100.0
77,5,2,1,4,-3,-75.0
77,5,3,11,8,3,37.5
77,5,4,3,16,-13,-81.25
77,5,5,18,32,-14,-43.75
77,5,6,65,64,1,1.5625
77,5,7,408,128,280,218.75
77,5,8,172,256,-84,-32.8125
77,5,9,249,512,-263,-51.3671875
77,5,10,389,1024,-635,-62.01171875
77,5,11,1293,2048,-755,-36.865234375
77,5,12,2298,4096,-1798,-43.896484375
77,5,13,950,8192,-7242,-88.4033203125
77,5,14,9826,16384,-6558,-40.02685546875
77,5,15,31141,32768,-1627,-4.9652099609375
77,6,1,0,2,-2,-100.0
77,6,2,2,4,-2,-50.0
77,6,3,2,8,-6,-75.0
77,6,4,7,16,-9,-56.25
77,6,5,104,32,72,225.0
77,6,6,56,64,-8,-12.5
77,6,7,17,128,-111,-86.71875
77,6,8,77,256,-179,-69.921875
77,6,9,1119,512,607,118.5546875
77,6,10,2051,1024,1027,100.29296875
77,6,11,634,2048,-1414,-69.04296875
77,6,12,4478,4096,382,9.326171875
77,6,13,3721,8192,-4471,-54.57763671875
77,6,14,9956,16384,-6428,-39.2333984375
77,6,15,33791,32768,1023,3.1219482421875
77,7,1,0,2,-2,-100.0
77,7,2,1,4,-3,-75.0
77,7,3,6,8,-2,-25.0
77,7,4,14,16,-2,-12.5
77,7,5,21,32,-11,-34.375
77,7,6,59,64,-5,-7.8125
77,7,7,22,128,-106,-82.8125
77,7,8,396,256,140,54.6875
77,7,9,1224,512,712,139.0625
77,7,10,2368,1024,1344,131.25
77,7,11,1309,2048,-739,-36.083984375
77,7,12,979,4096,-3117,-76.0986328125
77,7,13,2966,8192,-5226,-63.7939453125
77,7,14,12897,16384,-3487,-21.282958984375
77,7,15,211,32768,-32557,-99.3560791015625
77,8,1,0,2,-2,-100.0
77,8,2,1,4,-3,-75.0
77,8,3,2,8,-6,-75.0
77,8,4,3,16,-13,-81.25
77,8,5,10,32,-22,-68.75
77,8,6,110,64,46,71.875
77,8,7,26,128,-102,-79.6875
77,8,8,260,256,4,1.5625
77,8,9,134,512,-378,-73.828125
77,8,10,187,1024,-837,-81.73828125
77,8,11,618,2048,-1430,-69.82421875
77,8,12,1024,4096,-3072,-75.0
77,8,13,5481,8192,-2711,-33.09326171875
77,8,14,2631,16384,-13753,-83.941650390625
77,8,15,25150,32768,-7618,-23.248291015625
77,9,1,0,2,-2,-100.0
77,9,2,1,4,-3,-75.0
77,9,3,11,8,3,37.5
77,9,4,24,16,8,50.0
77,9,5,12,32,-20,-62.5
77,9,6,5,64,-59,-92.1875
77,9,7,39,128,-89,-69.53125
77,9,8,1235,256,979,382.421875
77,9,9,178,512,-334,-65.234375
77,9,10,1701,1024,677,66.11328125
77,9,11,10,2048,-2038,-99.51171875
77,9,12,2967,4096,-1129,-27.5634765625
77,9,13,1495,8192,-6697,-81.75048828125
77,9,14,19410,16384,3026,18.46923828125
77,9,15,8115,32768,-24653,-75.2349853515625
77,10,1,0,2,-2,-100.0
77,10,2,2,4,-2,-50.0
77,10,3,3,8,-5,-62.5
77,10,4,3,16,-13,-81.25
77,10,5,10,32,-22,-68.75
77,10,6,254,64,190,296.875
77,10,7,95,128,-33,-25.78125
77,10,8,591,256,335,130.859375
77,10,9,804,512,292,57.03125
77,10,10,1287,1024,263,25.68359375
77,10,11,1358,2048,-690,-33.69140625
77,10,12,7164,4096,3068,74.90234375
77,10,13,17729,8192,9537,116.41845703125
77,10,14,11614,16384,-4770,-29.11376953125
77,10,15,3294,32768,-29474,-89.947509765625
77,11,1,0,2,-2,-100.0
77,11,2,3,4,-1,-25.0
77,11,3,5,8,-3,-37.5
77,11,4,11,16,-5,-31.25
77,11,5,56,32,24,75.0
77,11,6,5,64,-59,-92.1875
77,11,7,345,128,217,169.53125
77,11,8,337,256,81,31.640625
77,11,9,195,512,-317,-61.9140625
77,11,10,523,1024,-501,-48.92578125
77,11,11,1271,2048,-777,-37.939453125
77,11,12,1491,4096,-2605,-63.5986328125
77,11,13,5033,8192,-3159,-38.56201171875
77,11,14,16691,16384,307,1.873779296875
77,11,15,7014,32768,-25754,-78.594970703125
77,12,1,0,2,-2,-100.0
77,12,2,1,4,-3,-75.0
77,12,3,8,8,0,0.0
77,12,4,13,16,-3,-18.75
77,12,5,10,32,-22,-68.75
77,12,6,171,64,107,167.1875
77,12,7,6,128,-122,-95.3125
77,12,8,114,256,-142,-55.46875
77,12,9,588,512,76,14.84375
77,12,10,379,1024,-645,-62.98828125
77,12,11,1065,2048,-983,-47.998046875
77,12,12,8057,4096,3961,96.7041015625
77,12,13,13507,8192,5315,64.88037109375
77,12,14,15014,16384,-1370,-8.36181640625
77,12,15,8718,32768,-24050,-73.394775390625
77,13,1,0,2,-2,-100.0
77,13,2,3,4,-1,-25.0
77,13,3,3,8,-5,-62.5
77,13,4,42,16,26,162.5
77,13,5,4,32,-28,-87.5
77,13,6,92,64,28,43.75
77,13,7,81,128,-47,-36.71875
77,13,8,117,256,-139,-54.296875
77,13,9,278,512,-234,-45.703125
77,13,10,1043,1024,19,1.85546875
77,13,11,1037,2048,-1011,-49.365234375
77,13,12,3270,4096,-826,-20.166015625
77,13,13,4876,8192,-3316,-40.478515625
77,13,14,6703,16384,-9681,-59.088134765625
77,13,15,9439,32768,-23329,-71.1944580078125
77,14,1,0,2,-2,-100.0
77,14,2,1,4,-3,-75.0
77,14,3,7,8,-1,-12.5
77,14,4,12,16,-4,-25.0
77,14,5,49,32,17,53.125
77,14,6,61,64,-3,-4.6875
77,14,7,61,128,-67,-52.34375
77,14,8,279,256,23,8.984375
77,14,9,633,512,121,23.6328125
77,14,10,42,1024,-982,-95.8984375
77,14,11,1204,2048,-844,-41.2109375
77,14,12,4317,4096,221,5.3955078125
77,14,13,1855,8192,-6337,-77.35595703125
77,14,14,40496,16384,24112,147.16796875
77,14,15,1815,32768,-30953,-94.4610595703125
77,15,1,0,2,-2,-100.0
77,15,2,5,4,1,25.0
77,15,3,2,8,-6,-75.0
77,15,4,14,16,-2,-12.5
77,15,5,13,32,-19,-59.375
77,15,6,31,64,-33,-51.5625
77,15,7,293,128,165,128.90625
77,15,8,225,256,-31,-12.109375
77,15,9,1124,512,612,119.53125
77,15,10,1648,1024,624,60.9375
77,15,11,1464,2048,-584,-28.515625
77,15,12,1092,4096,-3004,-73.33984375
77,15,13,8621,8192,429,5.23681640625
77,15,14,48728,16384,32344,197.412109375
77,15,15,9314,32768,-23454,-71.575927734375
77,16,1,0,2,-2,-100.0
77,16,2,4,4,0,0.0
77,16,3,5,8,-3,-37.5
77,16,4,11,16,-5,-31.25
77,16,5,5,32,-27,-84.375
77,16,6,21,64,-43,-67.1875
77,16,7,126,128,-2,-1.5625
77,16,8,459,256,203,79.296875
77,16,9,194,512,-318,-62.109375
77,16,10,537,1024,-487,-47.55859375
77,16,11,3300,2048,1252,61.1328125
77,16,12,1175,4096,-2921,-71.3134765625
77,16,13,37964,8192,29772,363.427734375
77,16,14,2975,16384,-13409,-81.842041015625
77,16,15,16166,32768,-16602,-50.665283203125
77,17,1,0,2,-2,-100.0
77,17,2,1,4,-3,-75.0
77,17,3,7,8,-1,-12.5
77,17,4,3,16,-13,-81.25
77,17,5,32,32,0,0.0
77,17,6,40,64,-24,-37.5
77,17,7,190,128,62,48.4375
77,17,8,206,256,-50,-19.53125
77,17,9,1288,512,776,151.5625
77,17,10,2059,1024,1035,101.07421875
77,17,11,3867,2048,1819,88.818359375
77,17,12,4329,4096,233,5.6884765625
77,17,13,622,8192,-7570,-92.4072265625
77,17,14,42466,16384,26082,159.19189453125
77,17,15,3676,32768,-29092,-88.78173828125
77,18,1,0,2,-2,-100.0
77,18,2,7,4,3,75.0
77,18,3,2,8,-6,-75.0
77,18,4,18,16,2,12.5
77,18,5,13,32,-19,-59.375
77,18,6,16,64,-48,-75.0
77,18,7,763,128,635,496.09375
77,18,8,67,256,-189,-73.828125
77,18,9,534,512,22,4.296875
77,18,10,2517,1024,1493,145.80078125
77,18,11,870,2048,-1178,-57.51953125
77,18,12,3600,4096,-496,-12.109375
77,18,13,11220,8192,3028,36.962890625
77,18,14,7384,16384,-9000,-54.931640625
77,18,15,107735,32768,74967,228.7811279296875
77,19,1,0,2,-2,-100.0
77,19,2,1,4,-3,-75.0
77,19,3,2,8,-6,-75.0
77,19,4,7,16,-9,-56.25
77,19,5,46,32,14,43.75
77,19,6,83,64,19,29.6875
77,19,7,505,128,377,294.53125
77,19,8,358,256,102,39.84375
77,19,9,280,512,-232,-45.3125
77,19,10,1412,1024,388,37.890625
77,19,11,2205,2048,157,7.666015625
77,19,12,1058,4096,-3038,-74.169921875
77,19,13,385,8192,-7807,-95.30029296875
77,19,14,17831,16384,1447,8.831787109375
77,19,15,97229,32768,64461,196.7193603515625
77,20,1,0,2,-2,-100.0
77,20,2,3,4,-1,-25.0
77,20,3,11,8,3,37.5
77,20,4,8,16,-8,-50.0
77,20,5,21,32,-11,-34.375
77,20,6,22,64,-42,-65.625
77,20,7,65,128,-63,-49.21875
77,20,8,80,256,-176,-68.75
77,20,9,370,512,-142,-27.734375
77,20,10,1306,1024,282,27.5390625
77,20,11,346,2048,-1702,-83.10546875
77,20,12,13200,4096,9104,222.265625
77,20,13,1881,8192,-6311,-77.03857421875
77,20,14,5637,16384,-10747,-65.594482421875
77,20,15,64071,32768,31303,95.5291748046875
77,21,1,0,2,-2,-100.0
77,21,2,2,4,-2,-50.0
77,21,3,7,8,-1,-12.5
77,21,4,4,16,-12,-75.0
77,21,5,48,32,16,50.0
77,21,6,35,64,-29,-45.3125
77,21,7,136,128,8,6.25
77,21,8,489,256,233,91.015625
77,21,9,426,512,-86,-16.796875
77,21,10,1933,1024,909,88.76953125
77,21,11,2714,2048,666,32.51953125
77,21,12,4151,4096,55,1.3427734375
77,21,13,391,8192,-7801,-95.22705078125
77,21,14,10883,16384,-5501,-33.575439453125
77,21,15,516,32768,-32252,-98.42529296875
77,22,1,0,2,-2,-100.0
77,22,2,2,4,-2,-50.0
77,22,3,3,8,-5,-62.5
77,22,4,13,16,-3,-18.75
77,22,5,33,32,1,3.125
77,22,6,6,64,-58,-90.625
77,22,7,121,128,-7,-5.46875
77,22,8,243,256,-13,-5.078125
77,22,9,435,512,-77,-15.0390625
77,22,10,14,1024,-1010,-98.6328125
77,22,11,279,2048,-1769,-86.376953125
77,22,12,3153,4096,-943,-23.0224609375
77,22,13,11066,8192,2874,35.0830078125
77,22,14,47503,16384,31119,189.935302734375
77,22,15,3084,32768,-29684,-90.58837890625
77,23,1,0,2,-2,-100.0
77,23,2,1,4,-3,-75.0
77,23,3,9,8,1,12.5
77,23,4,22,16,6,37.5
77,23,5,16,32,-16,-50.0
77,23,6,57,64,-7,-10.9375
77,23,7,307,128,179,139.84375
77,23,8,383,256,127,49.609375
77,23,9,1206,512,694,135.546875
77,23,10,51,1024,-973,-95.01953125
77,23,11,3930,2048,1882,91.89453125
77,23,12,3949,4096,-147,-3.5888671875
77,23,13,30523,8192,22331,272.59521484375
77,23,14,3027,16384,-13357,-81.524658203125
77,23,15,34952,32768,2184,6.6650390625
77,24,1,0,2,-2,-100.0
77,24,2,3,4,-1,-25.0
77,24,3,8,8,0,0.0
77,24,4,3,16,-13,-81.25
77,24,5,7,32,-25,-78.125
77,24,6,105,64,41,64.0625
77,24,7,203,128,75,58.59375
77,24,8,94,256,-162,-63.28125
77,24,9,1008,512,496,96.875
77,24,10,1554,1024,530,51.7578125
77,24,11,371,2048,-1677,-81.884765625
77,24,12,13762,4096,9666,235.986328125
77,24,13,26839,8192,18647,227.62451171875
77,24,14,4706,16384,-11678,-71.27685546875
77,24,15,55373,32768,22605,68.9849853515625
77,25,1,0,2,-2,-100.0
77,25,2,1,4,-3,-75.0
77,25,3,4,8,-4,-50.0
77,25,4,18,16,2,12.5
77,25,5,19,32,-13,-40.625
77,25,6,16,64,-48,-75.0
77,25,7,31,128,-97,-75.78125
77,25,8,123,256,-133,-51.953125
77,25,9,1625,512,1113,217.3828125
77,25,10,277,1024,-747,-72.94921875
77,25,11,2342,2048,294,14.35546875
77,25,12,2454,4096,-1642,-40.087890625
77,25,13,9393,8192,1201,14.66064453125
77,25,14,13328,16384,-3056,-18.65234375
77,25,15,20540,32768,-12228,-37.31689453125
77,26,1,0,2,-2,-100.0
77,26,2,1,4,-3,-75.0
77,26,3,6,8,-2,-25.0
77,26,4,12,16,-4,-25.0
77,26,5,51,32,19,59.375
77,26,6,19,64,-45,-70.3125
77,26,7,193,128,65,50.78125
77,26,8,695,256,439,171.484375
77,26,9,347,512,-165,-32.2265625
77,26,10,496,1024,-528,-51.5625
77,26,11,2568,2048,520,25.390625
77,26,12,5427,4096,1331,32.4951171875
77,26,13,12091,8192,3899,47.59521484375
77,26,14,2576,16384,-13808,-84.27734375
77,26,15,92895,32768,60127,183.4930419921875
77,27,1,0,2,-2,-100.0
77,27,2,1,4,-3,-75.0
77,27,3,4,8,-4,-50.0
77,27,4,7,16,-9,-56.25
77,27,5,108,32,76,237.5
77,27,6,27,64,-37,-57.8125
77,27,7,81,128,-47,-36.71875
77,27,8,12,256,-244,-95.3125
77,27,9,617,512,105,20.5078125
77,27,10,22,1024,-1002,-97.8515625
77,27,11,20,2048,-2028,-99.0234375
77,27,12,4666,4096,570,13.916015625
77,27,13,946,8192,-7246,-88.4521484375
77,27,14,5433,16384,-10951,-66.839599609375
77,27,15,100851,32768,68083,207.7728271484375
77,28,1,0,2,-2,-100.0
77,28,2,7,4,3,75.0
77,28,3,6,8,-2,-25.0
77,28,4,9,16,-7,-43.75
77,28,5,4,32,-28,-87.5
77,28,6,69,64,5,7.8125
77,28,7,334,128,206,160.9375
77,28,8,65,256,-191,-74.609375
77,28,9,999,512,487,95.1171875
77,28,10,1498,1024,474,46.2890625
77,28,11,1470,2048,-578,-28.22265625
77,28,12,4419,4096,323,7.8857421875
77,28,13,40358,8192,32166,392.6513671875
77,28,14,845,16384,-15539,-94.842529296875
77,28,15,382,32768,-32386,-98.834228515625
77,29,1,0,2,-2,-100.0
77,29,2,2,4,-2,-50.0
77,29,3,5,8,-3,-37.5
77,29,4,18,16,2,12.5
77,29,5,11,32,-21,-65.625
77,29,6,67,64,3,4.6875
77,29,7,140,128,12,9.375
77,29,8,92,256,-164,-64.0625
77,29,9,292,512,-220,-42.96875
77,29,10,1553,1024,529,51.66015625
77,29,11,274,2048,-1774,-86.62109375
77,29,12,265,4096,-3831,-93.5302734375
77,29,13,24974,8192,16782,204.8583984375
77,29,14,714,16384,-15670,-95.64208984375
77,29,15,26360,32768,-6408,-19.5556640625
77,30,1,0,2,-2,-100.0
77,30,2,3,4,-1,-25.0
77,30,3,2,8,-6,-75.0
77,30,4,67,16,51,318.75
77,30,5,37,32,5,15.625
77,30,6,103,64,39,60.9375
77,30,7,165,128,37,28.90625
77,30,8,121,256,-135,-52.734375
77,30,9,1503,512,991,193.5546875
77,30,10,1404,1024,380,37.109375
77,30,11,9382,2048,7334,358.10546875
77,30,12,3043,4096,-1053,-25.7080078125
77,30,13,6262,8192,-1930,-23.5595703125
77,30,14,38586,16384,22202,135.51025390625
77,30,15,8041,32768,-24727,-75.4608154296875
77,31,1,0,2,-2,-100.0
77,31,2,1,4,-3,-75.0
77,31,3,4,8,-4,-50.0
77,31,4,15,16,-1,-6.25
77,31,5,37,32,5,15.625
77,31,6,92,64,28,43.75
77,31,7,6,128,-122,-95.3125
77,31,8,60,256,-196,-76.5625
77,31,9,192,512,-320,-62.5
77,31,10,190,1024,-834,-81.4453125
77,31,11,2430,2048,382,18.65234375
77,31,12,451,4096,-3645,-88.9892578125
77,31,13,17781,8192,9589,117.05322265625
77,31,14,3476,16384,-12908,-78.7841796875
77,31,15,81948,32768,49180,150.08544921875
77,32,1,0,2,-2,-100.0
77,32,2,4,4,0,0.0
77,32,3,4,8,-4,-50.0
77,32,4,10,16,-6,-37.5
77,32,5,58,32,26,81.25
77,32,6,5,64,-59,-92.1875
77,32,7,108,128,-20,-15.625
77,32,8,22,256,-234,-91.40625
77,32,9,364,512,-148,-28.90625
77,32,10,141,1024,-883,-86.23046875
77,32,11,316,2048,-1732,-84.5703125
77,32,12,2706,4096,-1390,-33.935546875
77,32,13,6486,8192,-1706,-20.8251953125
77,32,14,10214,16384,-6170,-37.65869140625
77,32,15,17940,32768,-14828,-45.25146484375
77,33,1,0,2,-2,-100.0
77,33,2,2,4,-2,-50.0
77,33,3,5,8,-3,-37.5
77,33,4,3,16,-13,-81.25
77,33,5,37,32,5,15.625
77,33,6,14,64,-50,-78.125
77,33,7,53,128,-75,-58.59375
77,33,8,349,256,93,36.328125
77,33,9,2208,512,1696,331.25
77,33,10,3044,1024,2020,197.265625
77,33,11,193,2048,-1855,-90.576171875
77,33,12,909,4096,-3187,-77.8076171875
77,33,13,25756,8192,17564,214.404296875
77,33,14,13221,16384,-3163,-19.305419921875
77,33,15,26591,32768,-6177,-18.8507080078125
77,34,1,0,2,-2,-100.0
77,34,2,2,4,-2,-50.0
77,34,3,6,8,-2,-25.0
77,34,4,9,16,-7,-43.75
77,34,5,8,32,-24,-75.0
77,34,6,136,64,72,112.5
77,34,7,21,128,-107,-83.59375
77,34,8,13,256,-243,-94.921875
77,34,9,185,512,-327,-63.8671875
77,34,10,76,1024,-948,-92.578125
77,34,11,2620,2048,572,27.9296875
77,34,12,639,4096,-3457,-84.3994140625
77,34,13,2779,8192,-5413,-66.07666015625
77,34,14,3136,16384,-13248,-80.859375
77,34,15,76541,32768,43773,133.5845947265625
77,35,1,0,2,-2,-100.0
77,35,2,2,4,-2,-50.0
77,35,3,6,8,-2,-25.0
77,35,4,17,16,1,6.25
77,35,5,7,32,-25,-78.125
77,35,6,30,64,-34,-53.125
77,35,7,47,128,-81,-63.28125
77,35,8,616,256,360,140.625
77,35,9,681,512,169,33.0078125
77,35,10,269,1024,-755,-73.73046875
77,35,11,2263,2048,215,10.498046875
77,35,12,6827,4096,2731,66.6748046875
77,35,13,19898,8192,11706,142.8955078125
77,35,14,17679,16384,1295,7.904052734375
77,35,15,38436,32768,5668,17.29736328125
77,36,1,0,2,-2,-100.0
77,36,2,3,4,-1,-25.0
77,36,3,3,8,-5,-62.5
77,36,4,3,16,-13,-81.25
77,36,5,16,32,-16,-50.0
77,36,6,40,64,-24,-37.5
77,36,7,26,128,-102,-79.6875
77,36,8,699,256,443,173.046875
77,36,9,92,512,-420,-82.03125
77,36,10,2129,1024,1105,107.91015625
77,36,11,3033,2048,985,48.095703125
77,36,12,5486,4096,1390,33.935546875
77,36,13,2760,8192,-5432,-66.30859375
77,36,14,9704,16384,-6680,-40.771484375
77,36,15,26716,32768,-6052,-18.46923828125
77,37,1,0,2,-2,-100.0
77,37,2,1,4,-3,-75.0
77,37,3,2,8,-6,-75.0
77,37,4,5,16,-11,-68.75
77,37,5,41,32,9,28.125
77,37,6,122,64,58,90.625
77,37,7,14,128,-114,-89.0625
77,37,8,233,256,-23,-8.984375
77,37,9,37,512,-475,-92.7734375
77,37,10,30,1024,-994,-97.0703125
77,37,11,1188,2048,-860,-41.9921875
77,37,12,573,4096,-3523,-86.0107421875
77,37,13,10206,8192,2014,24.5849609375
77,37,14,286,16384,-16098,-98.25439453125
77,37,15,65317,32768,32549,99.3316650390625
77,38,1,0,2,-2,-100.0
77,38,2,1,4,-3,-75.0
77,38,3,3,8,-5,-62.5
77,38,4,7,16,-9,-56.25
77,38,5,6,32,-26,-81.25
77,38,6,219,64,155,242.1875
77,38,7,20,128,-108,-84.375
77,38,8,421,256,165,64.453125
77,38,9,315,512,-197,-38.4765625
77,38,10,589,1024,-435,-42.48046875
77,38,11,1345,2048,-703,-34.326171875
77,38,12,10301,4096,6205,151.4892578125
77,38,13,4751,8192,-3441,-42.00439453125
77,38,14,6349,16384,-10035,-61.248779296875
77,38,15,3344,32768,-29424,-89.794921875
77,39,1,0,2,-2,-100.0
77,39,2,1,4,-3,-75.0
77,39,3,5,8,-3,-37.5
77,39,4,8,16,-8,-50.0
77,39,5,27,32,-5,-15.625
77,39,6,41,64,-23,-35.9375
77,39,7,236,128,108,84.375
77,39,8,553,256,297,116.015625
77,39,9,973,512,461,90.0390625
77,39,10,207,1024,-817,-79.78515625
77,39,11,7024,2048,4976,242.96875
77,39,12,3743,4096,-353,-8.6181640625
77,39,13,6748,8192,-1444,-17.626953125
77,39,14,2705,16384,-13679,-83.489990234375
77,39,15,7340,32768,-25428,-77.60009765625
77,40,1,0,2,-2,-100.0
77,40,2,1,4,-3,-75.0
77,40,3,5,8,-3,-37.5
77,40,4,9,16,-7,-43.75
77,40,5,29,32,-3,-9.375
77,40,6,88,64,24,37.5
77,40,7,220,128,92,71.875
77,40,8,301,256,45,17.578125
77,40,9,488,512,-24,-4.6875
77,40,10,334,1024,-690,-67.3828125
77,40,11,221,2048,-1827,-89.208984375
77,40,12,6423,4096,2327,56.8115234375
77,40,13,6801,8192,-1391,-16.97998046875
77,40,14,11138,16384,-5246,-32.01904296875
77,40,15,2879,32768,-29889,-91.2139892578125
77,41,1,0,2,-2,-100.0
77,41,2,1,4,-3,-75.0
77,41,3,4,8,-4,-50.0
77,41,4,12,16,-4,-25.0
77,41,5,19,32,-13,-40.625
77,41,6,34,64,-30,-46.875
77,41,7,58,128,-70,-54.6875
77,41,8,62,256,-194,-75.78125
77,41,9,562,512,50,9.765625
77,41,10,3045,1024,2021,197.36328125
77,41,11,1207,2048,-841,-41.064453125
77,41,12,7540,4096,3444,84.08203125
77,41,13,169,8192,-8023,-97.93701171875
77,41,14,2684,16384,-13700,-83.6181640625
77,41,15,12452,32768,-20316,-61.99951171875
77,42,1,0,2,-2,-100.0
77,42,2,2,4,-2,-50.0
77,42,3,18,8,10,125.0
77,42,4,15,16,-1,-6.25
77,42,5,35,32,3,9.375
77,42,6,36,64,-28,-43.75
77,42,7,451,128,323,252.34375
77,42,8,122,256,-134,-52.34375
77,42,9,1106,512,594,116.015625
77,42,10,872,1024,-152,-14.84375
77,42,11,1564,2048,-484,-23.6328125
77,42,12,17875,4096,13779,336.4013671875
77,42,13,6354,8192,-1838,-22.4365234375
77,42,14,27116,16384,10732,65.5029296875
77,42,15,2695,32768,-30073,-91.7755126953125
77,43,1,0,2,-2,-100.0
77,43,2,1,4,-3,-75.0
77,43,3,6,8,-2,-25.0
77,43,4,7,16,-9,-56.25
77,43,5,76,32,44,137.5
77,43,6,68,64,4,6.25
77,43,7,340,128,212,165.625
77,43,8,138,256,-118,-46.09375
77,43,9,150,512,-362,-70.703125
77,43,10,2715,1024,1691,165.13671875
77,43,11,2445,2048,397,19.384765625
77,43,12,5549,4096,1453,35.4736328125
77,43,13,2701,8192,-5491,-67.02880859375
77,43,14,5704,16384,-10680,-65.185546875
77,43,15,68193,32768,35425,108.1085205078125
77,44,1,0,2,-2,-100.0
77,44,2,3,4,-1,-25.0
77,44,3,4,8,-4,-50.0
77,44,4,9,16,-7,-43.75
77,44,5,12,32,-20,-62.5
77,44,6,70,64,6,9.375
77,44,7,310,128,182,142.1875
77,44,8,151,256,-105,-41.015625
77,44,9,110,512,-402,-78.515625
77,44,10,655,1024,-369,-36.03515625
77,44,11,513,2048,-1535,-74.951171875
77,44,12,5408,4096,1312,32.03125
77,44,13,116,8192,-8076,-98.583984375
77,44,14,3249,16384,-13135,-80.169677734375
77,44,15,23763,32768,-9005,-27.4810791015625
77,45,1,0,2,-2,-100.0
77,45,2,1,4,-3,-75.0
77,45,3,2,8,-6,-75.0
77,45,4,3,16,-13,-81.25
77,45,5,8,32,-24,-75.0
77,45,6,86,64,22,34.375
77,45,7,207,128,79,61.71875
77,45,8,282,256,26,10.15625
77,45,9,871,512,359,70.1171875
77,45,10,1515,1024,491,47.94921875
77,45,11,1235,2048,-813,-39.697265625
77,45,12,13481,4096,9385,229.1259765625
77,45,13,6895,8192,-1297,-15.83251953125
77,45,14,22863,16384,6479,39.544677734375
77,45,15,19291,32768,-13477,-41.1285400390625
77,46,1,0,2,-2,-100.0
77,46,2,3,4,-1,-25.0
77,46,3,3,8,-5,-62.5
77,46,4,16,16,0,0.0
77,46,5,35,32,3,9.375
77,46,6,289,64,225,351.5625
77,46,7,6,128,-122,-95.3125
77,46,8,62,256,-194,-75.78125
77,46,9,408,512,-104,-20.3125
77,46,10,1132,1024,108,10.546875
77,46,11,3153,2048,1105,53.955078125
77,46,12,9476,4096,5380,131.34765625
77,46,13,3235,8192,-4957,-60.51025390625
77,46,14,2154,16384,-14230,-86.85302734375
77,46,15,8502,32768,-24266,-74.053955078125
77,47,1,0,2,-2,-100.0
77,47,2,2,4,-2,-50.0
77,47,3,4,8,-4,-50.0
77,47,4,4,16,-12,-75.0
77,47,5,79,32,47,146.875
77,47,6,5,64,-59,-92.1875
77,47,7,520,128,392,306.25
77,47,8,78,256,-178,-69.53125
77,47,9,255,512,-257,-50.1953125
77,47,10,814,1024,-210,-20.5078125
77,47,11,3129,2048,1081,52.783203125
77,47,12,4969,4096,873,21.3134765625
77,47,13,1796,8192,-6396,-78.076171875
77,47,14,663,16384,-15721,-95.953369140625
77,47,15,34984,32768,2216,6.7626953125
77,48,1,0,2,-2,-100.0
77,48,2,1,4,-3,-75.0
77,48,3,4,8,-4,-50.0
77,48,4,16,16,0,0.0
77,48,5,24,32,-8,-25.0
77,48,6,9,64,-55,-85.9375
77,48,7,351,128,223,174.21875
77,48,8,180,256,-76,-29.6875
77,48,9,211,512,-301,-58.7890625
77,48,10,1051,1024,27,2.63671875
77,48,11,909,2048,-1139,-55.615234375
77,48,12,1919,4096,-2177,-53.1494140625
77,48,13,591,8192,-7601,-92.78564453125
77,48,14,6206,16384,-10178,-62.12158203125
77,48,15,21196,32768,-11572,-35.31494140625
77,49,1,0,2,-2,-100.0
77,49,2,2,4,-2,-50.0
77,49,3,7,8,-1,-12.5
77,49,4,3,16,-13,-81.25
77,49,5,14,32,-18,-56.25
77,49,6,65,64,1,1.5625
77,49,7,38,128,-90,-70.3125
77,49,8,104,256,-152,-59.375
77,49,9,1081,512,569,111.1328125
77,49,10,1916,1024,892,87.109375
77,49,11,4326,2048,2278,111.23046875
77,49,12,3418,4096,-678,-16.552734375
77,49,13,17367,8192,9175,111.99951171875
77,49,14,63968,16384,47584,290.4296875
77,49,15,11571,32768,-21197,-64.6881103515625
77,50,1,0,2,-2,-100.0
77,50,2,2,4,-2,-50.0
77,50,3,2,8,-6,-75.0
77,50,4,9,16,-7,-43.75
77,50,5,6,32,-26,-81.25
77,50,6,9,64,-55,-85.9375
77,50,7,112,128,-16,-12.5
77,50,8,337,256,81,31.640625
77,50,9,1276,512,764,149.21875
77,50,10,1032,1024,8,0.78125
77,50,11,2908,2048,860,41.9921875
77,50,12,7700,4096,3604,87.98828125
77,50,13,7422,8192,-770,-9.3994140625
77,50,14,19277,16384,2893,17.657470703125
77,50,15,38769,32768,6001,18.3135986328125
77,51,1,0,2,-2,-100.0
77,51,2,1,4,-3,-75.0
77,51,3,7,8,-1,-12.5
77,51,4,9,16,-7,-43.75
77,51,5,75,32,43,134.375
77,51,6,47,64,-17,-26.5625
77,51,7,11,128,-117,-91.40625
77,51,8,125,256,-131,-51.171875
77,51,9,105,512,-407,-79.4921875
77,51,10,122,1024,-902,-88.0859375
77,51,11,2203,2048,155,7.568359375
77,51,12,8736,4096,4640,113.28125
77,51,13,19036,8192,10844,132.373046875
77,51,14,318,16384,-16066,-98.05908203125
77,51,15,12821,32768,-19947,-60.8734130859375
77,52,1,0,2,-2,-100.0
77,52,2,2,4,-2,-50.0
77,52,3,3,8,-5,-62.5
77,52,4,43,16,27,168.75
77,52,5,74,32,42,131.25
77,52,6,86,64,22,34.375
77,52,7,615,128,487,380.46875
77,52,8,106,256,-150,-58.59375
77,52,9,83,512,-429,-83.7890625
77,52,10,110,1024,-914,-89.2578125
77,52,11,5928,2048,3880,189.453125
77,52,12,5465,4096,1369,33.4228515625
77,52,13,4562,8192,-3630,-44.3115234375
77,52,14,25298,16384,8914,54.40673828125
77,52,15,62873,32768,30105,91.8731689453125
77,53,1,0,2,-2,-100.0
77,53,2,3,4,-1,-25.0
77,53,3,2,8,-6,-75.0
77,53,4,4,16,-12,-75.0
77,53,5,26,32,-6,-18.75
77,53,6,25,64,-39,-60.9375
77,53,7,375,128,247,192.96875
77,53,8,336,256,80,31.25
77,53,9,258,512,-254,-49.609375
77,53,10,897,1024,-127,-12.40234375
77,53,11,415,2048,-1633,-79.736328125
77,53,12,478,4096,-3618,-88.330078125
77,53,13,5708,8192,-2484,-30.322265625
77,53,14,4854,16384,-11530,-70.37353515625
77,53,15,40243,32768,7475,22.8118896484375
77,54,1,0,2,-2,-100.0
77,54,2,1,4,-3,-75.0
77,54,3,6,8,-2,-25.0
77,54,4,30,16,14,87.5
77,54,5,39,32,7,21.875
77,54,6,5,64,-59,-92.1875
77,54,7,165,128,37,28.90625
77,54,8,98,256,-158,-61.71875
77,54,9,553,512,41,8.0078125
77,54,10,209,1024,-815,-79.58984375
77,54,11,460,2048,-1588,-77.5390625
77,54,12,1134,4096,-2962,-72.314453125
77,54,13,18242,8192,10050,122.6806640625
77,54,14,4172,16384,-12212,-74.5361328125
77,54,15,7001,32768,-25767,-78.6346435546875
77,55,1,0,2,-2,-100.0
77,55,2,1,4,-3,-75.0
77,55,3,16,8,8,100.0
77,55,4,5,16,-11,-68.75
77,55,5,23,32,-9,-28.125
77,55,6,43,64,-21,-32.8125
77,55,7,263,128,135,105.46875
77,55,8,66,256,-190,-74.21875
77,55,9,989,512,477,93.1640625
77,55,10,646,1024,-378,-36.9140625
77,55,11,2389,2048,341,16.650390625
77,55,12,2265,4096,-1831,-44.7021484375
77,55,13,30,8192,-8162,-99.6337890625
77,55,14,2523,16384,-13861,-84.600830078125
77,55,15,30799,32768,-1969,-6.0089111328125
77,56,1,0,2,-2,-100.0
77,56,2,2,4,-2,-50.0
77,56,3,4,8,-4,-50.0
77,56,4,11,16,-5,-31.25
77,56,5,34,32,2,6.25
77,56,6,178,64,114,178.125
77,56,7,121,128,-7,-5.46875
77,56,8,250,256,-6,-2.34375
77,56,9,188,512,-324,-63.28125
77,56,10,228,1024,-796,-77.734375
77,56,11,148,2048,-1900,-92.7734375
77,56,12,2076,4096,-2020,-49.31640625
77,56,13,15255,8192,7063,86.21826171875
77,56,14,25529,16384,9145,55.816650390625
77,56,15,50545,32768,17777,54.2510986328125
77,57,1,0,2,-2,-100.0
77,57,2,2,4,-2,-50.0
77,57,3,18,8,10,125.0
77,57,4,15,16,-1,-6.25
77,57,5,16,32,-16,-50.0
77,57,6,76,64,12,18.75
77,57,7,104,128,-24,-18.75
77,57,8,12,256,-244,-95.3125
77,57,9,83,512,-429,-83.7890625
77,57,10,633,1024,-391,-38.18359375
77,57,11,2246,2048,198,9.66796875
77,57,12,3938,4096,-158,-3.857421875
77,57,13,1438,8192,-6754,-82.4462890625
77,57,14,17728,16384,1344,8.203125
77,57,15,8899,32768,-23869,-72.8424072265625
77,58,1,0,2,-2,-100.0
77,58,2,1,4,-3,-75.0
77,58,3,2,8,-6,-75.0
77,58,4,5,16,-11,-68.75
77,58,5,127,32,95,296.875
77,58,6,141,64,77,120.3125
77,58,7,43,128,-85,-66.40625
77,58,8,13,256,-243,-94.921875
77,58,9,176,512,-336,-65.625
77,58,10,215,1024,-809,-79.00390625
77,58,11,2198,2048,150,7.32421875
77,58,12,14503,4096,10407,254.0771484375
77,58,13,2721,8192,-5471,-66.78466796875
77,58,14,15505,16384,-879,-5.364990234375
77,58,15,6804,32768,-25964,-79.23583984375
77,59,1,0,2,-2,-100.0
77,59,2,1,4,-3,-75.0
77,59,3,3,8,-5,-62.5
77,59,4,22,16,6,37.5
77,59,5,64,32,32,100.0
77,59,6,119,64,55,85.9375
77,59,7,78,128,-50,-39.0625
77,59,8,185,256,-71,-27.734375
77,59,9,300,512,-212,-41.40625
77,59,10,227,1024,-797,-77.83203125
77,59,11,209,2048,-1839,-89.794921875
77,59,12,3827,4096,-269,-6.5673828125
77,59,13,11302,8192,3110,37.9638671875
77,59,14,38971,16384,22587,137.860107421875
77,59,15,949,32768,-31819,-97.1038818359375
77,60,1,0,2,-2,-100.0
77,60,2,3,4,-1,-25.0
77,60,3,6,8,-2,-25.0
77,60,4,6,16,-10,-62.5
77,60,5,9,32,-23,-71.875
77,60,6,36,64,-28,-43.75
77,60,7,170,128,42,32.8125
77,60,8,63,256,-193,-75.390625
77,60,9,1083,512,571,111.5234375
77,60,10,2471,1024,1447,141.30859375
77,60,11,577,2048,-1471,-71.826171875
77,60,12,2792,4096,-1304,-31.8359375
77,60,13,13273,8192,5081,62.02392578125
77,60,14,7648,16384,-8736,-53.3203125
77,60,15,26364,32768,-6404,-19.54345703125
77,61,1,0,2,-2,-100.0
77,61,2,1,4,-3,-75.0
77,61,3,12,8,4,50.0
77,61,4,10,16,-6,-37.5
77,61,5,39,32,7,21.875
77,61,6,64,64,0,0.0
77,61,7,62,128,-66,-51.5625
77,61,8,605,256,349,136.328125
77,61,9,108,512,-404,-78.90625
77,61,10,331,1024,-693,-67.67578125
77,61,11,1249,2048,-799,-39.013671875
77,61,12,7220,4096,3124,76.26953125
77,61,13,2888,8192,-5304,-64.74609375
77,61,14,915,16384,-15469,-94.415283203125
77,61,15,12527,32768,-20241,-61.7706298828125
77,62,1,0,2,-2,-100.0
77,62,2,9,4,5,125.0
77,62,3,5,8,-3,-37.5
77,62,4,10,16,-6,-37.5
77,62,5,15,32,-17,-53.125
77,62,6,21,64,-43,-67.1875
77,62,7,135,128,7,5.46875
77,62,8,128,256,-128,-50.0
77,62,9,527,512,15,2.9296875
77,62,10,517,1024,-507,-49.51171875
77,62,11,1732,2048,-316,-15.4296875
77,62,12,809,4096,-3287,-80.2490234375
77,62,13,623,8192,-7569,-92.39501953125
77,62,14,7751,16384,-8633,-52.691650390625
77,62,15,46247,32768,13479,41.1346435546875
77,63,1,0,2,-2,-100.0
77,63,2,2,4,-2,-50.0
77,63,3,2,8,-6,-75.0
77,63,4,4,16,-12,-75.0
77,63,5,39,32,7,21.875
77,63,6,42,64,-22,-34.375
77,63,7,271,128,143,111.71875
77,63,8,142,256,-114,-44.53125
77,63,9,52,512,-460,-89.84375
77,63,10,2127,1024,1103,107.71484375
77,63,11,6821,2048,4773,233.056640625
77,63,12,5546,4096,1450,35.400390625
77,63,13,367,8192,-7825,-95.52001953125
77,63,14,23200,16384,6816,41.6015625
77,63,15,30773,32768,-1995,-6.0882568359375
77,64,1,0,2,-2,-100.0
77,64,2,4,4,0,0.0
77,64,3,16,8,8,100.0
77,64,4,21,16,5,31.25
77,64,5,11,32,-21,-65.625
77,64,6,9,64,-55,-85.9375
77,64,7,105,128,-23,-17.96875
77,64,8,183,256,-73,-28.515625
77,64,9,187,512,-325,-63.4765625
77,64,10,1127,1024,103,10.05859375
77,64,11,1757,2048,-291,-14.208984375
77,64,12,428,4096,-3668,-89.55078125
77,64,13,21520,8192,13328,162.6953125
77,64,14,10737,16384,-5647,-34.466552734375
77,64,15,61163,32768,28395,86.6546630859375
77,65,1,0,2,-2,-100.0
77,65,2,1,4,-3,-75.0
77,65,3,6,8,-2,-25.0
77,65,4,13,16,-3,-18.75
77,65,5,39,32,7,21.875
77,65,6,92,64,28,43.75
77,65,7,108,128,-20,-15.625
77,65,8,243,256,-13,-5.078125
77,65,9,33,512,-479,-93.5546875
77,65,10,708,1024,-316,-30.859375
77,65,11,4986,2048,2938,143.45703125
77,65,12,1289,4096,-2807,-68.5302734375
77,65,13,10181,8192,1989,24.27978515625
77,65,14,2302,16384,-14082,-85.94970703125
77,65,15,27384,32768,-5384,-16.4306640625
77,66,1,0,2,-2,-100.0
77,66,2,1,4,-3,-75.0
77,66,3,3,8,-5,-62.5
77,66,4,48,16,32,200.0
77,66,5,25,32,-7,-21.875
77,66,6,152,64,88,137.5
77,66,7,281,128,153,119.53125
77,66,8,214,256,-42,-16.40625
77,66,9,560,512,48,9.375
77,66,10,1493,1024,469,45.80078125
77,66,11,1751,2048,-297,-14.501953125
77,66,12,936,4096,-3160,-77.1484375
77,66,13,2168,8192,-6024,-73.53515625
77,66,14,3664,16384,-12720,-77.63671875
77,66,15,2378,32768,-30390,-92.742919921875
77,67,1,0,2,-2,-100.0
77,67,2,2,4,-2,-50.0
77,67,3,4,8,-4,-50.0
77,67,4,3,16,-13,-81.25
77,67,5,49,32,17,53.125
77,67,6,87,64,23,35.9375
77,67,7,87,128,-41,-32.03125
77,67,8,681,256,425,166.015625
77,67,9,321,512,-191,-37.3046875
77,67,10,279,1024,-745,-72.75390625
77,67,11,2647,2048,599,29.248046875
77,67,12,961,4096,-3135,-76.5380859375
77,67,13,7946,8192,-246,-3.0029296875
77,67,14,4101,16384,-12283,-74.969482421875
77,67,15,8360,32768,-24408,-74.4873046875
77,68,1,0,2,-2,-100.0
77,68,2,1,4,-3,-75.0
77,68,3,6,8,-2,-25.0
77,68,4,8,16,-8,-50.0
77,68,5,46,32,14,43.75
77,68,6,163,64,99,154.6875
77,68,7,99,128,-29,-22.65625
77,68,8,918,256,662,258.59375
77,68,9,83,512,-429,-83.7890625
77,68,10,135,1024,-889,-86.81640625
77,68,11,1601,2048,-447,-21.826171875
77,68,12,4094,4096,-2,-0.048828125
77,68,13,20449,8192,12257,149.62158203125
77,68,14,4956,16384,-11428,-69.7509765625
77,68,15,14875,32768,-17893,-54.6051025390625
77,69,1,0,2,-2,-100.0
77,69,2,4,4,0,0.0
77,69,3,8,8,0,0.0
77,69,4,8,16,-8,-50.0
77,69,5,28,32,-4,-12.5
77,69,6,106,64,42,65.625
77,69,7,334,128,206,160.9375
77,69,8,63,256,-193,-75.390625
77,69,9,2150,512,1638,319.921875
77,69,10,228,1024,-796,-77.734375
77,69,11,610,2048,-1438,-70.21484375
77,69,12,2331,4096,-1765,-43.0908203125
77,69,13,4061,8192,-4131,-50.42724609375
77,69,14,17075,16384,691,4.217529296875
77,69,15,24061,32768,-8707,-26.5716552734375
77,70,1,0,2,-2,-100.0
77,70,2,1,4,-3,-75.0
77,70,3,2,8,-6,-75.0
77,70,4,9,16,-7,-43.75
77,70,5,7,32,-25,-78.125
77,70,6,16,64,-48,-75.0
77,70,7,22,128,-106,-82.8125
77,70,8,759,256,503,196.484375
77,70,9,76,512,-436,-85.15625
77,70,10,1307,1024,283,27.63671875
77,70,11,3768,2048,1720,83.984375
77,70,12,9597,4096,5501,134.3017578125
77,70,13,12331,8192,4139,50.52490234375
77,70,14,3661,16384,-12723,-77.655029296875
77,70,15,47430,32768,14662,44.744873046875
77,71,1,0,2,-2,-100.0
77,71,2,1,4,-3,-75.0
77,71,3,5,8,-3,-37.5
77,71,4,3,16,-13,-81.25
77,71,5,75,32,43,134.375
77,71,6,133,64,69,107.8125
77,71,7,175,128,47,36.71875
77,71,8,25,256,-231,-90.234375
77,71,9,939,512,427,83.3984375
77,71,10,566,1024,-458,-44.7265625
77,71,11,2277,2048,229,11.181640625
77,71,12,6346,4096,2250,54.931640625
77,71,13,2408,8192,-5784,-70.60546875
77,71,14,56267,16384,39883,243.426513671875
77,71,15,37575,32768,4807,14.6697998046875
77,72,1,0,2,-2,-100.0
77,72,2,2,4,-2,-50.0
77,72,3,5,8,-3,-37.5
77,72,4,4,16,-12,-75.0
77,72,5,35,32,3,9.375
77,72,6,88,64,24,37.5
77,72,7,214,128,86,67.1875
77,72,8,168,256,-88,-34.375
77,72,9,594,512,82,16.015625
77,72,10,20,1024,-1004,-98.046875
77,72,11,1840,2048,-208,-10.15625
77,72,12,3376,4096,-720,-17.578125
77,72,13,10302,8192,2110,25.7568359375
77,72,14,15430,16384,-954,-5.82275390625
77,72,15,669,32768,-32099,-97.9583740234375
77,73,1,0,2,-2,-100.0
77,73,2,1,4,-3,-75.0
77,73,3,9,8,1,12.5
77,73,4,3,16,-13,-81.25
77,73,5,4,32,-28,-87.5
77,73,6,22,64,-42,-65.625
77,73,7,135,128,7,5.46875
77,73,8,101,256,-155,-60.546875
77,73,9,372,512,-140,-27.34375
77,73,10,1331,1024,307,29.98046875
77,73,11,2774,2048,726,35.44921875
77,73,12,15260,4096,11164,272.55859375
77,73,13,12227,8192,4035,49.25537109375
77,73,14,6041,16384,-10343,-63.128662109375
77,73,15,58543,32768,25775,78.6590576171875
77,74,1,0,2,-2,-100.0
77,74,2,4,4,0,0.0
77,74,3,11,8,3,37.5
77,74,4,33,16,17,106.25
77,74,5,7,32,-25,-78.125
77,74,6,13,64,-51,-79.6875
77,74,7,36,128,-92,-71.875
77,74,8,122,256,-134,-52.34375
77,74,9,1266,512,754,147.265625
77,74,10,938,1024,-86,-8.3984375
77,74,11,1470,2048,-578,-28.22265625
77,74,12,2993,4096,-1103,-26.9287109375
77,74,13,22147,8192,13955,170.34912109375
77,74,14,3838,16384,-12546,-76.57470703125
77,74,15,1412,32768,-31356,-95.69091796875
77,75,1,0,2,-2,-100.0
77,75,2,2,4,-2,-50.0
77,75,3,2,8,-6,-75.0
77,75,4,10,16,-6,-37.5
77,75,5,6,32,-26,-81.25
77,75,6,204,64,140,218.75
77,75,7,130,128,2,1.5625
77,75,8,547,256,291,113.671875
77,75,9,40,512,-472,-92.1875
77,75,10,250,1024,-774,-75.5859375
77,75,11,4146,2048,2098,102.44140625
77,75,12,2584,4096,-1512,-36.9140625
77,75,13,5344,8192,-2848,-34.765625
77,75,14,8546,16384,-7838,-47.83935546875
77,75,15,2201,32768,-30567,-93.2830810546875
77,76,1,0,2,-2,-100.0
77,76,2,2,4,-2,-50.0
77,76,3,8,8,0,0.0
77,76,4,21,16,5,31.25
77,76,5,5,32,-27,-84.375
77,76,6,88,64,24,37.5
77,76,7,12,128,-116,-90.625
77,76,8,358,256,102,39.84375
77,76,9,215,512,-297,-58.0078125
77,76,10,2917,1024,1893,184.86328125
77,76,11,3166,2048,1118,54.58984375
77,76,12,721,4096,-3375,-82.3974609375
77,76,13,15636,8192,7444,90.869140625
77,76,14,5514,16384,-10870,-66.34521484375
77,76,15,5525,32768,-27243,-83.1390380859375
77,77,1,0,2,-2,-100.0
77,77,2,1,4,-3,-75.0
77,77,3,2,8,-6,-75.0
77,77,4,3,16,-13,-81.25
77,77,5,6,32,-26,-81.25
77,77,6,35,64,-29,-45.3125
77,77,7,72,128,-56,-43.75
77,77,8,87,256,-169,-66.015625
77,77,9,293,512,-219,-42.7734375
77,77,10,4089,1024,3065,299.31640625
77,77,11,223,2048,-1825,-89.111328125
77,77,12,875,4096,-3221,-78.6376953125
77,77,13,26675,8192,18483,225.62255859375
77,77,14,7899,16384,-8485,-51.788330078125
77,77,15,2679,32768,-30089,-91.8243408203125
78,1,1,0,2,-2,-100.0
78,1,2,1,4,-3,-75.0
78,1,3,10,8,2,25.0
78,1,4,22,16,6,37.5
78,1,5,14,32,-18,-56.25
78,1,6,77,64,13,20.3125
78,1,7,20,128,-108,-84.375
78,1,8,211,256,-45,-17.578125
78,1,9,490,512,-22,-4.296875
78,1,10,1218,1024,194,18.9453125
78,1,11,931,2048,-1117,-54.541015625
78,1,12,511,4096,-3585,-87.5244140625
78,1,13,1059,8192,-7133,-87.07275390625
78,1,14,19849,16384,3465,21.148681640625
78,1,15,3384,32768,-29384,-89.6728515625
78,2,1,0,2,-2,-100.0
78,2,2,3,4,-1,-25.0
78,2,3,7,8,-1,-12.5
78,2,4,14,16,-2,-12.5
78,2,5,87,32,55,171.875
78,2,6,56,64,-8,-12.5
78,2,7,142,128,14,10.9375
78,2,8,452,256,196,76.5625
78,2,9,81,512,-431,-84.1796875
78,2,10,451,1024,-573,-55.95703125
78,2,11,18,2048,-2030,-99.12109375
78,2,12,5037,4096,941,22.9736328125
78,2,13,57572,8192,49380,602.783203125
78,2,14,5251,16384,-11133,-67.950439453125
78,2,15,62966,32768,30198,92.156982421875
78,3,1,0,2,-2,-100.0
78,3,2,1,4,-3,-75.0
78,3,3,2,8,-6,-75.0
78,3,4,5,16,-11,-68.75
78,3,5,15,32,-17,-53.125
78,3,6,24,64,-40,-62.5
78,3,7,519,128,391,305.46875
78,3,8,194,256,-62,-24.21875
78,3,9,1463,512,951,185.7421875
78,3,10,256,1024,-768,-75.0
78,3,11,7435,2048,5387,263.037109375
78,3,12,155,4096,-3941,-96.2158203125
78,3,13,445,8192,-7747,-94.56787109375
78,3,14,717,16384,-15667,-95.623779296875
78,3,15,11830,32768,-20938,-63.897705078125
78,4,1,0,2,-2,-100.0
78,4,2,4,4,0,0.0
78,4,3,5,8,-3,-37.5
78,4,4,22,16,6,37.5
78,4,5,17,32,-15,-46.875
78,4,6,63,64,-1,-1.5625
78,4,7,595,128,467,364.84375
78,4,8,309,256,53,20.703125
78,4,9,1065,512,553,108.0078125
78,4,10,1447,1024,423,41.30859375
78,4,11,715,2048,-1333,-65.087890625
78,4,12,10621,4096,6525,159.3017578125
78,4,13,2499,8192,-5693,-69.49462890625
78,4,14,4105,16384,-12279,-74.945068359375
78,4,15,13757,32768,-19011,-58.0169677734375
78,5,1,0,2,-2,-100.0
78,5,2,3,4,-1,-25.0
78,5,3,9,8,1,12.5
78,5,4,48,16,32,200.0
78,5,5,21,32,-11,-34.375
78,5,6,12,64,-52,-81.25
78,5,7,28,128,-100,-78.125
78,5,8,58,256,-198,-77.34375
78,5,9,1777,512,1265,247.0703125
78,5,10,252,1024,-772,-75.390625
78,5,11,2203,2048,155,7.568359375
78,5,12,6625,4096,2529,61.7431640625
78,5,13,1174,8192,-7018,-85.6689453125
78,5,14,20507,16384,4123,25.164794921875
78,5,15,23871,32768,-8897,-27.1514892578125
78,6,1,0,2,-2,-100.0
78,6,2,3,4,-1,-25.0
78,6,3,2,8,-6,-75.0
78,6,4,6,16,-10,-62.5
78,6,5,4,32,-28,-87.5
78,6,6,124,64,60,93.75
78,6,7,16,128,-112,-87.5
78,6,8,614,256,358,139.84375
78,6,9,159,512,-353,-68.9453125
78,6,10,2422,1024,1398,136.5234375
78,6,11,2011,2048,-37,-1.806640625
78,6,12,9317,4096,5221,127.4658203125
78,6,13,4843,8192,-3349,-40.88134765625
78,6,14,5500,16384,-10884,-66.4306640625
78,6,15,9284,32768,-23484,-71.66748046875
78,7,1,0,2,-2,-100.0
78,7,2,1,4,-3,-75.0
78,7,3,5,8,-3,-37.5
78,7,4,12,16,-4,-25.0
78,7,5,33,32,1,3.125
78,7,6,22,64,-42,-65.625
78,7,7,165,128,37,28.90625
78,7,8,1149,256,893,348.828125
78,7,9,985,512,473,92.3828125
78,7,10,79,1024,-945,-92.28515625
78,7,11,9363,2048,7315,357.177734375
78,7,12,69,4096,-4027,-98.3154296875
78,7,13,3695,8192,-4497,-54.89501953125
78,7,14,15281,16384,-1103,-6.732177734375
78,7,15,6456,32768,-26312,-80.2978515625
78,8,1,0,2,-2,-100.0
78,8,2,2,4,-2,-50.0
78,8,3,8,8,0,0.0
78,8,4,53,16,37,231.25
78,8,5,28,32,-4,-12.5
78,8,6,75,64,11,17.1875
78,8,7,34,128,-94,-73.4375
78,8,8,616,256,360,140.625
78,8,9,791,512,279,54.4921875
78,8,10,1793,1024,769,75.09765625
78,8,11,1575,2048,-473,-23.095703125
78,8,12,9902,4096,5806,141.748046875
78,8,13,5699,8192,-2493,-30.43212890625
78,8,14,3902,16384,-12482,-76.18408203125
78,8,15,68046,32768,35278,107.659912109375
78,9,1,0,2,-2,-100.0
78,9,2,1,4,-3,-75.0
78,9,3,2,8,-6,-75.0
78,9,4,8,16,-8,-50.0
78,9,5,28,32,-4,-12.5
78,9,6,14,64,-50,-78.125
78,9,7,74,128,-54,-42.1875
78,9,8,930,256,674,263.28125
78,9,9,325,512,-187,-36.5234375
78,9,10,2072,1024,1048,102.34375
78,9,11,5601,2048,3553,173.486328125
78,9,12,2085,4096,-2011,-49.0966796875
78,9,13,3078,8192,-5114,-62.4267578125
78,9,14,9164,16384,-7220,-44.0673828125
78,9,15,60690,32768,27922,85.211181640625
78,10,1,0,2,-2,-100.0
78,10,2,1,4,-3,-75.0
78,10,3,7,8,-1,-12.5
78,10,4,8,16,-8,-50.0
78,10,5,41,32,9,28.125
78,10,6,90,64,26,40.625
78,10,7,159,128,31,24.21875
78,10,8,15,256,-241,-94.140625
78,10,9,388,512,-124,-24.21875
78,10,10,74,1024,-950,-92.7734375
78,10,11,1988,2048,-60,-2.9296875
78,10,12,184,4096,-3912,-95.5078125
78,10,13,1430,8192,-6762,-82.5439453125
78,10,14,4833,16384,-11551,-70.501708984375
78,10,15,50345,32768,17577,53.6407470703125
78,11,1,0,2,-2,-100.0
78,11,2,1,4,-3,-75.0
78,11,3,23,8,15,187.5
78,11,4,25,16,9,56.25
78,11,5,35,32,3,9.375
78,11,6,6,64,-58,-90.625
78,11,7,41,128,-87,-67.96875
78,11,8,29,256,-227,-88.671875
78,11,9,81,512,-431,-84.1796875
78,11,10,188,1024,-836,-81.640625
78,11,11,812,2048,-1236,-60.3515625
78,11,12,7967,4096,3871,94.5068359375
78,11,13,8469,8192,277,3.38134765625
78,11,14,14287,16384,-2097,-12.799072265625
78,11,15,10761,32768,-22007,-67.1600341796875
78,12,1,0,2,-2,-100.0
78,12,2,3,4,-1,-25.0
78,12,3,29,8,21,262.5
78,12,4,10,16,-6,-37.5
78,12,5,18,32,-14,-43.75
78,12,6,64,64,0,0.0
78,12,7,63,128,-65,-50.78125
78,12,8,372,256,116,45.3125
78,12,9,815,512,303,59.1796875
78,12,10,7405,1024,6381,623.14453125
78,12,11,2838,2048,790,38.57421875
78,12,12,5482,4096,1386,33.837890625
78,12,13,681,8192,-7511,-91.68701171875
78,12,14,15738,16384,-646,-3.94287109375
78,12,15,20300,32768,-12468,-38.04931640625
78,13,1,0,2,-2,-100.0
78,13,2,2,4,-2,-50.0
78,13,3,6,8,-2,-25.0
78,13,4,7,16,-9,-56.25
78,13,5,29,32,-3,-9.375
78,13,6,18,64,-46,-71.875
78,13,7,425,128,297,232.03125
78,13,8,27,256,-229,-89.453125
78,13,9,100,512,-412,-80.46875
78,13,10,816,1024,-208,-20.3125
78,13,11,1389,2048,-659,-32.177734375
78,13,12,2165,4096,-1931,-47.1435546875
78,13,13,6154,8192,-2038,-24.8779296875
78,13,14,17305,16384,921,5.621337890625
78,13,15,12589,32768,-20179,-61.5814208984375
78,14,1,0,2,-2,-100.0
78,14,2,1,4,-3,-75.0
78,14,3,3,8,-5,-62.5
78,14,4,26,16,10,62.5
78,14,5,11,32,-21,-65.625
78,14,6,28,64,-36,-56.25
78,14,7,70,128,-58,-45.3125
78,14,8,16,256,-240,-93.75
78,14,9,746,512,234,45.703125
78,14,10,257,1024,-767,-74.90234375
78,14,11,474,2048,-1574,-76.85546875
78,14,12,1626,4096,-2470,-60.302734375
78,14,13,1810,8192,-6382,-77.9052734375
78,14,14,9653,16384,-6731,-41.082763671875
78,14,15,21253,32768,-11515,-35.1409912109375
78,15,1,0,2,-2,-100.0
78,15,2,1,4,-3,-75.0
78,15,3,2,8,-6,-75.0
78,15,4,17,16,1,6.25
78,15,5,46,32,14,43.75
78,15,6,11,64,-53,-82.8125
78,15,7,58,128,-70,-54.6875
78,15,8,152,256,-104,-40.625
78,15,9,66,512,-446,-87.109375
78,15,10,130,1024,-894,-87.3046875
78,15,11,5679,2048,3631,177.294921875
78,15,12,3957,4096,-139,-3.3935546875
78,15,13,9335,8192,1143,13.95263671875
78,15,14,28046,16384,11662,71.17919921875
78,15,15,144670,32768,111902,341.497802734375
78,16,1,0,2,-2,-100.0
78,16,2,1,4,-3,-75.0
78,16,3,2,8,-6,-75.0
78,16,4,25,16,9,56.25
78,16,5,22,32,-10,-31.25
78,16,6,10,64,-54,-84.375
78,16,7,232,128,104,81.25
78,16,8,88,256,-168,-65.625
78,16,9,129,512,-383,-74.8046875
78,16,10,3114,1024,2090,204.1015625
78,16,11,94,2048,-1954,-95.41015625
78,16,12,5464,4096,1368,33.3984375
78,16,13,196,8192,-7996,-97.607421875
78,16,14,4392,16384,-11992,-73.193359375
78,16,15,5637,32768,-27131,-82.7972412109375
78,17,1,0,2,-2,-100.0
78,17,2,2,4,-2,-50.0
78,17,3,9,8,1,12.5
78,17,4,25,16,9,56.25
78,17,5,7,32,-25,-78.125
78,17,6,104,64,40,62.5
78,17,7,17,128,-111,-86.71875
78,17,8,505,256,249,97.265625
78,17,9,1067,512,555,108.3984375
78,17,10,70,1024,-954,-93.1640625
78,17,11,7542,2048,5494,268.26171875
78,17,12,9565,4096,5469,133.5205078125
78,17,13,11513,8192,3321,40.53955078125
78,17,14,17159,16384,775,4.730224609375
78,17,15,3953,32768,-28815,-87.9364013671875
78,18,1,0,2,-2,-100.0
78,18,2,1,4,-3,-75.0
78,18,3,5,8,-3,-37.5
78,18,4,14,16,-2,-12.5
78,18,5,43,32,11,34.375
78,18,6,75,64,11,17.1875
78,18,7,42,128,-86,-67.1875
78,18,8,204,256,-52,-20.3125
78,18,9,287,512,-225,-43.9453125
78,18,10,164,1024,-860,-83.984375
78,18,11,1759,2048,-289,-14.111328125
78,18,12,516,4096,-3580,-87.40234375
78,18,13,22765,8192,14573,177.89306640625
78,18,14,43910,16384,27526,168.00537109375
78,18,15,18345,32768,-14423,-44.0155029296875
78,19,1,0,2,-2,-100.0
78,19,2,1,4,-3,-75.0
78,19,3,5,8,-3,-37.5
78,19,4,17,16,1,6.25
78,19,5,11,32,-21,-65.625
78,19,6,57,64,-7,-10.9375
78,19,7,127,128,-1,-0.78125
78,19,8,486,256,230,89.84375
78,19,9,802,512,290,56.640625
78,19,10,1401,1024,377,36.81640625
78,19,11,306,2048,-1742,-85.05859375
78,19,12,1263,4096,-2833,-69.1650390625
78,19,13,5216,8192,-2976,-36.328125
78,19,14,5173,16384,-11211,-68.426513671875
78,19,15,22943,32768,-9825,-29.9835205078125
78,20,1,0,2,-2,-100.0
78,20,2,1,4,-3,-75.0
78,20,3,4,8,-4,-50.0
78,20,4,42,16,26,162.5
78,20,5,83,32,51,159.375
78,20,6,63,64,-1,-1.5625
78,20,7,53,128,-75,-58.59375
78,20,8,104,256,-152,-59.375
78,20,9,169,512,-343,-66.9921875
78,20,10,156,1024,-868,-84.765625
78,20,11,472,2048,-1576,-76.953125
78,20,12,2384,4096,-1712,-41.796875
78,20,13,15925,8192,7733,94.39697265625
78,20,14,3120,16384,-13264,-80.95703125
78,20,15,66560,32768,33792,103.125
78,21,1,0,2,-2,-100.0
78,21,2,3,4,-1,-25.0
78,21,3,3,8,-5,-62.5
78,21,4,21,16,5,31.25
78,21,5,69,32,37,115.625
78,21,6,6,64,-58,-90.625
78,21,7,54,128,-74,-57.8125
78,21,8,145,256,-111,-43.359375
78,21,9,201,512,-311,-60.7421875
78,21,10,1043,1024,19,1.85546875
78,21,11,1363,2048,-685,-33.447265625
78,21,12,2261,4096,-1835,-44.7998046875
78,21,13,11321,8192,3129,38.19580078125
78,21,14,7279,16384,-9105,-55.572509765625
78,21,15,2094,32768,-30674,-93.609619140625
78,22,1,0,2,-2,-100.0
78,22,2,1,4,-3,-75.0
78,22,3,4,8,-4,-50.0
78,22,4,15,16,-1,-6.25
78,22,5,38,32,6,18.75
78,22,6,96,64,32,50.0
78,22,7,206,128,78,60.9375
78,22,8,59,256,-197,-76.953125
78,22,9,825,512,313,61.1328125
78,22,10,63,1024,-961,-93.84765625
78,22,11,479,2048,-1569,-76.611328125
78,22,12,3774,4096,-322,-7.861328125
78,22,13,14862,8192,6670,81.4208984375
78,22,14,13202,16384,-3182,-19.42138671875
78,22,15,1691,32768,-31077,-94.8394775390625
78,23,1,0,2,-2,-100.0
78,23,2,2,4,-2,-50.0
78,23,3,2,8,-6,-75.0
78,23,4,19,16,3,18.75
78,23,5,21,32,-11,-34.375
78,23,6,8,64,-56,-87.5
78,23,7,6,128,-122,-95.3125
78,23,8,443,256,187,73.046875
78,23,9,261,512,-251,-49.0234375
78,23,10,92,1024,-932,-91.015625
78,23,11,716,2048,-1332,-65.0390625
78,23,12,3065,4096,-1031,-25.1708984375
78,23,13,3607,8192,-4585,-55.96923828125
78,23,14,26327,16384,9943,60.687255859375
78,23,15,737,32768,-32031,-97.7508544921875
78,24,1,0,2,-2,-100.0
78,24,2,1,4,-3,-75.0
78,24,3,3,8,-5,-62.5
78,24,4,12,16,-4,-25.0
78,24,5,9,32,-23,-71.875
78,24,6,19,64,-45,-70.3125
78,24,7,68,128,-60,-46.875
78,24,8,80,256,-176,-68.75
78,24,9,28,512,-484,-94.53125
78,24,10,3870,1024,2846,277.9296875
78,24,11,3065,2048,1017,49.658203125
78,24,12,4202,4096,106,2.587890625
78,24,13,313,8192,-7879,-96.17919921875
78,24,14,8142,16384,-8242,-50.30517578125
78,24,15,111442,32768,78674,240.093994140625
78,25,1,0,2,-2,-100.0
78,25,2,1,4,-3,-75.0
78,25,3,5,8,-3,-37.5
78,25,4,8,16,-8,-50.0
78,25,5,13,32,-19,-59.375
78,25,6,240,64,176,275.0
78,25,7,8,128,-120,-93.75
78,25,8,42,256,-214,-83.59375
78,25,9,75,512,-437,-85.3515625
78,25,10,479,1024,-545,-53.22265625
78,25,11,1483,2048,-565,-27.587890625
78,25,12,2193,4096,-1903,-46.4599609375
78,25,13,6145,8192,-2047,-24.98779296875
78,25,14,13198,16384,-3186,-19.44580078125
78,25,15,8864,32768,-23904,-72.94921875
78,26,1,0,2,-2,-100.0
78,26,2,1,4,-3,-75.0
78,26,3,5,8,-3,-37.5
78,26,4,7,16,-9,-56.25
78,26,5,24,32,-8,-25.0
78,26,6,38,64,-26,-40.625
78,26,7,211,128,83,64.84375
78,26,8,450,256,194,75.78125
78,26,9,1623,512,1111,216.9921875
78,26,10,679,1024,-345,-33.69140625
78,26,11,731,2048,-1317,-64.306640625
78,26,12,2682,4096,-1414,-34.521484375
78,26,13,5082,8192,-3110,-37.9638671875
78,26,14,2397,16384,-13987,-85.369873046875
78,26,15,34085,32768,1317,4.0191650390625
78,27,1,0,2,-2,-100.0
78,27,2,3,4,-1,-25.0
78,27,3,2,8,-6,-75.0
78,27,4,34,16,18,112.5
78,27,5,4,32,-28,-87.5
78,27,6,164,64,100,156.25
78,27,7,20,128,-108,-84.375
78,27,8,689,256,433,169.140625
78,27,9,1899,512,1387,270.8984375
78,27,10,699,1024,-325,-31.73828125
78,27,11,454,2048,-1594,-77.83203125
78,27,12,6315,4096,2219,54.1748046875
78,27,13,2191,8192,-6001,-73.25439453125
78,27,14,647,16384,-15737,-96.051025390625
78,27,15,35807,32768,3039,9.2742919921875
78,28,1,0,2,-2,-100.0
78,28,2,1,4,-3,-75.0
78,28,3,6,8,-2,-25.0
78,28,4,11,16,-5,-31.25
78,28,5,34,32,2,6.25
78,28,6,5,64,-59,-92.1875
78,28,7,182,128,54,42.1875
78,28,8,299,256,43,16.796875
78,28,9,1388,512,876,171.09375
78,28,10,133,1024,-891,-87.01171875
78,28,11,8516,2048,6468,315.8203125
78,28,12,5801,4096,1705,41.6259765625
78,28,13,2920,8192,-5272,-64.35546875
78,28,14,10894,16384,-5490,-33.50830078125
78,28,15,5880,32768,-26888,-82.0556640625
78,29,1,0,2,-2,-100.0
78,29,2,2,4,-2,-50.0
78,29,3,7,8,-1,-12.5
78,29,4,21,16,5,31.25
78,29,5,13,32,-19,-59.375
78,29,6,41,64,-23,-35.9375
78,29,7,218,128,90,70.3125
78,29,8,338,256,82,32.03125
78,29,9,368,512,-144,-28.125
78,29,10,5940,1024,4916,480.078125
78,29,11,669,2048,-1379,-67.333984375
78,29,12,5585,4096,1489,36.3525390625
78,29,13,643,8192,-7549,-92.15087890625
78,29,14,26929,16384,10545,64.361572265625
78,29,15,19547,32768,-13221,-40.3472900390625
78,30,1,0,2,-2,-100.0
78,30,2,1,4,-3,-75.0
78,30,3,2,8,-6,-75.0
78,30,4,4,16,-12,-75.0
78,30,5,19,32,-13,-40.625
78,30,6,5,64,-59,-92.1875
78,30,7,185,128,57,44.53125
78,30,8,338,256,82,32.03125
78,30,9,562,512,50,9.765625
78,30,10,273,1024,-751,-73.33984375
78,30,11,1395,2048,-653,-31.884765625
78,30,12,216,4096,-3880,-94.7265625
78,30,13,3443,8192,-4749,-57.97119140625
78,30,14,1416,16384,-14968,-91.357421875
78,30,15,40483,32768,7715,23.5443115234375
78,31,1,0,2,-2,-100.0
78,31,2,1,4,-3,-75.0
78,31,3,6,8,-2,-25.0
78,31,4,21,16,5,31.25
78,31,5,21,32,-11,-34.375
78,31,6,29,64,-35,-54.6875
78,31,7,331,128,203,158.59375
78,31,8,114,256,-142,-55.46875
78,31,9,68,512,-444,-86.71875
78,31,10,510,1024,-514,-50.1953125
78,31,11,466,2048,-1582,-77.24609375
78,31,12,3870,4096,-226,-5.517578125
78,31,13,3484,8192,-4708,-57.470703125
78,31,14,8869,16384,-7515,-45.867919921875
78,31,15,41762,32768,8994,27.447509765625
78,32,1,0,2,-2,-100.0
78,32,2,1,4,-3,-75.0
78,32,3,8,8,0,0.0
78,32,4,17,16,1,6.25
78,32,5,40,32,8,25.0
78,32,6,24,64,-40,-62.5
78,32,7,267,128,139,108.59375
78,32,8,285,256,29,11.328125
78,32,9,404,512,-108,-21.09375
78,32,10,528,1024,-496,-48.4375
78,32,11,315,2048,-1733,-84.619140625
78,32,12,5030,4096,934,22.802734375
78,32,13,4113,8192,-4079,-49.79248046875
78,32,14,37143,16384,20759,126.702880859375
78,32,15,2385,32768,-30383,-92.7215576171875
78,33,1,0,2,-2,-100.0
78,33,2,2,4,-2,-50.0
78,33,3,2,8,-6,-75.0
78,33,4,15,16,-1,-6.25
78,33,5,24,32,-8,-25.0
78,33,6,83,64,19,29.6875
78,33,7,19,128,-109,-85.15625
78,33,8,168,256,-88,-34.375
78,33,9,816,512,304,59.375
78,33,10,2530,1024,1506,147.0703125
78,33,11,767,2048,-1281,-62.548828125
78,33,12,3057,4096,-1039,-25.3662109375
78,33,13,14958,8192,6766,82.5927734375
78,33,14,171,16384,-16213,-98.956298828125
78,33,15,18880,32768,-13888,-42.3828125
78,34,1,0,2,-2,-100.0
78,34,2,1,4,-3,-75.0
78,34,3,2,8,-6,-75.0
78,34,4,4,16,-12,-75.0
78,34,5,58,32,26,81.25
78,34,6,11,64,-53,-82.8125
78,34,7,22,128,-106,-82.8125
78,34,8,226,256,-30,-11.71875
78,34,9,942,512,430,83.984375
78,34,10,129,1024,-895,-87.40234375
78,34,11,1270,2048,-778,-37.98828125
78,34,12,1834,4096,-2262,-55.224609375
78,34,13,95,8192,-8097,-98.84033203125
78,34,14,15437,16384,-947,-5.780029296875
78,34,15,4128,32768,-28640,-87.40234375
78,35,1,0,2,-2,-100.0
78,35,2,2,4,-2,-50.0
78,35,3,7,8,-1,-12.5
78,35,4,3,16,-13,-81.25
78,35,5,60,32,28,87.5
78,35,6,191,64,127,198.4375
78,35,7,17,128,-111,-86.71875
78,35,8,163,256,-93,-36.328125
78,35,9,297,512,-215,-41.9921875
78,35,10,166,1024,-858,-83.7890625
78,35,11,1287,2048,-761,-37.158203125
78,35,12,18521,4096,14425,352.1728515625
78,35,13,5485,8192,-2707,-33.04443359375
78,35,14,12630,16384,-3754,-22.91259765625
78,35,15,975,32768,-31793,-97.0245361328125
78,36,1,0,2,-2,-100.0
78,36,2,2,4,-2,-50.0
78,36,3,2,8,-6,-75.0
78,36,4,3,16,-13,-81.25
78,36,5,29,32,-3,-9.375
78,36,6,81,64,17,26.5625
78,36,7,33,128,-95,-74.21875
78,36,8,295,256,39,15.234375
78,36,9,547,512,35,6.8359375
78,36,10,291,1024,-733,-71.58203125
78,36,11,2662,2048,614,29.98046875
78,36,12,6605,4096,2509,61.2548828125
78,36,13,3601,8192,-4591,-56.04248046875
78,36,14,48714,16384,32330,197.32666015625
78,36,15,6647,32768,-26121,-79.7149658203125
78,37,1,0,2,-2,-100.0
78,37,2,3,4,-1,-25.0
78,37,3,2,8,-6,-75.0
78,37,4,12,16,-4,-25.0
78,37,5,5,32,-27,-84.375
78,37,6,27,64,-37,-57.8125
78,37,7,49,128,-79,-61.71875
78,37,8,479,256,223,87.109375
78,37,9,415,512,-97,-18.9453125
78,37,10,267,1024,-757,-73.92578125
78,37,11,2044,2048,-4,-0.1953125
78,37,12,3937,4096,-159,-3.8818359375
78,37,13,1214,8192,-6978,-85.1806640625
78,37,14,24325,16384,7941,48.468017578125
78,37,15,12965,32768,-19803,-60.4339599609375
78,38,1,0,2,-2,-100.0
78,38,2,1,4,-3,-75.0
78,38,3,6,8,-2,-25.0
78,38,4,17,16,1,6.25
78,38,5,30,32,-2,-6.25
78,38,6,29,64,-35,-54.6875
78,38,7,30,128,-98,-76.5625
78,38,8,262,256,6,2.34375
78,38,9,76,512,-436,-85.15625
78,38,10,191,1024,-833,-81.34765625
78,38,11,4495,2048,2447,119.482421875
78,38,12,7523,4096,3427,83.6669921875
78,38,13,6699,8192,-1493,-18.22509765625
78,38,14,8859,16384,-7525,-45.928955078125
78,38,15,20140,32768,-12628,-38.53759765625
78,39,1,0,2,-2,-100.0
78,39,2,1,4,-3,-75.0
78,39,3,3,8,-5,-62.5
78,39,4,7,16,-9,-56.25
78,39,5,26,32,-6,-18.75
78,39,6,76,64,12,18.75
78,39,7,64,128,-64,-50.0
78,39,8,28,256,-228,-89.0625
78,39,9,15,512,-497,-97.0703125
78,39,10,981,1024,-43,-4.19921875
78,39,11,2673,2048,625,30.517578125
78,39,12,1597,4096,-2499,-61.0107421875
78,39,13,10357,8192,2165,26.42822265625
78,39,14,6928,16384,-9456,-57.71484375
78,39,15,31514,32768,-1254,-3.826904296875
78,40,1,0,2,-2,-100.0
78,40,2,1,4,-3,-75.0
78,40,3,5,8,-3,-37.5
78,40,4,19,16,3,18.75
78,40,5,7,32,-25,-78.125
78,40,6,29,64,-35,-54.6875
78,40,7,138,128,10,7.8125
78,40,8,32,256,-224,-87.5
78,40,9,31,512,-481,-93.9453125
78,40,10,659,1024,-365,-35.64453125
78,40,11,1944,2048,-104,-5.078125
78,40,12,2279,4096,-1817,-44.3603515625
78,40,13,3758,8192,-4434,-54.1259765625
78,40,14,39404,16384,23020,140.5029296875
78,40,15,6433,32768,-26335,-80.3680419921875
78,41,1,0,2,-2,-100.0
78,41,2,4,4,0,0.0
78,41,3,12,8,4,50.0
78,41,4,11,16,-5,-31.25
78,41,5,5,32,-27,-84.375
78,41,6,213,64,149,232.8125
78,41,7,47,128,-81,-63.28125
78,41,8,84,256,-172,-67.1875
78,41,9,297,512,-215,-41.9921875
78,41,10,60,1024,-964,-94.140625
78,41,11,1360,2048,-688,-33.59375
78,41,12,3588,4096,-508,-12.40234375
78,41,13,3792,8192,-4400,-53.7109375
78,41,14,31170,16384,14786,90.24658203125
78,41,15,17825,32768,-14943,-45.6024169921875
78,42,1,0,2,-2,-100.0
78,42,2,2,4,-2,-50.0
78,42,3,4,8,-4,-50.0
78,42,4,9,16,-7,-43.75
78,42,5,63,32,31,96.875
78,42,6,51,64,-13,-20.3125
78,42,7,136,128,8,6.25
78,42,8,43,256,-213,-83.203125
78,42,9,28,512,-484,-94.53125
78,42,10,107,1024,-917,-89.55078125
78,42,11,64,2048,-1984,-96.875
78,42,12,1792,4096,-2304,-56.25
78,42,13,2831,8192,-5361,-65.44189453125
78,42,14,6762,16384,-9622,-58.72802734375
78,42,15,14794,32768,-17974,-54.852294921875
78,43,1,0,2,-2,-100.0
78,43,2,2,4,-2,-50.0
78,43,3,2,8,-6,-75.0
78,43,4,6,16,-10,-62.5
78,43,5,9,32,-23,-71.875
78,43,6,219,64,155,242.1875
78,43,7,66,128,-62,-48.4375
78,43,8,29,256,-227,-88.671875
78,43,9,238,512,-274,-53.515625
78,43,10,2004,1024,980,95.703125
78,43,11,1142,2048,-906,-44.23828125
78,43,12,2091,4096,-2005,-48.9501953125
78,43,13,14596,8192,6404,78.173828125
78,43,14,9609,16384,-6775,-41.351318359375
78,43,15,28222,32768,-4546,-13.873291015625
78,44,1,0,2,-2,-100.0
78,44,2,1,4,-3,-75.0
78,44,3,2,8,-6,-75.0
78,44,4,4,16,-12,-75.0
78,44,5,78,32,46,143.75
78,44,6,50,64,-14,-21.875
78,44,7,10,128,-118,-92.1875
78,44,8,175,256,-81,-31.640625
78,44,9,219,512,-293,-57.2265625
78,44,10,1517,1024,493,48.14453125
78,44,11,5696,2048,3648,178.125
78,44,12,8194,4096,4098,100.048828125
78,44,13,8853,8192,661,8.06884765625
78,44,14,18022,16384,1638,9.99755859375
78,44,15,7751,32768,-25017,-76.3458251953125
78,45,1,0,2,-2,-100.0
78,45,2,3,4,-1,-25.0
78,45,3,14,8,6,75.0
78,45,4,71,16,55,343.75
78,45,5,13,32,-19,-59.375
78,45,6,68,64,4,6.25
78,45,7,72,128,-56,-43.75
78,45,8,21,256,-235,-91.796875
78,45,9,1287,512,775,151.3671875
78,45,10,1043,1024,19,1.85546875
78,45,11,960,2048,-1088,-53.125
78,45,12,8523,4096,4427,108.0810546875
78,45,13,7277,8192,-915,-11.16943359375
78,45,14,3554,16384,-12830,-78.30810546875
78,45,15,2813,32768,-29955,-91.4154052734375
78,46,1,0,2,-2,-100.0
78,46,2,4,4,0,0.0
78,46,3,3,8,-5,-62.5
78,46,4,6,16,-10,-62.5
78,46,5,36,32,4,12.5
78,46,6,221,64,157,245.3125
78,46,7,95,128,-33,-25.78125
78,46,8,107,256,-149,-58.203125
78,46,9,161,512,-351,-68.5546875
78,46,10,1531,1024,507,49.51171875
78,46,11,3452,2048,1404,68.5546875
78,46,12,1050,4096,-3046,-74.365234375
78,46,13,2906,8192,-5286,-64.5263671875
78,46,14,8149,16384,-8235,-50.262451171875
78,46,15,16338,32768,-16430,-50.140380859375
78,47,1,0,2,-2,-100.0
78,47,2,1,4,-3,-75.0
78,47,3,2,8,-6,-75.0
78,47,4,6,16,-10,-62.5
78,47,5,17,32,-15,-46.875
78,47,6,53,64,-11,-17.1875
78,47,7,264,128,136,106.25
78,47,8,538,256,282,110.15625
78,47,9,10,512,-502,-98.046875
78,47,10,5856,1024,4832,471.875
78,47,11,2691,2048,643,31.396484375
78,47,12,2588,4096,-1508,-36.81640625
78,47,13,21552,8192,13360,163.0859375
78,47,14,15598,16384,-786,-4.79736328125
78,47,15,71461,32768,38693,118.0816650390625
78,48,1,0,2,-2,-100.0
78,48,2,1,4,-3,-75.0
78,48,3,11,8,3,37.5
78,48,4,22,16,6,37.5
78,48,5,42,32,10,31.25
78,48,6,113,64,49,76.5625
78,48,7,46,128,-82,-64.0625
78,48,8,484,256,228,89.0625
78,48,9,187,512,-325,-63.4765625
78,48,10,1913,1024,889,86.81640625
78,48,11,358,2048,-1690,-82.51953125
78,48,12,13020,4096,8924,217.87109375
78,48,13,4415,8192,-3777,-46.10595703125
78,48,14,19805,16384,3421,20.880126953125
78,48,15,5104,32768,-27664,-84.423828125
78,49,1,0,2,-2,-100.0
78,49,2,2,4,-2,-50.0
78,49,3,10,8,2,25.0
78,49,4,14,16,-2,-12.5
78,49,5,64,32,32,100.0
78,49,6,157,64,93,145.3125
78,49,7,64,128,-64,-50.0
78,49,8,409,256,153,59.765625
78,49,9,182,512,-330,-64.453125
78,49,10,193,1024,-831,-81.15234375
78,49,11,1657,2048,-391,-19.091796875
78,49,12,5020,4096,924,22.55859375
78,49,13,4435,8192,-3757,-45.86181640625
78,49,14,47213,16384,30829,188.165283203125
78,49,15,16886,32768,-15882,-48.468017578125
78,50,1,0,2,-2,-100.0
78,50,2,2,4,-2,-50.0
78,50,3,10,8,2,25.0
78,50,4,6,16,-10,-62.5
78,50,5,4,32,-28,-87.5
78,50,6,5,64,-59,-92.1875
78,50,7,42,128,-86,-67.1875
78,50,8,236,256,-20,-7.8125
78,50,9,287,512,-225,-43.9453125
78,50,10,1868,1024,844,82.421875
78,50,11,4573,2048,2525,123.291015625
78,50,12,1935,4096,-2161,-52.7587890625
78,50,13,670,8192,-7522,-91.8212890625
78,50,14,4204,16384,-12180,-74.3408203125
78,50,15,4837,32768,-27931,-85.2386474609375
78,51,1,0,2,-2,-100.0
78,51,2,3,4,-1,-25.0
78,51,3,4,8,-4,-50.0
78,51,4,6,16,-10,-62.5
78,51,5,5,32,-27,-84.375
78,51,6,111,64,47,73.4375
78,51,7,110,128,-18,-14.0625
78,51,8,78,256,-178,-69.53125
78,51,9,410,512,-102,-19.921875
78,51,10,658,1024,-366,-35.7421875
78,51,11,570,2048,-1478,-72.16796875
78,51,12,7203,4096,3107,75.8544921875
78,51,13,5102,8192,-3090,-37.7197265625
78,51,14,6133,16384,-10251,-62.567138671875
78,51,15,21833,32768,-10935,-33.3709716796875
78,52,1,0,2,-2,-100.0
78,52,2,5,4,1,25.0
78,52,3,9,8,1,12.5
78,52,4,31,16,15,93.75
78,52,5,14,32,-18,-56.25
78,52,6,39,64,-25,-39.0625
78,52,7,109,128,-19,-14.84375
78,52,8,107,256,-149,-58.203125
78,52,9,206,512,-306,-59.765625
78,52,10,1564,1024,540,52.734375
78,52,11,1032,2048,-1016,-49.609375
78,52,12,8327,4096,4231,103.2958984375
78,52,13,7582,8192,-610,-7.4462890625
78,52,14,46893,16384,30509,186.212158203125
78,52,15,48694,32768,15926,48.602294921875
78,53,1,0,2,-2,-100.0
78,53,2,1,4,-3,-75.0
78,53,3,10,8,2,25.0
78,53,4,9,16,-7,-43.75
78,53,5,38,32,6,18.75
78,53,6,190,64,126,196.875
78,53,7,7,128,-121,-94.53125
78,53,8,644,256,388,151.5625
78,53,9,489,512,-23,-4.4921875
78,53,10,599,1024,-425,-41.50390625
78,53,11,883,2048,-1165,-56.884765625
78,53,12,1061,4096,-3035,-74.0966796875
78,53,13,9944,8192,1752,21.38671875
78,53,14,51647,16384,35263,215.228271484375
78,53,15,20993,32768,-11775,-35.9344482421875
78,54,1,0,2,-2,-100.0
78,54,2,2,4,-2,-50.0
78,54,3,13,8,5,62.5
78,54,4,20,16,4,25.0
78,54,5,10,32,-22,-68.75
78,54,6,128,64,64,100.0
78,54,7,334,128,206,160.9375
78,54,8,385,256,129,50.390625
78,54,9,747,512,235,45.8984375
78,54,10,42,1024,-982,-95.8984375
78,54,11,1279,2048,-769,-37.548828125
78,54,12,6949,4096,2853,69.6533203125
78,54,13,1154,8192,-7038,-85.9130859375
78,54,14,34599,16384,18215,111.175537109375
78,54,15,5400,32768,-27368,-83.5205078125
78,55,1,0,2,-2,-100.0
78,55,2,3,4,-1,-25.0
78,55,3,5,8,-3,-37.5
78,55,4,9,16,-7,-43.75
78,55,5,50,32,18,56.25
78,55,6,39,64,-25,-39.0625
78,55,7,85,128,-43,-33.59375
78,55,8,117,256,-139,-54.296875
78,55,9,29,512,-483,-94.3359375
78,55,10,1057,1024,33,3.22265625
78,55,11,3896,2048,1848,90.234375
78,55,12,296,4096,-3800,-92.7734375
78,55,13,38703,8192,30511,372.44873046875
78,55,14,35593,16384,19209,117.242431640625
78,55,15,77338,32768,44570,136.016845703125
78,56,1,0,2,-2,-100.0
78,56,2,1,4,-3,-75.0
78,56,3,2,8,-6,-75.0
78,56,4,5,16,-11,-68.75
78,56,5,6,32,-26,-81.25
78,56,6,95,64,31,48.4375
78,56,7,105,128,-23,-17.96875
78,56,8,352,256,96,37.5
78,56,9,278,512,-234,-45.703125
78,56,10,408,1024,-616,-60.15625
78,56,11,524,2048,-1524,-74.4140625
78,56,12,6160,4096,2064,50.390625
78,56,13,5448,8192,-2744,-33.49609375
78,56,14,1583,16384,-14801,-90.338134765625
78,56,15,4950,32768,-27818,-84.893798828125
78,57,1,0,2,-2,-100.0
78,57,2,1,4,-3,-75.0
78,57,3,8,8,0,0.0
78,57,4,14,16,-2,-12.5
78,57,5,74,32,42,131.25
78,57,6,27,64,-37,-57.8125
78,57,7,142,128,14,10.9375
78,57,8,26,256,-230,-89.84375
78,57,9,3330,512,2818,550.390625
78,57,10,668,1024,-356,-34.765625
78,57,11,162,2048,-1886,-92.08984375
78,57,12,4981,4096,885,21.6064453125
78,57,13,4018,8192,-4174,-50.9521484375
78,57,14,9889,16384,-6495,-39.642333984375
78,57,15,82916,32768,50148,153.03955078125
78,58,1,0,2,-2,-100.0
78,58,2,2,4,-2,-50.0
78,58,3,2,8,-6,-75.0
78,58,4,9,16,-7,-43.75
78,58,5,84,32,52,162.5
78,58,6,44,64,-20,-31.25
78,58,7,155,128,27,21.09375
78,58,8,1071,256,815,318.359375
78,58,9,372,512,-140,-27.34375
78,58,10,555,1024,-469,-45.80078125
78,58,11,1921,2048,-127,-6.201171875
78,58,12,7979,4096,3883,94.7998046875
78,58,13,2306,8192,-5886,-71.8505859375
78,58,14,11845,16384,-4539,-27.703857421875
78,58,15,3373,32768,-29395,-89.7064208984375
78,59,1,0,2,-2,-100.0
78,59,2,1,4,-3,-75.0
78,59,3,3,8,-5,-62.5
78,59,4,20,16,4,25.0
78,59,5,8,32,-24,-75.0
78,59,6,39,64,-25,-39.0625
78,59,7,71,128,-57,-44.53125
78,59,8,207,256,-49,-19.140625
78,59,9,64,512,-448,-87.5
78,59,10,1076,1024,52,5.078125
78,59,11,1812,2048,-236,-11.5234375
78,59,12,1576,4096,-2520,-61.5234375
78,59,13,3646,8192,-4546,-55.4931640625
78,59,14,14917,16384,-1467,-8.953857421875
78,59,15,16788,32768,-15980,-48.76708984375
78,60,1,0,2,-2,-100.0
78,60,2,2,4,-2,-50.0
78,60,3,14,8,6,75.0
78,60,4,15,16,-1,-6.25
78,60,5,11,32,-21,-65.625
78,60,6,409,64,345,539.0625
78,60,7,44,128,-84,-65.625
78,60,8,11,256,-245,-95.703125
78,60,9,68,512,-444,-86.71875
78,60,10,562,1024,-462,-45.1171875
78,60,11,839,2048,-1209,-59.033203125
78,60,12,2515,4096,-1581,-38.5986328125
78,60,13,2588,8192,-5604,-68.408203125
78,60,14,51,16384,-16333,-99.688720703125
78,60,15,39280,32768,6512,19.873046875
78,61,1,0,2,-2,-100.0
78,61,2,4,4,0,0.0
78,61,3,14,8,6,75.0
78,61,4,13,16,-3,-18.75
78,61,5,33,32,1,3.125
78,61,6,59,64,-5,-7.8125
78,61,7,79,128,-49,-38.28125
78,61,8,476,256,220,85.9375
78,61,9,736,512,224,43.75
78,61,10,785,1024,-239,-23.33984375
78,61,11,742,2048,-1306,-63.76953125
78,61,12,1068,4096,-3028,-73.92578125
78,61,13,8373,8192,181,2.20947265625
78,61,14,631,16384,-15753,-96.148681640625
78,61,15,20915,32768,-11853,-36.1724853515625
78,62,1,0,2,-2,-100.0
78,62,2,2,4,-2,-50.0
78,62,3,6,8,-2,-25.0
78,62,4,7,16,-9,-56.25
78,62,5,62,32,30,93.75
78,62,6,110,64,46,71.875
78,62,7,89,128,-39,-30.46875
78,62,8,34,256,-222,-86.71875
78,62,9,37,512,-475,-92.7734375
78,62,10,3477,1024,2453,239.55078125
78,62,11,4171,2048,2123,103.662109375
78,62,12,5684,4096,1588,38.76953125
78,62,13,13040,8192,4848,59.1796875
78,62,14,31223,16384,14839,90.570068359375
78,62,15,75470,32768,42702,130.316162109375
78,63,1,0,2,-2,-100.0
78,63,2,3,4,-1,-25.0
78,63,3,9,8,1,12.5
78,63,4,19,16,3,18.75
78,63,5,93,32,61,190.625
78,63,6,52,64,-12,-18.75
78,63,7,123,128,-5,-3.90625
78,63,8,142,256,-114,-44.53125
78,63,9,1353,512,841,164.2578125
78,63,10,92,1024,-932,-91.015625
78,63,11,644,2048,-1404,-68.5546875
78,63,12,345,4096,-3751,-91.5771484375
78,63,13,6707,8192,-1485,-18.12744140625
78,63,14,708,16384,-15676,-95.6787109375
78,63,15,1015,32768,-31753,-96.9024658203125
78,64,1,0,2,-2,-100.0
78,64,2,3,4,-1,-25.0
78,64,3,6,8,-2,-25.0
78,64,4,24,16,8,50.0
78,64,5,6,32,-26,-81.25
78,64,6,42,64,-22,-34.375
78,64,7,42,128,-86,-67.1875
78,64,8,18,256,-238,-92.96875
78,64,9,427,512,-85,-16.6015625
78,64,10,15,1024,-1009,-98.53515625
78,64,11,1623,2048,-425,-20.751953125
78,64,12,1293,4096,-2803,-68.4326171875
78,64,13,18243,8192,10051,122.69287109375
78,64,14,11923,16384,-4461,-27.227783203125
78,64,15,64456,32768,31688,96.7041015625
78,65,1,0,2,-2,-100.0
78,65,2,1,4,-3,-75.0
78,65,3,3,8,-5,-62.5
78,65,4,3,16,-13,-81.25
78,65,5,99,32,67,209.375
78,65,6,121,64,57,89.0625
78,65,7,115,128,-13,-10.15625
78,65,8,28,256,-228,-89.0625
78,65,9,380,512,-132,-25.78125
78,65,10,202,1024,-822,-80.2734375
78,65,11,2801,2048,753,36.767578125
78,65,12,2033,4096,-2063,-50.3662109375
78,65,13,21459,8192,13267,161.95068359375
78,65,14,8070,16384,-8314,-50.74462890625
78,65,15,6986,32768,-25782,-78.680419921875
78,66,1,0,2,-2,-100.0
78,66,2,1,4,-3,-75.0
78,66,3,2,8,-6,-75.0
78,66,4,6,16,-10,-62.5
78,66,5,16,32,-16,-50.0
78,66,6,51,64,-13,-20.3125
78,66,7,33,128,-95,-74.21875
78,66,8,696,256,440,171.875
78,66,9,422,512,-90,-17.578125
78,66,10,1886,1024,862,84.1796875
78,66,11,230,2048,-1818,-88.76953125
78,66,12,4491,4096,395,9.6435546875
78,66,13,5012,8192,-3180,-38.818359375
78,66,14,3969,16384,-12415,-75.775146484375
78,66,15,13192,32768,-19576,-59.7412109375
78,67,1,0,2,-2,-100.0
78,67,2,1,4,-3,-75.0
78,67,3,2,8,-6,-75.0
78,67,4,9,16,-7,-43.75
78,67,5,14,32,-18,-56.25
78,67,6,371,64,307,479.6875
78,67,7,330,128,202,157.8125
78,67,8,191,256,-65,-25.390625
78,67,9,62,512,-450,-87.890625
78,67,10,3174,1024,2150,209.9609375
78,67,11,1238,2048,-810,-39.55078125
78,67,12,880,4096,-3216,-78.515625
78,67,13,1237,8192,-6955,-84.89990234375
78,67,14,7898,16384,-8486,-51.79443359375
78,67,15,26192,32768,-6576,-20.068359375
78,68,1,0,2,-2,-100.0
78,68,2,1,4,-3,-75.0
78,68,3,5,8,-3,-37.5
78,68,4,3,16,-13,-81.25
78,68,5,23,32,-9,-28.125
78,68,6,61,64,-3,-4.6875
78,68,7,216,128,88,68.75
78,68,8,167,256,-89,-34.765625
78,68,9,187,512,-325,-63.4765625
78,68,10,1988,1024,964,94.140625
78,68,11,663,2048,-1385,-67.626953125
78,68,12,1064,4096,-3032,-74.0234375
78,68,13,2519,8192,-5673,-69.25048828125
78,68,14,322,16384,-16062,-98.03466796875
78,68,15,32850,32768,82,0.250244140625
78,69,1,0,2,-2,-100.0
78,69,2,1,4,-3,-75.0
78,69,3,10,8,2,25.0
78,69,4,4,16,-12,-75.0
78,69,5,19,32,-13,-40.625
78,69,6,43,64,-21,-32.8125
78,69,7,177,128,49,38.28125
78,69,8,774,256,518,202.34375
78,69,9,1522,512,1010,197.265625
78,69,10,1953,1024,929,90.72265625
78,69,11,2136,2048,88,4.296875
78,69,12,181,4096,-3915,-95.5810546875
78,69,13,978,8192,-7214,-88.0615234375
78,69,14,4443,16384,-11941,-72.882080078125
78,69,15,36315,32768,3547,10.8245849609375
78,70,1,0,2,-2,-100.0
78,70,2,1,4,-3,-75.0
78,70,3,4,8,-4,-50.0
78,70,4,21,16,5,31.25
78,70,5,8,32,-24,-75.0
78,70,6,15,64,-49,-76.5625
78,70,7,13,128,-115,-89.84375
78,70,8,602,256,346,135.15625
78,70,9,402,512,-110,-21.484375
78,70,10,3026,1024,2002,195.5078125
78,70,11,3277,2048,1229,60.009765625
78,70,12,1160,4096,-2936,-71.6796875
78,70,13,15488,8192,7296,89.0625
78,70,14,7682,16384,-8702,-53.11279296875
78,70,15,20541,32768,-12227,-37.3138427734375
78,71,1,0,2,-2,-100.0
78,71,2,3,4,-1,-25.0
78,71,3,18,8,10,125.0
78,71,4,4,16,-12,-75.0
78,71,5,76,32,44,137.5
78,71,6,64,64,0,0.0
78,71,7,52,128,-76,-59.375
78,71,8,496,256,240,93.75
78,71,9,173,512,-339,-66.2109375
78,71,10,2178,1024,1154,112.6953125
78,71,11,345,2048,-1703,-83.154296875
78,71,12,6210,4096,2114,51.611328125
78,71,13,7176,8192,-1016,-12.40234375
78,71,14,24709,16384,8325,50.811767578125
78,71,15,13180,32768,-19588,-59.77783203125
78,72,1,0,2,-2,-100.0
78,72,2,3,4,-1,-25.0
78,72,3,3,8,-5,-62.5
78,72,4,24,16,8,50.0
78,72,5,16,32,-16,-50.0
78,72,6,14,64,-50,-78.125
78,72,7,138,128,10,7.8125
78,72,8,81,256,-175,-68.359375
78,72,9,1076,512,564,110.15625
78,72,10,97,1024,-927,-90.52734375
78,72,11,3466,2048,1418,69.23828125
78,72,12,8114,4096,4018,98.095703125
78,72,13,2836,8192,-5356,-65.380859375
78,72,14,22112,16384,5728,34.9609375
78,72,15,15330,32768,-17438,-53.216552734375
78,73,1,0,2,-2,-100.0
78,73,2,1,4,-3,-75.0
78,73,3,2,8,-6,-75.0
78,73,4,5,16,-11,-68.75
78,73,5,30,32,-2,-6.25
78,73,6,145,64,81,126.5625
78,73,7,176,128,48,37.5
78,73,8,52,256,-204,-79.6875
78,73,9,280,512,-232,-45.3125
78,73,10,1269,1024,245,23.92578125
78,73,11,3027,2048,979,47.802734375
78,73,12,5525,4096,1429,34.8876953125
78,73,13,11550,8192,3358,40.9912109375
78,73,14,16726,16384,342,2.08740234375
78,73,15,65110,32768,32342,98.699951171875
78,74,1,0,2,-2,-100.0
78,74,2,2,4,-2,-50.0
78,74,3,8,8,0,0.0
78,74,4,66,16,50,312.5
78,74,5,15,32,-17,-53.125
78,74,6,107,64,43,67.1875
78,74,7,156,128,28,21.875
78,74,8,55,256,-201,-78.515625
78,74,9,496,512,-16,-3.125
78,74,10,686,1024,-338,-33.0078125
78,74,11,2855,2048,807,39.404296875
78,74,12,8974,4096,4878,119.091796875
78,74,13,6004,8192,-2188,-26.708984375
78,74,14,8538,16384,-7846,-47.88818359375
78,74,15,17361,32768,-15407,-47.0184326171875
78,75,1,0,2,-2,-100.0
78,75,2,2,4,-2,-50.0
78,75,3,3,8,-5,-62.5
78,75,4,12,16,-4,-25.0
78,75,5,112,32,80,250.0
78,75,6,199,64,135,210.9375
78,75,7,36,128,-92,-71.875
78,75,8,20,256,-236,-92.1875
78,75,9,1731,512,1219,238.0859375
78,75,10,975,1024,-49,-4.78515625
78,75,11,1397,2048,-651,-31.787109375
78,75,12,1797,4096,-2299,-56.1279296875
78,75,13,14099,8192,5907,72.10693359375
78,75,14,26630,16384,10246,62.53662109375
78,75,15,94388,32768,61620,188.04931640625
78,76,1,0,2,-2,-100.0
78,76,2,1,4,-3,-75.0
78,76,3,7,8,-1,-12.5
78,76,4,18,16,2,12.5
78,76,5,19,32,-13,-40.625
78,76,6,114,64,50,78.125
78,76,7,111,128,-17,-13.28125
78,76,8,103,256,-153,-59.765625
78,76,9,172,512,-340,-66.40625
78,76,10,2707,1024,1683,164.35546875
78,76,11,3275,2048,1227,59.912109375
78,76,12,11630,4096,7534,183.935546875
78,76,13,20121,8192,11929,145.61767578125
78,76,14,9346,16384,-7038,-42.95654296875
78,76,15,9044,32768,-23724,-72.39990234375
78,77,1,0,2,-2,-100.0
78,77,2,6,4,2,50.0
78,77,3,7,8,-1,-12.5
78,77,4,7,16,-9,-56.25
78,77,5,63,32,31,96.875
78,77,6,258,64,194,303.125
78,77,7,1324,128,1196,934.375
78,77,8,147,256,-109,-42.578125
78,77,9,415,512,-97,-18.9453125
78,77,10,28,1024,-996,-97.265625
78,77,11,1853,2048,-195,-9.521484375
78,77,12,3075,4096,-1021,-24.9267578125
78,77,13,3491,8192,-4701,-57.38525390625
78,77,14,1836,16384,-14548,-88.7939453125
78,77,15,26638,32768,-6130,-18.707275390625
78,78,1,0,2,-2,-100.0
78,78,2,2,4,-2,-50.0
78,78,3,4,8,-4,-50.0
78,78,4,16,16,0,0.0
78,78,5,19,32,-13,-40.625
78,78,6,40,64,-24,-37.5
78,78,7,74,128,-54,-42.1875
78,78,8,536,256,280,109.375
78,78,9,494,512,-18,-3.515625
78,78,10,1146,1024,122,11.9140625
78,78,11,178,2048,-1870,-91.30859375
78,78,12,2905,4096,-1191,-29.0771484375
78,78,13,706,8192,-7486,-91.3818359375
78,78,14,51739,16384,35355,215.789794921875
78,78,15,50736,32768,17968,54.833984375
79,1,1,0,2,-2,-100.0
79,1,2,2,4,-2,-50.0
79,1,3,6,8,-2,-25.0
79,1,4,7,16,-9,-56.25
79,1,5,7,32,-25,-78.125
79,1,6,53,64,-11,-17.1875
79,1,7,99,128,-29,-22.65625
79,1,8,25,256,-231,-90.234375
79,1,9,1096,512,584,114.0625
79,1,10,740,1024,-284,-27.734375
79,1,11,704,2048,-1344,-65.625
79,1,12,9430,4096,5334,130.224609375
79,1,13,21843,8192,13651,166.63818359375
79,1,14,4997,16384,-11387,-69.500732421875
79,1,15,39990,32768,7222,22.039794921875
79,2,1,0,2,-2,-100.0
79,2,2,2,4,-2,-50.0
79,2,3,2,8,-6,-75.0
79,2,4,21,16,5,31.25
79,2,5,41,32,9,28.125
79,2,6,178,64,114,178.125
79,2,7,185,128,57,44.53125
79,2,8,77,256,-179,-69.921875
79,2,9,715,512,203,39.6484375
79,2,10,319,1024,-705,-68.84765625
79,2,11,2067,2048,19,0.927734375
79,2,12,484,4096,-3612,-88.18359375
79,2,13,833,8192,-7359,-89.83154296875
79,2,14,840,16384,-15544,-94.873046875
79,2,15,105579,32768,72811,222.2015380859375
79,3,1,0,2,-2,-100.0
79,3,2,2,4,-2,-50.0
79,3,3,3,8,-5,-62.5
79,3,4,18,16,2,12.5
79,3,5,6,32,-26,-81.25
79,3,6,164,64,100,156.25
79,3,7,20,128,-108,-84.375
79,3,8,51,256,-205,-80.078125
79,3,9,380,512,-132,-25.78125
79,3,10,2122,1024,1098,107.2265625
79,3,11,2263,2048,215,10.498046875
79,3,12,1909,4096,-2187,-53.3935546875
79,3,13,1425,8192,-6767,-82.60498046875
79,3,14,14100,16384,-2284,-13.9404296875
79,3,15,48370,32768,15602,47.613525390625
79,4,1,0,2,-2,-100.0
79,4,2,2,4,-2,-50.0
79,4,3,5,8,-3,-37.5
79,4,4,43,16,27,168.75
79,4,5,41,32,9,28.125
79,4,6,177,64,113,176.5625
79,4,7,6,128,-122,-95.3125
79,4,8,374,256,118,46.09375
79,4,9,50,512,-462,-90.234375
79,4,10,280,1024,-744,-72.65625
79,4,11,2028,2048,-20,-0.9765625
79,4,12,4992,4096,896,21.875
79,4,13,10271,8192,2079,25.37841796875
79,4,14,21909,16384,5525,33.721923828125
79,4,15,3502,32768,-29266,-89.312744140625
79,5,1,0,2,-2,-100.0
79,5,2,1,4,-3,-75.0
79,5,3,4,8,-4,-50.0
79,5,4,14,16,-2,-12.5
79,5,5,10,32,-22,-68.75
79,5,6,10,64,-54,-84.375
79,5,7,22,128,-106,-82.8125
79,5,8,31,256,-225,-87.890625
79,5,9,843,512,331,64.6484375
79,5,10,46,1024,-978,-95.5078125
79,5,11,92,2048,-1956,-95.5078125
79,5,12,4079,4096,-17,-0.4150390625
79,5,13,22668,8192,14476,176.708984375
79,5,14,9125,16384,-7259,-44.305419921875
79,5,15,13589,32768,-19179,-58.5296630859375
79,6,1,0,2,-2,-100.0
79,6,2,3,4,-1,-25.0
79,6,3,4,8,-4,-50.0
79,6,4,9,16,-7,-43.75
79,6,5,31,32,-1,-3.125
79,6,6,27,64,-37,-57.8125
79,6,7,64,128,-64,-50.0
79,6,8,35,256,-221,-86.328125
79,6,9,380,512,-132,-25.78125
79,6,10,960,1024,-64,-6.25
79,6,11,566,2048,-1482,-72.36328125
79,6,12,5462,4096,1366,33.349609375
79,6,13,18381,8192,10189,124.37744140625
79,6,14,33540,16384,17156,104.7119140625
79,6,15,13993,32768,-18775,-57.2967529296875
79,7,1,0,2,-2,-100.0
79,7,2,6,4,2,50.0
79,7,3,2,8,-6,-75.0
79,7,4,11,16,-5,-31.25
79,7,5,4,32,-28,-87.5
79,7,6,20,64,-44,-68.75
79,7,7,289,128,161,125.78125
79,7,8,94,256,-162,-63.28125
79,7,9,1243,512,731,142.7734375
79,7,10,357,1024,-667,-65.13671875
79,7,11,5450,2048,3402,166.11328125
79,7,12,5435,4096,1339,32.6904296875
79,7,13,4717,8192,-3475,-42.41943359375
79,7,14,19885,16384,3501,21.368408203125
79,7,15,7601,32768,-25167,-76.8035888671875
79,8,1,0,2,-2,-100.0
79,8,2,1,4,-3,-75.0
79,8,3,3,8,-5,-62.5
79,8,4,9,16,-7,-43.75
79,8,5,13,32,-19,-59.375
79,8,6,13,64,-51,-79.6875
79,8,7,131,128,3,2.34375
79,8,8,232,256,-24,-9.375
79,8,9,217,512,-295,-57.6171875
79,8,10,45,1024,-979,-95.60546875
79,8,11,473,2048,-1575,-76.904296875
79,8,12,3104,4096,-992,-24.21875
79,8,13,7328,8192,-864,-10.546875
79,8,14,53148,16384,36764,224.3896484375
79,8,15,103547,32768,70779,216.0003662109375
79,9,1,0,2,-2,-100.0
79,9,2,3,4,-1,-25.0
79,9,3,2,8,-6,-75.0
79,9,4,3,16,-13,-81.25
79,9,5,51,32,19,59.375
79,9,6,29,64,-35,-54.6875
79,9,7,50,128,-78,-60.9375
79,9,8,152,256,-104,-40.625
79,9,9,1391,512,879,171.6796875
79,9,10,157,1024,-867,-84.66796875
79,9,11,317,2048,-1731,-84.521484375
79,9,12,6461,4096,2365,57.7392578125
79,9,13,10283,8192,2091,25.52490234375
79,9,14,14305,16384,-2079,-12.689208984375
79,9,15,56317,32768,23549,71.8658447265625
79,10,1,0,2,-2,-100.0
79,10,2,3,4,-1,-25.0
79,10,3,11,8,3,37.5
79,10,4,3,16,-13,-81.25
79,10,5,45,32,13,40.625
79,10,6,35,64,-29,-45.3125
79,10,7,57,128,-71,-55.46875
79,10,8,101,256,-155,-60.546875
79,10,9,634,512,122,23.828125
79,10,10,959,1024,-65,-6.34765625
79,10,11,1143,2048,-905,-44.189453125
79,10,12,1153,4096,-2943,-71.8505859375
79,10,13,471,8192,-7721,-94.25048828125
79,10,14,19034,16384,2650,16.17431640625
79,10,15,17001,32768,-15767,-48.1170654296875
79,11,1,0,2,-2,-100.0
79,11,2,4,4,0,0.0
79,11,3,2,8,-6,-75.0
79,11,4,12,16,-4,-25.0
79,11,5,21,32,-11,-34.375
79,11,6,11,64,-53,-82.8125
79,11,7,235,128,107,83.59375
79,11,8,107,256,-149,-58.203125
79,11,9,466,512,-46,-8.984375
79,11,10,275,1024,-749,-73.14453125
79,11,11,2573,2048,525,25.634765625
79,11,12,4486,4096,390,9.521484375
79,11,13,5338,8192,-2854,-34.8388671875
79,11,14,13158,16384,-3226,-19.68994140625
79,11,15,17088,32768,-15680,-47.8515625
79,12,1,0,2,-2,-100.0
79,12,2,2,4,-2,-50.0
79,12,3,14,8,6,75.0
79,12,4,9,16,-7,-43.75
79,12,5,74,32,42,131.25
79,12,6,15,64,-49,-76.5625
79,12,7,89,128,-39,-30.46875
79,12,8,465,256,209,81.640625
79,12,9,1028,512,516,100.78125
79,12,10,412,1024,-612,-59.765625
79,12,11,3034,2048,986,48.14453125
79,12,12,47,4096,-4049,-98.8525390625
79,12,13,4077,8192,-4115,-50.23193359375
79,12,14,8075,16384,-8309,-50.714111328125
79,12,15,2762,32768,-30006,-91.571044921875
79,13,1,0,2,-2,-100.0
79,13,2,1,4,-3,-75.0
79,13,3,2,8,-6,-75.0
79,13,4,6,16,-10,-62.5
79,13,5,22,32,-10,-31.25
79,13,6,36,64,-28,-43.75
79,13,7,343,128,215,167.96875
79,13,8,24,256,-232,-90.625
79,13,9,360,512,-152,-29.6875
79,13,10,1423,1024,399,38.96484375
79,13,11,383,2048,-1665,-81.298828125
79,13,12,1211,4096,-2885,-70.4345703125
79,13,13,12097,8192,3905,47.66845703125
79,13,14,5026,16384,-11358,-69.32373046875
79,13,15,2581,32768,-30187,-92.1234130859375
79,14,1,0,2,-2,-100.0
79,14,2,2,4,-2,-50.0
79,14,3,14,8,6,75.0
79,14,4,6,16,-10,-62.5
79,14,5,31,32,-1,-3.125
79,14,6,5,64,-59,-92.1875
79,14,7,16,128,-112,-87.5
79,14,8,19,256,-237,-92.578125
79,14,9,76,512,-436,-85.15625
79,14,10,150,1024,-874,-85.3515625
79,14,11,5434,2048,3386,165.33203125
79,14,12,2326,4096,-1770,-43.212890625
79,14,13,9010,8192,818,9.9853515625
79,14,14,954,16384,-15430,-94.17724609375
79,14,15,12734,32768,-20034,-61.138916015625
79,15,1,0,2,-2,-100.0
79,15,2,7,4,3,75.0
79,15,3,2,8,-6,-75.0
79,15,4,6,16,-10,-62.5
79,15,5,42,32,10,31.25
79,15,6,78,64,14,21.875
79,15,7,346,128,218,170.3125
79,15,8,177,256,-79,-30.859375
79,15,9,92,512,-420,-82.03125
79,15,10,367,1024,-657,-64.16015625
79,15,11,537,2048,-1511,-73.779296875
79,15,12,2022,4096,-2074,-50.634765625
79,15,13,26055,8192,17863,218.05419921875
79,15,14,15100,16384,-1284,-7.8369140625
79,15,15,55716,32768,22948,70.03173828125
79,16,1,0,2,-2,-100.0
79,16,2,1,4,-3,-75.0
79,16,3,13,8,5,62.5
79,16,4,5,16,-11,-68.75
79,16,5,67,32,35,109.375
79,16,6,38,64,-26,-40.625
79,16,7,887,128,759,592.96875
79,16,8,140,256,-116,-45.3125
79,16,9,987,512,475,92.7734375
79,16,10,104,1024,-920,-89.84375
79,16,11,550,2048,-1498,-73.14453125
79,16,12,2159,4096,-1937,-47.2900390625
79,16,13,969,8192,-7223,-88.17138671875
79,16,14,29569,16384,13185,80.474853515625
79,16,15,37585,32768,4817,14.7003173828125
79,17,1,0,2,-2,-100.0
79,17,2,1,4,-3,-75.0
79,17,3,3,8,-5,-62.5
79,17,4,6,16,-10,-62.5
79,17,5,23,32,-9,-28.125
79,17,6,84,64,20,31.25
79,17,7,136,128,8,6.25
79,17,8,292,256,36,14.0625
79,17,9,1182,512,670,130.859375
79,17,10,1318,1024,294,28.7109375
79,17,11,197,2048,-1851,-90.380859375
79,17,12,3403,4096,-693,-16.9189453125
79,17,13,3154,8192,-5038,-61.4990234375
79,17,14,84437,16384,68053,415.362548828125
79,17,15,107022,32768,74254,226.605224609375
79,18,1,0,2,-2,-100.0
79,18,2,3,4,-1,-25.0
79,18,3,3,8,-5,-62.5
79,18,4,21,16,5,31.25
79,18,5,9,32,-23,-71.875
79,18,6,40,64,-24,-37.5
79,18,7,16,128,-112,-87.5
79,18,8,130,256,-126,-49.21875
79,18,9,1490,512,978,191.015625
79,18,10,407,1024,-617,-60.25390625
79,18,11,4093,2048,2045,99.853515625
79,18,12,6164,4096,2068,50.48828125
79,18,13,13458,8192,5266,64.2822265625
79,18,14,23422,16384,7038,42.95654296875
79,18,15,50,32768,-32718,-99.847412109375
79,19,1,0,2,-2,-100.0
79,19,2,1,4,-3,-75.0
79,19,3,5,8,-3,-37.5
79,19,4,11,16,-5,-31.25
79,19,5,30,32,-2,-6.25
79,19,6,38,64,-26,-40.625
79,19,7,208,128,80,62.5
79,19,8,84,256,-172,-67.1875
79,19,9,1104,512,592,115.625
79,19,10,986,1024,-38,-3.7109375
79,19,11,4934,2048,2886,140.91796875
79,19,12,382,4096,-3714,-90.673828125
79,19,13,25616,8192,17424,212.6953125
79,19,14,53333,16384,36949,225.518798828125
79,19,15,32706,32768,-62,-0.189208984375
79,20,1,0,2,-2,-100.0
79,20,2,4,4,0,0.0
79,20,3,6,8,-2,-25.0
79,20,4,3,16,-13,-81.25
79,20,5,4,32,-28,-87.5
79,20,6,24,64,-40,-62.5
79,20,7,147,128,19,14.84375
79,20,8,93,256,-163,-63.671875
79,20,9,243,512,-269,-52.5390625
79,20,10,429,1024,-595,-58.10546875
79,20,11,1553,2048,-495,-24.169921875
79,20,12,2949,4096,-1147,-28.0029296875
79,20,13,2631,8192,-5561,-67.88330078125
79,20,14,12680,16384,-3704,-22.607421875
79,20,15,18212,32768,-14556,-44.42138671875
79,21,1,0,2,-2,-100.0
79,21,2,3,4,-1,-25.0
79,21,3,2,8,-6,-75.0
79,21,4,11,16,-5,-31.25
79,21,5,4,32,-28,-87.5
79,21,6,155,64,91,142.1875
79,21,7,218,128,90,70.3125
79,21,8,21,256,-235,-91.796875
79,21,9,1100,512,588,114.84375
79,21,10,2375,1024,1351,131.93359375
79,21,11,1769,2048,-279,-13.623046875
79,21,12,2011,4096,-2085,-50.9033203125
79,21,13,12576,8192,4384,53.515625
79,21,14,3014,16384,-13370,-81.60400390625
79,21,15,7406,32768,-25362,-77.398681640625
79,22,1,0,2,-2,-100.0
79,22,2,1,4,-3,-75.0
79,22,3,2,8,-6,-75.0
79,22,4,25,16,9,56.25
79,22,5,29,32,-3,-9.375
79,22,6,23,64,-41,-64.0625
79,22,7,15,128,-113,-88.28125
79,22,8,213,256,-43,-16.796875
79,22,9,19,512,-493,-96.2890625
79,22,10,990,1024,-34,-3.3203125
79,22,11,447,2048,-1601,-78.173828125
79,22,12,1431,4096,-2665,-65.0634765625
79,22,13,3283,8192,-4909,-59.92431640625
79,22,14,628,16384,-15756,-96.1669921875
79,22,15,43639,32768,10871,33.1756591796875
79,23,1,0,2,-2,-100.0
79,23,2,1,4,-3,-75.0
79,23,3,10,8,2,25.0
79,23,4,4,16,-12,-75.0
79,23,5,38,32,6,18.75
79,23,6,43,64,-21,-32.8125
79,23,7,148,128,20,15.625
79,23,8,480,256,224,87.5
79,23,9,33,512,-479,-93.5546875
79,23,10,3429,1024,2405,234.86328125
79,23,11,4530,2048,2482,121.19140625
79,23,12,268,4096,-3828,-93.45703125
79,23,13,3820,8192,-4372,-53.369140625
79,23,14,4994,16384,-11390,-69.51904296875
79,23,15,6150,32768,-26618,-81.231689453125
79,24,1,0,2,-2,-100.0
79,24,2,1,4,-3,-75.0
79,24,3,8,8,0,0.0
79,24,4,14,16,-2,-12.5
79,24,5,41,32,9,28.125
79,24,6,51,64,-13,-20.3125
79,24,7,369,128,241,188.28125
79,24,8,241,256,-15,-5.859375
79,24,9,538,512,26,5.078125
79,24,10,238,1024,-786,-76.7578125
79,24,11,4707,2048,2659,129.833984375
79,24,12,1695,4096,-2401,-58.6181640625
79,24,13,10477,8192,2285,27.89306640625
79,24,14,25548,16384,9164,55.9326171875
79,24,15,1531,32768,-31237,-95.3277587890625
79,25,1,0,2,-2,-100.0
79,25,2,1,4,-3,-75.0
79,25,3,8,8,0,0.0
79,25,4,23,16,7,43.75
79,25,5,10,32,-22,-68.75
79,25,6,12,64,-52,-81.25
79,25,7,499,128,371,289.84375
79,25,8,426,256,170,66.40625
79,25,9,118,512,-394,-76.953125
79,25,10,935,1024,-89,-8.69140625
79,25,11,2696,2048,648,31.640625
79,25,12,13313,4096,9217,225.0244140625
79,25,13,6904,8192,-1288,-15.72265625
79,25,14,1113,16384,-15271,-93.206787109375
79,25,15,71509,32768,38741,118.2281494140625
79,26,1,0,2,-2,-100.0
79,26,2,3,4,-1,-25.0
79,26,3,17,8,9,112.5
79,26,4,7,16,-9,-56.25
79,26,5,12,32,-20,-62.5
79,26,6,60,64,-4,-6.25
79,26,7,11,128,-117,-91.40625
79,26,8,465,256,209,81.640625
79,26,9,370,512,-142,-27.734375
79,26,10,877,1024,-147,-14.35546875
79,26,11,2998,2048,950,46.38671875
79,26,12,4833,4096,737,17.9931640625
79,26,13,2820,8192,-5372,-65.576171875
79,26,14,43159,16384,26775,163.421630859375
79,26,15,12873,32768,-19895,-60.7147216796875
79,27,1,0,2,-2,-100.0
79,27,2,1,4,-3,-75.0
79,27,3,8,8,0,0.0
79,27,4,10,16,-6,-37.5
79,27,5,41,32,9,28.125
79,27,6,29,64,-35,-54.6875
79,27,7,10,128,-118,-92.1875
79,27,8,518,256,262,102.34375
79,27,9,254,512,-258,-50.390625
79,27,10,165,1024,-859,-83.88671875
79,27,11,876,2048,-1172,-57.2265625
79,27,12,1650,4096,-2446,-59.716796875
79,27,13,7195,8192,-997,-12.17041015625
79,27,14,8352,16384,-8032,-49.0234375
79,27,15,21611,32768,-11157,-34.0484619140625
79,28,1,0,2,-2,-100.0
79,28,2,1,4,-3,-75.0
79,28,3,10,8,2,25.0
79,28,4,10,16,-6,-37.5
79,28,5,12,32,-20,-62.5
79,28,6,93,64,29,45.3125
79,28,7,137,128,9,7.03125
79,28,8,236,256,-20,-7.8125
79,28,9,103,512,-409,-79.8828125
79,28,10,38,1024,-986,-96.2890625
79,28,11,1048,2048,-1000,-48.828125
79,28,12,1913,4096,-2183,-53.2958984375
79,28,13,5700,8192,-2492,-30.419921875
79,28,14,47337,16384,30953,188.922119140625
79,28,15,6890,32768,-25878,-78.973388671875
79,29,1,0,2,-2,-100.0
79,29,2,5,4,1,25.0
79,29,3,4,8,-4,-50.0
79,29,4,6,16,-10,-62.5
79,29,5,37,32,5,15.625
79,29,6,24,64,-40,-62.5
79,29,7,123,128,-5,-3.90625
79,29,8,234,256,-22,-8.59375
79,29,9,203,512,-309,-60.3515625
79,29,10,143,1024,-881,-86.03515625
79,29,11,182,2048,-1866,-91.11328125
79,29,12,16052,4096,11956,291.89453125
79,29,13,3589,8192,-4603,-56.18896484375
79,29,14,2547,16384,-13837,-84.454345703125
79,29,15,68711,32768,35943,109.6893310546875
79,30,1,0,2,-2,-100.0
79,30,2,2,4,-2,-50.0
79,30,3,4,8,-4,-50.0
79,30,4,11,16,-5,-31.25
79,30,5,12,32,-20,-62.5
79,30,6,5,64,-59,-92.1875
79,30,7,97,128,-31,-24.21875
79,30,8,188,256,-68,-26.5625
79,30,9,1309,512,797,155.6640625
79,30,10,284,1024,-740,-72.265625
79,30,11,3144,2048,1096,53.515625
79,30,12,3680,4096,-416,-10.15625
79,30,13,24645,8192,16453,200.84228515625
79,30,14,494,16384,-15890,-96.98486328125
79,30,15,11917,32768,-20851,-63.6322021484375
79,31,1,0,2,-2,-100.0
79,31,2,2,4,-2,-50.0
79,31,3,4,8,-4,-50.0
79,31,4,18,16,2,12.5
79,31,5,40,32,8,25.0
79,31,6,56,64,-8,-12.5
79,31,7,551,128,423,330.46875
79,31,8,161,256,-95,-37.109375
79,31,9,128,512,-384,-75.0
79,31,10,1131,1024,107,10.44921875
79,31,11,5347,2048,3299,161.083984375
79,31,12,1458,4096,-2638,-64.404296875
79,31,13,32235,8192,24043,293.49365234375
79,31,14,27472,16384,11088,67.67578125
79,31,15,65470,32768,32702,99.798583984375
79,32,1,0,2,-2,-100.0
79,32,2,1,4,-3,-75.0
79,32,3,4,8,-4,-50.0
79,32,4,70,16,54,337.5
79,32,5,58,32,26,81.25
79,32,6,110,64,46,71.875
79,32,7,30,128,-98,-76.5625
79,32,8,158,256,-98,-38.28125
79,32,9,1142,512,630,123.046875
79,32,10,3288,1024,2264,221.09375
79,32,11,98,2048,-1950,-95.21484375
79,32,12,7786,4096,3690,90.087890625
79,32,13,5093,8192,-3099,-37.82958984375
79,32,14,17167,16384,783,4.779052734375
79,32,15,13688,32768,-19080,-58.2275390625
79,33,1,0,2,-2,-100.0
79,33,2,6,4,2,50.0
79,33,3,3,8,-5,-62.5
79,33,4,10,16,-6,-37.5
79,33,5,112,32,80,250.0
79,33,6,25,64,-39,-60.9375
79,33,7,251,128,123,96.09375
79,33,8,635,256,379,148.046875
79,33,9,391,512,-121,-23.6328125
79,33,10,253,1024,-771,-75.29296875
79,33,11,436,2048,-1612,-78.7109375
79,33,12,964,4096,-3132,-76.46484375
79,33,13,8354,8192,162,1.9775390625
79,33,14,20548,16384,4164,25.4150390625
79,33,15,53167,32768,20399,62.2528076171875
79,34,1,0,2,-2,-100.0
79,34,2,4,4,0,0.0
79,34,3,24,8,16,200.0
79,34,4,3,16,-13,-81.25
79,34,5,50,32,18,56.25
79,34,6,82,64,18,28.125
79,34,7,82,128,-46,-35.9375
79,34,8,194,256,-62,-24.21875
79,34,9,947,512,435,84.9609375
79,34,10,832,1024,-192,-18.75
79,34,11,199,2048,-1849,-90.283203125
79,34,12,6209,4096,2113,51.5869140625
79,34,13,14968,8192,6776,82.71484375
79,34,14,32831,16384,16447,100.384521484375
79,34,15,70535,32768,37767,115.2557373046875
79,35,1,0,2,-2,-100.0
79,35,2,1,4,-3,-75.0
79,35,3,6,8,-2,-25.0
79,35,4,6,16,-10,-62.5
79,35,5,10,32,-22,-68.75
79,35,6,30,64,-34,-53.125
79,35,7,385,128,257,200.78125
79,35,8,227,256,-29,-11.328125
79,35,9,255,512,-257,-50.1953125
79,35,10,155,1024,-869,-84.86328125
79,35,11,3030,2048,982,47.94921875
79,35,12,1838,4096,-2258,-55.126953125
79,35,13,12936,8192,4744,57.91015625
79,35,14,26793,16384,10409,63.531494140625
79,35,15,34084,32768,1316,4.01611328125
79,36,1,0,2,-2,-100.0
79,36,2,2,4,-2,-50.0
79,36,3,3,8,-5,-62.5
79,36,4,3,16,-13,-81.25
79,36,5,24,32,-8,-25.0
79,36,6,123,64,59,92.1875
79,36,7,201,128,73,57.03125
79,36,8,122,256,-134,-52.34375
79,36,9,642,512,130,25.390625
79,36,10,560,1024,-464,-45.3125
79,36,11,908,2048,-1140,-55.6640625
79,36,12,1843,4096,-2253,-55.0048828125
79,36,13,9543,8192,1351,16.49169921875
79,36,14,2582,16384,-13802,-84.24072265625
79,36,15,69331,32768,36563,111.5814208984375
79,37,1,0,2,-2,-100.0
79,37,2,3,4,-1,-25.0
79,37,3,3,8,-5,-62.5
79,37,4,18,16,2,12.5
79,37,5,32,32,0,0.0
79,37,6,132,64,68,106.25
79,37,7,97,128,-31,-24.21875
79,37,8,46,256,-210,-82.03125
79,37,9,380,512,-132,-25.78125
79,37,10,1919,1024,895,87.40234375
79,37,11,223,2048,-1825,-89.111328125
79,37,12,654,4096,-3442,-84.033203125
79,37,13,146,8192,-8046,-98.2177734375
79,37,14,2797,16384,-13587,-82.928466796875
79,37,15,111249,32768,78481,239.5050048828125
79,38,1,0,2,-2,-100.0
79,38,2,1,4,-3,-75.0
79,38,3,3,8,-5,-62.5
79,38,4,14,16,-2,-12.5
79,38,5,15,32,-17,-53.125
79,38,6,76,64,12,18.75
79,38,7,31,128,-97,-75.78125
79,38,8,133,256,-123,-48.046875
79,38,9,253,512,-259,-50.5859375
79,38,10,2296,1024,1272,124.21875
79,38,11,3649,2048,1601,78.173828125
79,38,12,1234,4096,-2862,-69.873046875
79,38,13,451,8192,-7741,-94.49462890625
79,38,14,9569,16384,-6815,-41.595458984375
79,38,15,17228,32768,-15540,-47.42431640625
79,39,1,0,2,-2,-100.0
79,39,2,3,4,-1,-25.0
79,39,3,3,8,-5,-62.5
79,39,4,8,16,-8,-50.0
79,39,5,60,32,28,87.5
79,39,6,125,64,61,95.3125
79,39,7,72,128,-56,-43.75
79,39,8,414,256,158,61.71875
79,39,9,263,512,-249,-48.6328125
79,39,10,1711,1024,687,67.08984375
79,39,11,842,2048,-1206,-58.88671875
79,39,12,3502,4096,-594,-14.501953125
79,39,13,11193,8192,3001,36.63330078125
79,39,14,49594,16384,33210,202.69775390625
79,39,15,5207,32768,-27561,-84.1094970703125
79,40,1,0,2,-2,-100.0
79,40,2,1,4,-3,-75.0
79,40,3,6,8,-2,-25.0
79,40,4,20,16,4,25.0
79,40,5,6,32,-26,-81.25
79,40,6,110,64,46,71.875
79,40,7,35,128,-93,-72.65625
79,40,8,69,256,-187,-73.046875
79,40,9,488,512,-24,-4.6875
79,40,10,591,1024,-433,-42.28515625
79,40,11,2231,2048,183,8.935546875
79,40,12,3938,4096,-158,-3.857421875
79,40,13,1844,8192,-6348,-77.490234375
79,40,14,16267,16384,-117,-0.714111328125
79,40,15,17376,32768,-15392,-46.97265625
79,41,1,0,2,-2,-100.0
79,41,2,3,4,-1,-25.0
79,41,3,2,8,-6,-75.0
79,41,4,3,16,-13,-81.25
79,41,5,20,32,-12,-37.5
79,41,6,99,64,35,54.6875
79,41,7,7,128,-121,-94.53125
79,41,8,117,256,-139,-54.296875
79,41,9,91,512,-421,-82.2265625
79,41,10,655,1024,-369,-36.03515625
79,41,11,4745,2048,2697,131.689453125
79,41,12,3392,4096,-704,-17.1875
79,41,13,3185,8192,-5007,-61.12060546875
79,41,14,17718,16384,1334,8.14208984375
79,41,15,16290,32768,-16478,-50.286865234375
79,42,1,0,2,-2,-100.0
79,42,2,1,4,-3,-75.0
79,42,3,5,8,-3,-37.5
79,42,4,8,16,-8,-50.0
79,42,5,15,32,-17,-53.125
79,42,6,8,64,-56,-87.5
79,42,7,30,128,-98,-76.5625
79,42,8,146,256,-110,-42.96875
79,42,9,1752,512,1240,242.1875
79,42,10,69,1024,-955,-93.26171875
79,42,11,3802,2048,1754,85.64453125
79,42,12,1045,4096,-3051,-74.4873046875
79,42,13,5917,8192,-2275,-27.77099609375
79,42,14,58458,16384,42074,256.79931640625
79,42,15,47516,32768,14748,45.00732421875
79,43,1,0,2,-2,-100.0
79,43,2,1,4,-3,-75.0
79,43,3,2,8,-6,-75.0
79,43,4,6,16,-10,-62.5
79,43,5,19,32,-13,-40.625
79,43,6,70,64,6,9.375
79,43,7,124,128,-4,-3.125
79,43,8,333,256,77,30.078125
79,43,9,215,512,-297,-58.0078125
79,43,10,283,1024,-741,-72.36328125
79,43,11,81,2048,-1967,-96.044921875
79,43,12,8814,4096,4718,115.185546875
79,43,13,6294,8192,-1898,-23.1689453125
79,43,14,1005,16384,-15379,-93.865966796875
79,43,15,84556,32768,51788,158.04443359375
79,44,1,0,2,-2,-100.0
79,44,2,1,4,-3,-75.0
79,44,3,3,8,-5,-62.5
79,44,4,11,16,-5,-31.25
79,44,5,102,32,70,218.75
79,44,6,48,64,-16,-25.0
79,44,7,225,128,97,75.78125
79,44,8,536,256,280,109.375
79,44,9,2058,512,1546,301.953125
79,44,10,3073,1024,2049,200.09765625
79,44,11,2192,2048,144,7.03125
79,44,12,1862,4096,-2234,-54.541015625
79,44,13,3975,8192,-4217,-51.47705078125
79,44,14,15927,16384,-457,-2.789306640625
79,44,15,11169,32768,-21599,-65.9149169921875
79,45,1,0,2,-2,-100.0
79,45,2,4,4,0,0.0
79,45,3,5,8,-3,-37.5
79,45,4,22,16,6,37.5
79,45,5,26,32,-6,-18.75
79,45,6,21,64,-43,-67.1875
79,45,7,61,128,-67,-52.34375
79,45,8,76,256,-180,-70.3125
79,45,9,187,512,-325,-63.4765625
79,45,10,720,1024,-304,-29.6875
79,45,11,46,2048,-2002,-97.75390625
79,45,12,544,4096,-3552,-86.71875
79,45,13,19246,8192,11054,134.9365234375
79,45,14,856,16384,-15528,-94.775390625
79,45,15,191539,32768,158771,484.5306396484375
79,46,1,0,2,-2,-100.0
79,46,2,3,4,-1,-25.0
79,46,3,11,8,3,37.5
79,46,4,41,16,25,156.25
79,46,5,61,32,29,90.625
79,46,6,58,64,-6,-9.375
79,46,7,211,128,83,64.84375
79,46,8,93,256,-163,-63.671875
79,46,9,216,512,-296,-57.8125
79,46,10,1214,1024,190,18.5546875
79,46,11,7323,2048,5275,257.568359375
79,46,12,4196,4096,100,2.44140625
79,46,13,16260,8192,8068,98.486328125
79,46,14,2836,16384,-13548,-82.6904296875
79,46,15,6625,32768,-26143,-79.7821044921875
79,47,1,0,2,-2,-100.0
79,47,2,3,4,-1,-25.0
79,47,3,3,8,-5,-62.5
79,47,4,14,16,-2,-12.5
79,47,5,5,32,-27,-84.375
79,47,6,26,64,-38,-59.375
79,47,7,64,128,-64,-50.0
79,47,8,335,256,79,30.859375
79,47,9,109,512,-403,-78.7109375
79,47,10,2933,1024,1909,186.42578125
79,47,11,340,2048,-1708,-83.3984375
79,47,12,367,4096,-3729,-91.0400390625
79,47,13,19404,8192,11212,136.865234375
79,47,14,3426,16384,-12958,-79.08935546875
79,47,15,60752,32768,27984,85.400390625
79,48,1,0,2,-2,-100.0
79,48,2,2,4,-2,-50.0
79,48,3,2,8,-6,-75.0
79,48,4,24,16,8,50.0
79,48,5,22,32,-10,-31.25
79,48,6,103,64,39,60.9375
79,48,7,44,128,-84,-65.625
79,48,8,479,256,223,87.109375
79,48,9,605,512,93,18.1640625
79,48,10,57,1024,-967,-94.43359375
79,48,11,2941,2048,893,43.603515625
79,48,12,7014,4096,2918,71.240234375
79,48,13,6323,8192,-1869,-22.81494140625
79,48,14,33029,16384,16645,101.593017578125
79,48,15,11764,32768,-21004,-64.09912109375
79,49,1,0,2,-2,-100.0
79,49,2,1,4,-3,-75.0
79,49,3,2,8,-6,-75.0
79,49,4,6,16,-10,-62.5
79,49,5,100,32,68,212.5
79,49,6,66,64,2,3.125
79,49,7,71,128,-57,-44.53125
79,49,8,58,256,-198,-77.34375
79,49,9,1780,512,1268,247.65625
79,49,10,212,1024,-812,-79.296875
79,49,11,527,2048,-1521,-74.267578125
79,49,12,2365,4096,-1731,-42.2607421875
79,49,13,1857,8192,-6335,-77.33154296875
79,49,14,922,16384,-15462,-94.37255859375
79,49,15,3764,32768,-29004,-88.51318359375
79,50,1,0,2,-2,-100.0
79,50,2,2,4,-2,-50.0
79,50,3,8,8,0,0.0
79,50,4,3,16,-13,-81.25
79,50,5,54,32,22,68.75
79,50,6,55,64,-9,-14.0625
79,50,7,433,128,305,238.28125
79,50,8,131,256,-125,-48.828125
79,50,9,387,512,-125,-24.4140625
79,50,10,5748,1024,4724,461.328125
79,50,11,3190,2048,1142,55.76171875
79,50,12,112,4096,-3984,-97.265625
79,50,13,2538,8192,-5654,-69.0185546875
79,50,14,23900,16384,7516,45.8740234375
79,50,15,6866,32768,-25902,-79.046630859375
79,51,1,0,2,-2,-100.0
79,51,2,4,4,0,0.0
79,51,3,9,8,1,12.5
79,51,4,16,16,0,0.0
79,51,5,13,32,-19,-59.375
79,51,6,59,64,-5,-7.8125
79,51,7,102,128,-26,-20.3125
79,51,8,54,256,-202,-78.90625
79,51,9,21,512,-491,-95.8984375
79,51,10,248,1024,-776,-75.78125
79,51,11,2183,2048,135,6.591796875
79,51,12,877,4096,-3219,-78.5888671875
79,51,13,5153,8192,-3039,-37.09716796875
79,51,14,17630,16384,1246,7.60498046875
79,51,15,7546,32768,-25222,-76.971435546875
79,52,1,0,2,-2,-100.0
79,52,2,3,4,-1,-25.0
79,52,3,10,8,2,25.0
79,52,4,3,16,-13,-81.25
79,52,5,105,32,73,228.125
79,52,6,51,64,-13,-20.3125
79,52,7,211,128,83,64.84375
79,52,8,270,256,14,5.46875
79,52,9,317,512,-195,-38.0859375
79,52,10,80,1024,-944,-92.1875
79,52,11,2669,2048,621,30.322265625
79,52,12,2971,4096,-1125,-27.4658203125
79,52,13,6137,8192,-2055,-25.08544921875
79,52,14,8874,16384,-7510,-45.83740234375
79,52,15,37355,32768,4587,13.9984130859375
79,53,1,0,2,-2,-100.0
79,53,2,4,4,0,0.0
79,53,3,17,8,9,112.5
79,53,4,4,16,-12,-75.0
79,53,5,4,32,-28,-87.5
79,53,6,18,64,-46,-71.875
79,53,7,83,128,-45,-35.15625
79,53,8,379,256,123,48.046875
79,53,9,830,512,318,62.109375
79,53,10,886,1024,-138,-13.4765625
79,53,11,2258,2048,210,10.25390625
79,53,12,3064,4096,-1032,-25.1953125
79,53,13,3527,8192,-4665,-56.94580078125
79,53,14,603,16384,-15781,-96.319580078125
79,53,15,18044,32768,-14724,-44.93408203125
79,54,1,0,2,-2,-100.0
79,54,2,6,4,2,50.0
79,54,3,8,8,0,0.0
79,54,4,6,16,-10,-62.5
79,54,5,12,32,-20,-62.5
79,54,6,27,64,-37,-57.8125
79,54,7,76,128,-52,-40.625
79,54,8,474,256,218,85.15625
79,54,9,21,512,-491,-95.8984375
79,54,10,68,1024,-956,-93.359375
79,54,11,2202,2048,154,7.51953125
79,54,12,842,4096,-3254,-79.443359375
79,54,13,116,8192,-8076,-98.583984375
79,54,14,1400,16384,-14984,-91.455078125
79,54,15,46999,32768,14231,43.4295654296875
79,55,1,0,2,-2,-100.0
79,55,2,1,4,-3,-75.0
79,55,3,4,8,-4,-50.0
79,55,4,26,16,10,62.5
79,55,5,12,32,-20,-62.5
79,55,6,49,64,-15,-23.4375
79,55,7,99,128,-29,-22.65625
79,55,8,219,256,-37,-14.453125
79,55,9,9,512,-503,-98.2421875
79,55,10,767,1024,-257,-25.09765625
79,55,11,3687,2048,1639,80.029296875
79,55,12,1042,4096,-3054,-74.560546875
79,55,13,16976,8192,8784,107.2265625
79,55,14,22548,16384,6164,37.6220703125
79,55,15,66003,32768,33235,101.4251708984375
79,56,1,0,2,-2,-100.0
79,56,2,3,4,-1,-25.0
79,56,3,2,8,-6,-75.0
79,56,4,4,16,-12,-75.0
79,56,5,45,32,13,40.625
79,56,6,10,64,-54,-84.375
79,56,7,28,128,-100,-78.125
79,56,8,234,256,-22,-8.59375
79,56,9,151,512,-361,-70.5078125
79,56,10,1337,1024,313,30.56640625
79,56,11,1830,2048,-218,-10.64453125
79,56,12,4261,4096,165,4.0283203125
79,56,13,16242,8192,8050,98.2666015625
79,56,14,9391,16384,-6993,-42.681884765625
79,56,15,30384,32768,-2384,-7.275390625
79,57,1,0,2,-2,-100.0
79,57,2,1,4,-3,-75.0
79,57,3,2,8,-6,-75.0
79,57,4,7,16,-9,-56.25
79,57,5,14,32,-18,-56.25
79,57,6,128,64,64,100.0
79,57,7,90,128,-38,-29.6875
79,57,8,1175,256,919,358.984375
79,57,9,833,512,321,62.6953125
79,57,10,4513,1024,3489,340.72265625
79,57,11,532,2048,-1516,-74.0234375
79,57,12,8854,4096,4758,116.162109375
79,57,13,2374,8192,-5818,-71.0205078125
79,57,14,61927,16384,45543,277.972412109375
79,57,15,65298,32768,32530,99.273681640625
79,58,1,0,2,-2,-100.0
79,58,2,3,4,-1,-25.0
79,58,3,3,8,-5,-62.5
79,58,4,3,16,-13,-81.25
79,58,5,23,32,-9,-28.125
79,58,6,38,64,-26,-40.625
79,58,7,190,128,62,48.4375
79,58,8,362,256,106,41.40625
79,58,9,190,512,-322,-62.890625
79,58,10,1182,1024,158,15.4296875
79,58,11,4105,2048,2057,100.439453125
79,58,12,4493,4096,397,9.6923828125
79,58,13,757,8192,-7435,-90.75927734375
79,58,14,4172,16384,-12212,-74.5361328125
79,58,15,23326,32768,-9442,-28.814697265625
79,59,1,0,2,-2,-100.0
79,59,2,1,4,-3,-75.0
79,59,3,2,8,-6,-75.0
79,59,4,16,16,0,0.0
79,59,5,8,32,-24,-75.0
79,59,6,19,64,-45,-70.3125
79,59,7,22,128,-106,-82.8125
79,59,8,100,256,-156,-60.9375
79,59,9,1058,512,546,106.640625
79,59,10,2948,1024,1924,187.890625
79,59,11,3255,2048,1207,58.935546875
79,59,12,1076,4096,-3020,-73.73046875
79,59,13,1080,8192,-7112,-86.81640625
79,59,14,2439,16384,-13945,-85.113525390625
79,59,15,28024,32768,-4744,-14.4775390625
79,60,1,0,2,-2,-100.0
79,60,2,1,4,-3,-75.0
79,60,3,21,8,13,162.5
79,60,4,6,16,-10,-62.5
79,60,5,8,32,-24,-75.0
79,60,6,182,64,118,184.375
79,60,7,461,128,333,260.15625
79,60,8,129,256,-127,-49.609375
79,60,9,760,512,248,48.4375
79,60,10,332,1024,-692,-67.578125
79,60,11,2382,2048,334,16.30859375
79,60,12,5552,4096,1456,35.546875
79,60,13,6593,8192,-1599,-19.51904296875
79,60,14,12563,16384,-3821,-23.321533203125
79,60,15,60641,32768,27873,85.0616455078125
79,61,1,0,2,-2,-100.0
79,61,2,3,4,-1,-25.0
79,61,3,7,8,-1,-12.5
79,61,4,27,16,11,68.75
79,61,5,4,32,-28,-87.5
79,61,6,32,64,-32,-50.0
79,61,7,234,128,106,82.8125
79,61,8,181,256,-75,-29.296875
79,61,9,460,512,-52,-10.15625
79,61,10,214,1024,-810,-79.1015625
79,61,11,10183,2048,8135,397.216796875
79,61,12,3553,4096,-543,-13.2568359375
79,61,13,4503,8192,-3689,-45.03173828125
79,61,14,7311,16384,-9073,-55.377197265625
79,61,15,22657,32768,-10111,-30.8563232421875
79,62,1,0,2,-2,-100.0
79,62,2,3,4,-1,-25.0
79,62,3,2,8,-6,-75.0
79,62,4,21,16,5,31.25
79,62,5,26,32,-6,-18.75
79,62,6,19,64,-45,-70.3125
79,62,7,108,128,-20,-15.625
79,62,8,10,256,-246,-96.09375
79,62,9,956,512,444,86.71875
79,62,10,768,1024,-256,-25.0
79,62,11,422,2048,-1626,-79.39453125
79,62,12,798,4096,-3298,-80.517578125
79,62,13,4571,8192,-3621,-44.20166015625
79,62,14,24139,16384,7755,47.332763671875
79,62,15,10258,32768,-22510,-68.695068359375
79,63,1,0,2,-2,-100.0
79,63,2,2,4,-2,-50.0
79,63,3,3,8,-5,-62.5
79,63,4,12,16,-4,-25.0
79,63,5,6,32,-26,-81.25
79,63,6,23,64,-41,-64.0625
79,63,7,300,128,172,134.375
79,63,8,136,256,-120,-46.875
79,63,9,276,512,-236,-46.09375
79,63,10,1615,1024,591,57.71484375
79,63,11,2553,2048,505,24.658203125
79,63,12,4950,4096,854,20.849609375
79,63,13,6363,8192,-1829,-22.32666015625
79,63,14,4833,16384,-11551,-70.501708984375
79,63,15,27276,32768,-5492,-16.76025390625
79,64,1,0,2,-2,-100.0
79,64,2,2,4,-2,-50.0
79,64,3,4,8,-4,-50.0
79,64,4,10,16,-6,-37.5
79,64,5,28,32,-4,-12.5
79,64,6,27,64,-37,-57.8125
79,64,7,13,128,-115,-89.84375
79,64,8,228,256,-28,-10.9375
79,64,9,63,512,-449,-87.6953125
79,64,10,2301,1024,1277,124.70703125
79,64,11,2135,2048,87,4.248046875
79,64,12,3907,4096,-189,-4.6142578125
79,64,13,2643,8192,-5549,-67.73681640625
79,64,14,57216,16384,40832,249.21875
79,64,15,3003,32768,-29765,-90.8355712890625
79,65,1,0,2,-2,-100.0
79,65,2,1,4,-3,-75.0
79,65,3,2,8,-6,-75.0
79,65,4,6,16,-10,-62.5
79,65,5,15,32,-17,-53.125
79,65,6,96,64,32,50.0
79,65,7,6,128,-122,-95.3125
79,65,8,149,256,-107,-41.796875
79,65,9,564,512,52,10.15625
79,65,10,1557,1024,533,52.05078125
79,65,11,777,2048,-1271,-62.060546875
79,65,12,1388,4096,-2708,-66.11328125
79,65,13,10710,8192,2518,30.7373046875
79,65,14,18168,16384,1784,10.888671875
79,65,15,107760,32768,74992,228.857421875
79,66,1,0,2,-2,-100.0
79,66,2,1,4,-3,-75.0
79,66,3,15,8,7,87.5
79,66,4,3,16,-13,-81.25
79,66,5,43,32,11,34.375
79,66,6,152,64,88,137.5
79,66,7,17,128,-111,-86.71875
79,66,8,463,256,207,80.859375
79,66,9,877,512,365,71.2890625
79,66,10,2785,1024,1761,171.97265625
79,66,11,2368,2048,320,15.625
79,66,12,2701,4096,-1395,-34.0576171875
79,66,13,1300,8192,-6892,-84.130859375
79,66,14,5016,16384,-11368,-69.384765625
79,66,15,65736,32768,32968,100.6103515625
79,67,1,0,2,-2,-100.0
79,67,2,2,4,-2,-50.0
79,67,3,2,8,-6,-75.0
79,67,4,7,16,-9,-56.25
79,67,5,63,32,31,96.875
79,67,6,68,64,4,6.25
79,67,7,146,128,18,14.0625
79,67,8,30,256,-226,-88.28125
79,67,9,77,512,-435,-84.9609375
79,67,10,42,1024,-982,-95.8984375
79,67,11,517,2048,-1531,-74.755859375
79,67,12,3282,4096,-814,-19.873046875
79,67,13,593,8192,-7599,-92.76123046875
79,67,14,56321,16384,39937,243.756103515625
79,67,15,22238,32768,-10530,-32.135009765625
79,68,1,0,2,-2,-100.0
79,68,2,3,4,-1,-25.0
79,68,3,7,8,-1,-12.5
79,68,4,22,16,6,37.5
79,68,5,58,32,26,81.25
79,68,6,175,64,111,173.4375
79,68,7,141,128,13,10.15625
79,68,8,41,256,-215,-83.984375
79,68,9,1013,512,501,97.8515625
79,68,10,274,1024,-750,-73.2421875
79,68,11,1473,2048,-575,-28.076171875
79,68,12,2554,4096,-1542,-37.646484375
79,68,13,363,8192,-7829,-95.56884765625
79,68,14,4501,16384,-11883,-72.528076171875
79,68,15,106396,32768,73628,224.69482421875
79,69,1,0,2,-2,-100.0
79,69,2,3,4,-1,-25.0
79,69,3,8,8,0,0.0
79,69,4,24,16,8,50.0
79,69,5,58,32,26,81.25
79,69,6,41,64,-23,-35.9375
79,69,7,86,128,-42,-32.8125
79,69,8,28,256,-228,-89.0625
79,69,9,196,512,-316,-61.71875
79,69,10,1614,1024,590,57.6171875
79,69,11,1986,2048,-62,-3.02734375
79,69,12,20932,4096,16836,411.03515625
79,69,13,6341,8192,-1851,-22.59521484375
79,69,14,63146,16384,46762,285.41259765625
79,69,15,11712,32768,-21056,-64.2578125
79,70,1,0,2,-2,-100.0
79,70,2,1,4,-3,-75.0
79,70,3,6,8,-2,-25.0
79,70,4,5,16,-11,-68.75
79,70,5,17,32,-15,-46.875
79,70,6,56,64,-8,-12.5
79,70,7,135,128,7,5.46875
79,70,8,253,256,-3,-1.171875
79,70,9,267,512,-245,-47.8515625
79,70,10,413,1024,-611,-59.66796875
79,70,11,1265,2048,-783,-38.232421875
79,70,12,1347,4096,-2749,-67.1142578125
79,70,13,24486,8192,16294,198.9013671875
79,70,14,3048,16384,-13336,-81.396484375
79,70,15,8056,32768,-24712,-75.4150390625
79,71,1,0,2,-2,-100.0
79,71,2,1,4,-3,-75.0
79,71,3,10,8,2,25.0
79,71,4,7,16,-9,-56.25
79,71,5,67,32,35,109.375
79,71,6,59,64,-5,-7.8125
79,71,7,293,128,165,128.90625
79,71,8,50,256,-206,-80.46875
79,71,9,154,512,-358,-69.921875
79,71,10,1190,1024,166,16.2109375
79,71,11,2049,2048,1,0.048828125
79,71,12,1517,4096,-2579,-62.9638671875
79,71,13,5700,8192,-2492,-30.419921875
79,71,14,14056,16384,-2328,-14.208984375
79,71,15,1597,32768,-31171,-95.1263427734375
79,72,1,0,2,-2,-100.0
79,72,2,4,4,0,0.0
79,72,3,2,8,-6,-75.0
79,72,4,6,16,-10,-62.5
79,72,5,10,32,-22,-68.75
79,72,6,14,64,-50,-78.125
79,72,7,52,128,-76,-59.375
79,72,8,283,256,27,10.546875
79,72,9,9,512,-503,-98.2421875
79,72,10,1161,1024,137,13.37890625
79,72,11,31,2048,-2017,-98.486328125
79,72,12,2196,4096,-1900,-46.38671875
79,72,13,7520,8192,-672,-8.203125
79,72,14,3613,16384,-12771,-77.947998046875
79,72,15,76511,32768,43743,133.4930419921875
79,73,1,0,2,-2,-100.0
79,73,2,1,4,-3,-75.0
79,73,3,15,8,7,87.5
79,73,4,16,16,0,0.0
79,73,5,18,32,-14,-43.75
79,73,6,31,64,-33,-51.5625
79,73,7,76,128,-52,-40.625
79,73,8,390,256,134,52.34375
79,73,9,789,512,277,54.1015625
79,73,10,825,1024,-199,-19.43359375
79,73,11,9536,2048,7488,365.625
79,73,12,1742,4096,-2354,-57.470703125
79,73,13,1862,8192,-6330,-77.2705078125
79,73,14,55107,16384,38723,236.346435546875
79,73,15,30278,32768,-2490,-7.598876953125
79,74,1,0,2,-2,-100.0
79,74,2,3,4,-1,-25.0
79,74,3,7,8,-1,-12.5
79,74,4,4,16,-12,-75.0
79,74,5,47,32,15,46.875
79,74,6,202,64,138,215.625
79,74,7,197,128,69,53.90625
79,74,8,339,256,83,32.421875
79,74,9,881,512,369,72.0703125
79,74,10,150,1024,-874,-85.3515625
79,74,11,172,2048,-1876,-91.6015625
79,74,12,717,4096,-3379,-82.4951171875
79,74,13,411,8192,-7781,-94.98291015625
79,74,14,3701,16384,-12683,-77.410888671875
79,74,15,53273,32768,20505,62.5762939453125
79,75,1,0,2,-2,-100.0
79,75,2,2,4,-2,-50.0
79,75,3,2,8,-6,-75.0
79,75,4,9,16,-7,-43.75
79,75,5,46,32,14,43.75
79,75,6,51,64,-13,-20.3125
79,75,7,31,128,-97,-75.78125
79,75,8,620,256,364,142.1875
79,75,9,329,512,-183,-35.7421875
79,75,10,829,1024,-195,-19.04296875
79,75,11,1856,2048,-192,-9.375
79,75,12,5454,4096,1358,33.154296875
79,75,13,4185,8192,-4007,-48.91357421875
79,75,14,5020,16384,-11364,-69.3603515625
79,75,15,10587,32768,-22181,-67.6910400390625
79,76,1,0,2,-2,-100.0
79,76,2,1,4,-3,-75.0
79,76,3,10,8,2,25.0
79,76,4,6,16,-10,-62.5
79,76,5,45,32,13,40.625
79,76,6,95,64,31,48.4375
79,76,7,11,128,-117,-91.40625
79,76,8,304,256,48,18.75
79,76,9,77,512,-435,-84.9609375
79,76,10,598,1024,-426,-41.6015625
79,76,11,383,2048,-1665,-81.298828125
79,76,12,146,4096,-3950,-96.435546875
79,76,13,20645,8192,12453,152.01416015625
79,76,14,43115,16384,26731,163.153076171875
79,76,15,13731,32768,-19037,-58.0963134765625
79,77,1,0,2,-2,-100.0
79,77,2,3,4,-1,-25.0
79,77,3,3,8,-5,-62.5
79,77,4,7,16,-9,-56.25
79,77,5,7,32,-25,-78.125
79,77,6,17,64,-47,-73.4375
79,77,7,275,128,147,114.84375
79,77,8,171,256,-85,-33.203125
79,77,9,173,512,-339,-66.2109375
79,77,10,336,1024,-688,-67.1875
79,77,11,1453,2048,-595,-29.052734375
79,77,12,23443,4096,19347,472.3388671875
79,77,13,1700,8192,-6492,-79.248046875
79,77,14,938,16384,-15446,-94.27490234375
79,77,15,33291,32768,523,1.5960693359375
79,78,1,0,2,-2,-100.0
79,78,2,1,4,-3,-75.0
79,78,3,2,8,-6,-75.0
79,78,4,3,16,-13,-81.25
79,78,5,29,32,-3,-9.375
79,78,6,184,64,120,187.5
79,78,7,18,128,-110,-85.9375
79,78,8,22,256,-234,-91.40625
79,78,9,292,512,-220,-42.96875
79,78,10,582,1024,-442,-43.1640625
79,78,11,991,2048,-1057,-51.611328125
79,78,12,1678,4096,-2418,-59.033203125
79,78,13,10591,8192,2399,29.28466796875
79,78,14,46202,16384,29818,181.99462890625
79,78,15,21568,32768,-11200,-34.1796875
79,79,1,0,2,-2,-100.0
79,79,2,1,4,-3,-75.0
79,79,3,5,8,-3,-37.5
79,79,4,9,16,-7,-43.75
79,79,5,23,32,-9,-28.125
79,79,6,30,64,-34,-53.125
79,79,7,39,128,-89,-69.53125
79,79,8,250,256,-6,-2.34375
79,79,9,976,512,464,90.625
79,79,10,131,1024,-893,-87.20703125
79,79,11,37,2048,-2011,-98.193359375
79,79,12,24283,4096,20187,492.8466796875
79,79,13,6351,8192,-1841,-22.47314453125
79,79,14,10566,16384,-5818,-35.51025390625
79,79,15,58510,32768,25742,78.558349609375
80,1,1,0,2,-2,-100.0
80,1,2,2,4,-2,-50.0
80,1,3,4,8,-4,-50.0
80,1,4,9,16,-7,-43.75
80,1,5,26,32,-6,-18.75
80,1,6,15,64,-49,-76.5625
80,1,7,157,128,29,22.65625
80,1,8,11,256,-245,-95.703125
80,1,9,67,512,-445,-86.9140625
80,1,10,316,1024,-708,-69.140625
80,1,11,853,2048,-1195,-58.349609375
80,1,12,223,4096,-3873,-94.5556640625
80,1,13,4156,8192,-4036,-49.267578125
80,1,14,3853,16384,-12531,-76.483154296875
80,1,15,26793,32768,-5975,-18.2342529296875
80,2,1,0,2,-2,-100.0
80,2,2,2,4,-2,-50.0
80,2,3,6,8,-2,-25.0
80,2,4,15,16,-1,-6.25
80,2,5,35,32,3,9.375
80,2,6,64,64,0,0.0
80,2,7,112,128,-16,-12.5
80,2,8,555,256,299,116.796875
80,2,9,891,512,379,74.0234375
80,2,10,174,1024,-850,-83.0078125
80,2,11,3175,2048,1127,55.029296875
80,2,12,2779,4096,-1317,-32.1533203125
80,2,13,8265,8192,73,0.89111328125
80,2,14,58480,16384,42096,256.93359375
80,2,15,10985,32768,-21783,-66.4764404296875
80,3,1,0,2,-2,-100.0
80,3,2,1,4,-3,-75.0
80,3,3,3,8,-5,-62.5
80,3,4,3,16,-13,-81.25
80,3,5,21,32,-11,-34.375
80,3,6,81,64,17,26.5625
80,3,7,191,128,63,49.21875
80,3,8,371,256,115,44.921875
80,3,9,171,512,-341,-66.6015625
80,3,10,1718,1024,694,67.7734375
80,3,11,686,2048,-1362,-66.50390625
80,3,12,31,4096,-4065,-99.2431640625
80,3,13,3265,8192,-4927,-60.14404296875
80,3,14,15057,16384,-1327,-8.099365234375
80,3,15,17811,32768,-14957,-45.6451416015625
80,4,1,0,2,-2,-100.0
80,4,2,2,4,-2,-50.0
80,4,3,10,8,2,25.0
80,4,4,22,16,6,37.5
80,4,5,4,32,-28,-87.5
80,4,6,26,64,-38,-59.375
80,4,7,381,128,253,197.65625
80,4,8,123,256,-133,-51.953125
80,4,9,761,512,249,48.6328125
80,4,10,777,1024,-247,-24.12109375
80,4,11,1663,2048,-385,-18.798828125
80,4,12,3089,4096,-1007,-24.5849609375
80,4,13,5214,8192,-2978,-36.3525390625
80,4,14,29553,16384,13169,80.377197265625
80,4,15,3345,32768,-29423,-89.7918701171875
80,5,1,0,2,-2,-100.0
80,5,2,2,4,-2,-50.0
80,5,3,10,8,2,25.0
80,5,4,6,16,-10,-62.5
80,5,5,6,32,-26,-81.25
80,5,6,42,64,-22,-34.375
80,5,7,10,128,-118,-92.1875
80,5,8,145,256,-111,-43.359375
80,5,9,1714,512,1202,234.765625
80,5,10,1005,1024,-19,-1.85546875
80,5,11,4471,2048,2423,118.310546875
80,5,12,7313,4096,3217,78.5400390625
80,5,13,1254,8192,-6938,-84.6923828125
80,5,14,19997,16384,3613,22.052001953125
80,5,15,120160,32768,87392,266.69921875
80,6,1,0,2,-2,-100.0
80,6,2,1,4,-3,-75.0
80,6,3,11,8,3,37.5
80,6,4,16,16,0,0.0
80,6,5,55,32,23,71.875
80,6,6,94,64,30,46.875
80,6,7,201,128,73,57.03125
80,6,8,326,256,70,27.34375
80,6,9,370,512,-142,-27.734375
80,6,10,1528,1024,504,49.21875
80,6,11,2244,2048,196,9.5703125
80,6,12,1058,4096,-3038,-74.169921875
80,6,13,2059,8192,-6133,-74.86572265625
80,6,14,3624,16384,-12760,-77.880859375
80,6,15,75457,32768,42689,130.2764892578125
80,7,1,0,2,-2,-100.0
80,7,2,1,4,-3,-75.0
80,7,3,2,8,-6,-75.0
80,7,4,5,16,-11,-68.75
80,7,5,95,32,63,196.875
80,7,6,6,64,-58,-90.625
80,7,7,125,128,-3,-2.34375
80,7,8,24,256,-232,-90.625
80,7,9,335,512,-177,-34.5703125
80,7,10,1111,1024,87,8.49609375
80,7,11,2460,2048,412,20.1171875
80,7,12,1074,4096,-3022,-73.779296875
80,7,13,19998,8192,11806,144.1162109375
80,7,14,12222,16384,-4162,-25.40283203125
80,7,15,1945,32768,-30823,-94.0643310546875
80,8,1,0,2,-2,-100.0
80,8,2,2,4,-2,-50.0
80,8,3,9,8,1,12.5
80,8,4,26,16,10,62.5
80,8,5,17,32,-15,-46.875
80,8,6,21,64,-43,-67.1875
80,8,7,318,128,190,148.4375
80,8,8,60,256,-196,-76.5625
80,8,9,47,512,-465,-90.8203125
80,8,10,614,1024,-410,-40.0390625
80,8,11,1021,2048,-1027,-50.146484375
80,8,12,604,4096,-3492,-85.25390625
80,8,13,5775,8192,-2417,-29.50439453125
80,8,14,3311,16384,-13073,-79.791259765625
80,8,15,9786,32768,-22982,-70.135498046875
80,9,1,0,2,-2,-100.0
80,9,2,3,4,-1,-25.0
80,9,3,4,8,-4,-50.0
80,9,4,29,16,13,81.25
80,9,5,52,32,20,62.5
80,9,6,58,64,-6,-9.375
80,9,7,108,128,-20,-15.625
80,9,8,101,256,-155,-60.546875
80,9,9,65,512,-447,-87.3046875
80,9,10,806,1024,-218,-21.2890625
80,9,11,4370,2048,2322,113.37890625
80,9,12,15192,4096,11096,270.8984375
80,9,13,4623,8192,-3569,-43.56689453125
80,9,14,3170,16384,-13214,-80.65185546875
80,9,15,25694,32768,-7074,-21.588134765625
80,10,1,0,2,-2,-100.0
80,10,2,2,4,-2,-50.0
80,10,3,2,8,-6,-75.0
80,10,4,14,16,-2,-12.5
80,10,5,17,32,-15,-46.875
80,10,6,26,64,-38,-59.375
80,10,7,154,128,26,20.3125
80,10,8,630,256,374,146.09375
80,10,9,200,512,-312,-60.9375
80,10,10,728,1024,-296,-28.90625
80,10,11,4996,2048,2948,143.9453125
80,10,12,1962,4096,-2134,-52.099609375
80,10,13,471,8192,-7721,-94.25048828125
80,10,14,1316,16384,-15068,-91.9677734375
80,10,15,8816,32768,-23952,-73.095703125
80,11,1,0,2,-2,-100.0
80,11,2,3,4,-1,-25.0
80,11,3,6,8,-2,-25.0
80,11,4,14,16,-2,-12.5
80,11,5,4,32,-28,-87.5
80,11,6,19,64,-45,-70.3125
80,11,7,135,128,7,5.46875
80,11,8,183,256,-73,-28.515625
80,11,9,221,512,-291,-56.8359375
80,11,10,40,1024,-984,-96.09375
80,11,11,8573,2048,6525,318.603515625
80,11,12,4170,4096,74,1.806640625
80,11,13,5798,8192,-2394,-29.2236328125
80,11,14,45428,16384,29044,177.2705078125
80,11,15,44574,32768,11806,36.029052734375
80,12,1,0,2,-2,-100.0
80,12,2,1,4,-3,-75.0
80,12,3,5,8,-3,-37.5
80,12,4,16,16,0,0.0
80,12,5,31,32,-1,-3.125
80,12,6,80,64,16,25.0
80,12,7,187,128,59,46.09375
80,12,8,76,256,-180,-70.3125
80,12,9,117,512,-395,-77.1484375
80,12,10,2930,1024,1906,186.1328125
80,12,11,399,2048,-1649,-80.517578125
80,12,12,7554,4096,3458,84.423828125
80,12,13,2696,8192,-5496,-67.08984375
80,12,14,5665,16384,-10719,-65.423583984375
80,12,15,3513,32768,-29255,-89.2791748046875
80,13,1,0,2,-2,-100.0
80,13,2,4,4,0,0.0
80,13,3,3,8,-5,-62.5
80,13,4,5,16,-11,-68.75
80,13,5,76,32,44,137.5
80,13,6,5,64,-59,-92.1875
80,13,7,113,128,-15,-11.71875
80,13,8,146,256,-110,-42.96875
80,13,9,1561,512,1049,204.8828125
80,13,10,153,1024,-871,-85.05859375
80,13,11,3537,2048,1489,72.705078125
80,13,12,148,4096,-3948,-96.38671875
80,13,13,10334,8192,2142,26.1474609375
80,13,14,587,16384,-15797,-96.417236328125
80,13,15,61252,32768,28484,86.92626953125
80,14,1,0,2,-2,-100.0
80,14,2,1,4,-3,-75.0
80,14,3,3,8,-5,-62.5
80,14,4,5,16,-11,-68.75
80,14,5,25,32,-7,-21.875
80,14,6,43,64,-21,-32.8125
80,14,7,59,128,-69,-53.90625
80,14,8,559,256,303,118.359375
80,14,9,383,512,-129,-25.1953125
80,14,10,325,1024,-699,-68.26171875
80,14,11,3088,2048,1040,50.78125
80,14,12,2097,4096,-1999,-48.8037109375
80,14,13,14376,8192,6184,75.48828125
80,14,14,12694,16384,-3690,-22.52197265625
80,14,15,2037,32768,-30731,-93.7835693359375
80,15,1,0,2,-2,-100.0
80,15,2,1,4,-3,-75.0
80,15,3,4,8,-4,-50.0
80,15,4,5,16,-11,-68.75
80,15,5,11,32,-21,-65.625
80,15,6,89,64,25,39.0625
80,15,7,15,128,-113,-88.28125
80,15,8,605,256,349,136.328125
80,15,9,235,512,-277,-54.1015625
80,15,10,439,1024,-585,-57.12890625
80,15,11,2213,2048,165,8.056640625
80,15,12,196,4096,-3900,-95.21484375
80,15,13,32015,8192,23823,290.80810546875
80,15,14,5162,16384,-11222,-68.49365234375
80,15,15,3671,32768,-29097,-88.7969970703125
80,16,1,0,2,-2,-100.0
80,16,2,4,4,0,0.0
80,16,3,2,8,-6,-75.0
80,16,4,12,16,-4,-25.0
80,16,5,4,32,-28,-87.5
80,16,6,61,64,-3,-4.6875
80,16,7,44,128,-84,-65.625
80,16,8,256,256,0,0.0
80,16,9,1122,512,610,119.140625
80,16,10,612,1024,-412,-40.234375
80,16,11,2898,2048,850,41.50390625
80,16,12,2444,4096,-1652,-40.33203125
80,16,13,19224,8192,11032,134.66796875
80,16,14,16611,16384,227,1.385498046875
80,16,15,18202,32768,-14566,-44.451904296875
80,17,1,0,2,-2,-100.0
80,17,2,1,4,-3,-75.0
80,17,3,12,8,4,50.0
80,17,4,27,16,11,68.75
80,17,5,18,32,-14,-43.75
80,17,6,10,64,-54,-84.375
80,17,7,43,128,-85,-66.40625
80,17,8,84,256,-172,-67.1875
80,17,9,373,512,-139,-27.1484375
80,17,10,2808,1024,1784,174.21875
80,17,11,1855,2048,-193,-9.423828125
80,17,12,1030,4096,-3066,-74.853515625
80,17,13,17278,8192,9086,110.9130859375
80,17,14,1454,16384,-14930,-91.12548828125
80,17,15,43975,32768,11207,34.2010498046875
80,18,1,0,2,-2,-100.0
80,18,2,1,4,-3,-75.0
80,18,3,2,8,-6,-75.0
80,18,4,12,16,-4,-25.0
80,18,5,6,32,-26,-81.25
80,18,6,6,64,-58,-90.625
80,18,7,39,128,-89,-69.53125
80,18,8,162,256,-94,-36.71875
80,18,9,214,512,-298,-58.203125
80,18,10,1346,1024,322,31.4453125
80,18,11,1359,2048,-689,-33.642578125
80,18,12,4467,4096,371,9.0576171875
80,18,13,3304,8192,-4888,-59.66796875
80,18,14,14148,16384,-2236,-13.6474609375
80,18,15,13047,32768,-19721,-60.1837158203125
80,19,1,0,2,-2,-100.0
80,19,2,2,4,-2,-50.0
80,19,3,7,8,-1,-12.5
80,19,4,6,16,-10,-62.5
80,19,5,36,32,4,12.5
80,19,6,26,64,-38,-59.375
80,19,7,99,128,-29,-22.65625
80,19,8,118,256,-138,-53.90625
80,19,9,639,512,127,24.8046875
80,19,10,1046,1024,22,2.1484375
80,19,11,1327,2048,-721,-35.205078125
80,19,12,15444,4096,11348,277.05078125
80,19,13,9818,8192,1626,19.8486328125
80,19,14,4272,16384,-12112,-73.92578125
80,19,15,1691,32768,-31077,-94.8394775390625
80,20,1,0,2,-2,-100.0
80,20,2,3,4,-1,-25.0
80,20,3,2,8,-6,-75.0
80,20,4,12,16,-4,-25.0
80,20,5,31,32,-1,-3.125
80,20,6,25,64,-39,-60.9375
80,20,7,127,128,-1,-0.78125
80,20,8,12,256,-244,-95.3125
80,20,9,296,512,-216,-42.1875
80,20,10,1663,1024,639,62.40234375
80,20,11,821,2048,-1227,-59.912109375
80,20,12,11732,4096,7636,186.42578125
80,20,13,4144,8192,-4048,-49.4140625
80,20,14,1761,16384,-14623,-89.251708984375
80,20,15,28426,32768,-4342,-13.250732421875
80,21,1,0,2,-2,-100.0
80,21,2,3,4,-1,-25.0
80,21,3,9,8,1,12.5
80,21,4,9,16,-7,-43.75
80,21,5,12,32,-20,-62.5
80,21,6,13,64,-51,-79.6875
80,21,7,49,128,-79,-61.71875
80,21,8,582,256,326,127.34375
80,21,9,218,512,-294,-57.421875
80,21,10,240,1024,-784,-76.5625
80,21,11,4797,2048,2749,134.228515625
80,21,12,6008,4096,1912,46.6796875
80,21,13,1555,8192,-6637,-81.01806640625
80,21,14,3219,16384,-13165,-80.352783203125
80,21,15,6414,32768,-26354,-80.426025390625
80,22,1,0,2,-2,-100.0
80,22,2,1,4,-3,-75.0
80,22,3,4,8,-4,-50.0
80,22,4,15,16,-1,-6.25
80,22,5,4,32,-28,-87.5
80,22,6,12,64,-52,-81.25
80,22,7,92,128,-36,-28.125
80,22,8,146,256,-110,-42.96875
80,22,9,740,512,228,44.53125
80,22,10,31,1024,-993,-96.97265625
80,22,11,354,2048,-1694,-82.71484375
80,22,12,9109,4096,5013,122.3876953125
80,22,13,6491,8192,-1701,-20.76416015625
80,22,14,50863,16384,34479,210.443115234375
80,22,15,55752,32768,22984,70.1416015625
80,23,1,0,2,-2,-100.0
80,23,2,2,4,-2,-50.0
80,23,3,2,8,-6,-75.0
80,23,4,18,16,2,12.5
80,23,5,28,32,-4,-12.5
80,23,6,20,64,-44,-68.75
80,23,7,11,128,-117,-91.40625
80,23,8,30,256,-226,-88.28125
80,23,9,1644,512,1132,221.09375
80,23,10,1666,1024,642,62.6953125
80,23,11,462,2048,-1586,-77.44140625
80,23,12,1551,4096,-2545,-62.1337890625
80,23,13,10250,8192,2058,25.1220703125
80,23,14,9017,16384,-7367,-44.964599609375
80,23,15,95,32768,-32673,-99.7100830078125
80,24,1,0,2,-2,-100.0
80,24,2,1,4,-3,-75.0
80,24,3,3,8,-5,-62.5
80,24,4,4,16,-12,-75.0
80,24,5,4,32,-28,-87.5
80,24,6,5,64,-59,-92.1875
80,24,7,44,128,-84,-65.625
80,24,8,115,256,-141,-55.078125
80,24,9,402,512,-110,-21.484375
80,24,10,198,1024,-826,-80.6640625
80,24,11,1589,2048,-459,-22.412109375
80,24,12,3176,4096,-920,-22.4609375
80,24,13,5297,8192,-2895,-35.33935546875
80,24,14,53549,16384,37165,226.837158203125
80,24,15,11144,32768,-21624,-65.9912109375
80,25,1,0,2,-2,-100.0
80,25,2,1,4,-3,-75.0
80,25,3,10,8,2,25.0
80,25,4,5,16,-11,-68.75
80,25,5,25,32,-7,-21.875
80,25,6,117,64,53,82.8125
80,25,7,237,128,109,85.15625
80,25,8,477,256,221,86.328125
80,25,9,211,512,-301,-58.7890625
80,25,10,1911,1024,887,86.62109375
80,25,11,5697,2048,3649,178.173828125
80,25,12,85,4096,-4011,-97.9248046875
80,25,13,5421,8192,-2771,-33.82568359375
80,25,14,10978,16384,-5406,-32.99560546875
80,25,15,41096,32768,8328,25.4150390625
80,26,1,0,2,-2,-100.0
80,26,2,1,4,-3,-75.0
80,26,3,22,8,14,175.0
80,26,4,8,16,-8,-50.0
80,26,5,12,32,-20,-62.5
80,26,6,18,64,-46,-71.875
80,26,7,77,128,-51,-39.84375
80,26,8,316,256,60,23.4375
80,26,9,141,512,-371,-72.4609375
80,26,10,240,1024,-784,-76.5625
80,26,11,1103,2048,-945,-46.142578125
80,26,12,3632,4096,-464,-11.328125
80,26,13,674,8192,-7518,-91.7724609375
80,26,14,7092,16384,-9292,-56.7138671875
80,26,15,13587,32768,-19181,-58.5357666015625
80,27,1,0,2,-2,-100.0
80,27,2,2,4,-2,-50.0
80,27,3,2,8,-6,-75.0
80,27,4,53,16,37,231.25
80,27,5,82,32,50,156.25
80,27,6,19,64,-45,-70.3125
80,27,7,130,128,2,1.5625
80,27,8,693,256,437,170.703125
80,27,9,204,512,-308,-60.15625
80,27,10,694,1024,-330,-32.2265625
80,27,11,170,2048,-1878,-91.69921875
80,27,12,922,4096,-3174,-77.490234375
80,27,13,11078,8192,2886,35.2294921875
80,27,14,4887,16384,-11497,-70.172119140625
80,27,15,7710,32768,-25058,-76.470947265625
80,28,1,0,2,-2,-100.0
80,28,2,1,4,-3,-75.0
80,28,3,5,8,-3,-37.5
80,28,4,4,16,-12,-75.0
80,28,5,8,32,-24,-75.0
80,28,6,65,64,1,1.5625
80,28,7,33,128,-95,-74.21875
80,28,8,48,256,-208,-81.25
80,28,9,529,512,17,3.3203125
80,28,10,275,1024,-749,-73.14453125
80,28,11,322,2048,-1726,-84.27734375
80,28,12,8181,4096,4085,99.7314453125
80,28,13,15499,8192,7307,89.19677734375
80,28,14,13218,16384,-3166,-19.32373046875
80,28,15,45221,32768,12453,38.0035400390625
80,29,1,0,2,-2,-100.0
80,29,2,2,4,-2,-50.0
80,29,3,2,8,-6,-75.0
80,29,4,29,16,13,81.25
80,29,5,5,32,-27,-84.375
80,29,6,101,64,37,57.8125
80,29,7,259,128,131,102.34375
80,29,8,42,256,-214,-83.59375
80,29,9,310,512,-202,-39.453125
80,29,10,953,1024,-71,-6.93359375
80,29,11,1399,2048,-649,-31.689453125
80,29,12,4360,4096,264,6.4453125
80,29,13,18489,8192,10297,125.69580078125
80,29,14,4062,16384,-12322,-75.20751953125
80,29,15,36200,32768,3432,10.4736328125
80,30,1,0,2,-2,-100.0
80,30,2,4,4,0,0.0
80,30,3,4,8,-4,-50.0
80,30,4,11,16,-5,-31.25
80,30,5,105,32,73,228.125
80,30,6,5,64,-59,-92.1875
80,30,7,234,128,106,82.8125
80,30,8,183,256,-73,-28.515625
80,30,9,995,512,483,94.3359375
80,30,10,1645,1024,621,60.64453125
80,30,11,769,2048,-1279,-62.451171875
80,30,12,4879,4096,783,19.1162109375
80,30,13,1305,8192,-6887,-84.06982421875
80,30,14,11744,16384,-4640,-28.3203125
80,30,15,65187,32768,32419,98.9349365234375
80,31,1,0,2,-2,-100.0
80,31,2,3,4,-1,-25.0
80,31,3,4,8,-4,-50.0
80,31,4,7,16,-9,-56.25
80,31,5,71,32,39,121.875
80,31,6,23,64,-41,-64.0625
80,31,7,22,128,-106,-82.8125
80,31,8,172,256,-84,-32.8125
80,31,9,82,512,-430,-83.984375
80,31,10,672,1024,-352,-34.375
80,31,11,477,2048,-1571,-76.708984375
80,31,12,951,4096,-3145,-76.7822265625
80,31,13,51534,8192,43342,529.0771484375
80,31,14,7514,16384,-8870,-54.13818359375
80,31,15,9118,32768,-23650,-72.174072265625
80,32,1,0,2,-2,-100.0
80,32,2,1,4,-3,-75.0
80,32,3,5,8,-3,-37.5
80,32,4,14,16,-2,-12.5
80,32,5,9,32,-23,-71.875
80,32,6,203,64,139,217.1875
80,32,7,75,128,-53,-41.40625
80,32,8,11,256,-245,-95.703125
80,32,9,2194,512,1682,328.515625
80,32,10,38,1024,-986,-96.2890625
80,32,11,389,2048,-1659,-81.005859375
80,32,12,469,4096,-3627,-88.5498046875
80,32,13,19529,8192,11337,138.39111328125
80,32,14,2727,16384,-13657,-83.355712890625
80,32,15,7792,32768,-24976,-76.220703125
80,33,1,0,2,-2,-100.0
80,33,2,1,4,-3,-75.0
80,33,3,6,8,-2,-25.0
80,33,4,10,16,-6,-37.5
80,33,5,122,32,90,281.25
80,33,6,62,64,-2,-3.125
80,33,7,117,128,-11,-8.59375
80,33,8,126,256,-130,-50.78125
80,33,9,39,512,-473,-92.3828125
80,33,10,472,1024,-552,-53.90625
80,33,11,788,2048,-1260,-61.5234375
80,33,12,4241,4096,145,3.5400390625
80,33,13,1979,8192,-6213,-75.84228515625
80,33,14,9638,16384,-6746,-41.17431640625
80,33,15,25572,32768,-7196,-21.96044921875
80,34,1,0,2,-2,-100.0
80,34,2,2,4,-2,-50.0
80,34,3,3,8,-5,-62.5
80,34,4,3,16,-13,-81.25
80,34,5,23,32,-9,-28.125
80,34,6,160,64,96,150.0
80,34,7,6,128,-122,-95.3125
80,34,8,48,256,-208,-81.25
80,34,9,76,512,-436,-85.15625
80,34,10,733,1024,-291,-28.41796875
80,34,11,62,2048,-1986,-96.97265625
80,34,12,6523,4096,2427,59.2529296875
80,34,13,17403,8192,9211,112.43896484375
80,34,14,1491,16384,-14893,-90.899658203125
80,34,15,2750,32768,-30018,-91.607666015625
80,35,1,0,2,-2,-100.0
80,35,2,1,4,-3,-75.0
80,35,3,5,8,-3,-37.5
80,35,4,8,16,-8,-50.0
80,35,5,16,32,-16,-50.0
80,35,6,6,64,-58,-90.625
80,35,7,66,128,-62,-48.4375
80,35,8,71,256,-185,-72.265625
80,35,9,248,512,-264,-51.5625
80,35,10,114,1024,-910,-88.8671875
80,35,11,164,2048,-1884,-91.9921875
80,35,12,172,4096,-3924,-95.80078125
80,35,13,15266,8192,7074,86.3525390625
80,35,14,2384,16384,-14000,-85.44921875
80,35,15,46584,32768,13816,42.1630859375
80,36,1,0,2,-2,-100.0
80,36,2,2,4,-2,-50.0
80,36,3,5,8,-3,-37.5
80,36,4,4,16,-12,-75.0
80,36,5,26,32,-6,-18.75
80,36,6,116,64,52,81.25
80,36,7,92,128,-36,-28.125
80,36,8,865,256,609,237.890625
80,36,9,626,512,114,22.265625
80,36,10,1494,1024,470,45.8984375
80,36,11,709,2048,-1339,-65.380859375
80,36,12,4440,4096,344,8.3984375
80,36,13,9461,8192,1269,15.49072265625
80,36,14,5046,16384,-11338,-69.20166015625
80,36,15,31083,32768,-1685,-5.1422119140625
80,37,1,0,2,-2,-100.0
80,37,2,1,4,-3,-75.0
80,37,3,19,8,11,137.5
80,37,4,13,16,-3,-18.75
80,37,5,12,32,-20,-62.5
80,37,6,246,64,182,284.375
80,37,7,32,128,-96,-75.0
80,37,8,95,256,-161,-62.890625
80,37,9,212,512,-300,-58.59375
80,37,10,1226,1024,202,19.7265625
80,37,11,1436,2048,-612,-29.8828125
80,37,12,4534,4096,438,10.693359375
80,37,13,1988,8192,-6204,-75.732421875
80,37,14,1829,16384,-14555,-88.836669921875
80,37,15,170,32768,-32598,-99.481201171875
80,38,1,0,2,-2,-100.0
80,38,2,1,4,-3,-75.0
80,38,3,5,8,-3,-37.5
80,38,4,3,16,-13,-81.25
80,38,5,6,32,-26,-81.25
80,38,6,15,64,-49,-76.5625
80,38,7,39,128,-89,-69.53125
80,38,8,518,256,262,102.34375
80,38,9,2037,512,1525,297.8515625
80,38,10,489,1024,-535,-52.24609375
80,38,11,3757,2048,1709,83.447265625
80,38,12,13313,4096,9217,225.0244140625
80,38,13,4310,8192,-3882,-47.3876953125
80,38,14,27999,16384,11615,70.892333984375
80,38,15,8147,32768,-24621,-75.1373291015625
80,39,1,0,2,-2,-100.0
80,39,2,1,4,-3,-75.0
80,39,3,17,8,9,112.5
80,39,4,14,16,-2,-12.5
80,39,5,16,32,-16,-50.0
80,39,6,16,64,-48,-75.0
80,39,7,99,128,-29,-22.65625
80,39,8,36,256,-220,-85.9375
80,39,9,663,512,151,29.4921875
80,39,10,367,1024,-657,-64.16015625
80,39,11,1012,2048,-1036,-50.5859375
80,39,12,3739,4096,-357,-8.7158203125
80,39,13,12721,8192,4529,55.28564453125
80,39,14,7155,16384,-9229,-56.329345703125
80,39,15,57692,32768,24924,76.06201171875
80,40,1,0,2,-2,-100.0
80,40,2,5,4,1,25.0
80,40,3,2,8,-6,-75.0
80,40,4,16,16,0,0.0
80,40,5,24,32,-8,-25.0
80,40,6,81,64,17,26.5625
80,40,7,87,128,-41,-32.03125
80,40,8,108,256,-148,-57.8125
80,40,9,814,512,302,58.984375
80,40,10,589,1024,-435,-42.48046875
80,40,11,1975,2048,-73,-3.564453125
80,40,12,559,4096,-3537,-86.3525390625
80,40,13,13016,8192,4824,58.88671875
80,40,14,3769,16384,-12615,-76.995849609375
80,40,15,70201,32768,37433,114.2364501953125
80,41,1,0,2,-2,-100.0
80,41,2,3,4,-1,-25.0
80,41,3,3,8,-5,-62.5
80,41,4,12,16,-4,-25.0
80,41,5,14,32,-18,-56.25
80,41,6,11,64,-53,-82.8125
80,41,7,171,128,43,33.59375
80,41,8,467,256,211,82.421875
80,41,9,50,512,-462,-90.234375
80,41,10,904,1024,-120,-11.71875
80,41,11,213,2048,-1835,-89.599609375
80,41,12,6283,4096,2187,53.3935546875
80,41,13,398,8192,-7794,-95.1416015625
80,41,14,56552,16384,40168,245.166015625
80,41,15,3616,32768,-29152,-88.96484375
80,42,1,0,2,-2,-100.0
80,42,2,1,4,-3,-75.0
80,42,3,4,8,-4,-50.0
80,42,4,4,16,-12,-75.0
80,42,5,29,32,-3,-9.375
80,42,6,22,64,-42,-65.625
80,42,7,19,128,-109,-85.15625
80,42,8,356,256,100,39.0625
80,42,9,345,512,-167,-32.6171875
80,42,10,2657,1024,1633,159.47265625
80,42,11,1558,2048,-490,-23.92578125
80,42,12,6985,4096,2889,70.5322265625
80,42,13,2440,8192,-5752,-70.21484375
80,42,14,10587,16384,-5797,-35.382080078125
80,42,15,43083,32768,10315,31.4788818359375
80,43,1,0,2,-2,-100.0
80,43,2,1,4,-3,-75.0
80,43,3,2,8,-6,-75.0
80,43,4,13,16,-3,-18.75
80,43,5,38,32,6,18.75
80,43,6,19,64,-45,-70.3125
80,43,7,9,128,-119,-92.96875
80,43,8,186,256,-70,-27.34375
80,43,9,208,512,-304,-59.375
80,43,10,11,1024,-1013,-98.92578125
80,43,11,2426,2048,378,18.45703125
80,43,12,1885,4096,-2211,-53.9794921875
80,43,13,11827,8192,3635,44.37255859375
80,43,14,1500,16384,-14884,-90.8447265625
80,43,15,26293,32768,-6475,-19.7601318359375
80,44,1,0,2,-2,-100.0
80,44,2,2,4,-2,-50.0
80,44,3,9,8,1,12.5
80,44,4,5,16,-11,-68.75
80,44,5,58,32,26,81.25
80,44,6,35,64,-29,-45.3125
80,44,7,262,128,134,104.6875
80,44,8,554,256,298,116.40625
80,44,9,1150,512,638,124.609375
80,44,10,30,1024,-994,-97.0703125
80,44,11,1772,2048,-276,-13.4765625
80,44,12,2845,4096,-1251,-30.5419921875
80,44,13,8613,8192,421,5.13916015625
80,44,14,29759,16384,13375,81.634521484375
80,44,15,9421,32768,-23347,-71.2493896484375
80,45,1,0,2,-2,-100.0
80,45,2,1,4,-3,-75.0
80,45,3,7,8,-1,-12.5
80,45,4,6,16,-10,-62.5
80,45,5,31,32,-1,-3.125
80,45,6,42,64,-22,-34.375
80,45,7,84,128,-44,-34.375
80,45,8,574,256,318,124.21875
80,45,9,573,512,61,11.9140625
80,45,10,131,1024,-893,-87.20703125
80,45,11,1716,2048,-332,-16.2109375
80,45,12,2971,4096,-1125,-27.4658203125
80,45,13,1860,8192,-6332,-77.294921875
80,45,14,25213,16384,8829,53.887939453125
80,45,15,14792,32768,-17976,-54.8583984375
80,46,1,0,2,-2,-100.0
80,46,2,2,4,-2,-50.0
80,46,3,8,8,0,0.0
80,46,4,10,16,-6,-37.5
80,46,5,21,32,-11,-34.375
80,46,6,25,64,-39,-60.9375
80,46,7,17,128,-111,-86.71875
80,46,8,23,256,-233,-91.015625
80,46,9,334,512,-178,-34.765625
80,46,10,1132,1024,108,10.546875
80,46,11,4324,2048,2276,111.1328125
80,46,12,2987,4096,-1109,-27.0751953125
80,46,13,1349,8192,-6843,-83.53271484375
80,46,14,6046,16384,-10338,-63.09814453125
80,46,15,21056,32768,-11712,-35.7421875
80,47,1,0,2,-2,-100.0
80,47,2,1,4,-3,-75.0
80,47,3,2,8,-6,-75.0
80,47,4,16,16,0,0.0
80,47,5,10,32,-22,-68.75
80,47,6,22,64,-42,-65.625
80,47,7,55,128,-73,-57.03125
80,47,8,96,256,-160,-62.5
80,47,9,666,512,154,30.078125
80,47,10,88,1024,-936,-91.40625
80,47,11,81,2048,-1967,-96.044921875
80,47,12,3271,4096,-825,-20.1416015625
80,47,13,6259,8192,-1933,-23.59619140625
80,47,14,27746,16384,11362,69.34814453125
80,47,15,17317,32768,-15451,-47.1527099609375
80,48,1,0,2,-2,-100.0
80,48,2,3,4,-1,-25.0
80,48,3,9,8,1,12.5
80,48,4,4,16,-12,-75.0
80,48,5,33,32,1,3.125
80,48,6,24,64,-40,-62.5
80,48,7,317,128,189,147.65625
80,48,8,323,256,67,26.171875
80,48,9,784,512,272,53.125
80,48,10,204,1024,-820,-80.078125
80,48,11,7855,2048,5807,283.544921875
80,48,12,9392,4096,5296,129.296875
80,48,13,58,8192,-8134,-99.2919921875
80,48,14,811,16384,-15573,-95.050048828125
80,48,15,96842,32768,64074,195.538330078125
80,49,1,0,2,-2,-100.0
80,49,2,2,4,-2,-50.0
80,49,3,2,8,-6,-75.0
80,49,4,11,16,-5,-31.25
80,49,5,61,32,29,90.625
80,49,6,112,64,48,75.0
80,49,7,314,128,186,145.3125
80,49,8,275,256,19,7.421875
80,49,9,2095,512,1583,309.1796875
80,49,10,366,1024,-658,-64.2578125
80,49,11,4264,2048,2216,108.203125
80,49,12,8482,4096,4386,107.080078125
80,49,13,23619,8192,15427,188.31787109375
80,49,14,14665,16384,-1719,-10.491943359375
80,49,15,95354,32768,62586,190.997314453125
80,50,1,0,2,-2,-100.0
80,50,2,6,4,2,50.0
80,50,3,4,8,-4,-50.0
80,50,4,40,16,24,150.0
80,50,5,9,32,-23,-71.875
80,50,6,62,64,-2,-3.125
80,50,7,207,128,79,61.71875
80,50,8,419,256,163,63.671875
80,50,9,1068,512,556,108.59375
80,50,10,143,1024,-881,-86.03515625
80,50,11,3901,2048,1853,90.478515625
80,50,12,1793,4096,-2303,-56.2255859375
80,50,13,2480,8192,-5712,-69.7265625
80,50,14,7366,16384,-9018,-55.04150390625
80,50,15,1015,32768,-31753,-96.9024658203125
80,51,1,0,2,-2,-100.0
80,51,2,2,4,-2,-50.0
80,51,3,2,8,-6,-75.0
80,51,4,16,16,0,0.0
80,51,5,86,32,54,168.75
80,51,6,139,64,75,117.1875
80,51,7,368,128,240,187.5
80,51,8,1231,256,975,380.859375
80,51,9,203,512,-309,-60.3515625
80,51,10,3165,1024,2141,209.08203125
80,51,11,2244,2048,196,9.5703125
80,51,12,1342,4096,-2754,-67.236328125
80,51,13,3070,8192,-5122,-62.5244140625
80,51,14,27405,16384,11021,67.266845703125
80,51,15,20179,32768,-12589,-38.4185791015625
80,52,1,0,2,-2,-100.0
80,52,2,1,4,-3,-75.0
80,52,3,3,8,-5,-62.5
80,52,4,9,16,-7,-43.75
80,52,5,119,32,87,271.875
80,52,6,72,64,8,12.5
80,52,7,73,128,-55,-42.96875
80,52,8,720,256,464,181.25
80,52,9,152,512,-360,-70.3125
80,52,10,1130,1024,106,10.3515625
80,52,11,196,2048,-1852,-90.4296875
80,52,12,5487,4096,1391,33.9599609375
80,52,13,3462,8192,-4730,-57.7392578125
80,52,14,14408,16384,-1976,-12.060546875
80,52,15,11906,32768,-20862,-63.665771484375
80,53,1,0,2,-2,-100.0
80,53,2,1,4,-3,-75.0
80,53,3,11,8,3,37.5
80,53,4,18,16,2,12.5
80,53,5,4,32,-28,-87.5
80,53,6,130,64,66,103.125
80,53,7,118,128,-10,-7.8125
80,53,8,914,256,658,257.03125
80,53,9,622,512,110,21.484375
80,53,10,618,1024,-406,-39.6484375
80,53,11,3431,2048,1383,67.529296875
80,53,12,5530,4096,1434,35.009765625
80,53,13,1430,8192,-6762,-82.5439453125
80,53,14,7695,16384,-8689,-53.033447265625
80,53,15,17163,32768,-15605,-47.6226806640625
80,54,1,0,2,-2,-100.0
80,54,2,1,4,-3,-75.0
80,54,3,2,8,-6,-75.0
80,54,4,5,16,-11,-68.75
80,54,5,13,32,-19,-59.375
80,54,6,23,64,-41,-64.0625
80,54,7,28,128,-100,-78.125
80,54,8,164,256,-92,-35.9375
80,54,9,363,512,-149,-29.1015625
80,54,10,542,1024,-482,-47.0703125
80,54,11,2280,2048,232,11.328125
80,54,12,3114,4096,-982,-23.974609375
80,54,13,5277,8192,-2915,-35.58349609375
80,54,14,12263,16384,-4121,-25.152587890625
80,54,15,10643,32768,-22125,-67.5201416015625
80,55,1,0,2,-2,-100.0
80,55,2,1,4,-3,-75.0
80,55,3,7,8,-1,-12.5
80,55,4,5,16,-11,-68.75
80,55,5,15,32,-17,-53.125
80,55,6,140,64,76,118.75
80,55,7,107,128,-21,-16.40625
80,55,8,290,256,34,13.28125
80,55,9,400,512,-112,-21.875
80,55,10,259,1024,-765,-74.70703125
80,55,11,383,2048,-1665,-81.298828125
80,55,12,9049,4096,4953,120.9228515625
80,55,13,6656,8192,-1536,-18.75
80,55,14,1990,16384,-14394,-87.85400390625
80,55,15,91604,32768,58836,179.55322265625
80,56,1,0,2,-2,-100.0
80,56,2,1,4,-3,-75.0
80,56,3,2,8,-6,-75.0
80,56,4,11,16,-5,-31.25
80,56,5,8,32,-24,-75.0
80,56,6,86,64,22,34.375
80,56,7,28,128,-100,-78.125
80,56,8,49,256,-207,-80.859375
80,56,9,203,512,-309,-60.3515625
80,56,10,444,1024,-580,-56.640625
80,56,11,338,2048,-1710,-83.49609375
80,56,12,2059,4096,-2037,-49.7314453125
80,56,13,10481,8192,2289,27.94189453125
80,56,14,21675,16384,5291,32.293701171875
80,56,15,29048,32768,-3720,-11.3525390625
80,57,1,0,2,-2,-100.0
80,57,2,2,4,-2,-50.0
80,57,3,5,8,-3,-37.5
80,57,4,13,16,-3,-18.75
80,57,5,7,32,-25,-78.125
80,57,6,80,64,16,25.0
80,57,7,16,128,-112,-87.5
80,57,8,552,256,296,115.625
80,57,9,493,512,-19,-3.7109375
80,57,10,1144,1024,120,11.71875
80,57,11,1918,2048,-130,-6.34765625
80,57,12,5862,4096,1766,43.115234375
80,57,13,5875,8192,-2317,-28.28369140625
80,57,14,3640,16384,-12744,-77.783203125
80,57,15,4177,32768,-28591,-87.2528076171875
80,58,1,0,2,-2,-100.0
80,58,2,1,4,-3,-75.0
80,58,3,3,8,-5,-62.5
80,58,4,25,16,9,56.25
80,58,5,45,32,13,40.625
80,58,6,23,64,-41,-64.0625
80,58,7,47,128,-81,-63.28125
80,58,8,1584,256,1328,518.75
80,58,9,108,512,-404,-78.90625
80,58,10,1647,1024,623,60.83984375
80,58,11,76,2048,-1972,-96.2890625
80,58,12,6092,4096,1996,48.73046875
80,58,13,46351,8192,38159,465.80810546875
80,58,14,3027,16384,-13357,-81.524658203125
80,58,15,116939,32768,84171,256.8695068359375
80,59,1,0,2,-2,-100.0
80,59,2,3,4,-1,-25.0
80,59,3,3,8,-5,-62.5
80,59,4,5,16,-11,-68.75
80,59,5,14,32,-18,-56.25
80,59,6,59,64,-5,-7.8125
80,59,7,26,128,-102,-79.6875
80,59,8,137,256,-119,-46.484375
80,59,9,70,512,-442,-86.328125
80,59,10,31,1024,-993,-96.97265625
80,59,11,676,2048,-1372,-66.9921875
80,59,12,10819,4096,6723,164.1357421875
80,59,13,6385,8192,-1807,-22.05810546875
80,59,14,25345,16384,8961,54.693603515625
80,59,15,36989,32768,4221,12.8814697265625
80,60,1,0,2,-2,-100.0
80,60,2,3,4,-1,-25.0
80,60,3,2,8,-6,-75.0
80,60,4,12,16,-4,-25.0
80,60,5,17,32,-15,-46.875
80,60,6,94,64,30,46.875
80,60,7,16,128,-112,-87.5
80,60,8,1464,256,1208,471.875
80,60,9,150,512,-362,-70.703125
80,60,10,982,1024,-42,-4.1015625
80,60,11,539,2048,-1509,-73.681640625
80,60,12,649,4096,-3447,-84.1552734375
80,60,13,1269,8192,-6923,-84.50927734375
80,60,14,38789,16384,22405,136.749267578125
80,60,15,28727,32768,-4041,-12.3321533203125
80,61,1,0,2,-2,-100.0
80,61,2,1,4,-3,-75.0
80,61,3,11,8,3,37.5
80,61,4,13,16,-3,-18.75
80,61,5,17,32,-15,-46.875
80,61,6,30,64,-34,-53.125
80,61,7,465,128,337,263.28125
80,61,8,211,256,-45,-17.578125
80,61,9,716,512,204,39.84375
80,61,10,1173,1024,149,14.55078125
80,61,11,631,2048,-1417,-69.189453125
80,61,12,422,4096,-3674,-89.697265625
80,61,13,474,8192,-7718,-94.2138671875
80,61,14,4876,16384,-11508,-70.2392578125
80,61,15,21989,32768,-10779,-32.8948974609375
80,62,1,0,2,-2,-100.0
80,62,2,1,4,-3,-75.0
80,62,3,2,8,-6,-75.0
80,62,4,11,16,-5,-31.25
80,62,5,88,32,56,175.0
80,62,6,7,64,-57,-89.0625
80,62,7,376,128,248,193.75
80,62,8,52,256,-204,-79.6875
80,62,9,745,512,233,45.5078125
80,62,10,542,1024,-482,-47.0703125
80,62,11,1980,2048,-68,-3.3203125
80,62,12,812,4096,-3284,-80.17578125
80,62,13,23720,8192,15528,189.55078125
80,62,14,8627,16384,-7757,-47.344970703125
80,62,15,58506,32768,25738,78.546142578125
80,63,1,0,2,-2,-100.0
80,63,2,1,4,-3,-75.0
80,63,3,14,8,6,75.0
80,63,4,24,16,8,50.0
80,63,5,12,32,-20,-62.5
80,63,6,57,64,-7,-10.9375
80,63,7,137,128,9,7.03125
80,63,8,311,256,55,21.484375
80,63,9,43,512,-469,-91.6015625
80,63,10,796,1024,-228,-22.265625
80,63,11,181,2048,-1867,-91.162109375
80,63,12,727,4096,-3369,-82.2509765625
80,63,13,92,8192,-8100,-98.876953125
80,63,14,19497,16384,3113,19.000244140625
80,63,15,26180,32768,-6588,-20.10498046875
80,64,1,0,2,-2,-100.0
80,64,2,3,4,-1,-25.0
80,64,3,3,8,-5,-62.5
80,64,4,8,16,-8,-50.0
80,64,5,15,32,-17,-53.125
80,64,6,12,64,-52,-81.25
80,64,7,197,128,69,53.90625
80,64,8,25,256,-231,-90.234375
80,64,9,908,512,396,77.34375
80,64,10,101,1024,-923,-90.13671875
80,64,11,131,2048,-1917,-93.603515625
80,64,12,481,4096,-3615,-88.2568359375
80,64,13,7562,8192,-630,-7.6904296875
80,64,14,13925,16384,-2459,-15.008544921875
80,64,15,33311,32768,543,1.6571044921875
80,65,1,0,2,-2,-100.0
80,65,2,1,4,-3,-75.0
80,65,3,11,8,3,37.5
80,65,4,28,16,12,75.0
80,65,5,83,32,51,159.375
80,65,6,34,64,-30,-46.875
80,65,7,86,128,-42,-32.8125
80,65,8,45,256,-211,-82.421875
80,65,9,673,512,161,31.4453125
80,65,10,182,1024,-842,-82.2265625
80,65,11,900,2048,-1148,-56.0546875
80,65,12,5148,4096,1052,25.68359375
80,65,13,22662,8192,14470,176.6357421875
80,65,14,19196,16384,2812,17.1630859375
80,65,15,63098,32768,30330,92.559814453125
80,66,1,0,2,-2,-100.0
80,66,2,4,4,0,0.0
80,66,3,2,8,-6,-75.0
80,66,4,4,16,-12,-75.0
80,66,5,11,32,-21,-65.625
80,66,6,39,64,-25,-39.0625
80,66,7,122,128,-6,-4.6875
80,66,8,185,256,-71,-27.734375
80,66,9,305,512,-207,-40.4296875
80,66,10,3762,1024,2738,267.3828125
80,66,11,241,2048,-1807,-88.232421875
80,66,12,7402,4096,3306,80.712890625
80,66,13,8679,8192,487,5.94482421875
80,66,14,28146,16384,11762,71.78955078125
80,66,15,42508,32768,9740,29.72412109375
80,67,1,0,2,-2,-100.0
80,67,2,3,4,-1,-25.0
80,67,3,15,8,7,87.5
80,67,4,18,16,2,12.5
80,67,5,18,32,-14,-43.75
80,67,6,53,64,-11,-17.1875
80,67,7,122,128,-6,-4.6875
80,67,8,763,256,507,198.046875
80,67,9,140,512,-372,-72.65625
80,67,10,514,1024,-510,-49.8046875
80,67,11,2463,2048,415,20.263671875
80,67,12,617,4096,-3479,-84.9365234375
80,67,13,10267,8192,2075,25.32958984375
80,67,14,31023,16384,14639,89.349365234375
80,67,15,17964,32768,-14804,-45.17822265625
80,68,1,0,2,-2,-100.0
80,68,2,5,4,1,25.0
80,68,3,3,8,-5,-62.5
80,68,4,10,16,-6,-37.5
80,68,5,14,32,-18,-56.25
80,68,6,18,64,-46,-71.875
80,68,7,130,128,2,1.5625
80,68,8,8,256,-248,-96.875
80,68,9,344,512,-168,-32.8125
80,68,10,239,1024,-785,-76.66015625
80,68,11,564,2048,-1484,-72.4609375
80,68,12,10142,4096,6046,147.607421875
80,68,13,1145,8192,-7047,-86.02294921875
80,68,14,56602,16384,40218,245.47119140625
80,68,15,16795,32768,-15973,-48.7457275390625
80,69,1,0,2,-2,-100.0
80,69,2,2,4,-2,-50.0
80,69,3,2,8,-6,-75.0
80,69,4,3,16,-13,-81.25
80,69,5,15,32,-17,-53.125
80,69,6,13,64,-51,-79.6875
80,69,7,64,128,-64,-50.0
80,69,8,363,256,107,41.796875
80,69,9,221,512,-291,-56.8359375
80,69,10,1014,1024,-10,-0.9765625
80,69,11,3557,2048,1509,73.681640625
80,69,12,2290,4096,-1806,-44.091796875
80,69,13,1632,8192,-6560,-80.078125
80,69,14,2392,16384,-13992,-85.400390625
80,69,15,7719,32768,-25049,-76.4434814453125
80,70,1,0,2,-2,-100.0
80,70,2,1,4,-3,-75.0
80,70,3,4,8,-4,-50.0
80,70,4,6,16,-10,-62.5
80,70,5,5,32,-27,-84.375
80,70,6,6,64,-58,-90.625
80,70,7,56,128,-72,-56.25
80,70,8,939,256,683,266.796875
80,70,9,310,512,-202,-39.453125
80,70,10,1971,1024,947,92.48046875
80,70,11,426,2048,-1622,-79.19921875
80,70,12,15554,4096,11458,279.736328125
80,70,13,526,8192,-7666,-93.5791015625
80,70,14,36573,16384,20189,123.223876953125
80,70,15,10060,32768,-22708,-69.29931640625
80,71,1,0,2,-2,-100.0
80,71,2,1,4,-3,-75.0
80,71,3,10,8,2,25.0
80,71,4,4,16,-12,-75.0
80,71,5,10,32,-22,-68.75
80,71,6,45,64,-19,-29.6875
80,71,7,158,128,30,23.4375
80,71,8,160,256,-96,-37.5
80,71,9,86,512,-426,-83.203125
80,71,10,1423,1024,399,38.96484375
80,71,11,838,2048,-1210,-59.08203125
80,71,12,4105,4096,9,0.2197265625
80,71,13,5145,8192,-3047,-37.19482421875
80,71,14,27351,16384,10967,66.937255859375
80,71,15,3445,32768,-29323,-89.4866943359375
80,72,1,0,2,-2,-100.0
80,72,2,1,4,-3,-75.0
80,72,3,2,8,-6,-75.0
80,72,4,3,16,-13,-81.25
80,72,5,24,32,-8,-25.0
80,72,6,11,64,-53,-82.8125
80,72,7,185,128,57,44.53125
80,72,8,281,256,25,9.765625
80,72,9,185,512,-327,-63.8671875
80,72,10,244,1024,-780,-76.171875
80,72,11,1443,2048,-605,-29.541015625
80,72,12,6731,4096,2635,64.3310546875
80,72,13,4204,8192,-3988,-48.681640625
80,72,14,19222,16384,2838,17.32177734375
80,72,15,70224,32768,37456,114.306640625
80,73,1,0,2,-2,-100.0
80,73,2,2,4,-2,-50.0
80,73,3,2,8,-6,-75.0
80,73,4,15,16,-1,-6.25
80,73,5,34,32,2,6.25
80,73,6,126,64,62,96.875
80,73,7,30,128,-98,-76.5625
80,73,8,29,256,-227,-88.671875
80,73,9,311,512,-201,-39.2578125
80,73,10,2403,1024,1379,134.66796875
80,73,11,214,2048,-1834,-89.55078125
80,73,12,107,4096,-3989,-97.3876953125
80,73,13,23197,8192,15005,183.16650390625
80,73,14,2675,16384,-13709,-83.673095703125
80,73,15,25936,32768,-6832,-20.849609375
80,74,1,0,2,-2,-100.0
80,74,2,5,4,1,25.0
80,74,3,4,8,-4,-50.0
80,74,4,47,16,31,193.75
80,74,5,84,32,52,162.5
80,74,6,68,64,4,6.25
80,74,7,162,128,34,26.5625
80,74,8,106,256,-150,-58.59375
80,74,9,149,512,-363,-70.8984375
80,74,10,135,1024,-889,-86.81640625
80,74,11,109,2048,-1939,-94.677734375
80,74,12,1690,4096,-2406,-58.740234375
80,74,13,5802,8192,-2390,-29.1748046875
80,74,14,16842,16384,458,2.79541015625
80,74,15,28512,32768,-4256,-12.98828125
80,75,1,0,2,-2,-100.0
80,75,2,4,4,0,0.0
80,75,3,6,8,-2,-25.0
80,75,4,19,16,3,18.75
80,75,5,9,32,-23,-71.875
80,75,6,132,64,68,106.25
80,75,7,66,128,-62,-48.4375
80,75,8,338,256,82,32.03125
80,75,9,54,512,-458,-89.453125
80,75,10,1532,1024,508,49.609375
80,75,11,204,2048,-1844,-90.0390625
80,75,12,811,4096,-3285,-80.2001953125
80,75,13,17407,8192,9215,112.48779296875
80,75,14,7889,16384,-8495,-51.849365234375
80,75,15,5279,32768,-27489,-83.8897705078125
80,76,1,0,2,-2,-100.0
80,76,2,1,4,-3,-75.0
80,76,3,2,8,-6,-75.0
80,76,4,4,16,-12,-75.0
80,76,5,40,32,8,25.0
80,76,6,212,64,148,231.25
80,76,7,164,128,36,28.125
80,76,8,422,256,166,64.84375
80,76,9,2275,512,1763,344.3359375
80,76,10,260,1024,-764,-74.609375
80,76,11,128,2048,-1920,-93.75
80,76,12,4282,4096,186,4.541015625
80,76,13,140,8192,-8052,-98.291015625
80,76,14,37287,16384,20903,127.581787109375
80,76,15,26745,32768,-6023,-18.3807373046875
80,77,1,0,2,-2,-100.0
80,77,2,1,4,-3,-75.0
80,77,3,2,8,-6,-75.0
80,77,4,15,16,-1,-6.25
80,77,5,76,32,44,137.5
80,77,6,65,64,1,1.5625
80,77,7,118,128,-10,-7.8125
80,77,8,132,256,-124,-48.4375
80,77,9,120,512,-392,-76.5625
80,77,10,844,1024,-180,-17.578125
80,77,11,3392,2048,1344,65.625
80,77,12,2902,4096,-1194,-29.150390625
80,77,13,7621,8192,-571,-6.97021484375
80,77,14,57236,16384,40852,249.3408203125
80,77,15,29316,32768,-3452,-10.53466796875
80,78,1,0,2,-2,-100.0
80,78,2,5,4,1,25.0
80,78,3,6,8,-2,-25.0
80,78,4,19,16,3,18.75
80,78,5,79,32,47,146.875
80,78,6,10,64,-54,-84.375
80,78,7,282,128,154,120.3125
80,78,8,180,256,-76,-29.6875
80,78,9,398,512,-114,-22.265625
80,78,10,1000,1024,-24,-2.34375
80,78,11,1012,2048,-1036,-50.5859375
80,78,12,5907,4096,1811,44.2138671875
80,78,13,22039,8192,13847,169.03076171875
80,78,14,10505,16384,-5879,-35.882568359375
80,78,15,8102,32768,-24666,-75.274658203125
80,79,1,0,2,-2,-100.0
80,79,2,4,4,0,0.0
80,79,3,8,8,0,0.0
80,79,4,3,16,-13,-81.25
80,79,5,29,32,-3,-9.375
80,79,6,51,64,-13,-20.3125
80,79,7,37,128,-91,-71.09375
80,79,8,65,256,-191,-74.609375
80,79,9,1109,512,597,116.6015625
80,79,10,321,1024,-703,-68.65234375
80,79,11,869,2048,-1179,-57.568359375
80,79,12,12584,4096,8488,207.2265625
80,79,13,12317,8192,4125,50.35400390625
80,79,14,10229,16384,-6155,-37.567138671875
80,79,15,1183,32768,-31585,-96.3897705078125
80,80,1,0,2,-2,-100.0
80,80,2,2,4,-2,-50.0
80,80,3,15,8,7,87.5
80,80,4,18,16,2,12.5
80,80,5,31,32,-1,-3.125
80,80,6,18,64,-46,-71.875
80,80,7,90,128,-38,-29.6875
80,80,8,211,256,-45,-17.578125
80,80,9,143,512,-369,-72.0703125
80,80,10,137,1024,-887,-86.62109375
80,80,11,11147,2048,9099,444.287109375
80,80,12,537,4096,-3559,-86.8896484375
80,80,13,4835,8192,-3357,-40.97900390625
80,80,14,2899,16384,-13485,-82.305908203125
80,80,15,1620,32768,-31148,-95.05615234375
81,1,1,0,2,-2,-100.0
81,1,2,2,4,-2,-50.0
81,1,3,4,8,-4,-50.0
81,1,4,16,16,0,0.0
81,1,5,24,32,-8,-25.0
81,1,6,39,64,-25,-39.0625
81,1,7,166,128,38,29.6875
81,1,8,355,256,99,38.671875
81,1,9,1805,512,1293,252.5390625
81,1,10,782,1024,-242,-23.6328125
81,1,11,7675,2048,5627,274.755859375
81,1,12,7357,4096,3261,79.6142578125
81,1,13,550,8192,-7642,-93.2861328125
81,1,14,39809,16384,23425,142.974853515625
81,1,15,2250,32768,-30518,-93.133544921875
81,2,1,0,2,-2,-100.0
81,2,2,3,4,-1,-25.0
81,2,3,2,8,-6,-75.0
81,2,4,12,16,-4,-25.0
81,2,5,8,32,-24,-75.0
81,2,6,7,64,-57,-89.0625
81,2,7,63,128,-65,-50.78125
81,2,8,735,256,479,187.109375
81,2,9,888,512,376,73.4375
81,2,10,893,1024,-131,-12.79296875
81,2,11,3315,2048,1267,61.865234375
81,2,12,437,4096,-3659,-89.3310546875
81,2,13,627,8192,-7565,-92.34619140625
81,2,14,4327,16384,-12057,-73.590087890625
81,2,15,52633,32768,19865,60.6231689453125
81,3,1,0,2,-2,-100.0
81,3,2,2,4,-2,-50.0
81,3,3,2,8,-6,-75.0
81,3,4,4,16,-12,-75.0
81,3,5,7,32,-25,-78.125
81,3,6,20,64,-44,-68.75
81,3,7,334,128,206,160.9375
81,3,8,264,256,8,3.125
81,3,9,825,512,313,61.1328125
81,3,10,484,1024,-540,-52.734375
81,3,11,1006,2048,-1042,-50.87890625
81,3,12,4856,4096,760,18.5546875
81,3,13,3752,8192,-4440,-54.19921875
81,3,14,3108,16384,-13276,-81.0302734375
81,3,15,21330,32768,-11438,-34.906005859375
81,4,1,0,2,-2,-100.0
81,4,2,2,4,-2,-50.0
81,4,3,6,8,-2,-25.0
81,4,4,34,16,18,112.5
81,4,5,30,32,-2,-6.25
81,4,6,67,64,3,4.6875
81,4,7,105,128,-23,-17.96875
81,4,8,567,256,311,121.484375
81,4,9,59,512,-453,-88.4765625
81,4,10,422,1024,-602,-58.7890625
81,4,11,2485,2048,437,21.337890625
81,4,12,1966,4096,-2130,-52.001953125
81,4,13,3715,8192,-4477,-54.65087890625
81,4,14,5909,16384,-10475,-63.934326171875
81,4,15,1769,32768,-30999,-94.6014404296875
81,5,1,0,2,-2,-100.0
81,5,2,4,4,0,0.0
81,5,3,2,8,-6,-75.0
81,5,4,5,16,-11,-68.75
81,5,5,69,32,37,115.625
81,5,6,17,64,-47,-73.4375
81,5,7,73,128,-55,-42.96875
81,5,8,303,256,47,18.359375
81,5,9,486,512,-26,-5.078125
81,5,10,511,1024,-513,-50.09765625
81,5,11,2322,2048,274,13.37890625
81,5,12,2437,4096,-1659,-40.5029296875
81,5,13,1780,8192,-6412,-78.271484375
81,5,14,12334,16384,-4050,-24.71923828125
81,5,15,2448,32768,-30320,-92.529296875
81,6,1,0,2,-2,-100.0
81,6,2,2,4,-2,-50.0
81,6,3,6,8,-2,-25.0
81,6,4,13,16,-3,-18.75
81,6,5,9,32,-23,-71.875
81,6,6,39,64,-25,-39.0625
81,6,7,54,128,-74,-57.8125
81,6,8,288,256,32,12.5
81,6,9,481,512,-31,-6.0546875
81,6,10,599,1024,-425,-41.50390625
81,6,11,485,2048,-1563,-76.318359375
81,6,12,1054,4096,-3042,-74.267578125
81,6,13,2945,8192,-5247,-64.05029296875
81,6,14,15431,16384,-953,-5.816650390625
81,6,15,8957,32768,-23811,-72.6654052734375
81,7,1,0,2,-2,-100.0
81,7,2,1,4,-3,-75.0
81,7,3,6,8,-2,-25.0
81,7,4,10,16,-6,-37.5
81,7,5,16,32,-16,-50.0
81,7,6,337,64,273,426.5625
81,7,7,18,128,-110,-85.9375
81,7,8,15,256,-241,-94.140625
81,7,9,586,512,74,14.453125
81,7,10,786,1024,-238,-23.2421875
81,7,11,582,2048,-1466,-71.58203125
81,7,12,53,4096,-4043,-98.7060546875
81,7,13,5583,8192,-2609,-31.84814453125
81,7,14,324,16384,-16060,-98.0224609375
81,7,15,42663,32768,9895,30.1971435546875
81,8,1,0,2,-2,-100.0
81,8,2,1,4,-3,-75.0
81,8,3,3,8,-5,-62.5
81,8,4,5,16,-11,-68.75
81,8,5,28,32,-4,-12.5
81,8,6,49,64,-15,-23.4375
81,8,7,252,128,124,96.875
81,8,8,317,256,61,23.828125
81,8,9,53,512,-459,-89.6484375
81,8,10,1427,1024,403,39.35546875
81,8,11,1426,2048,-622,-30.37109375
81,8,12,3831,4096,-265,-6.4697265625
81,8,13,31301,8192,23109,282.09228515625
81,8,14,61271,16384,44887,273.968505859375
81,8,15,42616,32768,9848,30.0537109375
81,9,1,0,2,-2,-100.0
81,9,2,1,4,-3,-75.0
81,9,3,5,8,-3,-37.5
81,9,4,6,16,-10,-62.5
81,9,5,9,32,-23,-71.875
81,9,6,228,64,164,256.25
81,9,7,84,128,-44,-34.375
81,9,8,23,256,-233,-91.015625
81,9,9,565,512,53,10.3515625
81,9,10,38,1024,-986,-96.2890625
81,9,11,1629,2048,-419,-20.458984375
81,9,12,3729,4096,-367,-8.9599609375
81,9,13,78,8192,-8114,-99.0478515625
81,9,14,7375,16384,-9009,-54.986572265625
81,9,15,40828,32768,8060,24.59716796875
81,10,1,0,2,-2,-100.0
81,10,2,2,4,-2,-50.0
81,10,3,2,8,-6,-75.0
81,10,4,21,16,5,31.25
81,10,5,88,32,56,175.0
81,10,6,135,64,71,110.9375
81,10,7,18,128,-110,-85.9375
81,10,8,707,256,451,176.171875
81,10,9,408,512,-104,-20.3125
81,10,10,576,1024,-448,-43.75
81,10,11,11176,2048,9128,445.703125
81,10,12,230,4096,-3866,-94.384765625
81,10,13,6196,8192,-1996,-24.365234375
81,10,14,8535,16384,-7849,-47.906494140625
81,10,15,16453,32768,-16315,-49.7894287109375
81,11,1,0,2,-2,-100.0
81,11,2,1,4,-3,-75.0
81,11,3,4,8,-4,-50.0
81,11,4,15,16,-1,-6.25
81,11,5,12,32,-20,-62.5
81,11,6,36,64,-28,-43.75
81,11,7,27,128,-101,-78.90625
81,11,8,107,256,-149,-58.203125
81,11,9,47,512,-465,-90.8203125
81,11,10,4060,1024,3036,296.484375
81,11,11,32,2048,-2016,-98.4375
81,11,12,4505,4096,409,9.9853515625
81,11,13,12877,8192,4685,57.18994140625
81,11,14,18166,16384,1782,10.87646484375
81,11,15,61517,32768,28749,87.7349853515625
81,12,1,0,2,-2,-100.0
81,12,2,1,4,-3,-75.0
81,12,3,3,8,-5,-62.5
81,12,4,29,16,13,81.25
81,12,5,57,32,25,78.125
81,12,6,11,64,-53,-82.8125
81,12,7,149,128,21,16.40625
81,12,8,236,256,-20,-7.8125
81,12,9,51,512,-461,-90.0390625
81,12,10,1349,1024,325,31.73828125
81,12,11,483,2048,-1565,-76.416015625
81,12,12,4617,4096,521,12.7197265625
81,12,13,1597,8192,-6595,-80.50537109375
81,12,14,2604,16384,-13780,-84.1064453125
81,12,15,10404,32768,-22364,-68.24951171875
81,13,1,0,2,-2,-100.0
81,13,2,1,4,-3,-75.0
81,13,3,12,8,4,50.0
81,13,4,17,16,1,6.25
81,13,5,10,32,-22,-68.75
81,13,6,34,64,-30,-46.875
81,13,7,64,128,-64,-50.0
81,13,8,1085,256,829,323.828125
81,13,9,327,512,-185,-36.1328125
81,13,10,248,1024,-776,-75.78125
81,13,11,355,2048,-1693,-82.666015625
81,13,12,1470,4096,-2626,-64.111328125
81,13,13,325,8192,-7867,-96.03271484375
81,13,14,2168,16384,-14216,-86.767578125
81,13,15,115045,32768,82277,251.0894775390625
81,14,1,0,2,-2,-100.0
81,14,2,3,4,-1,-25.0
81,14,3,18,8,10,125.0
81,14,4,8,16,-8,-50.0
81,14,5,8,32,-24,-75.0
81,14,6,49,64,-15,-23.4375
81,14,7,174,128,46,35.9375
81,14,8,202,256,-54,-21.09375
81,14,9,481,512,-31,-6.0546875
81,14,10,80,1024,-944,-92.1875
81,14,11,3203,2048,1155,56.396484375
81,14,12,9733,4096,5637,137.6220703125
81,14,13,2590,8192,-5602,-68.3837890625
81,14,14,39532,16384,23148,141.2841796875
81,14,15,29534,32768,-3234,-9.869384765625
81,15,1,0,2,-2,-100.0
81,15,2,5,4,1,25.0
81,15,3,12,8,4,50.0
81,15,4,7,16,-9,-56.25
81,15,5,47,32,15,46.875
81,15,6,35,64,-29,-45.3125
81,15,7,261,128,133,103.90625
81,15,8,591,256,335,130.859375
81,15,9,25,512,-487,-95.1171875
81,15,10,2512,1024,1488,145.3125
81,15,11,3446,2048,1398,68.26171875
81,15,12,1318,4096,-2778,-67.822265625
81,15,13,8243,8192,51,0.62255859375
81,15,14,48491,16384,32107,195.965576171875
81,15,15,2117,32768,-30651,-93.5394287109375
81,16,1,0,2,-2,-100.0
81,16,2,1,4,-3,-75.0
81,16,3,3,8,-5,-62.5
81,16,4,17,16,1,6.25
81,16,5,34,32,2,6.25
81,16,6,11,64,-53,-82.8125
81,16,7,26,128,-102,-79.6875
81,16,8,400,256,144,56.25
81,16,9,179,512,-333,-65.0390625
81,16,10,1481,1024,457,44.62890625
81,16,11,1921,2048,-127,-6.201171875
81,16,12,303,4096,-3793,-92.6025390625
81,16,13,1951,8192,-6241,-76.18408203125
81,16,14,3322,16384,-13062,-79.72412109375
81,16,15,48815,32768,16047,48.9715576171875
81,17,1,0,2,-2,-100.0
81,17,2,2,4,-2,-50.0
81,17,3,7,8,-1,-12.5
81,17,4,5,16,-11,-68.75
81,17,5,30,32,-2,-6.25
81,17,6,37,64,-27,-42.1875
81,17,7,116,128,-12,-9.375
81,17,8,33,256,-223,-87.109375
81,17,9,438,512,-74,-14.453125
81,17,10,2184,1024,1160,113.28125
81,17,11,4091,2048,2043,99.755859375
81,17,12,256,4096,-3840,-93.75
81,17,13,2286,8192,-5906,-72.0947265625
81,17,14,11161,16384,-5223,-31.878662109375
81,17,15,26894,32768,-5874,-17.926025390625
81,18,1,0,2,-2,-100.0
81,18,2,1,4,-3,-75.0
81,18,3,2,8,-6,-75.0
81,18,4,3,16,-13,-81.25
81,18,5,54,32,22,68.75
81,18,6,168,64,104,162.5
81,18,7,13,128,-115,-89.84375
81,18,8,535,256,279,108.984375
81,18,9,620,512,108,21.09375
81,18,10,2026,1024,1002,97.8515625
81,18,11,998,2048,-1050,-51.26953125
81,18,12,1292,4096,-2804,-68.45703125
81,18,13,2248,8192,-5944,-72.55859375
81,18,14,4590,16384,-11794,-71.98486328125
81,18,15,23276,32768,-9492,-28.96728515625
81,19,1,0,2,-2,-100.0
81,19,2,1,4,-3,-75.0
81,19,3,3,8,-5,-62.5
81,19,4,61,16,45,281.25
81,19,5,15,32,-17,-53.125
81,19,6,112,64,48,75.0
81,19,7,9,128,-119,-92.96875
81,19,8,332,256,76,29.6875
81,19,9,82,512,-430,-83.984375
81,19,10,431,1024,-593,-57.91015625
81,19,11,4206,2048,2158,105.37109375
81,19,12,706,4096,-3390,-82.763671875
81,19,13,3381,8192,-4811,-58.72802734375
81,19,14,6996,16384,-9388,-57.2998046875
81,19,15,35318,32768,2550,7.781982421875
81,20,1,0,2,-2,-100.0
81,20,2,8,4,4,100.0
81,20,3,2,8,-6,-75.0
81,20,4,9,16,-7,-43.75
81,20,5,54,32,22,68.75
81,20,6,11,64,-53,-82.8125
81,20,7,318,128,190,148.4375
81,20,8,415,256,159,62.109375
81,20,9,1076,512,564,110.15625
81,20,10,263,1024,-761,-74.31640625
81,20,11,2180,2048,132,6.4453125
81,20,12,4102,4096,6,0.146484375
81,20,13,27546,8192,19354,236.2548828125
81,20,14,8064,16384,-8320,-50.78125
81,20,15,23116,32768,-9652,-29.45556640625
81,21,1,0,2,-2,-100.0
81,21,2,1,4,-3,-75.0
81,21,3,2,8,-6,-75.0
81,21,4,10,16,-6,-37.5
81,21,5,10,32,-22,-68.75
81,21,6,53,64,-11,-17.1875
81,21,7,308,128,180,140.625
81,21,8,380,256,124,48.4375
81,21,9,233,512,-279,-54.4921875
81,21,10,208,1024,-816,-79.6875
81,21,11,2994,2048,946,46.19140625
81,21,12,99,4096,-3997,-97.5830078125
81,21,13,123,8192,-8069,-98.49853515625
81,21,14,3838,16384,-12546,-76.57470703125
81,21,15,50608,32768,17840,54.443359375
81,22,1,0,2,-2,-100.0
81,22,2,1,4,-3,-75.0
81,22,3,7,8,-1,-12.5
81,22,4,6,16,-10,-62.5
81,22,5,31,32,-1,-3.125
81,22,6,14,64,-50,-78.125
81,22,7,228,128,100,78.125
81,22,8,203,256,-53,-20.703125
81,22,9,103,512,-409,-79.8828125
81,22,10,197,1024,-827,-80.76171875
81,22,11,641,2048,-1407,-68.701171875
81,22,12,1475,4096,-2621,-63.9892578125
81,22,13,3101,8192,-5091,-62.14599609375
81,22,14,414,16384,-15970,-97.47314453125
81,22,15,13514,32768,-19254,-58.758544921875
81,23,1,0,2,-2,-100.0
81,23,2,1,4,-3,-75.0
81,23,3,3,8,-5,-62.5
81,23,4,19,16,3,18.75
81,23,5,8,32,-24,-75.0
81,23,6,42,64,-22,-34.375
81,23,7,27,128,-101,-78.90625
81,23,8,50,256,-206,-80.46875
81,23,9,108,512,-404,-78.90625
81,23,10,60,1024,-964,-94.140625
81,23,11,199,2048,-1849,-90.283203125
81,23,12,75,4096,-4021,-98.1689453125
81,23,13,1668,8192,-6524,-79.638671875
81,23,14,10714,16384,-5670,-34.60693359375
81,23,15,100666,32768,67898,207.208251953125
81,24,1,0,2,-2,-100.0
81,24,2,1,4,-3,-75.0
81,24,3,6,8,-2,-25.0
81,24,4,9,16,-7,-43.75
81,24,5,56,32,24,75.0
81,24,6,75,64,11,17.1875
81,24,7,10,128,-118,-92.1875
81,24,8,191,256,-65,-25.390625
81,24,9,654,512,142,27.734375
81,24,10,1468,1024,444,43.359375
81,24,11,213,2048,-1835,-89.599609375
81,24,12,452,4096,-3644,-88.96484375
81,24,13,1296,8192,-6896,-84.1796875
81,24,14,25247,16384,8863,54.095458984375
81,24,15,38602,32768,5834,17.803955078125
81,25,1,0,2,-2,-100.0
81,25,2,1,4,-3,-75.0
81,25,3,2,8,-6,-75.0
81,25,4,21,16,5,31.25
81,25,5,8,32,-24,-75.0
81,25,6,19,64,-45,-70.3125
81,25,7,365,128,237,185.15625
81,25,8,18,256,-238,-92.96875
81,25,9,1386,512,874,170.703125
81,25,10,303,1024,-721,-70.41015625
81,25,11,312,2048,-1736,-84.765625
81,25,12,1448,4096,-2648,-64.6484375
81,25,13,8636,8192,444,5.419921875
81,25,14,7821,16384,-8563,-52.264404296875
81,25,15,20652,32768,-12116,-36.97509765625
81,26,1,0,2,-2,-100.0
81,26,2,1,4,-3,-75.0
81,26,3,9,8,1,12.5
81,26,4,24,16,8,50.0
81,26,5,8,32,-24,-75.0
81,26,6,8,64,-56,-87.5
81,26,7,30,128,-98,-76.5625
81,26,8,188,256,-68,-26.5625
81,26,9,1388,512,876,171.09375
81,26,10,352,1024,-672,-65.625
81,26,11,3638,2048,1590,77.63671875
81,26,12,4922,4096,826,20.166015625
81,26,13,5656,8192,-2536,-30.95703125
81,26,14,20294,16384,3910,23.86474609375
81,26,15,18035,32768,-14733,-44.9615478515625
81,27,1,0,2,-2,-100.0
81,27,2,2,4,-2,-50.0
81,27,3,4,8,-4,-50.0
81,27,4,4,16,-12,-75.0
81,27,5,6,32,-26,-81.25
81,27,6,92,64,28,43.75
81,27,7,306,128,178,139.0625
81,27,8,154,256,-102,-39.84375
81,27,9,941,512,429,83.7890625
81,27,10,22,1024,-1002,-97.8515625
81,27,11,51,2048,-1997,-97.509765625
81,27,12,5469,4096,1373,33.5205078125
81,27,13,244,8192,-7948,-97.021484375
81,27,14,38672,16384,22288,136.03515625
81,27,15,5885,32768,-26883,-82.0404052734375
81,28,1,0,2,-2,-100.0
81,28,2,2,4,-2,-50.0
81,28,3,9,8,1,12.5
81,28,4,11,16,-5,-31.25
81,28,5,62,32,30,93.75
81,28,6,32,64,-32,-50.0
81,28,7,100,128,-28,-21.875
81,28,8,302,256,46,17.96875
81,28,9,1908,512,1396,272.65625
81,28,10,2937,1024,1913,186.81640625
81,28,11,2723,2048,675,32.958984375
81,28,12,2398,4096,-1698,-41.455078125
81,28,13,2857,8192,-5335,-65.12451171875
81,28,14,21960,16384,5576,34.033203125
81,28,15,3260,32768,-29508,-90.05126953125
81,29,1,0,2,-2,-100.0
81,29,2,3,4,-1,-25.0
81,29,3,3,8,-5,-62.5
81,29,4,11,16,-5,-31.25
81,29,5,61,32,29,90.625
81,29,6,55,64,-9,-14.0625
81,29,7,112,128,-16,-12.5
81,29,8,18,256,-238,-92.96875
81,29,9,211,512,-301,-58.7890625
81,29,10,5732,1024,4708,459.765625
81,29,11,4668,2048,2620,127.9296875
81,29,12,6105,4096,2009,49.0478515625
81,29,13,15851,8192,7659,93.49365234375
81,29,14,9512,16384,-6872,-41.943359375
81,29,15,28889,32768,-3879,-11.8377685546875
81,30,1,0,2,-2,-100.0
81,30,2,1,4,-3,-75.0
81,30,3,10,8,2,25.0
81,30,4,3,16,-13,-81.25
81,30,5,25,32,-7,-21.875
81,30,6,103,64,39,60.9375
81,30,7,75,128,-53,-41.40625
81,30,8,103,256,-153,-59.765625
81,30,9,270,512,-242,-47.265625
81,30,10,169,1024,-855,-83.49609375
81,30,11,2773,2048,725,35.400390625
81,30,12,2896,4096,-1200,-29.296875
81,30,13,1826,8192,-6366,-77.7099609375
81,30,14,32414,16384,16030,97.83935546875
81,30,15,1149,32768,-31619,-96.4935302734375
81,31,1,0,2,-2,-100.0
81,31,2,1,4,-3,-75.0
81,31,3,2,8,-6,-75.0
81,31,4,4,16,-12,-75.0
81,31,5,44,32,12,37.5
81,31,6,6,64,-58,-90.625
81,31,7,60,128,-68,-53.125
81,31,8,245,256,-11,-4.296875
81,31,9,254,512,-258,-50.390625
81,31,10,288,1024,-736,-71.875
81,31,11,2466,2048,418,20.41015625
81,31,12,1580,4096,-2516,-61.42578125
81,31,13,10241,8192,2049,25.01220703125
81,31,14,14327,16384,-2057,-12.554931640625
81,31,15,70577,32768,37809,115.3839111328125
81,32,1,0,2,-2,-100.0
81,32,2,2,4,-2,-50.0
81,32,3,7,8,-1,-12.5
81,32,4,29,16,13,81.25
81,32,5,71,32,39,121.875
81,32,6,16,64,-48,-75.0
81,32,7,24,128,-104,-81.25
81,32,8,15,256,-241,-94.140625
81,32,9,264,512,-248,-48.4375
81,32,10,180,1024,-844,-82.421875
81,32,11,898,2048,-1150,-56.15234375
81,32,12,8739,4096,4643,113.3544921875
81,32,13,9225,8192,1033,12.60986328125
81,32,14,2455,16384,-13929,-85.015869140625
81,32,15,61495,32768,28727,87.6678466796875
81,33,1,0,2,-2,-100.0
81,33,2,1,4,-3,-75.0
81,33,3,2,8,-6,-75.0
81,33,4,3,16,-13,-81.25
81,33,5,39,32,7,21.875
81,33,6,5,64,-59,-92.1875
81,33,7,83,128,-45,-35.15625
81,33,8,317,256,61,23.828125
81,33,9,636,512,124,24.21875
81,33,10,933,1024,-91,-8.88671875
81,33,11,2769,2048,721,35.205078125
81,33,12,2253,4096,-1843,-44.9951171875
81,33,13,15150,8192,6958,84.9365234375
81,33,14,12373,16384,-4011,-24.481201171875
81,33,15,198939,32768,166171,507.1136474609375
81,34,1,0,2,-2,-100.0
81,34,2,3,4,-1,-25.0
81,34,3,4,8,-4,-50.0
81,34,4,3,16,-13,-81.25
81,34,5,20,32,-12,-37.5
81,34,6,51,64,-13,-20.3125
81,34,7,80,128,-48,-37.5
81,34,8,153,256,-103,-40.234375
81,34,9,20,512,-492,-96.09375
81,34,10,520,1024,-504,-49.21875
81,34,11,2976,2048,928,45.3125
81,34,12,7780,4096,3684,89.94140625
81,34,13,3875,8192,-4317,-52.69775390625
81,34,14,9547,16384,-6837,-41.729736328125
81,34,15,166119,32768,133351,406.9549560546875
81,35,1,0,2,-2,-100.0
81,35,2,1,4,-3,-75.0
81,35,3,15,8,7,87.5
81,35,4,24,16,8,50.0
81,35,5,21,32,-11,-34.375
81,35,6,7,64,-57,-89.0625
81,35,7,19,128,-109,-85.15625
81,35,8,386,256,130,50.78125
81,35,9,140,512,-372,-72.65625
81,35,10,1045,1024,21,2.05078125
81,35,11,1329,2048,-719,-35.107421875
81,35,12,9117,4096,5021,122.5830078125
81,35,13,19637,8192,11445,139.70947265625
81,35,14,1936,16384,-14448,-88.18359375
81,35,15,36433,32768,3665,11.1846923828125
81,36,1,0,2,-2,-100.0
81,36,2,1,4,-3,-75.0
81,36,3,7,8,-1,-12.5
81,36,4,42,16,26,162.5
81,36,5,4,32,-28,-87.5
81,36,6,12,64,-52,-81.25
81,36,7,84,128,-44,-34.375
81,36,8,857,256,601,234.765625
81,36,9,1203,512,691,134.9609375
81,36,10,569,1024,-455,-44.43359375
81,36,11,1471,2048,-577,-28.173828125
81,36,12,2008,4096,-2088,-50.9765625
81,36,13,4730,8192,-3462,-42.2607421875
81,36,14,4195,16384,-12189,-74.395751953125
81,36,15,1039,32768,-31729,-96.8292236328125
81,37,1,0,2,-2,-100.0
81,37,2,5,4,1,25.0
81,37,3,10,8,2,25.0
81,37,4,3,16,-13,-81.25
81,37,5,15,32,-17,-53.125
81,37,6,72,64,8,12.5
81,37,7,143,128,15,11.71875
81,37,8,305,256,49,19.140625
81,37,9,443,512,-69,-13.4765625
81,37,10,134,1024,-890,-86.9140625
81,37,11,13,2048,-2035,-99.365234375
81,37,12,188,4096,-3908,-95.41015625
81,37,13,1743,8192,-6449,-78.72314453125
81,37,14,5905,16384,-10479,-63.958740234375
81,37,15,96913,32768,64145,195.7550048828125
81,38,1,0,2,-2,-100.0
81,38,2,1,4,-3,-75.0
81,38,3,20,8,12,150.0
81,38,4,14,16,-2,-12.5
81,38,5,15,32,-17,-53.125
81,38,6,44,64,-20,-31.25
81,38,7,104,128,-24,-18.75
81,38,8,303,256,47,18.359375
81,38,9,170,512,-342,-66.796875
81,38,10,390,1024,-634,-61.9140625
81,38,11,4220,2048,2172,106.0546875
81,38,12,4712,4096,616,15.0390625
81,38,13,1598,8192,-6594,-80.4931640625
81,38,14,23598,16384,7214,44.03076171875
81,38,15,117929,32768,85161,259.8907470703125
81,39,1,0,2,-2,-100.0
81,39,2,2,4,-2,-50.0
81,39,3,8,8,0,0.0
81,39,4,6,16,-10,-62.5
81,39,5,19,32,-13,-40.625
81,39,6,154,64,90,140.625
81,39,7,35,128,-93,-72.65625
81,39,8,55,256,-201,-78.515625
81,39,9,379,512,-133,-25.9765625
81,39,10,299,1024,-725,-70.80078125
81,39,11,3642,2048,1594,77.83203125
81,39,12,3442,4096,-654,-15.966796875
81,39,13,3274,8192,-4918,-60.0341796875
81,39,14,13023,16384,-3361,-20.513916015625
81,39,15,14519,32768,-18249,-55.6915283203125
81,40,1,0,2,-2,-100.0
81,40,2,2,4,-2,-50.0
81,40,3,5,8,-3,-37.5
81,40,4,17,16,1,6.25
81,40,5,20,32,-12,-37.5
81,40,6,140,64,76,118.75
81,40,7,120,128,-8,-6.25
81,40,8,16,256,-240,-93.75
81,40,9,509,512,-3,-0.5859375
81,40,10,801,1024,-223,-21.77734375
81,40,11,1749,2048,-299,-14.599609375
81,40,12,5883,4096,1787,43.6279296875
81,40,13,2638,8192,-5554,-67.7978515625
81,40,14,9665,16384,-6719,-41.009521484375
81,40,15,5302,32768,-27466,-83.819580078125
81,41,1,0,2,-2,-100.0
81,41,2,4,4,0,0.0
81,41,3,4,8,-4,-50.0
81,41,4,11,16,-5,-31.25
81,41,5,31,32,-1,-3.125
81,41,6,52,64,-12,-18.75
81,41,7,197,128,69,53.90625
81,41,8,192,256,-64,-25.0
81,41,9,174,512,-338,-66.015625
81,41,10,1529,1024,505,49.31640625
81,41,11,1186,2048,-862,-42.08984375
81,41,12,3307,4096,-789,-19.2626953125
81,41,13,11841,8192,3649,44.54345703125
81,41,14,6673,16384,-9711,-59.271240234375
81,41,15,16417,32768,-16351,-49.8992919921875
81,42,1,0,2,-2,-100.0
81,42,2,3,4,-1,-25.0
81,42,3,3,8,-5,-62.5
81,42,4,38,16,22,137.5
81,42,5,15,32,-17,-53.125
81,42,6,5,64,-59,-92.1875
81,42,7,305,128,177,138.28125
81,42,8,336,256,80,31.25
81,42,9,1341,512,829,161.9140625
81,42,10,365,1024,-659,-64.35546875
81,42,11,6224,2048,4176,203.90625
81,42,12,251,4096,-3845,-93.8720703125
81,42,13,948,8192,-7244,-88.427734375
81,42,14,4956,16384,-11428,-69.7509765625
81,42,15,75253,32768,42485,129.6539306640625
81,43,1,0,2,-2,-100.0
81,43,2,3,4,-1,-25.0
81,43,3,5,8,-3,-37.5
81,43,4,11,16,-5,-31.25
81,43,5,22,32,-10,-31.25
81,43,6,32,64,-32,-50.0
81,43,7,146,128,18,14.0625
81,43,8,70,256,-186,-72.65625
81,43,9,82,512,-430,-83.984375
81,43,10,1643,1024,619,60.44921875
81,43,11,2789,2048,741,36.181640625
81,43,12,2869,4096,-1227,-29.9560546875
81,43,13,3958,8192,-4234,-51.6845703125
81,43,14,3646,16384,-12738,-77.74658203125
81,43,15,40201,32768,7433,22.6837158203125
81,44,1,0,2,-2,-100.0
81,44,2,1,4,-3,-75.0
81,44,3,2,8,-6,-75.0
81,44,4,29,16,13,81.25
81,44,5,33,32,1,3.125
81,44,6,28,64,-36,-56.25
81,44,7,250,128,122,95.3125
81,44,8,494,256,238,92.96875
81,44,9,559,512,47,9.1796875
81,44,10,175,1024,-849,-82.91015625
81,44,11,5822,2048,3774,184.27734375
81,44,12,1064,4096,-3032,-74.0234375
81,44,13,2979,8192,-5213,-63.63525390625
81,44,14,5442,16384,-10942,-66.78466796875
81,44,15,48919,32768,16151,49.2889404296875
81,45,1,0,2,-2,-100.0
81,45,2,2,4,-2,-50.0
81,45,3,3,8,-5,-62.5
81,45,4,30,16,14,87.5
81,45,5,28,32,-4,-12.5
81,45,6,26,64,-38,-59.375
81,45,7,64,128,-64,-50.0
81,45,8,476,256,220,85.9375
81,45,9,204,512,-308,-60.15625
81,45,10,3176,1024,2152,210.15625
81,45,11,2640,2048,592,28.90625
81,45,12,1576,4096,-2520,-61.5234375
81,45,13,11240,8192,3048,37.20703125
81,45,14,27090,16384,10706,65.34423828125
81,45,15,688,32768,-32080,-97.900390625
81,46,1,0,2,-2,-100.0
81,46,2,2,4,-2,-50.0
81,46,3,4,8,-4,-50.0
81,46,4,49,16,33,206.25
81,46,5,105,32,73,228.125
81,46,6,27,64,-37,-57.8125
81,46,7,30,128,-98,-76.5625
81,46,8,348,256,92,35.9375
81,46,9,681,512,169,33.0078125
81,46,10,873,1024,-151,-14.74609375
81,46,11,1170,2048,-878,-42.87109375
81,46,12,2600,4096,-1496,-36.5234375
81,46,13,1440,8192,-6752,-82.421875
81,46,14,6382,16384,-10002,-61.04736328125
81,46,15,3164,32768,-29604,-90.34423828125
81,47,1,0,2,-2,-100.0
81,47,2,2,4,-2,-50.0
81,47,3,2,8,-6,-75.0
81,47,4,3,16,-13,-81.25
81,47,5,57,32,25,78.125
81,47,6,26,64,-38,-59.375
81,47,7,6,128,-122,-95.3125
81,47,8,388,256,132,51.5625
81,47,9,257,512,-255,-49.8046875
81,47,10,2290,1024,1266,123.6328125
81,47,11,1488,2048,-560,-27.34375
81,47,12,8327,4096,4231,103.2958984375
81,47,13,2990,8192,-5202,-63.5009765625
81,47,14,11904,16384,-4480,-27.34375
81,47,15,5691,32768,-27077,-82.6324462890625
81,48,1,0,2,-2,-100.0
81,48,2,1,4,-3,-75.0
81,48,3,9,8,1,12.5
81,48,4,7,16,-9,-56.25
81,48,5,125,32,93,290.625
81,48,6,19,64,-45,-70.3125
81,48,7,112,128,-16,-12.5
81,48,8,42,256,-214,-83.59375
81,48,9,412,512,-100,-19.53125
81,48,10,665,1024,-359,-35.05859375
81,48,11,5596,2048,3548,173.2421875
81,48,12,5437,4096,1341,32.7392578125
81,48,13,14948,8192,6756,82.470703125
81,48,14,6838,16384,-9546,-58.26416015625
81,48,15,11360,32768,-21408,-65.33203125
81,49,1,0,2,-2,-100.0
81,49,2,1,4,-3,-75.0
81,49,3,11,8,3,37.5
81,49,4,4,16,-12,-75.0
81,49,5,11,32,-21,-65.625
81,49,6,8,64,-56,-87.5
81,49,7,16,128,-112,-87.5
81,49,8,126,256,-130,-50.78125
81,49,9,494,512,-18,-3.515625
81,49,10,223,1024,-801,-78.22265625
81,49,11,764,2048,-1284,-62.6953125
81,49,12,754,4096,-3342,-81.591796875
81,49,13,13676,8192,5484,66.943359375
81,49,14,29062,16384,12678,77.38037109375
81,49,15,34686,32768,1918,5.853271484375
81,50,1,0,2,-2,-100.0
81,50,2,1,4,-3,-75.0
81,50,3,4,8,-4,-50.0
81,50,4,3,16,-13,-81.25
81,50,5,27,32,-5,-15.625
81,50,6,12,64,-52,-81.25
81,50,7,220,128,92,71.875
81,50,8,69,256,-187,-73.046875
81,50,9,492,512,-20,-3.90625
81,50,10,760,1024,-264,-25.78125
81,50,11,1068,2048,-980,-47.8515625
81,50,12,6236,4096,2140,52.24609375
81,50,13,1279,8192,-6913,-84.38720703125
81,50,14,9799,16384,-6585,-40.191650390625
81,50,15,40109,32768,7341,22.4029541015625
81,51,1,0,2,-2,-100.0
81,51,2,1,4,-3,-75.0
81,51,3,4,8,-4,-50.0
81,51,4,14,16,-2,-12.5
81,51,5,4,32,-28,-87.5
81,51,6,252,64,188,293.75
81,51,7,42,128,-86,-67.1875
81,51,8,8,256,-248,-96.875
81,51,9,430,512,-82,-16.015625
81,51,10,1448,1024,424,41.40625
81,51,11,1409,2048,-639,-31.201171875
81,51,12,6950,4096,2854,69.677734375
81,51,13,7484,8192,-708,-8.642578125
81,51,14,29847,16384,13463,82.171630859375
81,51,15,3230,32768,-29538,-90.142822265625
81,52,1,0,2,-2,-100.0
81,52,2,5,4,1,25.0
81,52,3,8,8,0,0.0
81,52,4,20,16,4,25.0
81,52,5,62,32,30,93.75
81,52,6,14,64,-50,-78.125
81,52,7,152,128,24,18.75
81,52,8,103,256,-153,-59.765625
81,52,9,1225,512,713,139.2578125
81,52,10,899,1024,-125,-12.20703125
81,52,11,2722,2048,674,32.91015625
81,52,12,1804,4096,-2292,-55.95703125
81,52,13,14699,8192,6507,79.43115234375
81,52,14,1874,16384,-14510,-88.56201171875
81,52,15,128366,32768,95598,291.741943359375
81,53,1,0,2,-2,-100.0
81,53,2,1,4,-3,-75.0
81,53,3,4,8,-4,-50.0
81,53,4,16,16,0,0.0
81,53,5,26,32,-6,-18.75
81,53,6,8,64,-56,-87.5
81,53,7,606,128,478,373.4375
81,53,8,511,256,255,99.609375
81,53,9,989,512,477,93.1640625
81,53,10,153,1024,-871,-85.05859375
81,53,11,2685,2048,637,31.103515625
81,53,12,2208,4096,-1888,-46.09375
81,53,13,3346,8192,-4846,-59.1552734375
81,53,14,2500,16384,-13884,-84.7412109375
81,53,15,117444,32768,84676,258.41064453125
81,54,1,0,2,-2,-100.0
81,54,2,3,4,-1,-25.0
81,54,3,9,8,1,12.5
81,54,4,9,16,-7,-43.75
81,54,5,31,32,-1,-3.125
81,54,6,40,64,-24,-37.5
81,54,7,27,128,-101,-78.90625
81,54,8,77,256,-179,-69.921875
81,54,9,273,512,-239,-46.6796875
81,54,10,632,1024,-392,-38.28125
81,54,11,2543,2048,495,24.169921875
81,54,12,5909,4096,1813,44.2626953125
81,54,13,5684,8192,-2508,-30.615234375
81,54,14,3237,16384,-13147,-80.242919921875
81,54,15,27434,32768,-5334,-16.278076171875
81,55,1,0,2,-2,-100.0
81,55,2,2,4,-2,-50.0
81,55,3,5,8,-3,-37.5
81,55,4,9,16,-7,-43.75
81,55,5,96,32,64,200.0
81,55,6,29,64,-35,-54.6875
81,55,7,77,128,-51,-39.84375
81,55,8,207,256,-49,-19.140625
81,55,9,260,512,-252,-49.21875
81,55,10,300,1024,-724,-70.703125
81,55,11,186,2048,-1862,-90.91796875
81,55,12,968,4096,-3128,-76.3671875
81,55,13,2894,8192,-5298,-64.6728515625
81,55,14,16013,16384,-371,-2.264404296875
81,55,15,26329,32768,-6439,-19.6502685546875
81,56,1,0,2,-2,-100.0
81,56,2,2,4,-2,-50.0
81,56,3,12,8,4,50.0
81,56,4,15,16,-1,-6.25
81,56,5,30,32,-2,-6.25
81,56,6,22,64,-42,-65.625
81,56,7,143,128,15,11.71875
81,56,8,266,256,10,3.90625
81,56,9,128,512,-384,-75.0
81,56,10,209,1024,-815,-79.58984375
81,56,11,1127,2048,-921,-44.970703125
81,56,12,1908,4096,-2188,-53.41796875
81,56,13,1005,8192,-7187,-87.73193359375
81,56,14,1544,16384,-14840,-90.576171875
81,56,15,50128,32768,17360,52.978515625
81,57,1,0,2,-2,-100.0
81,57,2,1,4,-3,-75.0
81,57,3,11,8,3,37.5
81,57,4,22,16,6,37.5
81,57,5,7,32,-25,-78.125
81,57,6,60,64,-4,-6.25
81,57,7,29,128,-99,-77.34375
81,57,8,445,256,189,73.828125
81,57,9,990,512,478,93.359375
81,57,10,699,1024,-325,-31.73828125
81,57,11,197,2048,-1851,-90.380859375
81,57,12,2062,4096,-2034,-49.658203125
81,57,13,3344,8192,-4848,-59.1796875
81,57,14,31049,16384,14665,89.508056640625
81,57,15,73345,32768,40577,123.8311767578125
81,58,1,0,2,-2,-100.0
81,58,2,2,4,-2,-50.0
81,58,3,2,8,-6,-75.0
81,58,4,19,16,3,18.75
81,58,5,19,32,-13,-40.625
81,58,6,122,64,58,90.625
81,58,7,11,128,-117,-91.40625
81,58,8,272,256,16,6.25
81,58,9,80,512,-432,-84.375
81,58,10,1028,1024,4,0.390625
81,58,11,836,2048,-1212,-59.1796875
81,58,12,1542,4096,-2554,-62.353515625
81,58,13,2904,8192,-5288,-64.55078125
81,58,14,22603,16384,6219,37.957763671875
81,58,15,95521,32768,62753,191.5069580078125
81,59,1,0,2,-2,-100.0
81,59,2,1,4,-3,-75.0
81,59,3,4,8,-4,-50.0
81,59,4,12,16,-4,-25.0
81,59,5,4,32,-28,-87.5
81,59,6,44,64,-20,-31.25
81,59,7,205,128,77,60.15625
81,59,8,32,256,-224,-87.5
81,59,9,756,512,244,47.65625
81,59,10,677,1024,-347,-33.88671875
81,59,11,9954,2048,7906,386.03515625
81,59,12,928,4096,-3168,-77.34375
81,59,13,17252,8192,9060,110.595703125
81,59,14,723,16384,-15661,-95.587158203125
81,59,15,21393,32768,-11375,-34.7137451171875
81,60,1,0,2,-2,-100.0
81,60,2,1,4,-3,-75.0
81,60,3,2,8,-6,-75.0
81,60,4,18,16,2,12.5
81,60,5,69,32,37,115.625
81,60,6,21,64,-43,-67.1875
81,60,7,45,128,-83,-64.84375
81,60,8,97,256,-159,-62.109375
81,60,9,934,512,422,82.421875
81,60,10,1992,1024,968,94.53125
81,60,11,910,2048,-1138,-55.56640625
81,60,12,420,4096,-3676,-89.74609375
81,60,13,10182,8192,1990,24.2919921875
81,60,14,23539,16384,7155,43.670654296875
81,60,15,40951,32768,8183,24.9725341796875
81,61,1,0,2,-2,-100.0
81,61,2,2,4,-2,-50.0
81,61,3,2,8,-6,-75.0
81,61,4,8,16,-8,-50.0
81,61,5,7,32,-25,-78.125
81,61,6,15,64,-49,-76.5625
81,61,7,235,128,107,83.59375
81,61,8,25,256,-231,-90.234375
81,61,9,8,512,-504,-98.4375
81,61,10,1575,1024,551,53.80859375
81,61,11,2593,2048,545,26.611328125
81,61,12,6562,4096,2466,60.205078125
81,61,13,7095,8192,-1097,-13.39111328125
81,61,14,6151,16384,-10233,-62.457275390625
81,61,15,42719,32768,9951,30.3680419921875
81,62,1,0,2,-2,-100.0
81,62,2,2,4,-2,-50.0
81,62,3,5,8,-3,-37.5
81,62,4,4,16,-12,-75.0
81,62,5,69,32,37,115.625
81,62,6,98,64,34,53.125
81,62,7,575,128,447,349.21875
81,62,8,40,256,-216,-84.375
81,62,9,418,512,-94,-18.359375
81,62,10,81,1024,-943,-92.08984375
81,62,11,1631,2048,-417,-20.361328125
81,62,12,2500,4096,-1596,-38.96484375
81,62,13,1217,8192,-6975,-85.14404296875
81,62,14,11326,16384,-5058,-30.87158203125
81,62,15,12569,32768,-20199,-61.6424560546875
81,63,1,0,2,-2,-100.0
81,63,2,1,4,-3,-75.0
81,63,3,4,8,-4,-50.0
81,63,4,10,16,-6,-37.5
81,63,5,32,32,0,0.0
81,63,6,60,64,-4,-6.25
81,63,7,94,128,-34,-26.5625
81,63,8,58,256,-198,-77.34375
81,63,9,549,512,37,7.2265625
81,63,10,2223,1024,1199,117.08984375
81,63,11,5730,2048,3682,179.78515625
81,63,12,2332,4096,-1764,-43.06640625
81,63,13,34459,8192,26267,320.64208984375
81,63,14,7786,16384,-8598,-52.47802734375
81,63,15,62937,32768,30169,92.0684814453125
81,64,1,0,2,-2,-100.0
81,64,2,1,4,-3,-75.0
81,64,3,9,8,1,12.5
81,64,4,6,16,-10,-62.5
81,64,5,8,32,-24,-75.0
81,64,6,58,64,-6,-9.375
81,64,7,645,128,517,403.90625
81,64,8,324,256,68,26.5625
81,64,9,679,512,167,32.6171875
81,64,10,968,1024,-56,-5.46875
81,64,11,1983,2048,-65,-3.173828125
81,64,12,2170,4096,-1926,-47.021484375
81,64,13,17073,8192,8881,108.41064453125
81,64,14,63536,16384,47152,287.79296875
81,64,15,1643,32768,-31125,-94.9859619140625
81,65,1,0,2,-2,-100.0
81,65,2,4,4,0,0.0
81,65,3,6,8,-2,-25.0
81,65,4,27,16,11,68.75
81,65,5,17,32,-15,-46.875
81,65,6,124,64,60,93.75
81,65,7,79,128,-49,-38.28125
81,65,8,326,256,70,27.34375
81,65,9,1836,512,1324,258.59375
81,65,10,1709,1024,685,66.89453125
81,65,11,4743,2048,2695,131.591796875
81,65,12,2570,4096,-1526,-37.255859375
81,65,13,2000,8192,-6192,-75.5859375
81,65,14,7588,16384,-8796,-53.6865234375
81,65,15,17233,32768,-15535,-47.4090576171875
81,66,1,0,2,-2,-100.0
81,66,2,1,4,-3,-75.0
81,66,3,2,8,-6,-75.0
81,66,4,12,16,-4,-25.0
81,66,5,20,32,-12,-37.5
81,66,6,45,64,-19,-29.6875
81,66,7,160,128,32,25.0
81,66,8,292,256,36,14.0625
81,66,9,144,512,-368,-71.875
81,66,10,862,1024,-162,-15.8203125
81,66,11,666,2048,-1382,-67.48046875
81,66,12,9462,4096,5366,131.005859375
81,66,13,12882,8192,4690,57.2509765625
81,66,14,29461,16384,13077,79.815673828125
81,66,15,81790,32768,49022,149.603271484375
81,67,1,0,2,-2,-100.0
81,67,2,1,4,-3,-75.0
81,67,3,2,8,-6,-75.0
81,67,4,32,16,16,100.0
81,67,5,38,32,6,18.75
81,67,6,140,64,76,118.75
81,67,7,850,128,722,564.0625
81,67,8,86,256,-170,-66.40625
81,67,9,384,512,-128,-25.0
81,67,10,1852,1024,828,80.859375
81,67,11,3980,2048,1932,94.3359375
81,67,12,996,4096,-3100,-75.68359375
81,67,13,611,8192,-7581,-92.54150390625
81,67,14,8731,16384,-7653,-46.710205078125
81,67,15,56317,32768,23549,71.8658447265625
81,68,1,0,2,-2,-100.0
81,68,2,4,4,0,0.0
81,68,3,2,8,-6,-75.0
81,68,4,18,16,2,12.5
81,68,5,37,32,5,15.625
81,68,6,14,64,-50,-78.125
81,68,7,97,128,-31,-24.21875
81,68,8,139,256,-117,-45.703125
81,68,9,66,512,-446,-87.109375
81,68,10,75,1024,-949,-92.67578125
81,68,11,1687,2048,-361,-17.626953125
81,68,12,4856,4096,760,18.5546875
81,68,13,15089,8192,6897,84.19189453125
81,68,14,6005,16384,-10379,-63.348388671875
81,68,15,232513,32768,199745,609.5733642578125
81,69,1,0,2,-2,-100.0
81,69,2,1,4,-3,-75.0
81,69,3,2,8,-6,-75.0
81,69,4,6,16,-10,-62.5
81,69,5,67,32,35,109.375
81,69,6,41,64,-23,-35.9375
81,69,7,188,128,60,46.875
81,69,8,180,256,-76,-29.6875
81,69,9,359,512,-153,-29.8828125
81,69,10,2680,1024,1656,161.71875
81,69,11,1177,2048,-871,-42.529296875
81,69,12,144,4096,-3952,-96.484375
81,69,13,329,8192,-7863,-95.98388671875
81,69,14,14808,16384,-1576,-9.619140625
81,69,15,48431,32768,15663,47.7996826171875
81,70,1,0,2,-2,-100.0
81,70,2,1,4,-3,-75.0
81,70,3,12,8,4,50.0
81,70,4,34,16,18,112.5
81,70,5,33,32,1,3.125
81,70,6,13,64,-51,-79.6875
81,70,7,80,128,-48,-37.5
81,70,8,1175,256,919,358.984375
81,70,9,1675,512,1163,227.1484375
81,70,10,301,1024,-723,-70.60546875
81,70,11,1033,2048,-1015,-49.560546875
81,70,12,3920,4096,-176,-4.296875
81,70,13,185,8192,-8007,-97.74169921875
81,70,14,2930,16384,-13454,-82.11669921875
81,70,15,10359,32768,-22409,-68.3868408203125
81,71,1,0,2,-2,-100.0
81,71,2,1,4,-3,-75.0
81,71,3,9,8,1,12.5
81,71,4,30,16,14,87.5
81,71,5,34,32,2,6.25
81,71,6,13,64,-51,-79.6875
81,71,7,404,128,276,215.625
81,71,8,34,256,-222,-86.71875
81,71,9,55,512,-457,-89.2578125
81,71,10,624,1024,-400,-39.0625
81,71,11,1432,2048,-616,-30.078125
81,71,12,662,4096,-3434,-83.837890625
81,71,13,36917,8192,28725,350.64697265625
81,71,14,1362,16384,-15022,-91.68701171875
81,71,15,19184,32768,-13584,-41.455078125
81,72,1,0,2,-2,-100.0
81,72,2,2,4,-2,-50.0
81,72,3,7,8,-1,-12.5
81,72,4,13,16,-3,-18.75
81,72,5,19,32,-13,-40.625
81,72,6,58,64,-6,-9.375
81,72,7,57,128,-71,-55.46875
81,72,8,445,256,189,73.828125
81,72,9,2553,512,2041,398.6328125
81,72,10,340,1024,-684,-66.796875
81,72,11,2464,2048,416,20.3125
81,72,12,1429,4096,-2667,-65.1123046875
81,72,13,3517,8192,-4675,-57.06787109375
81,72,14,40050,16384,23666,144.44580078125
81,72,15,12798,32768,-19970,-60.943603515625
81,73,1,0,2,-2,-100.0
81,73,2,2,4,-2,-50.0
81,73,3,9,8,1,12.5
81,73,4,33,16,17,106.25
81,73,5,88,32,56,175.0
81,73,6,120,64,56,87.5
81,73,7,270,128,142,110.9375
81,73,8,163,256,-93,-36.328125
81,73,9,525,512,13,2.5390625
81,73,10,598,1024,-426,-41.6015625
81,73,11,237,2048,-1811,-88.427734375
81,73,12,10215,4096,6119,149.3896484375
81,73,13,12846,8192,4654,56.8115234375
81,73,14,33160,16384,16776,102.392578125
81,73,15,73833,32768,41065,125.3204345703125
81,74,1,0,2,-2,-100.0
81,74,2,1,4,-3,-75.0
81,74,3,4,8,-4,-50.0
81,74,4,6,16,-10,-62.5
81,74,5,6,32,-26,-81.25
81,74,6,34,64,-30,-46.875
81,74,7,275,128,147,114.84375
81,74,8,97,256,-159,-62.109375
81,74,9,69,512,-443,-86.5234375
81,74,10,243,1024,-781,-76.26953125
81,74,11,4409,2048,2361,115.283203125
81,74,12,1597,4096,-2499,-61.0107421875
81,74,13,14378,8192,6186,75.5126953125
81,74,14,9796,16384,-6588,-40.2099609375
81,74,15,145,32768,-32623,-99.5574951171875
81,75,1,0,2,-2,-100.0
81,75,2,1,4,-3,-75.0
81,75,3,5,8,-3,-37.5
81,75,4,3,16,-13,-81.25
81,75,5,23,32,-9,-28.125
81,75,6,73,64,9,14.0625
81,75,7,231,128,103,80.46875
81,75,8,289,256,33,12.890625
81,75,9,1366,512,854,166.796875
81,75,10,669,1024,-355,-34.66796875
81,75,11,1286,2048,-762,-37.20703125
81,75,12,3029,4096,-1067,-26.0498046875
81,75,13,2472,8192,-5720,-69.82421875
81,75,14,14255,16384,-2129,-12.994384765625
81,75,15,55297,32768,22529,68.7530517578125
81,76,1,0,2,-2,-100.0
81,76,2,1,4,-3,-75.0
81,76,3,6,8,-2,-25.0
81,76,4,8,16,-8,-50.0
81,76,5,8,32,-24,-75.0
81,76,6,35,64,-29,-45.3125
81,76,7,101,128,-27,-21.09375
81,76,8,115,256,-141,-55.078125
81,76,9,130,512,-382,-74.609375
81,76,10,3931,1024,2907,283.88671875
81,76,11,1009,2048,-1039,-50.732421875
81,76,12,4097,4096,1,0.0244140625
81,76,13,108,8192,-8084,-98.681640625
81,76,14,7659,16384,-8725,-53.253173828125
81,76,15,30309,32768,-2459,-7.5042724609375
81,77,1,0,2,-2,-100.0
81,77,2,1,4,-3,-75.0
81,77,3,2,8,-6,-75.0
81,77,4,19,16,3,18.75
81,77,5,11,32,-21,-65.625
81,77,6,22,64,-42,-65.625
81,77,7,22,128,-106,-82.8125
81,77,8,31,256,-225,-87.890625
81,77,9,334,512,-178,-34.765625
81,77,10,1254,1024,230,22.4609375
81,77,11,995,2048,-1053,-51.416015625
81,77,12,3775,4096,-321,-7.8369140625
81,77,13,3056,8192,-5136,-62.6953125
81,77,14,16162,16384,-222,-1.35498046875
81,77,15,32824,32768,56,0.1708984375
81,78,1,0,2,-2,-100.0
81,78,2,3,4,-1,-25.0
81,78,3,6,8,-2,-25.0
81,78,4,22,16,6,37.5
81,78,5,32,32,0,0.0
81,78,6,130,64,66,103.125
81,78,7,53,128,-75,-58.59375
81,78,8,540,256,284,110.9375
81,78,9,542,512,30,5.859375
81,78,10,293,1024,-731,-71.38671875
81,78,11,5636,2048,3588,175.1953125
81,78,12,4750,4096,654,15.966796875
81,78,13,8172,8192,-20,-0.244140625
81,78,14,2684,16384,-13700,-83.6181640625
81,78,15,35717,32768,2949,8.9996337890625
81,79,1,0,2,-2,-100.0
81,79,2,1,4,-3,-75.0
81,79,3,3,8,-5,-62.5
81,79,4,8,16,-8,-50.0
81,79,5,10,32,-22,-68.75
81,79,6,11,64,-53,-82.8125
81,79,7,321,128,193,150.78125
81,79,8,208,256,-48,-18.75
81,79,9,845,512,333,65.0390625
81,79,10,3178,1024,2154,210.3515625
81,79,11,4473,2048,2425,118.408203125
81,79,12,6649,4096,2553,62.3291015625
81,79,13,368,8192,-7824,-95.5078125
81,79,14,19603,16384,3219,19.647216796875
81,79,15,14259,32768,-18509,-56.4849853515625
81,80,1,0,2,-2,-100.0
81,80,2,1,4,-3,-75.0
81,80,3,6,8,-2,-25.0
81,80,4,4,16,-12,-75.0
81,80,5,26,32,-6,-18.75
81,80,6,217,64,153,239.0625
81,80,7,194,128,66,51.5625
81,80,8,70,256,-186,-72.65625
81,80,9,410,512,-102,-19.921875
81,80,10,1276,1024,252,24.609375
81,80,11,3028,2048,980,47.8515625
81,80,12,4975,4096,879,21.4599609375
81,80,13,11785,8192,3593,43.85986328125
81,80,14,11737,16384,-4647,-28.363037109375
81,80,15,22861,32768,-9907,-30.2337646484375
81,81,1,0,2,-2,-100.0
81,81,2,2,4,-2,-50.0
81,81,3,2,8,-6,-75.0
81,81,4,25,16,9,56.25
81,81,5,13,32,-19,-59.375
81,81,6,41,64,-23,-35.9375
81,81,7,580,128,452,353.125
81,81,8,542,256,286,111.71875
81,81,9,1284,512,772,150.78125
81,81,10,1607,1024,583,56.93359375
81,81,11,386,2048,-1662,-81.15234375
81,81,12,4956,4096,860,20.99609375
81,81,13,4597,8192,-3595,-43.88427734375
81,81,14,744,16384,-15640,-95.458984375
81,81,15,36608,32768,3840,11.71875
82,1,1,0,2,-2,-100.0
82,1,2,3,4,-1,-25.0
82,1,3,3,8,-5,-62.5
82,1,4,13,16,-3,-18.75
82,1,5,64,32,32,100.0
82,1,6,56,64,-8,-12.5
82,1,7,6,128,-122,-95.3125
82,1,8,134,256,-122,-47.65625
82,1,9,63,512,-449,-87.6953125
82,1,10,11,1024,-1013,-98.92578125
82,1,11,463,2048,-1585,-77.392578125
82,1,12,3488,4096,-608,-14.84375
82,1,13,7882,8192,-310,-3.7841796875
82,1,14,5148,16384,-11236,-68.5791015625
82,1,15,13128,32768,-19640,-59.9365234375
82,2,1,0,2,-2,-100.0
82,2,2,2,4,-2,-50.0
82,2,3,2,8,-6,-75.0
82,2,4,19,16,3,18.75
82,2,5,16,32,-16,-50.0
82,2,6,164,64,100,156.25
82,2,7,105,128,-23,-17.96875
82,2,8,151,256,-105,-41.015625
82,2,9,862,512,350,68.359375
82,2,10,550,1024,-474,-46.2890625
82,2,11,605,2048,-1443,-70.458984375
82,2,12,2053,4096,-2043,-49.8779296875
82,2,13,5031,8192,-3161,-38.58642578125
82,2,14,12439,16384,-3945,-24.078369140625
82,2,15,50037,32768,17269,52.7008056640625
82,3,1,0,2,-2,-100.0
82,3,2,1,4,-3,-75.0
82,3,3,4,8,-4,-50.0
82,3,4,33,16,17,106.25
82,3,5,10,32,-22,-68.75
82,3,6,5,64,-59,-92.1875
82,3,7,65,128,-63,-49.21875
82,3,8,657,256,401,156.640625
82,3,9,1308,512,796,155.46875
82,3,10,759,1024,-265,-25.87890625
82,3,11,80,2048,-1968,-96.09375
82,3,12,408,4096,-3688,-90.0390625
82,3,13,5926,8192,-2266,-27.6611328125
82,3,14,14441,16384,-1943,-11.859130859375
82,3,15,26421,32768,-6347,-19.3695068359375
82,4,1,0,2,-2,-100.0
82,4,2,2,4,-2,-50.0
82,4,3,2,8,-6,-75.0
82,4,4,53,16,37,231.25
82,4,5,40,32,8,25.0
82,4,6,10,64,-54,-84.375
82,4,7,79,128,-49,-38.28125
82,4,8,387,256,131,51.171875
82,4,9,154,512,-358,-69.921875
82,4,10,369,1024,-655,-63.96484375
82,4,11,885,2048,-1163,-56.787109375
82,4,12,4409,4096,313,7.6416015625
82,4,13,1522,8192,-6670,-81.4208984375
82,4,14,11593,16384,-4791,-29.241943359375
82,4,15,16614,32768,-16154,-49.298095703125
82,5,1,0,2,-2,-100.0
82,5,2,1,4,-3,-75.0
82,5,3,2,8,-6,-75.0
82,5,4,5,16,-11,-68.75
82,5,5,48,32,16,50.0
82,5,6,9,64,-55,-85.9375
82,5,7,6,128,-122,-95.3125
82,5,8,63,256,-193,-75.390625
82,5,9,242,512,-270,-52.734375
82,5,10,851,1024,-173,-16.89453125
82,5,11,7222,2048,5174,252.63671875
82,5,12,3270,4096,-826,-20.166015625
82,5,13,19982,8192,11790,143.9208984375
82,5,14,12609,16384,-3775,-23.040771484375
82,5,15,14830,32768,-17938,-54.742431640625
82,6,1,0,2,-2,-100.0
82,6,2,3,4,-1,-25.0
82,6,3,2,8,-6,-75.0
82,6,4,8,16,-8,-50.0
82,6,5,13,32,-19,-59.375
82,6,6,25,64,-39,-60.9375
82,6,7,15,128,-113,-88.28125
82,6,8,184,256,-72,-28.125
82,6,9,111,512,-401,-78.3203125
82,6,10,128,1024,-896,-87.5
82,6,11,1112,2048,-936,-45.703125
82,6,12,11675,4096,7579,185.0341796875
82,6,13,11897,8192,3705,45.22705078125
82,6,14,9786,16384,-6598,-40.27099609375
82,6,15,50079,32768,17311,52.8289794921875
82,7,1,0,2,-2,-100.0
82,7,2,1,4,-3,-75.0
82,7,3,10,8,2,25.0
82,7,4,6,16,-10,-62.5
82,7,5,50,32,18,56.25
82,7,6,9,64,-55,-85.9375
82,7,7,220,128,92,71.875
82,7,8,144,256,-112,-43.75
82,7,9,177,512,-335,-65.4296875
82,7,10,462,1024,-562,-54.8828125
82,7,11,95,2048,-1953,-95.361328125
82,7,12,4152,4096,56,1.3671875
82,7,13,12313,8192,4121,50.30517578125
82,7,14,19803,16384,3419,20.867919921875
82,7,15,12459,32768,-20309,-61.9781494140625
82,8,1,0,2,-2,-100.0
82,8,2,2,4,-2,-50.0
82,8,3,2,8,-6,-75.0
82,8,4,15,16,-1,-6.25
82,8,5,4,32,-28,-87.5
82,8,6,7,64,-57,-89.0625
82,8,7,513,128,385,300.78125
82,8,8,148,256,-108,-42.1875
82,8,9,388,512,-124,-24.21875
82,8,10,843,1024,-181,-17.67578125
82,8,11,825,2048,-1223,-59.716796875
82,8,12,10543,4096,6447,157.3974609375
82,8,13,211,8192,-7981,-97.42431640625
82,8,14,22094,16384,5710,34.85107421875
82,8,15,45459,32768,12691,38.7298583984375
82,9,1,0,2,-2,-100.0
82,9,2,4,4,0,0.0
82,9,3,10,8,2,25.0
82,9,4,40,16,24,150.0
82,9,5,42,32,10,31.25
82,9,6,50,64,-14,-21.875
82,9,7,145,128,17,13.28125
82,9,8,130,256,-126,-49.21875
82,9,9,1373,512,861,168.1640625
82,9,10,64,1024,-960,-93.75
82,9,11,1688,2048,-360,-17.578125
82,9,12,4717,4096,621,15.1611328125
82,9,13,11558,8192,3366,41.0888671875
82,9,14,37232,16384,20848,127.24609375
82,9,15,2643,32768,-30125,-91.9342041015625
82,10,1,0,2,-2,-100.0
82,10,2,2,4,-2,-50.0
82,10,3,2,8,-6,-75.0
82,10,4,3,16,-13,-81.25
82,10,5,13,32,-19,-59.375
82,10,6,16,64,-48,-75.0
82,10,7,66,128,-62,-48.4375
82,10,8,16,256,-240,-93.75
82,10,9,252,512,-260,-50.78125
82,10,10,531,1024,-493,-48.14453125
82,10,11,3263,2048,1215,59.326171875
82,10,12,833,4096,-3263,-79.6630859375
82,10,13,1807,8192,-6385,-77.94189453125
82,10,14,3284,16384,-13100,-79.9560546875
82,10,15,22172,32768,-10596,-32.33642578125
82,11,1,0,2,-2,-100.0
82,11,2,1,4,-3,-75.0
82,11,3,5,8,-3,-37.5
82,11,4,25,16,9,56.25
82,11,5,15,32,-17,-53.125
82,11,6,12,64,-52,-81.25
82,11,7,100,128,-28,-21.875
82,11,8,697,256,441,172.265625
82,11,9,52,512,-460,-89.84375
82,11,10,864,1024,-160,-15.625
82,11,11,4147,2048,2099,102.490234375
82,11,12,327,4096,-3769,-92.0166015625
82,11,13,6896,8192,-1296,-15.8203125
82,11,14,7125,16384,-9259,-56.512451171875
82,11,15,70183,32768,37415,114.1815185546875
82,12,1,0,2,-2,-100.0
82,12,2,2,4,-2,-50.0
82,12,3,2,8,-6,-75.0
82,12,4,19,16,3,18.75
82,12,5,26,32,-6,-18.75
82,12,6,49,64,-15,-23.4375
82,12,7,109,128,-19,-14.84375
82,12,8,132,256,-124,-48.4375
82,12,9,1033,512,521,101.7578125
82,12,10,974,1024,-50,-4.8828125
82,12,11,128,2048,-1920,-93.75
82,12,12,115,4096,-3981,-97.1923828125
82,12,13,2437,8192,-5755,-70.25146484375
82,12,14,2339,16384,-14045,-85.723876953125
82,12,15,11784,32768,-20984,-64.0380859375
82,13,1,0,2,-2,-100.0
82,13,2,1,4,-3,-75.0
82,13,3,2,8,-6,-75.0
82,13,4,9,16,-7,-43.75
82,13,5,15,32,-17,-53.125
82,13,6,56,64,-8,-12.5
82,13,7,116,128,-12,-9.375
82,13,8,1135,256,879,343.359375
82,13,9,373,512,-139,-27.1484375
82,13,10,323,1024,-701,-68.45703125
82,13,11,5561,2048,3513,171.533203125
82,13,12,4315,4096,219,5.3466796875
82,13,13,1651,8192,-6541,-79.84619140625
82,13,14,21669,16384,5285,32.257080078125
82,13,15,22458,32768,-10310,-31.463623046875
82,14,1,0,2,-2,-100.0
82,14,2,2,4,-2,-50.0
82,14,3,10,8,2,25.0
82,14,4,12,16,-4,-25.0
82,14,5,4,32,-28,-87.5
82,14,6,31,64,-33,-51.5625
82,14,7,229,128,101,78.90625
82,14,8,390,256,134,52.34375
82,14,9,1044,512,532,103.90625
82,14,10,173,1024,-851,-83.10546875
82,14,11,762,2048,-1286,-62.79296875
82,14,12,319,4096,-3777,-92.2119140625
82,14,13,5961,8192,-2231,-27.23388671875
82,14,14,14320,16384,-2064,-12.59765625
82,14,15,48434,32768,15666,47.808837890625
82,15,1,0,2,-2,-100.0
82,15,2,3,4,-1,-25.0
82,15,3,5,8,-3,-37.5
82,15,4,16,16,0,0.0
82,15,5,16,32,-16,-50.0
82,15,6,78,64,14,21.875
82,15,7,304,128,176,137.5
82,15,8,510,256,254,99.21875
82,15,9,24,512,-488,-95.3125
82,15,10,1010,1024,-14,-1.3671875
82,15,11,945,2048,-1103,-53.857421875
82,15,12,5308,4096,1212,29.58984375
82,15,13,9473,8192,1281,15.63720703125
82,15,14,33218,16384,16834,102.74658203125
82,15,15,92596,32768,59828,182.58056640625
82,16,1,0,2,-2,-100.0
82,16,2,2,4,-2,-50.0
82,16,3,6,8,-2,-25.0
82,16,4,13,16,-3,-18.75
82,16,5,4,32,-28,-87.5
82,16,6,11,64,-53,-82.8125
82,16,7,127,128,-1,-0.78125
82,16,8,1353,256,1097,428.515625
82,16,9,49,512,-463,-90.4296875
82,16,10,1457,1024,433,42.28515625
82,16,11,3414,2048,1366,66.69921875
82,16,12,779,4096,-3317,-80.9814453125
82,16,13,8705,8192,513,6.26220703125
82,16,14,7616,16384,-8768,-53.515625
82,16,15,23414,32768,-9354,-28.546142578125
82,17,1,0,2,-2,-100.0
82,17,2,1,4,-3,-75.0
82,17,3,8,8,0,0.0
82,17,4,4,16,-12,-75.0
82,17,5,13,32,-19,-59.375
82,17,6,7,64,-57,-89.0625
82,17,7,45,128,-83,-64.84375
82,17,8,187,256,-69,-26.953125
82,17,9,758,512,246,48.046875
82,17,10,2121,1024,1097,107.12890625
82,17,11,100,2048,-1948,-95.1171875
82,17,12,616,4096,-3480,-84.9609375
82,17,13,899,8192,-7293,-89.02587890625
82,17,14,3895,16384,-12489,-76.226806640625
82,17,15,44384,32768,11616,35.44921875
82,18,1,0,2,-2,-100.0
82,18,2,2,4,-2,-50.0
82,18,3,3,8,-5,-62.5
82,18,4,3,16,-13,-81.25
82,18,5,12,32,-20,-62.5
82,18,6,40,64,-24,-37.5
82,18,7,7,128,-121,-94.53125
82,18,8,183,256,-73,-28.515625
82,18,9,1676,512,1164,227.34375
82,18,10,242,1024,-782,-76.3671875
82,18,11,3943,2048,1895,92.529296875
82,18,12,363,4096,-3733,-91.1376953125
82,18,13,3297,8192,-4895,-59.75341796875
82,18,14,7917,16384,-8467,-51.678466796875
82,18,15,5476,32768,-27292,-83.28857421875
82,19,1,0,2,-2,-100.0
82,19,2,1,4,-3,-75.0
82,19,3,5,8,-3,-37.5
82,19,4,3,16,-13,-81.25
82,19,5,45,32,13,40.625
82,19,6,20,64,-44,-68.75
82,19,7,346,128,218,170.3125
82,19,8,703,256,447,174.609375
82,19,9,1157,512,645,125.9765625
82,19,10,383,1024,-641,-62.59765625
82,19,11,5216,2048,3168,154.6875
82,19,12,2273,4096,-1823,-44.5068359375
82,19,13,2972,8192,-5220,-63.720703125
82,19,14,20593,16384,4209,25.689697265625
82,19,15,37180,32768,4412,13.46435546875
82,20,1,0,2,-2,-100.0
82,20,2,1,4,-3,-75.0
82,20,3,5,8,-3,-37.5
82,20,4,24,16,8,50.0
82,20,5,10,32,-22,-68.75
82,20,6,33,64,-31,-48.4375
82,20,7,98,128,-30,-23.4375
82,20,8,258,256,2,0.78125
82,20,9,875,512,363,70.8984375
82,20,10,3232,1024,2208,215.625
82,20,11,9228,2048,7180,350.5859375
82,20,12,2037,4096,-2059,-50.2685546875
82,20,13,5517,8192,-2675,-32.65380859375
82,20,14,1510,16384,-14874,-90.78369140625
82,20,15,17684,32768,-15084,-46.03271484375
82,21,1,0,2,-2,-100.0
82,21,2,2,4,-2,-50.0
82,21,3,2,8,-6,-75.0
82,21,4,3,16,-13,-81.25
82,21,5,35,32,3,9.375
82,21,6,8,64,-56,-87.5
82,21,7,38,128,-90,-70.3125
82,21,8,505,256,249,97.265625
82,21,9,415,512,-97,-18.9453125
82,21,10,210,1024,-814,-79.4921875
82,21,11,1895,2048,-153,-7.470703125
82,21,12,12,4096,-4084,-99.70703125
82,21,13,7490,8192,-702,-8.5693359375
82,21,14,1537,16384,-14847,-90.618896484375
82,21,15,38359,32768,5591,17.0623779296875
82,22,1,0,2,-2,-100.0
82,22,2,2,4,-2,-50.0
82,22,3,19,8,11,137.5
82,22,4,17,16,1,6.25
82,22,5,17,32,-15,-46.875
82,22,6,119,64,55,85.9375
82,22,7,146,128,18,14.0625
82,22,8,217,256,-39,-15.234375
82,22,9,270,512,-242,-47.265625
82,22,10,3494,1024,2470,241.2109375
82,22,11,3051,2048,1003,48.974609375
82,22,12,316,4096,-3780,-92.28515625
82,22,13,4683,8192,-3509,-42.83447265625
82,22,14,22342,16384,5958,36.36474609375
82,22,15,18694,32768,-14074,-42.950439453125
82,23,1,0,2,-2,-100.0
82,23,2,2,4,-2,-50.0
82,23,3,7,8,-1,-12.5
82,23,4,8,16,-8,-50.0
82,23,5,31,32,-1,-3.125
82,23,6,137,64,73,114.0625
82,23,7,53,128,-75,-58.59375
82,23,8,1374,256,1118,436.71875
82,23,9,434,512,-78,-15.234375
82,23,10,271,1024,-753,-73.53515625
82,23,11,2326,2048,278,13.57421875
82,23,12,717,4096,-3379,-82.4951171875
82,23,13,3915,8192,-4277,-52.20947265625
82,23,14,10286,16384,-6098,-37.21923828125
82,23,15,26467,32768,-6301,-19.2291259765625
82,24,1,0,2,-2,-100.0
82,24,2,3,4,-1,-25.0
82,24,3,5,8,-3,-37.5
82,24,4,18,16,2,12.5
82,24,5,21,32,-11,-34.375
82,24,6,34,64,-30,-46.875
82,24,7,9,128,-119,-92.96875
82,24,8,294,256,38,14.84375
82,24,9,483,512,-29,-5.6640625
82,24,10,422,1024,-602,-58.7890625
82,24,11,1372,2048,-676,-33.0078125
82,24,12,9903,4096,5807,141.7724609375
82,24,13,7273,8192,-919,-11.21826171875
82,24,14,6770,16384,-9614,-58.67919921875
82,24,15,122773,32768,90005,274.6734619140625
82,25,1,0,2,-2,-100.0
82,25,2,1,4,-3,-75.0
82,25,3,3,8,-5,-62.5
82,25,4,4,16,-12,-75.0
82,25,5,78,32,46,143.75
82,25,6,107,64,43,67.1875
82,25,7,256,128,128,100.0
82,25,8,404,256,148,57.8125
82,25,9,1072,512,560,109.375
82,25,10,37,1024,-987,-96.38671875
82,25,11,3947,2048,1899,92.724609375
82,25,12,3982,4096,-114,-2.783203125
82,25,13,14752,8192,6560,80.078125
82,25,14,4399,16384,-11985,-73.150634765625
82,25,15,3642,32768,-29126,-88.885498046875
82,26,1,0,2,-2,-100.0
82,26,2,3,4,-1,-25.0
82,26,3,5,8,-3,-37.5
82,26,4,36,16,20,125.0
82,26,5,17,32,-15,-46.875
82,26,6,18,64,-46,-71.875
82,26,7,136,128,8,6.25
82,26,8,146,256,-110,-42.96875
82,26,9,1626,512,1114,217.578125
82,26,10,2030,1024,1006,98.2421875
82,26,11,57,2048,-1991,-97.216796875
82,26,12,3155,4096,-941,-22.9736328125
82,26,13,7863,8192,-329,-4.01611328125
82,26,14,1669,16384,-14715,-89.813232421875
82,26,15,22929,32768,-9839,-30.0262451171875
82,27,1,0,2,-2,-100.0
82,27,2,1,4,-3,-75.0
82,27,3,5,8,-3,-37.5
82,27,4,4,16,-12,-75.0
82,27,5,6,32,-26,-81.25
82,27,6,113,64,49,76.5625
82,27,7,291,128,163,127.34375
82,27,8,52,256,-204,-79.6875
82,27,9,124,512,-388,-75.78125
82,27,10,59,1024,-965,-94.23828125
82,27,11,10,2048,-2038,-99.51171875
82,27,12,467,4096,-3629,-88.5986328125
82,27,13,4810,8192,-3382,-41.2841796875
82,27,14,86660,16384,70276,428.9306640625
82,27,15,4441,32768,-28327,-86.4471435546875
82,28,1,0,2,-2,-100.0
82,28,2,2,4,-2,-50.0
82,28,3,2,8,-6,-75.0
82,28,4,28,16,12,75.0
82,28,5,75,32,43,134.375
82,28,6,41,64,-23,-35.9375
82,28,7,54,128,-74,-57.8125
82,28,8,183,256,-73,-28.515625
82,28,9,399,512,-113,-22.0703125
82,28,10,950,1024,-74,-7.2265625
82,28,11,2582,2048,534,26.07421875
82,28,12,1459,4096,-2637,-64.3798828125
82,28,13,26389,8192,18197,222.13134765625
82,28,14,7130,16384,-9254,-56.48193359375
82,28,15,48573,32768,15805,48.2330322265625
82,29,1,0,2,-2,-100.0
82,29,2,2,4,-2,-50.0
82,29,3,4,8,-4,-50.0
82,29,4,4,16,-12,-75.0
82,29,5,58,32,26,81.25
82,29,6,65,64,1,1.5625
82,29,7,56,128,-72,-56.25
82,29,8,180,256,-76,-29.6875
82,29,9,288,512,-224,-43.75
82,29,10,1716,1024,692,67.578125
82,29,11,604,2048,-1444,-70.5078125
82,29,12,2168,4096,-1928,-47.0703125
82,29,13,5317,8192,-2875,-35.09521484375
82,29,14,4684,16384,-11700,-71.4111328125
82,29,15,36866,32768,4098,12.506103515625
82,30,1,0,2,-2,-100.0
82,30,2,5,4,1,25.0
82,30,3,6,8,-2,-25.0
82,30,4,3,16,-13,-81.25
82,30,5,18,32,-14,-43.75
82,30,6,82,64,18,28.125
82,30,7,96,128,-32,-25.0
82,30,8,40,256,-216,-84.375
82,30,9,43,512,-469,-91.6015625
82,30,10,817,1024,-207,-20.21484375
82,30,11,4208,2048,2160,105.46875
82,30,12,2486,4096,-1610,-39.306640625
82,30,13,7813,8192,-379,-4.62646484375
82,30,14,14904,16384,-1480,-9.033203125
82,30,15,10614,32768,-22154,-67.608642578125
82,31,1,0,2,-2,-100.0
82,31,2,1,4,-3,-75.0
82,31,3,6,8,-2,-25.0
82,31,4,12,16,-4,-25.0
82,31,5,15,32,-17,-53.125
82,31,6,29,64,-35,-54.6875
82,31,7,127,128,-1,-0.78125
82,31,8,157,256,-99,-38.671875
82,31,9,2467,512,1955,381.8359375
82,31,10,86,1024,-938,-91.6015625
82,31,11,1511,2048,-537,-26.220703125
82,31,12,10650,4096,6554,160.009765625
82,31,13,932,8192,-7260,-88.623046875
82,31,14,2182,16384,-14202,-86.68212890625
82,31,15,1798,32768,-30970,-94.512939453125
82,32,1,0,2,-2,-100.0
82,32,2,1,4,-3,-75.0
82,32,3,11,8,3,37.5
82,32,4,11,16,-5,-31.25
82,32,5,65,32,33,103.125
82,32,6,171,64,107,167.1875
82,32,7,9,128,-119,-92.96875
82,32,8,179,256,-77,-30.078125
82,32,9,113,512,-399,-77.9296875
82,32,10,2162,1024,1138,111.1328125
82,32,11,756,2048,-1292,-63.0859375
82,32,12,560,4096,-3536,-86.328125
82,32,13,760,8192,-7432,-90.72265625
82,32,14,6974,16384,-9410,-57.43408203125
82,32,15,80328,32768,47560,145.1416015625
82,33,1,0,2,-2,-100.0
82,33,2,4,4,0,0.0
82,33,3,9,8,1,12.5
82,33,4,6,16,-10,-62.5
82,33,5,8,32,-24,-75.0
82,33,6,37,64,-27,-42.1875
82,33,7,66,128,-62,-48.4375
82,33,8,7,256,-249,-97.265625
82,33,9,172,512,-340,-66.40625
82,33,10,86,1024,-938,-91.6015625
82,33,11,147,2048,-1901,-92.822265625
82,33,12,3306,4096,-790,-19.287109375
82,33,13,20593,8192,12401,151.37939453125
82,33,14,474,16384,-15910,-97.10693359375
82,33,15,76837,32768,44069,134.4879150390625
82,34,1,0,2,-2,-100.0
82,34,2,2,4,-2,-50.0
82,34,3,12,8,4,50.0
82,34,4,10,16,-6,-37.5
82,34,5,198,32,166,518.75
82,34,6,165,64,101,157.8125
82,34,7,112,128,-16,-12.5
82,34,8,21,256,-235,-91.796875
82,34,9,81,512,-431,-84.1796875
82,34,10,3187,1024,2163,211.23046875
82,34,11,1277,2048,-771,-37.646484375
82,34,12,16875,4096,12779,311.9873046875
82,34,13,1254,8192,-6938,-84.6923828125
82,34,14,653,16384,-15731,-96.014404296875
82,34,15,70349,32768,37581,114.6881103515625
82,35,1,0,2,-2,-100.0
82,35,2,1,4,-3,-75.0
82,35,3,3,8,-5,-62.5
82,35,4,7,16,-9,-56.25
82,35,5,15,32,-17,-53.125
82,35,6,171,64,107,167.1875
82,35,7,35,128,-93,-72.65625
82,35,8,244,256,-12,-4.6875
82,35,9,185,512,-327,-63.8671875
82,35,10,2395,1024,1371,133.88671875
82,35,11,429,2048,-1619,-79.052734375
82,35,12,110,4096,-3986,-97.314453125
82,35,13,10201,8192,2009,24.52392578125
82,35,14,2708,16384,-13676,-83.4716796875
82,35,15,68638,32768,35870,109.466552734375
82,36,1,0,2,-2,-100.0
82,36,2,1,4,-3,-75.0
82,36,3,4,8,-4,-50.0
82,36,4,15,16,-1,-6.25
82,36,5,17,32,-15,-46.875
82,36,6,43,64,-21,-32.8125
82,36,7,70,128,-58,-45.3125
82,36,8,528,256,272,106.25
82,36,9,192,512,-320,-62.5
82,36,10,1708,1024,684,66.796875
82,36,11,3248,2048,1200,58.59375
82,36,12,4691,4096,595,14.5263671875
82,36,13,2881,8192,-5311,-64.83154296875
82,36,14,3413,16384,-12971,-79.168701171875
82,36,15,2554,32768,-30214,-92.205810546875
82,37,1,0,2,-2,-100.0
82,37,2,2,4,-2,-50.0
82,37,3,18,8,10,125.0
82,37,4,11,16,-5,-31.25
82,37,5,4,32,-28,-87.5
82,37,6,160,64,96,150.0
82,37,7,18,128,-110,-85.9375
82,37,8,15,256,-241,-94.140625
82,37,9,274,512,-238,-46.484375
82,37,10,444,1024,-580,-56.640625
82,37,11,6681,2048,4633,226.220703125
82,37,12,594,4096,-3502,-85.498046875
82,37,13,1130,8192,-7062,-86.2060546875
82,37,14,2113,16384,-14271,-87.103271484375
82,37,15,10651,32768,-22117,-67.4957275390625
82,38,1,0,2,-2,-100.0
82,38,2,1,4,-3,-75.0
82,38,3,2,8,-6,-75.0
82,38,4,17,16,1,6.25
82,38,5,31,32,-1,-3.125
82,38,6,74,64,10,15.625
82,38,7,283,128,155,121.09375
82,38,8,212,256,-44,-17.1875
82,38,9,329,512,-183,-35.7421875
82,38,10,589,1024,-435,-42.48046875
82,38,11,876,2048,-1172,-57.2265625
82,38,12,1419,4096,-2677,-65.3564453125
82,38,13,5903,8192,-2289,-27.94189453125
82,38,14,33655,16384,17271,105.413818359375
82,38,15,3339,32768,-29429,-89.8101806640625
82,39,1,0,2,-2,-100.0
82,39,2,2,4,-2,-50.0
82,39,3,11,8,3,37.5
82,39,4,13,16,-3,-18.75
82,39,5,38,32,6,18.75
82,39,6,29,64,-35,-54.6875
82,39,7,251,128,123,96.09375
82,39,8,66,256,-190,-74.21875
82,39,9,878,512,366,71.484375
82,39,10,346,1024,-678,-66.2109375
82,39,11,4597,2048,2549,124.462890625
82,39,12,3732,4096,-364,-8.88671875
82,39,13,9434,8192,1242,15.1611328125
82,39,14,8883,16384,-7501,-45.782470703125
82,39,15,170256,32768,137488,419.580078125
82,40,1,0,2,-2,-100.0
82,40,2,2,4,-2,-50.0
82,40,3,7,8,-1,-12.5
82,40,4,22,16,6,37.5
82,40,5,4,32,-28,-87.5
82,40,6,49,64,-15,-23.4375
82,40,7,105,128,-23,-17.96875
82,40,8,18,256,-238,-92.96875
82,40,9,277,512,-235,-45.8984375
82,40,10,1120,1024,96,9.375
82,40,11,3026,2048,978,47.75390625
82,40,12,9277,4096,5181,126.4892578125
82,40,13,15208,8192,7016,85.64453125
82,40,14,51504,16384,35120,214.35546875
82,40,15,24986,32768,-7782,-23.748779296875
82,41,1,0,2,-2,-100.0
82,41,2,3,4,-1,-25.0
82,41,3,9,8,1,12.5
82,41,4,26,16,10,62.5
82,41,5,5,32,-27,-84.375
82,41,6,19,64,-45,-70.3125
82,41,7,13,128,-115,-89.84375
82,41,8,125,256,-131,-51.171875
82,41,9,1143,512,631,123.2421875
82,41,10,93,1024,-931,-90.91796875
82,41,11,8172,2048,6124,299.0234375
82,41,12,2040,4096,-2056,-50.1953125
82,41,13,5161,8192,-3031,-36.99951171875
82,41,14,24859,16384,8475,51.727294921875
82,41,15,5094,32768,-27674,-84.454345703125
82,42,1,0,2,-2,-100.0
82,42,2,1,4,-3,-75.0
82,42,3,6,8,-2,-25.0
82,42,4,8,16,-8,-50.0
82,42,5,17,32,-15,-46.875
82,42,6,43,64,-21,-32.8125
82,42,7,134,128,6,4.6875
82,42,8,34,256,-222,-86.71875
82,42,9,39,512,-473,-92.3828125
82,42,10,1131,1024,107,10.44921875
82,42,11,5692,2048,3644,177.9296875
82,42,12,995,4096,-3101,-75.7080078125
82,42,13,5167,8192,-3025,-36.92626953125
82,42,14,9149,16384,-7235,-44.158935546875
82,42,15,19625,32768,-13143,-40.1092529296875
82,43,1,0,2,-2,-100.0
82,43,2,1,4,-3,-75.0
82,43,3,18,8,10,125.0
82,43,4,5,16,-11,-68.75
82,43,5,95,32,63,196.875
82,43,6,9,64,-55,-85.9375
82,43,7,147,128,19,14.84375
82,43,8,536,256,280,109.375
82,43,9,1186,512,674,131.640625
82,43,10,220,1024,-804,-78.515625
82,43,11,594,2048,-1454,-70.99609375
82,43,12,8816,4096,4720,115.234375
82,43,13,1047,8192,-7145,-87.21923828125
82,43,14,5262,16384,-11122,-67.88330078125
82,43,15,20727,32768,-12041,-36.7462158203125
82,44,1,0,2,-2,-100.0
82,44,2,3,4,-1,-25.0
82,44,3,2,8,-6,-75.0
82,44,4,3,16,-13,-81.25
82,44,5,23,32,-9,-28.125
82,44,6,25,64,-39,-60.9375
82,44,7,65,128,-63,-49.21875
82,44,8,81,256,-175,-68.359375
82,44,9,331,512,-181,-35.3515625
82,44,10,456,1024,-568,-55.46875
82,44,11,74,2048,-1974,-96.38671875
82,44,12,4869,4096,773,18.8720703125
82,44,13,190,8192,-8002,-97.6806640625
82,44,14,1058,16384,-15326,-93.54248046875
82,44,15,50622,32768,17854,54.486083984375
82,45,1,0,2,-2,-100.0
82,45,2,1,4,-3,-75.0
82,45,3,5,8,-3,-37.5
82,45,4,20,16,4,25.0
82,45,5,77,32,45,140.625
82,45,6,66,64,2,3.125
82,45,7,21,128,-107,-83.59375
82,45,8,1236,256,980,382.8125
82,45,9,301,512,-211,-41.2109375
82,45,10,308,1024,-716,-69.921875
82,45,11,975,2048,-1073,-52.392578125
82,45,12,109,4096,-3987,-97.3388671875
82,45,13,3770,8192,-4422,-53.9794921875
82,45,14,1697,16384,-14687,-89.642333984375
82,45,15,52648,32768,19880,60.6689453125
82,46,1,0,2,-2,-100.0
82,46,2,1,4,-3,-75.0
82,46,3,13,8,5,62.5
82,46,4,25,16,9,56.25
82,46,5,46,32,14,43.75
82,46,6,129,64,65,101.5625
82,46,7,21,128,-107,-83.59375
82,46,8,56,256,-200,-78.125
82,46,9,152,512,-360,-70.3125
82,46,10,1039,1024,15,1.46484375
82,46,11,545,2048,-1503,-73.388671875
82,46,12,1001,4096,-3095,-75.5615234375
82,46,13,3025,8192,-5167,-63.07373046875
82,46,14,6987,16384,-9397,-57.354736328125
82,46,15,32375,32768,-393,-1.1993408203125
82,47,1,0,2,-2,-100.0
82,47,2,2,4,-2,-50.0
82,47,3,4,8,-4,-50.0
82,47,4,16,16,0,0.0
82,47,5,33,32,1,3.125
82,47,6,28,64,-36,-56.25
82,47,7,10,128,-118,-92.1875
82,47,8,12,256,-244,-95.3125
82,47,9,552,512,40,7.8125
82,47,10,996,1024,-28,-2.734375
82,47,11,3354,2048,1306,63.76953125
82,47,12,13556,4096,9460,230.95703125
82,47,13,21086,8192,12894,157.3974609375
82,47,14,45320,16384,28936,176.611328125
82,47,15,11377,32768,-21391,-65.2801513671875
82,48,1,0,2,-2,-100.0
82,48,2,3,4,-1,-25.0
82,48,3,11,8,3,37.5
82,48,4,19,16,3,18.75
82,48,5,52,32,20,62.5
82,48,6,5,64,-59,-92.1875
82,48,7,23,128,-105,-82.03125
82,48,8,304,256,48,18.75
82,48,9,946,512,434,84.765625
82,48,10,533,1024,-491,-47.94921875
82,48,11,3066,2048,1018,49.70703125
82,48,12,2750,4096,-1346,-32.861328125
82,48,13,8177,8192,-15,-0.18310546875
82,48,14,23213,16384,6829,41.680908203125
82,48,15,30166,32768,-2602,-7.940673828125
82,49,1,0,2,-2,-100.0
82,49,2,1,4,-3,-75.0
82,49,3,2,8,-6,-75.0
82,49,4,19,16,3,18.75
82,49,5,22,32,-10,-31.25
82,49,6,69,64,5,7.8125
82,49,7,132,128,4,3.125
82,49,8,38,256,-218,-85.15625
82,49,9,201,512,-311,-60.7421875
82,49,10,689,1024,-335,-32.71484375
82,49,11,398,2048,-1650,-80.56640625
82,49,12,17573,4096,13477,329.0283203125
82,49,13,5560,8192,-2632,-32.12890625
82,49,14,5892,16384,-10492,-64.0380859375
82,49,15,16437,32768,-16331,-49.8382568359375
82,50,1,0,2,-2,-100.0
82,50,2,3,4,-1,-25.0
82,50,3,5,8,-3,-37.5
82,50,4,7,16,-9,-56.25
82,50,5,22,32,-10,-31.25
82,50,6,44,64,-20,-31.25
82,50,7,52,128,-76,-59.375
82,50,8,89,256,-167,-65.234375
82,50,9,555,512,43,8.3984375
82,50,10,13,1024,-1011,-98.73046875
82,50,11,2258,2048,210,10.25390625
82,50,12,11856,4096,7760,189.453125
82,50,13,670,8192,-7522,-91.8212890625
82,50,14,4390,16384,-11994,-73.20556640625
82,50,15,67833,32768,35065,107.0098876953125
82,51,1,0,2,-2,-100.0
82,51,2,1,4,-3,-75.0
82,51,3,4,8,-4,-50.0
82,51,4,18,16,2,12.5
82,51,5,19,32,-13,-40.625
82,51,6,185,64,121,189.0625
82,51,7,177,128,49,38.28125
82,51,8,202,256,-54,-21.09375
82,51,9,253,512,-259,-50.5859375
82,51,10,3629,1024,2605,254.39453125
82,51,11,2282,2048,234,11.42578125
82,51,12,8551,4096,4455,108.7646484375
82,51,13,868,8192,-7324,-89.404296875
82,51,14,48966,16384,32582,198.86474609375
82,51,15,90677,32768,57909,176.7242431640625
82,52,1,0,2,-2,-100.0
82,52,2,1,4,-3,-75.0
82,52,3,2,8,-6,-75.0
82,52,4,37,16,21,131.25
82,52,5,33,32,1,3.125
82,52,6,5,64,-59,-92.1875
82,52,7,69,128,-59,-46.09375
82,52,8,116,256,-140,-54.6875
82,52,9,137,512,-375,-73.2421875
82,52,10,2810,1024,1786,174.4140625
82,52,11,165,2048,-1883,-91.943359375
82,52,12,5041,4096,945,23.0712890625
82,52,13,8324,8192,132,1.611328125
82,52,14,21618,16384,5234,31.94580078125
82,52,15,59053,32768,26285,80.2154541015625
82,53,1,0,2,-2,-100.0
82,53,2,2,4,-2,-50.0
82,53,3,3,8,-5,-62.5
82,53,4,13,16,-3,-18.75
82,53,5,106,32,74,231.25
82,53,6,30,64,-34,-53.125
82,53,7,259,128,131,102.34375
82,53,8,448,256,192,75.0
82,53,9,1846,512,1334,260.546875
82,53,10,303,1024,-721,-70.41015625
82,53,11,1634,2048,-414,-20.21484375
82,53,12,293,4096,-3803,-92.8466796875
82,53,13,8992,8192,800,9.765625
82,53,14,3645,16384,-12739,-77.752685546875
82,53,15,19896,32768,-12872,-39.2822265625
82,54,1,0,2,-2,-100.0
82,54,2,2,4,-2,-50.0
82,54,3,8,8,0,0.0
82,54,4,14,16,-2,-12.5
82,54,5,22,32,-10,-31.25
82,54,6,44,64,-20,-31.25
82,54,7,50,128,-78,-60.9375
82,54,8,390,256,134,52.34375
82,54,9,207,512,-305,-59.5703125
82,54,10,70,1024,-954,-93.1640625
82,54,11,1047,2048,-1001,-48.876953125
82,54,12,3483,4096,-613,-14.9658203125
82,54,13,11776,8192,3584,43.75
82,54,14,41498,16384,25114,153.28369140625
82,54,15,124722,32768,91954,280.621337890625
82,55,1,0,2,-2,-100.0
82,55,2,2,4,-2,-50.0
82,55,3,7,8,-1,-12.5
82,55,4,11,16,-5,-31.25
82,55,5,36,32,4,12.5
82,55,6,9,64,-55,-85.9375
82,55,7,48,128,-80,-62.5
82,55,8,825,256,569,222.265625
82,55,9,10,512,-502,-98.046875
82,55,10,1225,1024,201,19.62890625
82,55,11,1789,2048,-259,-12.646484375
82,55,12,846,4096,-3250,-79.345703125
82,55,13,15911,8192,7719,94.22607421875
82,55,14,1128,16384,-15256,-93.115234375
82,55,15,40287,32768,7519,22.9461669921875
82,56,1,0,2,-2,-100.0
82,56,2,2,4,-2,-50.0
82,56,3,2,8,-6,-75.0
82,56,4,17,16,1,6.25
82,56,5,30,32,-2,-6.25
82,56,6,87,64,23,35.9375
82,56,7,280,128,152,118.75
82,56,8,257,256,1,0.390625
82,56,9,25,512,-487,-95.1171875
82,56,10,231,1024,-793,-77.44140625
82,56,11,724,2048,-1324,-64.6484375
82,56,12,9831,4096,5735,140.0146484375
82,56,13,23153,8192,14961,182.62939453125
82,56,14,1712,16384,-14672,-89.55078125
82,56,15,8620,32768,-24148,-73.69384765625
82,57,1,0,2,-2,-100.0
82,57,2,2,4,-2,-50.0
82,57,3,7,8,-1,-12.5
82,57,4,17,16,1,6.25
82,57,5,28,32,-4,-12.5
82,57,6,47,64,-17,-26.5625
82,57,7,34,128,-94,-73.4375
82,57,8,142,256,-114,-44.53125
82,57,9,437,512,-75,-14.6484375
82,57,10,877,1024,-147,-14.35546875
82,57,11,1269,2048,-779,-38.037109375
82,57,12,2591,4096,-1505,-36.7431640625
82,57,13,19495,8192,11303,137.97607421875
82,57,14,2350,16384,-14034,-85.65673828125
82,57,15,13536,32768,-19232,-58.69140625
82,58,1,0,2,-2,-100.0
82,58,2,1,4,-3,-75.0
82,58,3,9,8,1,12.5
82,58,4,3,16,-13,-81.25
82,58,5,16,32,-16,-50.0
82,58,6,44,64,-20,-31.25
82,58,7,57,128,-71,-55.46875
82,58,8,155,256,-101,-39.453125
82,58,9,417,512,-95,-18.5546875
82,58,10,2016,1024,992,96.875
82,58,11,2371,2048,323,15.771484375
82,58,12,287,4096,-3809,-92.9931640625
82,58,13,1321,8192,-6871,-83.87451171875
82,58,14,29583,16384,13199,80.560302734375
82,58,15,103402,32768,70634,215.557861328125
82,59,1,0,2,-2,-100.0
82,59,2,1,4,-3,-75.0
82,59,3,5,8,-3,-37.5
82,59,4,14,16,-2,-12.5
82,59,5,17,32,-15,-46.875
82,59,6,232,64,168,262.5
82,59,7,50,128,-78,-60.9375
82,59,8,1055,256,799,312.109375
82,59,9,959,512,447,87.3046875
82,59,10,928,1024,-96,-9.375
82,59,11,2441,2048,393,19.189453125
82,59,12,7634,4096,3538,86.376953125
82,59,13,6031,8192,-2161,-26.37939453125
82,59,14,10483,16384,-5901,-36.016845703125
82,59,15,140018,32768,107250,327.301025390625
82,60,1,0,2,-2,-100.0
82,60,2,1,4,-3,-75.0
82,60,3,2,8,-6,-75.0
82,60,4,8,16,-8,-50.0
82,60,5,88,32,56,175.0
82,60,6,23,64,-41,-64.0625
82,60,7,23,128,-105,-82.03125
82,60,8,340,256,84,32.8125
82,60,9,1621,512,1109,216.6015625
82,60,10,1050,1024,26,2.5390625
82,60,11,1201,2048,-847,-41.357421875
82,60,12,7816,4096,3720,90.8203125
82,60,13,2495,8192,-5697,-69.54345703125
82,60,14,14704,16384,-1680,-10.25390625
82,60,15,45081,32768,12313,37.5762939453125
82,61,1,0,2,-2,-100.0
82,61,2,1,4,-3,-75.0
82,61,3,4,8,-4,-50.0
82,61,4,23,16,7,43.75
82,61,5,16,32,-16,-50.0
82,61,6,17,64,-47,-73.4375
82,61,7,13,128,-115,-89.84375
82,61,8,93,256,-163,-63.671875
82,61,9,1806,512,1294,252.734375
82,61,10,664,1024,-360,-35.15625
82,61,11,2280,2048,232,11.328125
82,61,12,14425,4096,10329,252.1728515625
82,61,13,4346,8192,-3846,-46.9482421875
82,61,14,64252,16384,47868,292.1630859375
82,61,15,39234,32768,6466,19.732666015625
82,62,1,0,2,-2,-100.0
82,62,2,2,4,-2,-50.0
82,62,3,2,8,-6,-75.0
82,62,4,15,16,-1,-6.25
82,62,5,73,32,41,128.125
82,62,6,8,64,-56,-87.5
82,62,7,126,128,-2,-1.5625
82,62,8,289,256,33,12.890625
82,62,9,46,512,-466,-91.015625
82,62,10,253,1024,-771,-75.29296875
82,62,11,4207,2048,2159,105.419921875
82,62,12,201,4096,-3895,-95.0927734375
82,62,13,6119,8192,-2073,-25.30517578125
82,62,14,952,16384,-15432,-94.189453125
82,62,15,100121,32768,67353,205.5450439453125
82,63,1,0,2,-2,-100.0
82,63,2,1,4,-3,-75.0
82,63,3,5,8,-3,-37.5
82,63,4,12,16,-4,-25.0
82,63,5,30,32,-2,-6.25
82,63,6,67,64,3,4.6875
82,63,7,25,128,-103,-80.46875
82,63,8,489,256,233,91.015625
82,63,9,249,512,-263,-51.3671875
82,63,10,1136,1024,112,10.9375
82,63,11,2012,2048,-36,-1.7578125
82,63,12,259,4096,-3837,-93.6767578125
82,63,13,30505,8192,22313,272.37548828125
82,63,14,7410,16384,-8974,-54.77294921875
82,63,15,53252,32768,20484,62.51220703125
82,64,1,0,2,-2,-100.0
82,64,2,2,4,-2,-50.0
82,64,3,9,8,1,12.5
82,64,4,19,16,3,18.75
82,64,5,12,32,-20,-62.5
82,64,6,131,64,67,104.6875
82,64,7,147,128,19,14.84375
82,64,8,569,256,313,122.265625
82,64,9,103,512,-409,-79.8828125
82,64,10,3226,1024,2202,215.0390625
82,64,11,1000,2048,-1048,-51.171875
82,64,12,581,4096,-3515,-85.8154296875
82,64,13,12712,8192,4520,55.17578125
82,64,14,18475,16384,2091,12.762451171875
82,64,15,4824,32768,-27944,-85.2783203125
82,65,1,0,2,-2,-100.0
82,65,2,1,4,-3,-75.0
82,65,3,12,8,4,50.0
82,65,4,59,16,43,268.75
82,65,5,20,32,-12,-37.5
82,65,6,42,64,-22,-34.375
82,65,7,397,128,269,210.15625
82,65,8,812,256,556,217.1875
82,65,9,117,512,-395,-77.1484375
82,65,10,925,1024,-99,-9.66796875
82,65,11,5826,2048,3778,184.47265625
82,65,12,7315,4096,3219,78.5888671875
82,65,13,8820,8192,628,7.666015625
82,65,14,8630,16384,-7754,-47.32666015625
82,65,15,59985,32768,27217,83.0596923828125
82,66,1,0,2,-2,-100.0
82,66,2,2,4,-2,-50.0
82,66,3,3,8,-5,-62.5
82,66,4,17,16,1,6.25
82,66,5,75,32,43,134.375
82,66,6,68,64,4,6.25
82,66,7,32,128,-96,-75.0
82,66,8,650,256,394,153.90625
82,66,9,65,512,-447,-87.3046875
82,66,10,372,1024,-652,-63.671875
82,66,11,2121,2048,73,3.564453125
82,66,12,3087,4096,-1009,-24.6337890625
82,66,13,915,8192,-7277,-88.83056640625
82,66,14,19313,16384,2929,17.877197265625
82,66,15,91454,32768,58686,179.095458984375
82,67,1,0,2,-2,-100.0
82,67,2,1,4,-3,-75.0
82,67,3,2,8,-6,-75.0
82,67,4,23,16,7,43.75
82,67,5,4,32,-28,-87.5
82,67,6,195,64,131,204.6875
82,67,7,37,128,-91,-71.09375
82,67,8,810,256,554,216.40625
82,67,9,137,512,-375,-73.2421875
82,67,10,680,1024,-344,-33.59375
82,67,11,1030,2048,-1018,-49.70703125
82,67,12,23541,4096,19445,474.7314453125
82,67,13,1518,8192,-6674,-81.4697265625
82,67,14,19393,16384,3009,18.365478515625
82,67,15,94971,32768,62203,189.8284912109375
82,68,1,0,2,-2,-100.0
82,68,2,2,4,-2,-50.0
82,68,3,8,8,0,0.0
82,68,4,24,16,8,50.0
82,68,5,143,32,111,346.875
82,68,6,14,64,-50,-78.125
82,68,7,111,128,-17,-13.28125
82,68,8,139,256,-117,-45.703125
82,68,9,64,512,-448,-87.5
82,68,10,1137,1024,113,11.03515625
82,68,11,1636,2048,-412,-20.1171875
82,68,12,674,4096,-3422,-83.544921875
82,68,13,13251,8192,5059,61.75537109375
82,68,14,4370,16384,-12014,-73.32763671875
82,68,15,2654,32768,-30114,-91.900634765625
82,69,1,0,2,-2,-100.0
82,69,2,1,4,-3,-75.0
82,69,3,4,8,-4,-50.0
82,69,4,27,16,11,68.75
82,69,5,32,32,0,0.0
82,69,6,111,64,47,73.4375
82,69,7,15,128,-113,-88.28125
82,69,8,7,256,-249,-97.265625
82,69,9,198,512,-314,-61.328125
82,69,10,630,1024,-394,-38.4765625
82,69,11,1442,2048,-606,-29.58984375
82,69,12,1576,4096,-2520,-61.5234375
82,69,13,7366,8192,-826,-10.0830078125
82,69,14,27410,16384,11026,67.29736328125
82,69,15,9429,32768,-23339,-71.2249755859375
82,70,1,0,2,-2,-100.0
82,70,2,1,4,-3,-75.0
82,70,3,2,8,-6,-75.0
82,70,4,44,16,28,175.0
82,70,5,78,32,46,143.75
82,70,6,44,64,-20,-31.25
82,70,7,25,128,-103,-80.46875
82,70,8,278,256,22,8.59375
82,70,9,72,512,-440,-85.9375
82,70,10,284,1024,-740,-72.265625
82,70,11,568,2048,-1480,-72.265625
82,70,12,8353,4096,4257,103.9306640625
82,70,13,342,8192,-7850,-95.8251953125
82,70,14,13920,16384,-2464,-15.0390625
82,70,15,4350,32768,-28418,-86.724853515625
82,71,1,0,2,-2,-100.0
82,71,2,4,4,0,0.0
82,71,3,8,8,0,0.0
82,71,4,44,16,28,175.0
82,71,5,44,32,12,37.5
82,71,6,173,64,109,170.3125
82,71,7,47,128,-81,-63.28125
82,71,8,410,256,154,60.15625
82,71,9,392,512,-120,-23.4375
82,71,10,173,1024,-851,-83.10546875
82,71,11,1580,2048,-468,-22.8515625
82,71,12,5263,4096,1167,28.4912109375
82,71,13,14966,8192,6774,82.6904296875
82,71,14,17476,16384,1092,6.6650390625
82,71,15,1583,32768,-31185,-95.1690673828125
82,72,1,0,2,-2,-100.0
82,72,2,2,4,-2,-50.0
82,72,3,5,8,-3,-37.5
82,72,4,21,16,5,31.25
82,72,5,36,32,4,12.5
82,72,6,25,64,-39,-60.9375
82,72,7,97,128,-31,-24.21875
82,72,8,465,256,209,81.640625
82,72,9,756,512,244,47.65625
82,72,10,1178,1024,154,15.0390625
82,72,11,279,2048,-1769,-86.376953125
82,72,12,10107,4096,6011,146.7529296875
82,72,13,35873,8192,27681,337.90283203125
82,72,14,4372,16384,-12012,-73.3154296875
82,72,15,35334,32768,2566,7.830810546875
82,73,1,0,2,-2,-100.0
82,73,2,1,4,-3,-75.0
82,73,3,9,8,1,12.5
82,73,4,3,16,-13,-81.25
82,73,5,45,32,13,40.625
82,73,6,33,64,-31,-48.4375
82,73,7,200,128,72,56.25
82,73,8,138,256,-118,-46.09375
82,73,9,677,512,165,32.2265625
82,73,10,3935,1024,2911,284.27734375
82,73,11,2111,2048,63,3.076171875
82,73,12,6741,4096,2645,64.5751953125
82,73,13,388,8192,-7804,-95.263671875
82,73,14,19907,16384,3523,21.502685546875
82,73,15,1819,32768,-30949,-94.4488525390625
82,74,1,0,2,-2,-100.0
82,74,2,1,4,-3,-75.0
82,74,3,3,8,-5,-62.5
82,74,4,3,16,-13,-81.25
82,74,5,95,32,63,196.875
82,74,6,125,64,61,95.3125
82,74,7,21,128,-107,-83.59375
82,74,8,317,256,61,23.828125
82,74,9,191,512,-321,-62.6953125
82,74,10,1003,1024,-21,-2.05078125
82,74,11,661,2048,-1387,-67.724609375
82,74,12,9594,4096,5498,134.228515625
82,74,13,8377,8192,185,2.25830078125
82,74,14,6152,16384,-10232,-62.451171875
82,74,15,33296,32768,528,1.611328125
82,75,1,0,2,-2,-100.0
82,75,2,2,4,-2,-50.0
82,75,3,6,8,-2,-25.0
82,75,4,18,16,2,12.5
82,75,5,19,32,-13,-40.625
82,75,6,86,64,22,34.375
82,75,7,84,128,-44,-34.375
82,75,8,812,256,556,217.1875
82,75,9,177,512,-335,-65.4296875
82,75,10,584,1024,-440,-42.96875
82,75,11,1861,2048,-187,-9.130859375
82,75,12,3243,4096,-853,-20.8251953125
82,75,13,4945,8192,-3247,-39.63623046875
82,75,14,16869,16384,485,2.960205078125
82,75,15,80258,32768,47490,144.927978515625
82,76,1,0,2,-2,-100.0
82,76,2,2,4,-2,-50.0
82,76,3,5,8,-3,-37.5
82,76,4,7,16,-9,-56.25
82,76,5,6,32,-26,-81.25
82,76,6,101,64,37,57.8125
82,76,7,349,128,221,172.65625
82,76,8,408,256,152,59.375
82,76,9,16,512,-496,-96.875
82,76,10,3054,1024,2030,198.2421875
82,76,11,1512,2048,-536,-26.171875
82,76,12,1782,4096,-2314,-56.494140625
82,76,13,4580,8192,-3612,-44.091796875
82,76,14,10396,16384,-5988,-36.5478515625
82,76,15,36512,32768,3744,11.42578125
82,77,1,0,2,-2,-100.0
82,77,2,2,4,-2,-50.0
82,77,3,6,8,-2,-25.0
82,77,4,14,16,-2,-12.5
82,77,5,16,32,-16,-50.0
82,77,6,81,64,17,26.5625
82,77,7,245,128,117,91.40625
82,77,8,37,256,-219,-85.546875
82,77,9,351,512,-161,-31.4453125
82,77,10,167,1024,-857,-83.69140625
82,77,11,491,2048,-1557,-76.025390625
82,77,12,2927,4096,-1169,-28.5400390625
82,77,13,1046,8192,-7146,-87.2314453125
82,77,14,17167,16384,783,4.779052734375
82,77,15,41942,32768,9174,27.996826171875
82,78,1,0,2,-2,-100.0
82,78,2,1,4,-3,-75.0
82,78,3,2,8,-6,-75.0
82,78,4,6,16,-10,-62.5
82,78,5,13,32,-19,-59.375
82,78,6,194,64,130,203.125
82,78,7,13,128,-115,-89.84375
82,78,8,241,256,-15,-5.859375
82,78,9,409,512,-103,-20.1171875
82,78,10,296,1024,-728,-71.09375
82,78,11,10467,2048,8419,411.083984375
82,78,12,6129,4096,2033,49.6337890625
82,78,13,9574,8192,1382,16.8701171875
82,78,14,56225,16384,39841,243.170166015625
82,78,15,58608,32768,25840,78.857421875
82,79,1,0,2,-2,-100.0
82,79,2,1,4,-3,-75.0
82,79,3,6,8,-2,-25.0
82,79,4,3,16,-13,-81.25
82,79,5,128,32,96,300.0
82,79,6,40,64,-24,-37.5
82,79,7,141,128,13,10.15625
82,79,8,104,256,-152,-59.375
82,79,9,528,512,16,3.125
82,79,10,206,1024,-818,-79.8828125
82,79,11,1422,2048,-626,-30.56640625
82,79,12,7425,4096,3329,81.2744140625
82,79,13,3904,8192,-4288,-52.34375
82,79,14,3641,16384,-12743,-77.777099609375
82,79,15,72519,32768,39751,121.3104248046875
82,80,1,0,2,-2,-100.0
82,80,2,2,4,-2,-50.0
82,80,3,3,8,-5,-62.5
82,80,4,19,16,3,18.75
82,80,5,132,32,100,312.5
82,80,6,17,64,-47,-73.4375
82,80,7,73,128,-55,-42.96875
82,80,8,232,256,-24,-9.375
82,80,9,846,512,334,65.234375
82,80,10,824,1024,-200,-19.53125
82,80,11,4838,2048,2790,136.23046875
82,80,12,2954,4096,-1142,-27.880859375
82,80,13,6746,8192,-1446,-17.6513671875
82,80,14,7248,16384,-9136,-55.76171875
82,80,15,19830,32768,-12938,-39.483642578125
82,81,1,0,2,-2,-100.0
82,81,2,1,4,-3,-75.0
82,81,3,5,8,-3,-37.5
82,81,4,4,16,-12,-75.0
82,81,5,6,32,-26,-81.25
82,81,6,134,64,70,109.375
82,81,7,232,128,104,81.25
82,81,8,158,256,-98,-38.28125
82,81,9,129,512,-383,-74.8046875
82,81,10,201,1024,-823,-80.37109375
82,81,11,2458,2048,410,20.01953125
82,81,12,3845,4096,-251,-6.1279296875
82,81,13,22854,8192,14662,178.9794921875
82,81,14,52081,16384,35697,217.877197265625
82,81,15,16847,32768,-15921,-48.5870361328125
82,82,1,0,2,-2,-100.0
82,82,2,1,4,-3,-75.0
82,82,3,4,8,-4,-50.0
82,82,4,11,16,-5,-31.25
82,82,5,31,32,-1,-3.125
82,82,6,254,64,190,296.875
82,82,7,316,128,188,146.875
82,82,8,122,256,-134,-52.34375
82,82,9,47,512,-465,-90.8203125
82,82,10,1657,1024,633,61.81640625
82,82,11,680,2048,-1368,-66.796875
82,82,12,11859,4096,7763,189.5263671875
82,82,13,7146,8192,-1046,-12.7685546875
82,82,14,42935,16384,26551,162.054443359375
82,82,15,173865,32768,141097,430.5938720703125
83,1,1,0,2,-2,-100.0
83,1,2,1,4,-3,-75.0
83,1,3,3,8,-5,-62.5
83,1,4,20,16,4,25.0
83,1,5,16,32,-16,-50.0
83,1,6,80,64,16,25.0
83,1,7,6,128,-122,-95.3125
83,1,8,66,256,-190,-74.21875
83,1,9,322,512,-190,-37.109375
83,1,10,355,1024,-669,-65.33203125
83,1,11,398,2048,-1650,-80.56640625
83,1,12,1652,4096,-2444,-59.66796875
83,1,13,14144,8192,5952,72.65625
83,1,14,10633,16384,-5751,-35.101318359375
83,1,15,55860,32768,23092,70.47119140625
83,2,1,0,2,-2,-100.0
83,2,2,2,4,-2,-50.0
83,2,3,2,8,-6,-75.0
83,2,4,10,16,-6,-37.5
83,2,5,50,32,18,56.25
83,2,6,166,64,102,159.375
83,2,7,155,128,27,21.09375
83,2,8,10,256,-246,-96.09375
83,2,9,168,512,-344,-67.1875
83,2,10,5743,1024,4719,460.83984375
83,2,11,386,2048,-1662,-81.15234375
83,2,12,9588,4096,5492,134.08203125
83,2,13,3835,8192,-4357,-53.18603515625
83,2,14,27325,16384,10941,66.778564453125
83,2,15,9610,32768,-23158,-70.672607421875
83,3,1,0,2,-2,-100.0
83,3,2,2,4,-2,-50.0
83,3,3,11,8,3,37.5
83,3,4,8,16,-8,-50.0
83,3,5,9,32,-23,-71.875
83,3,6,263,64,199,310.9375
83,3,7,46,128,-82,-64.0625
83,3,8,757,256,501,195.703125
83,3,9,85,512,-427,-83.3984375
83,3,10,851,1024,-173,-16.89453125
83,3,11,5051,2048,3003,146.630859375
83,3,12,1671,4096,-2425,-59.2041015625
83,3,13,10138,8192,1946,23.7548828125
83,3,14,17156,16384,772,4.7119140625
83,3,15,119763,32768,86995,265.4876708984375
83,4,1,0,2,-2,-100.0
83,4,2,1,4,-3,-75.0
83,4,3,6,8,-2,-25.0
83,4,4,9,16,-7,-43.75
83,4,5,14,32,-18,-56.25
83,4,6,18,64,-46,-71.875
83,4,7,10,128,-118,-92.1875
83,4,8,552,256,296,115.625
83,4,9,399,512,-113,-22.0703125
83,4,10,399,1024,-625,-61.03515625
83,4,11,2674,2048,626,30.56640625
83,4,12,2346,4096,-1750,-42.724609375
83,4,13,19121,8192,10929,133.41064453125
83,4,14,15548,16384,-836,-5.1025390625
83,4,15,25700,32768,-7068,-21.56982421875
83,5,1,0,2,-2,-100.0
83,5,2,2,4,-2,-50.0
83,5,3,3,8,-5,-62.5
83,5,4,23,16,7,43.75
83,5,5,9,32,-23,-71.875
83,5,6,34,64,-30,-46.875
83,5,7,18,128,-110,-85.9375
83,5,8,262,256,6,2.34375
83,5,9,98,512,-414,-80.859375
83,5,10,156,1024,-868,-84.765625
83,5,11,675,2048,-1373,-67.041015625
83,5,12,746,4096,-3350,-81.787109375
83,5,13,17400,8192,9208,112.40234375
83,5,14,3660,16384,-12724,-77.6611328125
83,5,15,4398,32768,-28370,-86.578369140625
83,6,1,0,2,-2,-100.0
83,6,2,1,4,-3,-75.0
83,6,3,2,8,-6,-75.0
83,6,4,6,16,-10,-62.5
83,6,5,9,32,-23,-71.875
83,6,6,10,64,-54,-84.375
83,6,7,138,128,10,7.8125
83,6,8,78,256,-178,-69.53125
83,6,9,982,512,470,91.796875
83,6,10,139,1024,-885,-86.42578125
83,6,11,2285,2048,237,11.572265625
83,6,12,1254,4096,-2842,-69.384765625
83,6,13,10154,8192,1962,23.9501953125
83,6,14,4764,16384,-11620,-70.9228515625
83,6,15,14843,32768,-17925,-54.7027587890625
83,7,1,0,2,-2,-100.0
83,7,2,1,4,-3,-75.0
83,7,3,2,8,-6,-75.0
83,7,4,65,16,49,306.25
83,7,5,12,32,-20,-62.5
83,7,6,5,64,-59,-92.1875
83,7,7,106,128,-22,-17.1875
83,7,8,216,256,-40,-15.625
83,7,9,312,512,-200,-39.0625
83,7,10,1805,1024,781,76.26953125
83,7,11,35,2048,-2013,-98.291015625
83,7,12,1323,4096,-2773,-67.7001953125
83,7,13,4142,8192,-4050,-49.4384765625
83,7,14,21940,16384,5556,33.9111328125
83,7,15,66608,32768,33840,103.271484375
83,8,1,0,2,-2,-100.0
83,8,2,3,4,-1,-25.0
83,8,3,7,8,-1,-12.5
83,8,4,11,16,-5,-31.25
83,8,5,23,32,-9,-28.125
83,8,6,9,64,-55,-85.9375
83,8,7,106,128,-22,-17.1875
83,8,8,641,256,385,150.390625
83,8,9,385,512,-127,-24.8046875
83,8,10,624,1024,-400,-39.0625
83,8,11,5883,2048,3835,187.255859375
83,8,12,181,4096,-3915,-95.5810546875
83,8,13,21824,8192,13632,166.40625
83,8,14,9805,16384,-6579,-40.155029296875
83,8,15,63517,32768,30749,93.8385009765625
83,9,1,0,2,-2,-100.0
83,9,2,2,4,-2,-50.0
83,9,3,9,8,1,12.5
83,9,4,34,16,18,112.5
83,9,5,23,32,-9,-28.125
83,9,6,18,64,-46,-71.875
83,9,7,138,128,10,7.8125
83,9,8,130,256,-126,-49.21875
83,9,9,173,512,-339,-66.2109375
83,9,10,1457,1024,433,42.28515625
83,9,11,2116,2048,68,3.3203125
83,9,12,498,4096,-3598,-87.841796875
83,9,13,3133,8192,-5059,-61.75537109375
83,9,14,4220,16384,-12164,-74.2431640625
83,9,15,43387,32768,10619,32.4066162109375
83,10,1,0,2,-2,-100.0
83,10,2,1,4,-3,-75.0
83,10,3,2,8,-6,-75.0
83,10,4,8,16,-8,-50.0
83,10,5,62,32,30,93.75
83,10,6,52,64,-12,-18.75
83,10,7,280,128,152,118.75
83,10,8,322,256,66,25.78125
83,10,9,2470,512,1958,382.421875
83,10,10,1331,1024,307,29.98046875
83,10,11,345,2048,-1703,-83.154296875
83,10,12,251,4096,-3845,-93.8720703125
83,10,13,4207,8192,-3985,-48.64501953125
83,10,14,784,16384,-15600,-95.21484375
83,10,15,14464,32768,-18304,-55.859375
83,11,1,0,2,-2,-100.0
83,11,2,3,4,-1,-25.0
83,11,3,3,8,-5,-62.5
83,11,4,87,16,71,443.75
83,11,5,79,32,47,146.875
83,11,6,55,64,-9,-14.0625
83,11,7,94,128,-34,-26.5625
83,11,8,735,256,479,187.109375
83,11,9,110,512,-402,-78.515625
83,11,10,745,1024,-279,-27.24609375
83,11,11,978,2048,-1070,-52.24609375
83,11,12,278,4096,-3818,-93.212890625
83,11,13,8259,8192,67,0.81787109375
83,11,14,40528,16384,24144,147.36328125
83,11,15,34985,32768,2217,6.7657470703125
83,12,1,0,2,-2,-100.0
83,12,2,1,4,-3,-75.0
83,12,3,4,8,-4,-50.0
83,12,4,46,16,30,187.5
83,12,5,11,32,-21,-65.625
83,12,6,145,64,81,126.5625
83,12,7,228,128,100,78.125
83,12,8,383,256,127,49.609375
83,12,9,326,512,-186,-36.328125
83,12,10,476,1024,-548,-53.515625
83,12,11,982,2048,-1066,-52.05078125
83,12,12,2057,4096,-2039,-49.7802734375
83,12,13,6676,8192,-1516,-18.505859375
83,12,14,17542,16384,1158,7.06787109375
83,12,15,8995,32768,-23773,-72.5494384765625
83,13,1,0,2,-2,-100.0
83,13,2,1,4,-3,-75.0
83,13,3,3,8,-5,-62.5
83,13,4,24,16,8,50.0
83,13,5,49,32,17,53.125
83,13,6,26,64,-38,-59.375
83,13,7,142,128,14,10.9375
83,13,8,290,256,34,13.28125
83,13,9,221,512,-291,-56.8359375
83,13,10,988,1024,-36,-3.515625
83,13,11,250,2048,-1798,-87.79296875
83,13,12,513,4096,-3583,-87.4755859375
83,13,13,18243,8192,10051,122.69287109375
83,13,14,24495,16384,8111,49.505615234375
83,13,15,43526,32768,10758,32.830810546875
83,14,1,0,2,-2,-100.0
83,14,2,1,4,-3,-75.0
83,14,3,4,8,-4,-50.0
83,14,4,6,16,-10,-62.5
83,14,5,24,32,-8,-25.0
83,14,6,46,64,-18,-28.125
83,14,7,100,128,-28,-21.875
83,14,8,204,256,-52,-20.3125
83,14,9,288,512,-224,-43.75
83,14,10,1221,1024,197,19.23828125
83,14,11,1062,2048,-986,-48.14453125
83,14,12,8263,4096,4167,101.7333984375
83,14,13,4416,8192,-3776,-46.09375
83,14,14,17376,16384,992,6.0546875
83,14,15,27161,32768,-5607,-17.1112060546875
83,15,1,0,2,-2,-100.0
83,15,2,7,4,3,75.0
83,15,3,2,8,-6,-75.0
83,15,4,3,16,-13,-81.25
83,15,5,47,32,15,46.875
83,15,6,8,64,-56,-87.5
83,15,7,6,128,-122,-95.3125
83,15,8,529,256,273,106.640625
83,15,9,730,512,218,42.578125
83,15,10,163,1024,-861,-84.08203125
83,15,11,1431,2048,-617,-30.126953125
83,15,12,7175,4096,3079,75.1708984375
83,15,13,4896,8192,-3296,-40.234375
83,15,14,14055,16384,-2329,-14.215087890625
83,15,15,5818,32768,-26950,-82.244873046875
83,16,1,0,2,-2,-100.0
83,16,2,1,4,-3,-75.0
83,16,3,9,8,1,12.5
83,16,4,25,16,9,56.25
83,16,5,12,32,-20,-62.5
83,16,6,38,64,-26,-40.625
83,16,7,1254,128,1126,879.6875
83,16,8,189,256,-67,-26.171875
83,16,9,37,512,-475,-92.7734375
83,16,10,314,1024,-710,-69.3359375
83,16,11,2807,2048,759,37.060546875
83,16,12,82,4096,-4014,-97.998046875
83,16,13,15246,8192,7054,86.1083984375
83,16,14,5118,16384,-11266,-68.76220703125
83,16,15,4726,32768,-28042,-85.577392578125
83,17,1,0,2,-2,-100.0
83,17,2,7,4,3,75.0
83,17,3,15,8,7,87.5
83,17,4,13,16,-3,-18.75
83,17,5,21,32,-11,-34.375
83,17,6,5,64,-59,-92.1875
83,17,7,69,128,-59,-46.09375
83,17,8,190,256,-66,-25.78125
83,17,9,710,512,198,38.671875
83,17,10,1142,1024,118,11.5234375
83,17,11,5051,2048,3003,146.630859375
83,17,12,13977,4096,9881,241.2353515625
83,17,13,7213,8192,-979,-11.95068359375
83,17,14,11700,16384,-4684,-28.5888671875
83,17,15,4987,32768,-27781,-84.7808837890625
83,18,1,0,2,-2,-100.0
83,18,2,1,4,-3,-75.0
83,18,3,3,8,-5,-62.5
83,18,4,4,16,-12,-75.0
83,18,5,64,32,32,100.0
83,18,6,69,64,5,7.8125
83,18,7,122,128,-6,-4.6875
83,18,8,259,256,3,1.171875
83,18,9,226,512,-286,-55.859375
83,18,10,11,1024,-1013,-98.92578125
83,18,11,4669,2048,2621,127.978515625
83,18,12,2917,4096,-1179,-28.7841796875
83,18,13,33247,8192,25055,305.84716796875
83,18,14,9330,16384,-7054,-43.05419921875
83,18,15,119420,32768,86652,264.44091796875
83,19,1,0,2,-2,-100.0
83,19,2,2,4,-2,-50.0
83,19,3,9,8,1,12.5
83,19,4,15,16,-1,-6.25
83,19,5,4,32,-28,-87.5
83,19,6,9,64,-55,-85.9375
83,19,7,381,128,253,197.65625
83,19,8,102,256,-154,-60.15625
83,19,9,41,512,-471,-91.9921875
83,19,10,488,1024,-536,-52.34375
83,19,11,2286,2048,238,11.62109375
83,19,12,436,4096,-3660,-89.35546875
83,19,13,4081,8192,-4111,-50.18310546875
83,19,14,31448,16384,15064,91.943359375
83,19,15,423,32768,-32345,-98.7091064453125
83,20,1,0,2,-2,-100.0
83,20,2,2,4,-2,-50.0
83,20,3,4,8,-4,-50.0
83,20,4,88,16,72,450.0
83,20,5,4,32,-28,-87.5
83,20,6,29,64,-35,-54.6875
83,20,7,150,128,22,17.1875
83,20,8,130,256,-126,-49.21875
83,20,9,192,512,-320,-62.5
83,20,10,125,1024,-899,-87.79296875
83,20,11,1707,2048,-341,-16.650390625
83,20,12,8150,4096,4054,98.974609375
83,20,13,24834,8192,16642,203.1494140625
83,20,14,14195,16384,-2189,-13.360595703125
83,20,15,21408,32768,-11360,-34.66796875
83,21,1,0,2,-2,-100.0
83,21,2,2,4,-2,-50.0
83,21,3,2,8,-6,-75.0
83,21,4,45,16,29,181.25
83,21,5,22,32,-10,-31.25
83,21,6,19,64,-45,-70.3125
83,21,7,307,128,179,139.84375
83,21,8,98,256,-158,-61.71875
83,21,9,805,512,293,57.2265625
83,21,10,779,1024,-245,-23.92578125
83,21,11,416,2048,-1632,-79.6875
83,21,12,3898,4096,-198,-4.833984375
83,21,13,72982,8192,64790,790.8935546875
83,21,14,20167,16384,3783,23.089599609375
83,21,15,27344,32768,-5424,-16.552734375
83,22,1,0,2,-2,-100.0
83,22,2,1,4,-3,-75.0
83,22,3,2,8,-6,-75.0
83,22,4,15,16,-1,-6.25
83,22,5,6,32,-26,-81.25
83,22,6,5,64,-59,-92.1875
83,22,7,151,128,23,17.96875
83,22,8,379,256,123,48.046875
83,22,9,806,512,294,57.421875
83,22,10,3268,1024,2244,219.140625
83,22,11,345,2048,-1703,-83.154296875
83,22,12,7955,4096,3859,94.2138671875
83,22,13,7367,8192,-825,-10.07080078125
83,22,14,11846,16384,-4538,-27.69775390625
83,22,15,6422,32768,-26346,-80.401611328125
83,23,1,0,2,-2,-100.0
83,23,2,2,4,-2,-50.0
83,23,3,15,8,7,87.5
83,23,4,17,16,1,6.25
83,23,5,13,32,-19,-59.375
83,23,6,9,64,-55,-85.9375
83,23,7,97,128,-31,-24.21875
83,23,8,21,256,-235,-91.796875
83,23,9,711,512,199,38.8671875
83,23,10,77,1024,-947,-92.48046875
83,23,11,1605,2048,-443,-21.630859375
83,23,12,725,4096,-3371,-82.2998046875
83,23,13,2503,8192,-5689,-69.44580078125
83,23,14,24936,16384,8552,52.197265625
83,23,15,37879,32768,5111,15.5975341796875
83,24,1,0,2,-2,-100.0
83,24,2,3,4,-1,-25.0
83,24,3,5,8,-3,-37.5
83,24,4,18,16,2,12.5
83,24,5,30,32,-2,-6.25
83,24,6,55,64,-9,-14.0625
83,24,7,129,128,1,0.78125
83,24,8,84,256,-172,-67.1875
83,24,9,109,512,-403,-78.7109375
83,24,10,643,1024,-381,-37.20703125
83,24,11,6903,2048,4855,237.060546875
83,24,12,16592,4096,12496,305.078125
83,24,13,2815,8192,-5377,-65.63720703125
83,24,14,21219,16384,4835,29.510498046875
83,24,15,96896,32768,64128,195.703125
83,25,1,0,2,-2,-100.0
83,25,2,1,4,-3,-75.0
83,25,3,16,8,8,100.0
83,25,4,8,16,-8,-50.0
83,25,5,23,32,-9,-28.125
83,25,6,75,64,11,17.1875
83,25,7,78,128,-50,-39.0625
83,25,8,236,256,-20,-7.8125
83,25,9,618,512,106,20.703125
83,25,10,140,1024,-884,-86.328125
83,25,11,2971,2048,923,45.068359375
83,25,12,2198,4096,-1898,-46.337890625
83,25,13,2266,8192,-5926,-72.3388671875
83,25,14,4283,16384,-12101,-73.858642578125
83,25,15,12812,32768,-19956,-60.90087890625
83,26,1,0,2,-2,-100.0
83,26,2,1,4,-3,-75.0
83,26,3,5,8,-3,-37.5
83,26,4,12,16,-4,-25.0
83,26,5,18,32,-14,-43.75
83,26,6,65,64,1,1.5625
83,26,7,233,128,105,82.03125
83,26,8,223,256,-33,-12.890625
83,26,9,1051,512,539,105.2734375
83,26,10,230,1024,-794,-77.5390625
83,26,11,137,2048,-1911,-93.310546875
83,26,12,6923,4096,2827,69.0185546875
83,26,13,25776,8192,17584,214.6484375
83,26,14,58656,16384,42272,258.0078125
83,26,15,7399,32768,-25369,-77.4200439453125
83,27,1,0,2,-2,-100.0
83,27,2,1,4,-3,-75.0
83,27,3,6,8,-2,-25.0
83,27,4,7,16,-9,-56.25
83,27,5,9,32,-23,-71.875
83,27,6,46,64,-18,-28.125
83,27,7,179,128,51,39.84375
83,27,8,246,256,-10,-3.90625
83,27,9,385,512,-127,-24.8046875
83,27,10,1655,1024,631,61.62109375
83,27,11,765,2048,-1283,-62.646484375
83,27,12,573,4096,-3523,-86.0107421875
83,27,13,2404,8192,-5788,-70.654296875
83,27,14,10783,16384,-5601,-34.185791015625
83,27,15,4649,32768,-28119,-85.8123779296875
83,28,1,0,2,-2,-100.0
83,28,2,1,4,-3,-75.0
83,28,3,13,8,5,62.5
83,28,4,3,16,-13,-81.25
83,28,5,14,32,-18,-56.25
83,28,6,82,64,18,28.125
83,28,7,121,128,-7,-5.46875
83,28,8,101,256,-155,-60.546875
83,28,9,160,512,-352,-68.75
83,28,10,770,1024,-254,-24.8046875
83,28,11,3339,2048,1291,63.037109375
83,28,12,197,4096,-3899,-95.1904296875
83,28,13,7828,8192,-364,-4.443359375
83,28,14,12628,16384,-3756,-22.9248046875
83,28,15,58959,32768,26191,79.9285888671875
83,29,1,0,2,-2,-100.0
83,29,2,3,4,-1,-25.0
83,29,3,6,8,-2,-25.0
83,29,4,18,16,2,12.5
83,29,5,12,32,-20,-62.5
83,29,6,60,64,-4,-6.25
83,29,7,123,128,-5,-3.90625
83,29,8,119,256,-137,-53.515625
83,29,9,590,512,78,15.234375
83,29,10,257,1024,-767,-74.90234375
83,29,11,1895,2048,-153,-7.470703125
83,29,12,8562,4096,4466,109.033203125
83,29,13,6799,8192,-1393,-17.00439453125
83,29,14,1257,16384,-15127,-92.327880859375
83,29,15,7652,32768,-25116,-76.64794921875
83,30,1,0,2,-2,-100.0
83,30,2,1,4,-3,-75.0
83,30,3,7,8,-1,-12.5
83,30,4,11,16,-5,-31.25
83,30,5,7,32,-25,-78.125
83,30,6,64,64,0,0.0
83,30,7,33,128,-95,-74.21875
83,30,8,473,256,217,84.765625
83,30,9,80,512,-432,-84.375
83,30,10,1678,1024,654,63.8671875
83,30,11,751,2048,-1297,-63.330078125
83,30,12,3844,4096,-252,-6.15234375
83,30,13,9266,8192,1074,13.1103515625
83,30,14,3639,16384,-12745,-77.789306640625
83,30,15,29794,32768,-2974,-9.075927734375
83,31,1,0,2,-2,-100.0
83,31,2,1,4,-3,-75.0
83,31,3,2,8,-6,-75.0
83,31,4,11,16,-5,-31.25
83,31,5,10,32,-22,-68.75
83,31,6,55,64,-9,-14.0625
83,31,7,38,128,-90,-70.3125
83,31,8,38,256,-218,-85.15625
83,31,9,709,512,197,38.4765625
83,31,10,1882,1024,858,83.7890625
83,31,11,2524,2048,476,23.2421875
83,31,12,2532,4096,-1564,-38.18359375
83,31,13,12526,8192,4334,52.9052734375
83,31,14,6672,16384,-9712,-59.27734375
83,31,15,18295,32768,-14473,-44.1680908203125
83,32,1,0,2,-2,-100.0
83,32,2,1,4,-3,-75.0
83,32,3,2,8,-6,-75.0
83,32,4,18,16,2,12.5
83,32,5,15,32,-17,-53.125
83,32,6,9,64,-55,-85.9375
83,32,7,115,128,-13,-10.15625
83,32,8,77,256,-179,-69.921875
83,32,9,328,512,-184,-35.9375
83,32,10,1827,1024,803,78.41796875
83,32,11,3634,2048,1586,77.44140625
83,32,12,4350,4096,254,6.201171875
83,32,13,958,8192,-7234,-88.3056640625
83,32,14,48334,16384,31950,195.00732421875
83,32,15,102365,32768,69597,212.3931884765625
83,33,1,0,2,-2,-100.0
83,33,2,2,4,-2,-50.0
83,33,3,2,8,-6,-75.0
83,33,4,13,16,-3,-18.75
83,33,5,14,32,-18,-56.25
83,33,6,5,64,-59,-92.1875
83,33,7,129,128,1,0.78125
83,33,8,175,256,-81,-31.640625
83,33,9,71,512,-441,-86.1328125
83,33,10,525,1024,-499,-48.73046875
83,33,11,3261,2048,1213,59.228515625
83,33,12,5732,4096,1636,39.94140625
83,33,13,24296,8192,16104,196.58203125
83,33,14,8152,16384,-8232,-50.244140625
83,33,15,12516,32768,-20252,-61.80419921875
83,34,1,0,2,-2,-100.0
83,34,2,1,4,-3,-75.0
83,34,3,5,8,-3,-37.5
83,34,4,5,16,-11,-68.75
83,34,5,50,32,18,56.25
83,34,6,53,64,-11,-17.1875
83,34,7,86,128,-42,-32.8125
83,34,8,255,256,-1,-0.390625
83,34,9,195,512,-317,-61.9140625
83,34,10,66,1024,-958,-93.5546875
83,34,11,531,2048,-1517,-74.072265625
83,34,12,3356,4096,-740,-18.06640625
83,34,13,499,8192,-7693,-93.90869140625
83,34,14,7907,16384,-8477,-51.739501953125
83,34,15,29435,32768,-3333,-10.1715087890625
83,35,1,0,2,-2,-100.0
83,35,2,1,4,-3,-75.0
83,35,3,2,8,-6,-75.0
83,35,4,6,16,-10,-62.5
83,35,5,27,32,-5,-15.625
83,35,6,63,64,-1,-1.5625
83,35,7,14,128,-114,-89.0625
83,35,8,765,256,509,198.828125
83,35,9,486,512,-26,-5.078125
83,35,10,248,1024,-776,-75.78125
83,35,11,2407,2048,359,17.529296875
83,35,12,8347,4096,4251,103.7841796875
83,35,13,1258,8192,-6934,-84.6435546875
83,35,14,23609,16384,7225,44.097900390625
83,35,15,42045,32768,9277,28.3111572265625
83,36,1,0,2,-2,-100.0
83,36,2,4,4,0,0.0
83,36,3,7,8,-1,-12.5
83,36,4,28,16,12,75.0
83,36,5,62,32,30,93.75
83,36,6,221,64,157,245.3125
83,36,7,12,128,-116,-90.625
83,36,8,70,256,-186,-72.65625
83,36,9,881,512,369,72.0703125
83,36,10,1668,1024,644,62.890625
83,36,11,4850,2048,2802,136.81640625
83,36,12,1896,4096,-2200,-53.7109375
83,36,13,13648,8192,5456,66.6015625
83,36,14,20186,16384,3802,23.20556640625
83,36,15,8688,32768,-24080,-73.486328125
83,37,1,0,2,-2,-100.0
83,37,2,1,4,-3,-75.0
83,37,3,2,8,-6,-75.0
83,37,4,7,16,-9,-56.25
83,37,5,40,32,8,25.0
83,37,6,21,64,-43,-67.1875
83,37,7,134,128,6,4.6875
83,37,8,522,256,266,103.90625
83,37,9,66,512,-446,-87.109375
83,37,10,28,1024,-996,-97.265625
83,37,11,624,2048,-1424,-69.53125
83,37,12,1211,4096,-2885,-70.4345703125
83,37,13,16795,8192,8603,105.01708984375
83,37,14,5143,16384,-11241,-68.609619140625
83,37,15,32368,32768,-400,-1.220703125
83,38,1,0,2,-2,-100.0
83,38,2,2,4,-2,-50.0
83,38,3,2,8,-6,-75.0
83,38,4,14,16,-2,-12.5
83,38,5,25,32,-7,-21.875
83,38,6,49,64,-15,-23.4375
83,38,7,7,128,-121,-94.53125
83,38,8,24,256,-232,-90.625
83,38,9,224,512,-288,-56.25
83,38,10,13,1024,-1011,-98.73046875
83,38,11,6507,2048,4459,217.724609375
83,38,12,5872,4096,1776,43.359375
83,38,13,5556,8192,-2636,-32.177734375
83,38,14,1872,16384,-14512,-88.57421875
83,38,15,1504,32768,-31264,-95.41015625
83,39,1,0,2,-2,-100.0
83,39,2,1,4,-3,-75.0
83,39,3,4,8,-4,-50.0
83,39,4,9,16,-7,-43.75
83,39,5,22,32,-10,-31.25
83,39,6,111,64,47,73.4375
83,39,7,75,128,-53,-41.40625
83,39,8,132,256,-124,-48.4375
83,39,9,57,512,-455,-88.8671875
83,39,10,2498,1024,1474,143.9453125
83,39,11,4387,2048,2339,114.208984375
83,39,12,5741,4096,1645,40.1611328125
83,39,13,12459,8192,4267,52.08740234375
83,39,14,7780,16384,-8604,-52.5146484375
83,39,15,22071,32768,-10697,-32.6446533203125
83,40,1,0,2,-2,-100.0
83,40,2,1,4,-3,-75.0
83,40,3,3,8,-5,-62.5
83,40,4,11,16,-5,-31.25
83,40,5,35,32,3,9.375
83,40,6,44,64,-20,-31.25
83,40,7,249,128,121,94.53125
83,40,8,7,256,-249,-97.265625
83,40,9,265,512,-247,-48.2421875
83,40,10,1358,1024,334,32.6171875
83,40,11,435,2048,-1613,-78.759765625
83,40,12,566,4096,-3530,-86.181640625
83,40,13,23547,8192,15355,187.43896484375
83,40,14,22952,16384,6568,40.087890625
83,40,15,3459,32768,-29309,-89.4439697265625
83,41,1,0,2,-2,-100.0
83,41,2,1,4,-3,-75.0
83,41,3,4,8,-4,-50.0
83,41,4,8,16,-8,-50.0
83,41,5,71,32,39,121.875
83,41,6,26,64,-38,-59.375
83,41,7,108,128,-20,-15.625
83,41,8,505,256,249,97.265625
83,41,9,1363,512,851,166.2109375
83,41,10,453,1024,-571,-55.76171875
83,41,11,1707,2048,-341,-16.650390625
83,41,12,10365,4096,6269,153.0517578125
83,41,13,4712,8192,-3480,-42.48046875
83,41,14,12402,16384,-3982,-24.30419921875
83,41,15,9266,32768,-23502,-71.722412109375
83,42,1,0,2,-2,-100.0
83,42,2,2,4,-2,-50.0
83,42,3,10,8,2,25.0
83,42,4,5,16,-11,-68.75
83,42,5,29,32,-3,-9.375
83,42,6,20,64,-44,-68.75
83,42,7,93,128,-35,-27.34375
83,42,8,138,256,-118,-46.09375
83,42,9,1017,512,505,98.6328125
83,42,10,1790,1024,766,74.8046875
83,42,11,1489,2048,-559,-27.294921875
83,42,12,6814,4096,2718,66.357421875
83,42,13,9306,8192,1114,13.5986328125
83,42,14,10577,16384,-5807,-35.443115234375
83,42,15,83957,32768,51189,156.2164306640625
83,43,1,0,2,-2,-100.0
83,43,2,1,4,-3,-75.0
83,43,3,5,8,-3,-37.5
83,43,4,18,16,2,12.5
83,43,5,33,32,1,3.125
83,43,6,12,64,-52,-81.25
83,43,7,72,128,-56,-43.75
83,43,8,189,256,-67,-26.171875
83,43,9,55,512,-457,-89.2578125
83,43,10,203,1024,-821,-80.17578125
83,43,11,499,2048,-1549,-75.634765625
83,43,12,939,4096,-3157,-77.0751953125
83,43,13,36732,8192,28540,348.388671875
83,43,14,2897,16384,-13487,-82.318115234375
83,43,15,45887,32768,13119,40.0360107421875
83,44,1,0,2,-2,-100.0
83,44,2,4,4,0,0.0
83,44,3,12,8,4,50.0
83,44,4,5,16,-11,-68.75
83,44,5,15,32,-17,-53.125
83,44,6,16,64,-48,-75.0
83,44,7,81,128,-47,-36.71875
83,44,8,44,256,-212,-82.8125
83,44,9,68,512,-444,-86.71875
83,44,10,329,1024,-695,-67.87109375
83,44,11,1102,2048,-946,-46.19140625
83,44,12,6304,4096,2208,53.90625
83,44,13,4793,8192,-3399,-41.49169921875
83,44,14,12601,16384,-3783,-23.089599609375
83,44,15,191962,32768,159194,485.821533203125
83,45,1,0,2,-2,-100.0
83,45,2,3,4,-1,-25.0
83,45,3,2,8,-6,-75.0
83,45,4,24,16,8,50.0
83,45,5,75,32,43,134.375
83,45,6,9,64,-55,-85.9375
83,45,7,6,128,-122,-95.3125
83,45,8,109,256,-147,-57.421875
83,45,9,958,512,446,87.109375
83,45,10,1069,1024,45,4.39453125
83,45,11,2781,2048,733,35.791015625
83,45,12,628,4096,-3468,-84.66796875
83,45,13,564,8192,-7628,-93.115234375
83,45,14,15685,16384,-699,-4.266357421875
83,45,15,27001,32768,-5767,-17.5994873046875
83,46,1,0,2,-2,-100.0
83,46,2,3,4,-1,-25.0
83,46,3,2,8,-6,-75.0
83,46,4,14,16,-2,-12.5
83,46,5,4,32,-28,-87.5
83,46,6,122,64,58,90.625
83,46,7,577,128,449,350.78125
83,46,8,382,256,126,49.21875
83,46,9,196,512,-316,-61.71875
83,46,10,983,1024,-41,-4.00390625
83,46,11,2649,2048,601,29.345703125
83,46,12,3278,4096,-818,-19.970703125
83,46,13,3868,8192,-4324,-52.783203125
83,46,14,3903,16384,-12481,-76.177978515625
83,46,15,8764,32768,-24004,-73.25439453125
83,47,1,0,2,-2,-100.0
83,47,2,1,4,-3,-75.0
83,47,3,13,8,5,62.5
83,47,4,5,16,-11,-68.75
83,47,5,44,32,12,37.5
83,47,6,15,64,-49,-76.5625
83,47,7,8,128,-120,-93.75
83,47,8,175,256,-81,-31.640625
83,47,9,275,512,-237,-46.2890625
83,47,10,1423,1024,399,38.96484375
83,47,11,5338,2048,3290,160.64453125
83,47,12,172,4096,-3924,-95.80078125
83,47,13,64,8192,-8128,-99.21875
83,47,14,1400,16384,-14984,-91.455078125
83,47,15,7885,32768,-24883,-75.9368896484375
83,48,1,0,2,-2,-100.0
83,48,2,1,4,-3,-75.0
83,48,3,2,8,-6,-75.0
83,48,4,19,16,3,18.75
83,48,5,26,32,-6,-18.75
83,48,6,69,64,5,7.8125
83,48,7,225,128,97,75.78125
83,48,8,306,256,50,19.53125
83,48,9,279,512,-233,-45.5078125
83,48,10,1074,1024,50,4.8828125
83,48,11,7839,2048,5791,282.763671875
83,48,12,1357,4096,-2739,-66.8701171875
83,48,13,5965,8192,-2227,-27.18505859375
83,48,14,17471,16384,1087,6.634521484375
83,48,15,26949,32768,-5819,-17.7581787109375
83,49,1,0,2,-2,-100.0
83,49,2,1,4,-3,-75.0
83,49,3,5,8,-3,-37.5
83,49,4,23,16,7,43.75
83,49,5,37,32,5,15.625
83,49,6,86,64,22,34.375
83,49,7,52,128,-76,-59.375
83,49,8,107,256,-149,-58.203125
83,49,9,212,512,-300,-58.59375
83,49,10,4501,1024,3477,339.55078125
83,49,11,4527,2048,2479,121.044921875
83,49,12,5768,4096,1672,40.8203125
83,49,13,38577,8192,30385,370.91064453125
83,49,14,29187,16384,12803,78.143310546875
83,49,15,15835,32768,-16933,-51.6754150390625
83,50,1,0,2,-2,-100.0
83,50,2,3,4,-1,-25.0
83,50,3,6,8,-2,-25.0
83,50,4,8,16,-8,-50.0
83,50,5,14,32,-18,-56.25
83,50,6,30,64,-34,-53.125
83,50,7,17,128,-111,-86.71875
83,50,8,87,256,-169,-66.015625
83,50,9,449,512,-63,-12.3046875
83,50,10,709,1024,-315,-30.76171875
83,50,11,9290,2048,7242,353.61328125
83,50,12,11698,4096,7602,185.595703125
83,50,13,13295,8192,5103,62.29248046875
83,50,14,609,16384,-15775,-96.282958984375
83,50,15,1192,32768,-31576,-96.3623046875
83,51,1,0,2,-2,-100.0
83,51,2,6,4,2,50.0
83,51,3,9,8,1,12.5
83,51,4,4,16,-12,-75.0
83,51,5,51,32,19,59.375
83,51,6,19,64,-45,-70.3125
83,51,7,17,128,-111,-86.71875
83,51,8,1204,256,948,370.3125
83,51,9,365,512,-147,-28.7109375
83,51,10,726,1024,-298,-29.1015625
83,51,11,65,2048,-1983,-96.826171875
83,51,12,3277,4096,-819,-19.9951171875
83,51,13,622,8192,-7570,-92.4072265625
83,51,14,3585,16384,-12799,-78.118896484375
83,51,15,2219,32768,-30549,-93.2281494140625
83,52,1,0,2,-2,-100.0
83,52,2,1,4,-3,-75.0
83,52,3,3,8,-5,-62.5
83,52,4,10,16,-6,-37.5
83,52,5,9,32,-23,-71.875
83,52,6,19,64,-45,-70.3125
83,52,7,332,128,204,159.375
83,52,8,11,256,-245,-95.703125
83,52,9,33,512,-479,-93.5546875
83,52,10,208,1024,-816,-79.6875
83,52,11,693,2048,-1355,-66.162109375
83,52,12,8098,4096,4002,97.705078125
83,52,13,4433,8192,-3759,-45.88623046875
83,52,14,1499,16384,-14885,-90.850830078125
83,52,15,32435,32768,-333,-1.0162353515625
83,53,1,0,2,-2,-100.0
83,53,2,6,4,2,50.0
83,53,3,3,8,-5,-62.5
83,53,4,28,16,12,75.0
83,53,5,56,32,24,75.0
83,53,6,75,64,11,17.1875
83,53,7,123,128,-5,-3.90625
83,53,8,280,256,24,9.375
83,53,9,309,512,-203,-39.6484375
83,53,10,830,1024,-194,-18.9453125
83,53,11,2066,2048,18,0.87890625
83,53,12,1864,4096,-2232,-54.4921875
83,53,13,24334,8192,16142,197.0458984375
83,53,14,335,16384,-16049,-97.955322265625
83,53,15,476,32768,-32292,-98.54736328125
83,54,1,0,2,-2,-100.0
83,54,2,1,4,-3,-75.0
83,54,3,2,8,-6,-75.0
83,54,4,3,16,-13,-81.25
83,54,5,18,32,-14,-43.75
83,54,6,134,64,70,109.375
83,54,7,138,128,10,7.8125
83,54,8,618,256,362,141.40625
83,54,9,561,512,49,9.5703125
83,54,10,815,1024,-209,-20.41015625
83,54,11,6626,2048,4578,223.53515625
83,54,12,10277,4096,6181,150.9033203125
83,54,13,23829,8192,15637,190.88134765625
83,54,14,4249,16384,-12135,-74.066162109375
83,54,15,66451,32768,33683,102.7923583984375
83,55,1,0,2,-2,-100.0
83,55,2,1,4,-3,-75.0
83,55,3,5,8,-3,-37.5
83,55,4,3,16,-13,-81.25
83,55,5,36,32,4,12.5
83,55,6,182,64,118,184.375
83,55,7,46,128,-82,-64.0625
83,55,8,124,256,-132,-51.5625
83,55,9,444,512,-68,-13.28125
83,55,10,687,1024,-337,-32.91015625
83,55,11,2728,2048,680,33.203125
83,55,12,1592,4096,-2504,-61.1328125
83,55,13,18542,8192,10350,126.3427734375
83,55,14,4861,16384,-11523,-70.330810546875
83,55,15,140774,32768,108006,329.608154296875
83,56,1,0,2,-2,-100.0
83,56,2,1,4,-3,-75.0
83,56,3,5,8,-3,-37.5
83,56,4,8,16,-8,-50.0
83,56,5,8,32,-24,-75.0
83,56,6,80,64,16,25.0
83,56,7,103,128,-25,-19.53125
83,56,8,398,256,142,55.46875
83,56,9,1023,512,511,99.8046875
83,56,10,68,1024,-956,-93.359375
83,56,11,2633,2048,585,28.564453125
83,56,12,9893,4096,5797,141.5283203125
83,56,13,333,8192,-7859,-95.93505859375
83,56,14,15104,16384,-1280,-7.8125
83,56,15,60520,32768,27752,84.6923828125
83,57,1,0,2,-2,-100.0
83,57,2,1,4,-3,-75.0
83,57,3,11,8,3,37.5
83,57,4,14,16,-2,-12.5
83,57,5,5,32,-27,-84.375
83,57,6,95,64,31,48.4375
83,57,7,22,128,-106,-82.8125
83,57,8,334,256,78,30.46875
83,57,9,630,512,118,23.046875
83,57,10,472,1024,-552,-53.90625
83,57,11,524,2048,-1524,-74.4140625
83,57,12,7996,4096,3900,95.21484375
83,57,13,17290,8192,9098,111.0595703125
83,57,14,17287,16384,903,5.511474609375
83,57,15,60943,32768,28175,85.9832763671875
83,58,1,0,2,-2,-100.0
83,58,2,3,4,-1,-25.0
83,58,3,9,8,1,12.5
83,58,4,41,16,25,156.25
83,58,5,7,32,-25,-78.125
83,58,6,82,64,18,28.125
83,58,7,101,128,-27,-21.09375
83,58,8,65,256,-191,-74.609375
83,58,9,1214,512,702,137.109375
83,58,10,293,1024,-731,-71.38671875
83,58,11,540,2048,-1508,-73.6328125
83,58,12,679,4096,-3417,-83.4228515625
83,58,13,9327,8192,1135,13.85498046875
83,58,14,15388,16384,-996,-6.0791015625
83,58,15,37358,32768,4590,14.007568359375
83,59,1,0,2,-2,-100.0
83,59,2,3,4,-1,-25.0
83,59,3,10,8,2,25.0
83,59,4,11,16,-5,-31.25
83,59,5,67,32,35,109.375
83,59,6,88,64,24,37.5
83,59,7,38,128,-90,-70.3125
83,59,8,151,256,-105,-41.015625
83,59,9,947,512,435,84.9609375
83,59,10,1768,1024,744,72.65625
83,59,11,4502,2048,2454,119.82421875
83,59,12,9582,4096,5486,133.935546875
83,59,13,7645,8192,-547,-6.67724609375
83,59,14,11690,16384,-4694,-28.64990234375
83,59,15,2750,32768,-30018,-91.607666015625
83,60,1,0,2,-2,-100.0
83,60,2,1,4,-3,-75.0
83,60,3,3,8,-5,-62.5
83,60,4,18,16,2,12.5
83,60,5,139,32,107,334.375
83,60,6,209,64,145,226.5625
83,60,7,373,128,245,191.40625
83,60,8,253,256,-3,-1.171875
83,60,9,1016,512,504,98.4375
83,60,10,1811,1024,787,76.85546875
83,60,11,2847,2048,799,39.013671875
83,60,12,1357,4096,-2739,-66.8701171875
83,60,13,16588,8192,8396,102.490234375
83,60,14,9325,16384,-7059,-43.084716796875
83,60,15,2640,32768,-30128,-91.943359375
83,61,1,0,2,-2,-100.0
83,61,2,1,4,-3,-75.0
83,61,3,2,8,-6,-75.0
83,61,4,5,16,-11,-68.75
83,61,5,36,32,4,12.5
83,61,6,162,64,98,153.125
83,61,7,123,128,-5,-3.90625
83,61,8,192,256,-64,-25.0
83,61,9,489,512,-23,-4.4921875
83,61,10,2436,1024,1412,137.890625
83,61,11,4272,2048,2224,108.59375
83,61,12,2723,4096,-1373,-33.5205078125
83,61,13,4105,8192,-4087,-49.89013671875
83,61,14,13915,16384,-2469,-15.069580078125
83,61,15,825,32768,-31943,-97.4822998046875
83,62,1,0,2,-2,-100.0
83,62,2,1,4,-3,-75.0
83,62,3,8,8,0,0.0
83,62,4,7,16,-9,-56.25
83,62,5,16,32,-16,-50.0
83,62,6,16,64,-48,-75.0
83,62,7,49,128,-79,-61.71875
83,62,8,314,256,58,22.65625
83,62,9,253,512,-259,-50.5859375
83,62,10,678,1024,-346,-33.7890625
83,62,11,725,2048,-1323,-64.599609375
83,62,12,4838,4096,742,18.115234375
83,62,13,15542,8192,7350,89.7216796875
83,62,14,1627,16384,-14757,-90.069580078125
83,62,15,14203,32768,-18565,-56.6558837890625
83,63,1,0,2,-2,-100.0
83,63,2,1,4,-3,-75.0
83,63,3,2,8,-6,-75.0
83,63,4,6,16,-10,-62.5
83,63,5,32,32,0,0.0
83,63,6,29,64,-35,-54.6875
83,63,7,6,128,-122,-95.3125
83,63,8,25,256,-231,-90.234375
83,63,9,290,512,-222,-43.359375
83,63,10,1363,1024,339,33.10546875
83,63,11,1527,2048,-521,-25.439453125
83,63,12,798,4096,-3298,-80.517578125
83,63,13,336,8192,-7856,-95.8984375
83,63,14,4717,16384,-11667,-71.209716796875
83,63,15,78168,32768,45400,138.5498046875
83,64,1,0,2,-2,-100.0
83,64,2,2,4,-2,-50.0
83,64,3,4,8,-4,-50.0
83,64,4,19,16,3,18.75
83,64,5,28,32,-4,-12.5
83,64,6,93,64,29,45.3125
83,64,7,59,128,-69,-53.90625
83,64,8,68,256,-188,-73.4375
83,64,9,361,512,-151,-29.4921875
83,64,10,183,1024,-841,-82.12890625
83,64,11,4589,2048,2541,124.072265625
83,64,12,777,4096,-3319,-81.0302734375
83,64,13,11363,8192,3171,38.70849609375
83,64,14,30978,16384,14594,89.07470703125
83,64,15,21485,32768,-11283,-34.4329833984375
83,65,1,0,2,-2,-100.0
83,65,2,4,4,0,0.0
83,65,3,2,8,-6,-75.0
83,65,4,15,16,-1,-6.25
83,65,5,6,32,-26,-81.25
83,65,6,31,64,-33,-51.5625
83,65,7,131,128,3,2.34375
83,65,8,233,256,-23,-8.984375
83,65,9,290,512,-222,-43.359375
83,65,10,1602,1024,578,56.4453125
83,65,11,1078,2048,-970,-47.36328125
83,65,12,11311,4096,7215,176.1474609375
83,65,13,2282,8192,-5910,-72.1435546875
83,65,14,18687,16384,2303,14.056396484375
83,65,15,10553,32768,-22215,-67.7947998046875
83,66,1,0,2,-2,-100.0
83,66,2,1,4,-3,-75.0
83,66,3,7,8,-1,-12.5
83,66,4,6,16,-10,-62.5
83,66,5,20,32,-12,-37.5
83,66,6,17,64,-47,-73.4375
83,66,7,42,128,-86,-67.1875
83,66,8,279,256,23,8.984375
83,66,9,127,512,-385,-75.1953125
83,66,10,1119,1024,95,9.27734375
83,66,11,451,2048,-1597,-77.978515625
83,66,12,1716,4096,-2380,-58.10546875
83,66,13,2037,8192,-6155,-75.13427734375
83,66,14,29021,16384,12637,77.130126953125
83,66,15,4027,32768,-28741,-87.7105712890625
83,67,1,0,2,-2,-100.0
83,67,2,3,4,-1,-25.0
83,67,3,3,8,-5,-62.5
83,67,4,28,16,12,75.0
83,67,5,10,32,-22,-68.75
83,67,6,8,64,-56,-87.5
83,67,7,158,128,30,23.4375
83,67,8,210,256,-46,-17.96875
83,67,9,127,512,-385,-75.1953125
83,67,10,110,1024,-914,-89.2578125
83,67,11,6323,2048,4275,208.740234375
83,67,12,3823,4096,-273,-6.6650390625
83,67,13,25345,8192,17153,209.38720703125
83,67,14,10400,16384,-5984,-36.5234375
83,67,15,18259,32768,-14509,-44.2779541015625
83,68,1,0,2,-2,-100.0
83,68,2,3,4,-1,-25.0
83,68,3,7,8,-1,-12.5
83,68,4,53,16,37,231.25
83,68,5,28,32,-4,-12.5
83,68,6,78,64,14,21.875
83,68,7,102,128,-26,-20.3125
83,68,8,331,256,75,29.296875
83,68,9,1275,512,763,149.0234375
83,68,10,340,1024,-684,-66.796875
83,68,11,1883,2048,-165,-8.056640625
83,68,12,6921,4096,2825,68.9697265625
83,68,13,9794,8192,1602,19.5556640625
83,68,14,4955,16384,-11429,-69.757080078125
83,68,15,41620,32768,8852,27.01416015625
83,69,1,0,2,-2,-100.0
83,69,2,1,4,-3,-75.0
83,69,3,4,8,-4,-50.0
83,69,4,5,16,-11,-68.75
83,69,5,26,32,-6,-18.75
83,69,6,17,64,-47,-73.4375
83,69,7,167,128,39,30.46875
83,69,8,466,256,210,82.03125
83,69,9,278,512,-234,-45.703125
83,69,10,230,1024,-794,-77.5390625
83,69,11,1610,2048,-438,-21.38671875
83,69,12,147,4096,-3949,-96.4111328125
83,69,13,10429,8192,2237,27.30712890625
83,69,14,12276,16384,-4108,-25.0732421875
83,69,15,57831,32768,25063,76.4862060546875
83,70,1,0,2,-2,-100.0
83,70,2,2,4,-2,-50.0
83,70,3,5,8,-3,-37.5
83,70,4,7,16,-9,-56.25
83,70,5,12,32,-20,-62.5
83,70,6,241,64,177,276.5625
83,70,7,46,128,-82,-64.0625
83,70,8,198,256,-58,-22.65625
83,70,9,197,512,-315,-61.5234375
83,70,10,546,1024,-478,-46.6796875
83,70,11,316,2048,-1732,-84.5703125
83,70,12,1835,4096,-2261,-55.2001953125
83,70,13,6414,8192,-1778,-21.7041015625
83,70,14,16520,16384,136,0.830078125
83,70,15,8586,32768,-24182,-73.797607421875
83,71,1,0,2,-2,-100.0
83,71,2,1,4,-3,-75.0
83,71,3,2,8,-6,-75.0
83,71,4,3,16,-13,-81.25
83,71,5,90,32,58,181.25
83,71,6,5,64,-59,-92.1875
83,71,7,173,128,45,35.15625
83,71,8,193,256,-63,-24.609375
83,71,9,376,512,-136,-26.5625
83,71,10,1873,1024,849,82.91015625
83,71,11,299,2048,-1749,-85.400390625
83,71,12,18429,4096,14333,349.9267578125
83,71,13,1989,8192,-6203,-75.72021484375
83,71,14,10645,16384,-5739,-35.028076171875
83,71,15,92140,32768,59372,181.18896484375
83,72,1,0,2,-2,-100.0
83,72,2,2,4,-2,-50.0
83,72,3,2,8,-6,-75.0
83,72,4,12,16,-4,-25.0
83,72,5,33,32,1,3.125
83,72,6,28,64,-36,-56.25
83,72,7,165,128,37,28.90625
83,72,8,51,256,-205,-80.078125
83,72,9,1033,512,521,101.7578125
83,72,10,180,1024,-844,-82.421875
83,72,11,377,2048,-1671,-81.591796875
83,72,12,2752,4096,-1344,-32.8125
83,72,13,5938,8192,-2254,-27.5146484375
83,72,14,82438,16384,66054,403.16162109375
83,72,15,4368,32768,-28400,-86.669921875
83,73,1,0,2,-2,-100.0
83,73,2,6,4,2,50.0
83,73,3,3,8,-5,-62.5
83,73,4,3,16,-13,-81.25
83,73,5,15,32,-17,-53.125
83,73,6,147,64,83,129.6875
83,73,7,289,128,161,125.78125
83,73,8,846,256,590,230.46875
83,73,9,522,512,10,1.953125
83,73,10,1457,1024,433,42.28515625
83,73,11,39,2048,-2009,-98.095703125
83,73,12,4773,4096,677,16.5283203125
83,73,13,2451,8192,-5741,-70.08056640625
83,73,14,42802,16384,26418,161.24267578125
83,73,15,12180,32768,-20588,-62.82958984375
83,74,1,0,2,-2,-100.0
83,74,2,2,4,-2,-50.0
83,74,3,2,8,-6,-75.0
83,74,4,3,16,-13,-81.25
83,74,5,46,32,14,43.75
83,74,6,14,64,-50,-78.125
83,74,7,102,128,-26,-20.3125
83,74,8,201,256,-55,-21.484375
83,74,9,442,512,-70,-13.671875
83,74,10,1062,1024,38,3.7109375
83,74,11,6375,2048,4327,211.279296875
83,74,12,2184,4096,-1912,-46.6796875
83,74,13,14964,8192,6772,82.666015625
83,74,14,47284,16384,30900,188.5986328125
83,74,15,60733,32768,27965,85.3424072265625
83,75,1,0,2,-2,-100.0
83,75,2,1,4,-3,-75.0
83,75,3,7,8,-1,-12.5
83,75,4,3,16,-13,-81.25
83,75,5,46,32,14,43.75
83,75,6,23,64,-41,-64.0625
83,75,7,45,128,-83,-64.84375
83,75,8,319,256,63,24.609375
83,75,9,157,512,-355,-69.3359375
83,75,10,641,1024,-383,-37.40234375
83,75,11,1863,2048,-185,-9.033203125
83,75,12,2361,4096,-1735,-42.3583984375
83,75,13,12419,8192,4227,51.59912109375
83,75,14,13017,16384,-3367,-20.550537109375
83,75,15,5217,32768,-27551,-84.0789794921875
83,76,1,0,2,-2,-100.0
83,76,2,1,4,-3,-75.0
83,76,3,18,8,10,125.0
83,76,4,10,16,-6,-37.5
83,76,5,22,32,-10,-31.25
83,76,6,24,64,-40,-62.5
83,76,7,42,128,-86,-67.1875
83,76,8,109,256,-147,-57.421875
83,76,9,24,512,-488,-95.3125
83,76,10,484,1024,-540,-52.734375
83,76,11,1699,2048,-349,-17.041015625
83,76,12,824,4096,-3272,-79.8828125
83,76,13,16105,8192,7913,96.59423828125
83,76,14,18100,16384,1716,10.4736328125
83,76,15,9003,32768,-23765,-72.5250244140625
83,77,1,0,2,-2,-100.0
83,77,2,1,4,-3,-75.0
83,77,3,5,8,-3,-37.5
83,77,4,7,16,-9,-56.25
83,77,5,70,32,38,118.75
83,77,6,89,64,25,39.0625
83,77,7,266,128,138,107.8125
83,77,8,422,256,166,64.84375
83,77,9,156,512,-356,-69.53125
83,77,10,627,1024,-397,-38.76953125
83,77,11,2859,2048,811,39.599609375
83,77,12,4538,4096,442,10.791015625
83,77,13,1978,8192,-6214,-75.8544921875
83,77,14,8320,16384,-8064,-49.21875
83,77,15,59098,32768,26330,80.352783203125
83,78,1,0,2,-2,-100.0
83,78,2,2,4,-2,-50.0
83,78,3,2,8,-6,-75.0
83,78,4,22,16,6,37.5
83,78,5,8,32,-24,-75.0
83,78,6,13,64,-51,-79.6875
83,78,7,9,128,-119,-92.96875
83,78,8,66,256,-190,-74.21875
83,78,9,290,512,-222,-43.359375
83,78,10,183,1024,-841,-82.12890625
83,78,11,741,2048,-1307,-63.818359375
83,78,12,146,4096,-3950,-96.435546875
83,78,13,10183,8192,1991,24.30419921875
83,78,14,21519,16384,5135,31.341552734375
83,78,15,31708,32768,-1060,-3.23486328125
83,79,1,0,2,-2,-100.0
83,79,2,8,4,4,100.0
83,79,3,6,8,-2,-25.0
83,79,4,12,16,-4,-25.0
83,79,5,4,32,-28,-87.5
83,79,6,130,64,66,103.125
83,79,7,70,128,-58,-45.3125
83,79,8,218,256,-38,-14.84375
83,79,9,668,512,156,30.46875
83,79,10,496,1024,-528,-51.5625
83,79,11,11059,2048,9011,439.990234375
83,79,12,2757,4096,-1339,-32.6904296875
83,79,13,9901,8192,1709,20.86181640625
83,79,14,28223,16384,11839,72.259521484375
83,79,15,32565,32768,-203,-0.6195068359375
83,80,1,0,2,-2,-100.0
83,80,2,1,4,-3,-75.0
83,80,3,16,8,8,100.0
83,80,4,3,16,-13,-81.25
83,80,5,5,32,-27,-84.375
83,80,6,26,64,-38,-59.375
83,80,7,51,128,-77,-60.15625
83,80,8,288,256,32,12.5
83,80,9,1206,512,694,135.546875
83,80,10,2661,1024,1637,159.86328125
83,80,11,7189,2048,5141,251.025390625
83,80,12,1393,4096,-2703,-65.9912109375
83,80,13,12933,8192,4741,57.87353515625
83,80,14,23485,16384,7101,43.341064453125
83,80,15,80322,32768,47554,145.123291015625
83,81,1,0,2,-2,-100.0
83,81,2,6,4,2,50.0
83,81,3,5,8,-3,-37.5
83,81,4,4,16,-12,-75.0
83,81,5,29,32,-3,-9.375
83,81,6,45,64,-19,-29.6875
83,81,7,203,128,75,58.59375
83,81,8,193,256,-63,-24.609375
83,81,9,154,512,-358,-69.921875
83,81,10,348,1024,-676,-66.015625
83,81,11,1294,2048,-754,-36.81640625
83,81,12,2904,4096,-1192,-29.1015625
83,81,13,11680,8192,3488,42.578125
83,81,14,22197,16384,5813,35.479736328125
83,81,15,28,32768,-32740,-99.91455078125
83,82,1,0,2,-2,-100.0
83,82,2,1,4,-3,-75.0
83,82,3,12,8,4,50.0
83,82,4,16,16,0,0.0
83,82,5,17,32,-15,-46.875
83,82,6,148,64,84,131.25
83,82,7,32,128,-96,-75.0
83,82,8,114,256,-142,-55.46875
83,82,9,434,512,-78,-15.234375
83,82,10,1279,1024,255,24.90234375
83,82,11,973,2048,-1075,-52.490234375
83,82,12,7382,4096,3286,80.224609375
83,82,13,27052,8192,18860,230.224609375
83,82,14,4310,16384,-12074,-73.69384765625
83,82,15,20523,32768,-12245,-37.3687744140625
83,83,1,0,2,-2,-100.0
83,83,2,1,4,-3,-75.0
83,83,3,3,8,-5,-62.5
83,83,4,8,16,-8,-50.0
83,83,5,26,32,-6,-18.75
83,83,6,41,64,-23,-35.9375
83,83,7,79,128,-49,-38.28125
83,83,8,305,256,49,19.140625
83,83,9,385,512,-127,-24.8046875
83,83,10,249,1024,-775,-75.68359375
83,83,11,7039,2048,4991,243.701171875
83,83,12,15715,4096,11619,283.6669921875
83,83,13,7622,8192,-570,-6.9580078125
83,83,14,25644,16384,9260,56.5185546875
83,83,15,4231,32768,-28537,-87.0880126953125
84,1,1,0,2,-2,-100.0
84,1,2,1,4,-3,-75.0
84,1,3,8,8,0,0.0
84,1,4,5,16,-11,-68.75
84,1,5,22,32,-10,-31.25
84,1,6,178,64,114,178.125
84,1,7,7,128,-121,-94.53125
84,1,8,576,256,320,125.0
84,1,9,321,512,-191,-37.3046875
84,1,10,1629,1024,605,59.08203125
84,1,11,979,2048,-1069,-52.197265625
84,1,12,1451,4096,-2645,-64.5751953125
84,1,13,1387,8192,-6805,-83.06884765625
84,1,14,2864,16384,-13520,-82.51953125
84,1,15,97054,32768,64286,196.185302734375
84,2,1,0,2,-2,-100.0
84,2,2,2,4,-2,-50.0
84,2,3,13,8,5,62.5
84,2,4,3,16,-13,-81.25
84,2,5,6,32,-26,-81.25
84,2,6,32,64,-32,-50.0
84,2,7,20,128,-108,-84.375
84,2,8,357,256,101,39.453125
84,2,9,8,512,-504,-98.4375
84,2,10,125,1024,-899,-87.79296875
84,2,11,4127,2048,2079,101.513671875
84,2,12,5330,4096,1234,30.126953125
84,2,13,13477,8192,5285,64.51416015625
84,2,14,2637,16384,-13747,-83.905029296875
84,2,15,13569,32768,-19199,-58.5906982421875
84,3,1,0,2,-2,-100.0
84,3,2,1,4,-3,-75.0
84,3,3,17,8,9,112.5
84,3,4,3,16,-13,-81.25
84,3,5,9,32,-23,-71.875
84,3,6,8,64,-56,-87.5
84,3,7,140,128,12,9.375
84,3,8,799,256,543,212.109375
84,3,9,192,512,-320,-62.5
84,3,10,260,1024,-764,-74.609375
84,3,11,1269,2048,-779,-38.037109375
84,3,12,268,4096,-3828,-93.45703125
84,3,13,16642,8192,8450,103.1494140625
84,3,14,4798,16384,-11586,-70.71533203125
84,3,15,23899,32768,-8869,-27.0660400390625
84,4,1,0,2,-2,-100.0
84,4,2,1,4,-3,-75.0
84,4,3,7,8,-1,-12.5
84,4,4,35,16,19,118.75
84,4,5,4,32,-28,-87.5
84,4,6,46,64,-18,-28.125
84,4,7,83,128,-45,-35.15625
84,4,8,550,256,294,114.84375
84,4,9,529,512,17,3.3203125
84,4,10,157,1024,-867,-84.66796875
84,4,11,2914,2048,866,42.28515625
84,4,12,1598,4096,-2498,-60.986328125
84,4,13,11021,8192,2829,34.53369140625
84,4,14,7331,16384,-9053,-55.255126953125
84,4,15,18619,32768,-14149,-43.1793212890625
84,5,1,0,2,-2,-100.0
84,5,2,2,4,-2,-50.0
84,5,3,4,8,-4,-50.0
84,5,4,41,16,25,156.25
84,5,5,26,32,-6,-18.75
84,5,6,36,64,-28,-43.75
84,5,7,361,128,233,182.03125
84,5,8,35,256,-221,-86.328125
84,5,9,215,512,-297,-58.0078125
84,5,10,1903,1024,879,85.83984375
84,5,11,1190,2048,-858,-41.89453125
84,5,12,7628,4096,3532,86.23046875
84,5,13,4760,8192,-3432,-41.89453125
84,5,14,19431,16384,3047,18.597412109375
84,5,15,18676,32768,-14092,-43.00537109375
84,6,1,0,2,-2,-100.0
84,6,2,1,4,-3,-75.0
84,6,3,2,8,-6,-75.0
84,6,4,16,16,0,0.0
84,6,5,36,32,4,12.5
84,6,6,203,64,139,217.1875
84,6,7,144,128,16,12.5
84,6,8,1076,256,820,320.3125
84,6,9,363,512,-149,-29.1015625
84,6,10,568,1024,-456,-44.53125
84,6,11,123,2048,-1925,-93.994140625
84,6,12,732,4096,-3364,-82.12890625
84,6,13,5568,8192,-2624,-32.03125
84,6,14,18395,16384,2011,12.274169921875
84,6,15,29923,32768,-2845,-8.6822509765625
84,7,1,0,2,-2,-100.0
84,7,2,1,4,-3,-75.0
84,7,3,10,8,2,25.0
84,7,4,9,16,-7,-43.75
84,7,5,5,32,-27,-84.375
84,7,6,89,64,25,39.0625
84,7,7,11,128,-117,-91.40625
84,7,8,578,256,322,125.78125
84,7,9,378,512,-134,-26.171875
84,7,10,89,1024,-935,-91.30859375
84,7,11,1687,2048,-361,-17.626953125
84,7,12,1734,4096,-2362,-57.666015625
84,7,13,10314,8192,2122,25.9033203125
84,7,14,53075,16384,36691,223.944091796875
84,7,15,35683,32768,2915,8.8958740234375
84,8,1,0,2,-2,-100.0
84,8,2,2,4,-2,-50.0
84,8,3,4,8,-4,-50.0
84,8,4,12,16,-4,-25.0
84,8,5,83,32,51,159.375
84,8,6,58,64,-6,-9.375
84,8,7,19,128,-109,-85.15625
84,8,8,133,256,-123,-48.046875
84,8,9,316,512,-196,-38.28125
84,8,10,886,1024,-138,-13.4765625
84,8,11,1213,2048,-835,-40.771484375
84,8,12,190,4096,-3906,-95.361328125
84,8,13,18170,8192,9978,121.8017578125
84,8,14,24479,16384,8095,49.407958984375
84,8,15,59042,32768,26274,80.181884765625
84,9,1,0,2,-2,-100.0
84,9,2,2,4,-2,-50.0
84,9,3,6,8,-2,-25.0
84,9,4,21,16,5,31.25
84,9,5,21,32,-11,-34.375
84,9,6,13,64,-51,-79.6875
84,9,7,31,128,-97,-75.78125
84,9,8,86,256,-170,-66.40625
84,9,9,651,512,139,27.1484375
84,9,10,210,1024,-814,-79.4921875
84,9,11,652,2048,-1396,-68.1640625
84,9,12,6603,4096,2507,61.2060546875
84,9,13,12995,8192,4803,58.63037109375
84,9,14,89808,16384,73424,448.14453125
84,9,15,10631,32768,-22137,-67.5567626953125
84,10,1,0,2,-2,-100.0
84,10,2,2,4,-2,-50.0
84,10,3,4,8,-4,-50.0
84,10,4,7,16,-9,-56.25
84,10,5,12,32,-20,-62.5
84,10,6,20,64,-44,-68.75
84,10,7,172,128,44,34.375
84,10,8,351,256,95,37.109375
84,10,9,28,512,-484,-94.53125
84,10,10,510,1024,-514,-50.1953125
84,10,11,1489,2048,-559,-27.294921875
84,10,12,966,4096,-3130,-76.416015625
84,10,13,33205,8192,25013,305.33447265625
84,10,14,7464,16384,-8920,-54.443359375
84,10,15,21457,32768,-11311,-34.5184326171875
84,11,1,0,2,-2,-100.0
84,11,2,3,4,-1,-25.0
84,11,3,11,8,3,37.5
84,11,4,14,16,-2,-12.5
84,11,5,34,32,2,6.25
84,11,6,19,64,-45,-70.3125
84,11,7,93,128,-35,-27.34375
84,11,8,174,256,-82,-32.03125
84,11,9,98,512,-414,-80.859375
84,11,10,2216,1024,1192,116.40625
84,11,11,350,2048,-1698,-82.91015625
84,11,12,527,4096,-3569,-87.1337890625
84,11,13,16211,8192,8019,97.88818359375
84,11,14,8849,16384,-7535,-45.989990234375
84,11,15,33514,32768,746,2.276611328125
84,12,1,0,2,-2,-100.0
84,12,2,2,4,-2,-50.0
84,12,3,3,8,-5,-62.5
84,12,4,4,16,-12,-75.0
84,12,5,12,32,-20,-62.5
84,12,6,10,64,-54,-84.375
84,12,7,265,128,137,107.03125
84,12,8,581,256,325,126.953125
84,12,9,1996,512,1484,289.84375
84,12,10,1024,1024,0,0.0
84,12,11,603,2048,-1445,-70.556640625
84,12,12,4165,4096,69,1.6845703125
84,12,13,6866,8192,-1326,-16.1865234375
84,12,14,1198,16384,-15186,-92.68798828125
84,12,15,148047,32768,115279,351.8035888671875
84,13,1,0,2,-2,-100.0
84,13,2,2,4,-2,-50.0
84,13,3,3,8,-5,-62.5
84,13,4,3,16,-13,-81.25
84,13,5,16,32,-16,-50.0
84,13,6,21,64,-43,-67.1875
84,13,7,145,128,17,13.28125
84,13,8,44,256,-212,-82.8125
84,13,9,207,512,-305,-59.5703125
84,13,10,1174,1024,150,14.6484375
84,13,11,5597,2048,3549,173.291015625
84,13,12,3190,4096,-906,-22.119140625
84,13,13,883,8192,-7309,-89.22119140625
84,13,14,16479,16384,95,0.579833984375
84,13,15,27502,32768,-5266,-16.070556640625
84,14,1,0,2,-2,-100.0
84,14,2,2,4,-2,-50.0
84,14,3,9,8,1,12.5
84,14,4,3,16,-13,-81.25
84,14,5,25,32,-7,-21.875
84,14,6,70,64,6,9.375
84,14,7,32,128,-96,-75.0
84,14,8,442,256,186,72.65625
84,14,9,385,512,-127,-24.8046875
84,14,10,1425,1024,401,39.16015625
84,14,11,679,2048,-1369,-66.845703125
84,14,12,9644,4096,5548,135.44921875
84,14,13,39638,8192,31446,383.8623046875
84,14,14,6055,16384,-10329,-63.043212890625
84,14,15,7448,32768,-25320,-77.2705078125
84,15,1,0,2,-2,-100.0
84,15,2,1,4,-3,-75.0
84,15,3,4,8,-4,-50.0
84,15,4,9,16,-7,-43.75
84,15,5,22,32,-10,-31.25
84,15,6,26,64,-38,-59.375
84,15,7,181,128,53,41.40625
84,15,8,251,256,-5,-1.953125
84,15,9,260,512,-252,-49.21875
84,15,10,1142,1024,118,11.5234375
84,15,11,4452,2048,2404,117.3828125
84,15,12,1972,4096,-2124,-51.85546875
84,15,13,10931,8192,2739,33.43505859375
84,15,14,16614,16384,230,1.40380859375
84,15,15,11940,32768,-20828,-63.56201171875
84,16,1,0,2,-2,-100.0
84,16,2,2,4,-2,-50.0
84,16,3,14,8,6,75.0
84,16,4,13,16,-3,-18.75
84,16,5,24,32,-8,-25.0
84,16,6,17,64,-47,-73.4375
84,16,7,144,128,16,12.5
84,16,8,324,256,68,26.5625
84,16,9,218,512,-294,-57.421875
84,16,10,314,1024,-710,-69.3359375
84,16,11,217,2048,-1831,-89.404296875
84,16,12,690,4096,-3406,-83.154296875
84,16,13,50643,8192,42451,518.20068359375
84,16,14,1220,16384,-15164,-92.5537109375
84,16,15,12757,32768,-20011,-61.0687255859375
84,17,1,0,2,-2,-100.0
84,17,2,1,4,-3,-75.0
84,17,3,5,8,-3,-37.5
84,17,4,15,16,-1,-6.25
84,17,5,73,32,41,128.125
84,17,6,10,64,-54,-84.375
84,17,7,244,128,116,90.625
84,17,8,176,256,-80,-31.25
84,17,9,277,512,-235,-45.8984375
84,17,10,887,1024,-137,-13.37890625
84,17,11,15011,2048,12963,632.958984375
84,17,12,2171,4096,-1925,-46.9970703125
84,17,13,4194,8192,-3998,-48.8037109375
84,17,14,71565,16384,55181,336.798095703125
84,17,15,7286,32768,-25482,-77.764892578125
84,18,1,0,2,-2,-100.0
84,18,2,2,4,-2,-50.0
84,18,3,6,8,-2,-25.0
84,18,4,44,16,28,175.0
84,18,5,5,32,-27,-84.375
84,18,6,31,64,-33,-51.5625
84,18,7,117,128,-11,-8.59375
84,18,8,58,256,-198,-77.34375
84,18,9,157,512,-355,-69.3359375
84,18,10,731,1024,-293,-28.61328125
84,18,11,1185,2048,-863,-42.138671875
84,18,12,4273,4096,177,4.3212890625
84,18,13,3973,8192,-4219,-51.50146484375
84,18,14,4407,16384,-11977,-73.101806640625
84,18,15,50421,32768,17653,53.8726806640625
84,19,1,0,2,-2,-100.0
84,19,2,4,4,0,0.0
84,19,3,12,8,4,50.0
84,19,4,9,16,-7,-43.75
84,19,5,11,32,-21,-65.625
84,19,6,5,64,-59,-92.1875
84,19,7,573,128,445,347.65625
84,19,8,62,256,-194,-75.78125
84,19,9,92,512,-420,-82.03125
84,19,10,923,1024,-101,-9.86328125
84,19,11,1065,2048,-983,-47.998046875
84,19,12,2054,4096,-2042,-49.853515625
84,19,13,1095,8192,-7097,-86.63330078125
84,19,14,5854,16384,-10530,-64.27001953125
84,19,15,30329,32768,-2439,-7.4432373046875
84,20,1,0,2,-2,-100.0
84,20,2,1,4,-3,-75.0
84,20,3,7,8,-1,-12.5
84,20,4,14,16,-2,-12.5
84,20,5,22,32,-10,-31.25
84,20,6,13,64,-51,-79.6875
84,20,7,123,128,-5,-3.90625
84,20,8,10,256,-246,-96.09375
84,20,9,1014,512,502,98.046875
84,20,10,1446,1024,422,41.2109375
84,20,11,2494,2048,446,21.77734375
84,20,12,1909,4096,-2187,-53.3935546875
84,20,13,2983,8192,-5209,-63.58642578125
84,20,14,52158,16384,35774,218.34716796875
84,20,15,30421,32768,-2347,-7.1624755859375
84,21,1,0,2,-2,-100.0
84,21,2,3,4,-1,-25.0
84,21,3,3,8,-5,-62.5
84,21,4,27,16,11,68.75
84,21,5,6,32,-26,-81.25
84,21,6,14,64,-50,-78.125
84,21,7,53,128,-75,-58.59375
84,21,8,857,256,601,234.765625
84,21,9,101,512,-411,-80.2734375
84,21,10,3284,1024,2260,220.703125
84,21,11,84,2048,-1964,-95.8984375
84,21,12,3932,4096,-164,-4.00390625
84,21,13,7021,8192,-1171,-14.29443359375
84,21,14,48944,16384,32560,198.73046875
84,21,15,19693,32768,-13075,-39.9017333984375
84,22,1,0,2,-2,-100.0
84,22,2,2,4,-2,-50.0
84,22,3,2,8,-6,-75.0
84,22,4,4,16,-12,-75.0
84,22,5,11,32,-21,-65.625
84,22,6,23,64,-41,-64.0625
84,22,7,385,128,257,200.78125
84,22,8,303,256,47,18.359375
84,22,9,212,512,-300,-58.59375
84,22,10,5044,1024,4020,392.578125
84,22,11,692,2048,-1356,-66.2109375
84,22,12,9994,4096,5898,143.994140625
84,22,13,239,8192,-7953,-97.08251953125
84,22,14,18209,16384,1825,11.138916015625
84,22,15,6084,32768,-26684,-81.43310546875
84,23,1,0,2,-2,-100.0
84,23,2,1,4,-3,-75.0
84,23,3,2,8,-6,-75.0
84,23,4,6,16,-10,-62.5
84,23,5,36,32,4,12.5
84,23,6,32,64,-32,-50.0
84,23,7,144,128,16,12.5
84,23,8,86,256,-170,-66.40625
84,23,9,192,512,-320,-62.5
84,23,10,243,1024,-781,-76.26953125
84,23,11,362,2048,-1686,-82.32421875
84,23,12,3584,4096,-512,-12.5
84,23,13,18730,8192,10538,128.6376953125
84,23,14,28583,16384,12199,74.456787109375
84,23,15,35073,32768,2305,7.0343017578125
84,24,1,0,2,-2,-100.0
84,24,2,3,4,-1,-25.0
84,24,3,9,8,1,12.5
84,24,4,8,16,-8,-50.0
84,24,5,30,32,-2,-6.25
84,24,6,202,64,138,215.625
84,24,7,131,128,3,2.34375
84,24,8,433,256,177,69.140625
84,24,9,365,512,-147,-28.7109375
84,24,10,1229,1024,205,20.01953125
84,24,11,1168,2048,-880,-42.96875
84,24,12,3189,4096,-907,-22.1435546875
84,24,13,3763,8192,-4429,-54.06494140625
84,24,14,19581,16384,3197,19.512939453125
84,24,15,7560,32768,-25208,-76.9287109375
84,25,1,0,2,-2,-100.0
84,25,2,1,4,-3,-75.0
84,25,3,2,8,-6,-75.0
84,25,4,6,16,-10,-62.5
84,25,5,9,32,-23,-71.875
84,25,6,56,64,-8,-12.5
84,25,7,311,128,183,142.96875
84,25,8,170,256,-86,-33.59375
84,25,9,1059,512,547,106.8359375
84,25,10,232,1024,-792,-77.34375
84,25,11,2573,2048,525,25.634765625
84,25,12,3159,4096,-937,-22.8759765625
84,25,13,413,8192,-7779,-94.95849609375
84,25,14,18314,16384,1930,11.77978515625
84,25,15,1926,32768,-30842,-94.122314453125
84,26,1,0,2,-2,-100.0
84,26,2,1,4,-3,-75.0
84,26,3,2,8,-6,-75.0
84,26,4,8,16,-8,-50.0
84,26,5,4,32,-28,-87.5
84,26,6,61,64,-3,-4.6875
84,26,7,50,128,-78,-60.9375
84,26,8,29,256,-227,-88.671875
84,26,9,811,512,299,58.3984375
84,26,10,335,1024,-689,-67.28515625
84,26,11,865,2048,-1183,-57.763671875
84,26,12,9036,4096,4940,120.60546875
84,26,13,8418,8192,226,2.7587890625
84,26,14,10901,16384,-5483,-33.465576171875
84,26,15,21056,32768,-11712,-35.7421875
84,27,1,0,2,-2,-100.0
84,27,2,2,4,-2,-50.0
84,27,3,9,8,1,12.5
84,27,4,6,16,-10,-62.5
84,27,5,11,32,-21,-65.625
84,27,6,8,64,-56,-87.5
84,27,7,204,128,76,59.375
84,27,8,524,256,268,104.6875
84,27,9,434,512,-78,-15.234375
84,27,10,669,1024,-355,-34.66796875
84,27,11,5069,2048,3021,147.509765625
84,27,12,87,4096,-4009,-97.8759765625
84,27,13,11892,8192,3700,45.166015625
84,27,14,14094,16384,-2290,-13.97705078125
84,27,15,14062,32768,-18706,-57.086181640625
84,28,1,0,2,-2,-100.0
84,28,2,2,4,-2,-50.0
84,28,3,2,8,-6,-75.0
84,28,4,5,16,-11,-68.75
84,28,5,43,32,11,34.375
84,28,6,69,64,5,7.8125
84,28,7,476,128,348,271.875
84,28,8,82,256,-174,-67.96875
84,28,9,63,512,-449,-87.6953125
84,28,10,624,1024,-400,-39.0625
84,28,11,75,2048,-1973,-96.337890625
84,28,12,1388,4096,-2708,-66.11328125
84,28,13,10630,8192,2438,29.7607421875
84,28,14,8637,16384,-7747,-47.283935546875
84,28,15,8535,32768,-24233,-73.9532470703125
84,29,1,0,2,-2,-100.0
84,29,2,5,4,1,25.0
84,29,3,7,8,-1,-12.5
84,29,4,7,16,-9,-56.25
84,29,5,38,32,6,18.75
84,29,6,69,64,5,7.8125
84,29,7,107,128,-21,-16.40625
84,29,8,11,256,-245,-95.703125
84,29,9,64,512,-448,-87.5
84,29,10,485,1024,-539,-52.63671875
84,29,11,1735,2048,-313,-15.283203125
84,29,12,798,4096,-3298,-80.517578125
84,29,13,3392,8192,-4800,-58.59375
84,29,14,472,16384,-15912,-97.119140625
84,29,15,20466,32768,-12302,-37.542724609375
84,30,1,0,2,-2,-100.0
84,30,2,1,4,-3,-75.0
84,30,3,3,8,-5,-62.5
84,30,4,17,16,1,6.25
84,30,5,23,32,-9,-28.125
84,30,6,22,64,-42,-65.625
84,30,7,63,128,-65,-50.78125
84,30,8,293,256,37,14.453125
84,30,9,517,512,5,0.9765625
84,30,10,9,1024,-1015,-99.12109375
84,30,11,1223,2048,-825,-40.283203125
84,30,12,5642,4096,1546,37.744140625
84,30,13,32320,8192,24128,294.53125
84,30,14,7171,16384,-9213,-56.231689453125
84,30,15,32222,32768,-546,-1.666259765625
84,31,1,0,2,-2,-100.0
84,31,2,2,4,-2,-50.0
84,31,3,8,8,0,0.0
84,31,4,15,16,-1,-6.25
84,31,5,51,32,19,59.375
84,31,6,113,64,49,76.5625
84,31,7,12,128,-116,-90.625
84,31,8,8,256,-248,-96.875
84,31,9,718,512,206,40.234375
84,31,10,226,1024,-798,-77.9296875
84,31,11,2619,2048,571,27.880859375
84,31,12,1173,4096,-2923,-71.3623046875
84,31,13,17671,8192,9479,115.71044921875
84,31,14,32554,16384,16170,98.69384765625
84,31,15,10888,32768,-21880,-66.7724609375
84,32,1,0,2,-2,-100.0
84,32,2,1,4,-3,-75.0
84,32,3,2,8,-6,-75.0
84,32,4,3,16,-13,-81.25
84,32,5,48,32,16,50.0
84,32,6,9,64,-55,-85.9375
84,32,7,167,128,39,30.46875
84,32,8,13,256,-243,-94.921875
84,32,9,654,512,142,27.734375
84,32,10,1717,1024,693,67.67578125
84,32,11,2936,2048,888,43.359375
84,32,12,12702,4096,8606,210.107421875
84,32,13,22247,8192,14055,171.56982421875
84,32,14,37812,16384,21428,130.7861328125
84,32,15,27260,32768,-5508,-16.80908203125
84,33,1,0,2,-2,-100.0
84,33,2,1,4,-3,-75.0
84,33,3,2,8,-6,-75.0
84,33,4,3,16,-13,-81.25
84,33,5,28,32,-4,-12.5
84,33,6,122,64,58,90.625
84,33,7,29,128,-99,-77.34375
84,33,8,33,256,-223,-87.109375
84,33,9,1805,512,1293,252.5390625
84,33,10,626,1024,-398,-38.8671875
84,33,11,1041,2048,-1007,-49.169921875
84,33,12,4176,4096,80,1.953125
84,33,13,1793,8192,-6399,-78.11279296875
84,33,14,29795,16384,13411,81.854248046875
84,33,15,133405,32768,100637,307.1197509765625
84,34,1,0,2,-2,-100.0
84,34,2,2,4,-2,-50.0
84,34,3,11,8,3,37.5
84,34,4,20,16,4,25.0
84,34,5,15,32,-17,-53.125
84,34,6,53,64,-11,-17.1875
84,34,7,133,128,5,3.90625
84,34,8,288,256,32,12.5
84,34,9,497,512,-15,-2.9296875
84,34,10,1026,1024,2,0.1953125
84,34,11,2180,2048,132,6.4453125
84,34,12,630,4096,-3466,-84.619140625
84,34,13,7818,8192,-374,-4.5654296875
84,34,14,7996,16384,-8388,-51.1962890625
84,34,15,4003,32768,-28765,-87.7838134765625
84,35,1,0,2,-2,-100.0
84,35,2,1,4,-3,-75.0
84,35,3,2,8,-6,-75.0
84,35,4,6,16,-10,-62.5
84,35,5,11,32,-21,-65.625
84,35,6,49,64,-15,-23.4375
84,35,7,123,128,-5,-3.90625
84,35,8,225,256,-31,-12.109375
84,35,9,1008,512,496,96.875
84,35,10,967,1024,-57,-5.56640625
84,35,11,4894,2048,2846,138.96484375
84,35,12,13022,4096,8926,217.919921875
84,35,13,4668,8192,-3524,-43.017578125
84,35,14,14268,16384,-2116,-12.9150390625
84,35,15,10358,32768,-22410,-68.389892578125
84,36,1,0,2,-2,-100.0
84,36,2,1,4,-3,-75.0
84,36,3,7,8,-1,-12.5
84,36,4,26,16,10,62.5
84,36,5,14,32,-18,-56.25
84,36,6,10,64,-54,-84.375
84,36,7,36,128,-92,-71.875
84,36,8,503,256,247,96.484375
84,36,9,831,512,319,62.3046875
84,36,10,76,1024,-948,-92.578125
84,36,11,2337,2048,289,14.111328125
84,36,12,3717,4096,-379,-9.2529296875
84,36,13,4376,8192,-3816,-46.58203125
84,36,14,12339,16384,-4045,-24.688720703125
84,36,15,9210,32768,-23558,-71.893310546875
84,37,1,0,2,-2,-100.0
84,37,2,3,4,-1,-25.0
84,37,3,2,8,-6,-75.0
84,37,4,3,16,-13,-81.25
84,37,5,26,32,-6,-18.75
84,37,6,16,64,-48,-75.0
84,37,7,9,128,-119,-92.96875
84,37,8,26,256,-230,-89.84375
84,37,9,854,512,342,66.796875
84,37,10,1722,1024,698,68.1640625
84,37,11,340,2048,-1708,-83.3984375
84,37,12,4110,4096,14,0.341796875
84,37,13,6155,8192,-2037,-24.86572265625
84,37,14,6667,16384,-9717,-59.307861328125
84,37,15,50857,32768,18089,55.2032470703125
84,38,1,0,2,-2,-100.0
84,38,2,1,4,-3,-75.0
84,38,3,2,8,-6,-75.0
84,38,4,20,16,4,25.0
84,38,5,76,32,44,137.5
84,38,6,287,64,223,348.4375
84,38,7,39,128,-89,-69.53125
84,38,8,22,256,-234,-91.40625
84,38,9,1007,512,495,96.6796875
84,38,10,664,1024,-360,-35.15625
84,38,11,798,2048,-1250,-61.03515625
84,38,12,4193,4096,97,2.3681640625
84,38,13,6745,8192,-1447,-17.66357421875
84,38,14,17794,16384,1410,8.60595703125
84,38,15,21929,32768,-10839,-33.0780029296875
84,39,1,0,2,-2,-100.0
84,39,2,1,4,-3,-75.0
84,39,3,2,8,-6,-75.0
84,39,4,25,16,9,56.25
84,39,5,9,32,-23,-71.875
84,39,6,62,64,-2,-3.125
84,39,7,106,128,-22,-17.1875
84,39,8,68,256,-188,-73.4375
84,39,9,227,512,-285,-55.6640625
84,39,10,459,1024,-565,-55.17578125
84,39,11,965,2048,-1083,-52.880859375
84,39,12,1711,4096,-2385,-58.2275390625
84,39,13,31593,8192,23401,285.65673828125
84,39,14,4693,16384,-11691,-71.356201171875
84,39,15,4044,32768,-28724,-87.65869140625
84,40,1,0,2,-2,-100.0
84,40,2,2,4,-2,-50.0
84,40,3,10,8,2,25.0
84,40,4,21,16,5,31.25
84,40,5,7,32,-25,-78.125
84,40,6,120,64,56,87.5
84,40,7,109,128,-19,-14.84375
84,40,8,28,256,-228,-89.0625
84,40,9,116,512,-396,-77.34375
84,40,10,645,1024,-379,-37.01171875
84,40,11,2402,2048,354,17.28515625
84,40,12,5723,4096,1627,39.7216796875
84,40,13,4328,8192,-3864,-47.16796875
84,40,14,9201,16384,-7183,-43.841552734375
84,40,15,70704,32768,37936,115.771484375
84,41,1,0,2,-2,-100.0
84,41,2,5,4,1,25.0
84,41,3,4,8,-4,-50.0
84,41,4,8,16,-8,-50.0
84,41,5,29,32,-3,-9.375
84,41,6,28,64,-36,-56.25
84,41,7,12,128,-116,-90.625
84,41,8,81,256,-175,-68.359375
84,41,9,104,512,-408,-79.6875
84,41,10,1957,1024,933,91.11328125
84,41,11,2473,2048,425,20.751953125
84,41,12,2941,4096,-1155,-28.1982421875
84,41,13,1617,8192,-6575,-80.26123046875
84,41,14,28640,16384,12256,74.8046875
84,41,15,14508,32768,-18260,-55.72509765625
84,42,1,0,2,-2,-100.0
84,42,2,5,4,1,25.0
84,42,3,21,8,13,162.5
84,42,4,14,16,-2,-12.5
84,42,5,43,32,11,34.375
84,42,6,154,64,90,140.625
84,42,7,26,128,-102,-79.6875
84,42,8,8,256,-248,-96.875
84,42,9,70,512,-442,-86.328125
84,42,10,887,1024,-137,-13.37890625
84,42,11,575,2048,-1473,-71.923828125
84,42,12,1316,4096,-2780,-67.87109375
84,42,13,4346,8192,-3846,-46.9482421875
84,42,14,16531,16384,147,0.897216796875
84,42,15,66653,32768,33885,103.4088134765625
84,43,1,0,2,-2,-100.0
84,43,2,1,4,-3,-75.0
84,43,3,11,8,3,37.5
84,43,4,14,16,-2,-12.5
84,43,5,30,32,-2,-6.25
84,43,6,169,64,105,164.0625
84,43,7,30,128,-98,-76.5625
84,43,8,130,256,-126,-49.21875
84,43,9,548,512,36,7.03125
84,43,10,72,1024,-952,-92.96875
84,43,11,1054,2048,-994,-48.53515625
84,43,12,6016,4096,1920,46.875
84,43,13,9554,8192,1362,16.6259765625
84,43,14,55853,16384,39469,240.899658203125
84,43,15,37797,32768,5029,15.3472900390625
84,44,1,0,2,-2,-100.0
84,44,2,2,4,-2,-50.0
84,44,3,5,8,-3,-37.5
84,44,4,7,16,-9,-56.25
84,44,5,20,32,-12,-37.5
84,44,6,183,64,119,185.9375
84,44,7,97,128,-31,-24.21875
84,44,8,319,256,63,24.609375
84,44,9,904,512,392,76.5625
84,44,10,139,1024,-885,-86.42578125
84,44,11,3798,2048,1750,85.44921875
84,44,12,5747,4096,1651,40.3076171875
84,44,13,16304,8192,8112,99.0234375
84,44,14,8138,16384,-8246,-50.32958984375
84,44,15,33876,32768,1108,3.38134765625
84,45,1,0,2,-2,-100.0
84,45,2,1,4,-3,-75.0
84,45,3,10,8,2,25.0
84,45,4,5,16,-11,-68.75
84,45,5,91,32,59,184.375
84,45,6,119,64,55,85.9375
84,45,7,47,128,-81,-63.28125
84,45,8,868,256,612,239.0625
84,45,9,986,512,474,92.578125
84,45,10,2254,1024,1230,120.1171875
84,45,11,317,2048,-1731,-84.521484375
84,45,12,1069,4096,-3027,-73.9013671875
84,45,13,897,8192,-7295,-89.05029296875
84,45,14,4045,16384,-12339,-75.311279296875
84,45,15,25909,32768,-6859,-20.9320068359375
84,46,1,0,2,-2,-100.0
84,46,2,2,4,-2,-50.0
84,46,3,4,8,-4,-50.0
84,46,4,6,16,-10,-62.5
84,46,5,35,32,3,9.375
84,46,6,41,64,-23,-35.9375
84,46,7,70,128,-58,-45.3125
84,46,8,36,256,-220,-85.9375
84,46,9,1688,512,1176,229.6875
84,46,10,739,1024,-285,-27.83203125
84,46,11,1117,2048,-931,-45.458984375
84,46,12,2108,4096,-1988,-48.53515625
84,46,13,12411,8192,4219,51.50146484375
84,46,14,23003,16384,6619,40.399169921875
84,46,15,92582,32768,59814,182.537841796875
84,47,1,0,2,-2,-100.0
84,47,2,1,4,-3,-75.0
84,47,3,2,8,-6,-75.0
84,47,4,8,16,-8,-50.0
84,47,5,21,32,-11,-34.375
84,47,6,60,64,-4,-6.25
84,47,7,30,128,-98,-76.5625
84,47,8,274,256,18,7.03125
84,47,9,2270,512,1758,343.359375
84,47,10,680,1024,-344,-33.59375
84,47,11,804,2048,-1244,-60.7421875
84,47,12,2397,4096,-1699,-41.4794921875
84,47,13,13857,8192,5665,69.15283203125
84,47,14,1340,16384,-15044,-91.8212890625
84,47,15,23514,32768,-9254,-28.240966796875
84,48,1,0,2,-2,-100.0
84,48,2,2,4,-2,-50.0
84,48,3,38,8,30,375.0
84,48,4,16,16,0,0.0
84,48,5,56,32,24,75.0
84,48,6,31,64,-33,-51.5625
84,48,7,6,128,-122,-95.3125
84,48,8,110,256,-146,-57.03125
84,48,9,1748,512,1236,241.40625
84,48,10,563,1024,-461,-45.01953125
84,48,11,1057,2048,-991,-48.388671875
84,48,12,8209,4096,4113,100.4150390625
84,48,13,3221,8192,-4971,-60.68115234375
84,48,14,4352,16384,-12032,-73.4375
84,48,15,8428,32768,-24340,-74.27978515625
84,49,1,0,2,-2,-100.0
84,49,2,1,4,-3,-75.0
84,49,3,17,8,9,112.5
84,49,4,29,16,13,81.25
84,49,5,7,32,-25,-78.125
84,49,6,137,64,73,114.0625
84,49,7,41,128,-87,-67.96875
84,49,8,292,256,36,14.0625
84,49,9,680,512,168,32.8125
84,49,10,39,1024,-985,-96.19140625
84,49,11,98,2048,-1950,-95.21484375
84,49,12,2151,4096,-1945,-47.4853515625
84,49,13,4554,8192,-3638,-44.4091796875
84,49,14,11548,16384,-4836,-29.5166015625
84,49,15,12531,32768,-20237,-61.7584228515625
84,50,1,0,2,-2,-100.0
84,50,2,2,4,-2,-50.0
84,50,3,10,8,2,25.0
84,50,4,21,16,5,31.25
84,50,5,27,32,-5,-15.625
84,50,6,56,64,-8,-12.5
84,50,7,6,128,-122,-95.3125
84,50,8,225,256,-31,-12.109375
84,50,9,277,512,-235,-45.8984375
84,50,10,896,1024,-128,-12.5
84,50,11,397,2048,-1651,-80.615234375
84,50,12,1315,4096,-2781,-67.8955078125
84,50,13,11958,8192,3766,45.9716796875
84,50,14,18235,16384,1851,11.297607421875
84,50,15,14492,32768,-18276,-55.77392578125
84,51,1,0,2,-2,-100.0
84,51,2,1,4,-3,-75.0
84,51,3,3,8,-5,-62.5
84,51,4,12,16,-4,-25.0
84,51,5,12,32,-20,-62.5
84,51,6,28,64,-36,-56.25
84,51,7,25,128,-103,-80.46875
84,51,8,126,256,-130,-50.78125
84,51,9,386,512,-126,-24.609375
84,51,10,2356,1024,1332,130.078125
84,51,11,147,2048,-1901,-92.822265625
84,51,12,2505,4096,-1591,-38.8427734375
84,51,13,4448,8192,-3744,-45.703125
84,51,14,33652,16384,17268,105.3955078125
84,51,15,21993,32768,-10775,-32.8826904296875
84,52,1,0,2,-2,-100.0
84,52,2,1,4,-3,-75.0
84,52,3,6,8,-2,-25.0
84,52,4,12,16,-4,-25.0
84,52,5,20,32,-12,-37.5
84,52,6,28,64,-36,-56.25
84,52,7,65,128,-63,-49.21875
84,52,8,172,256,-84,-32.8125
84,52,9,133,512,-379,-74.0234375
84,52,10,675,1024,-349,-34.08203125
84,52,11,300,2048,-1748,-85.3515625
84,52,12,372,4096,-3724,-90.91796875
84,52,13,30122,8192,21930,267.7001953125
84,52,14,6767,16384,-9617,-58.697509765625
84,52,15,21624,32768,-11144,-34.0087890625
84,53,1,0,2,-2,-100.0
84,53,2,1,4,-3,-75.0
84,53,3,2,8,-6,-75.0
84,53,4,51,16,35,218.75
84,53,5,106,32,74,231.25
84,53,6,53,64,-11,-17.1875
84,53,7,15,128,-113,-88.28125
84,53,8,1925,256,1669,651.953125
84,53,9,1475,512,963,188.0859375
84,53,10,671,1024,-353,-34.47265625
84,53,11,4657,2048,2609,127.392578125
84,53,12,6531,4096,2435,59.4482421875
84,53,13,9829,8192,1637,19.98291015625
84,53,14,51830,16384,35446,216.34521484375
84,53,15,6689,32768,-26079,-79.5867919921875
84,54,1,0,2,-2,-100.0
84,54,2,1,4,-3,-75.0
84,54,3,4,8,-4,-50.0
84,54,4,13,16,-3,-18.75
84,54,5,10,32,-22,-68.75
84,54,6,28,64,-36,-56.25
84,54,7,169,128,41,32.03125
84,54,8,101,256,-155,-60.546875
84,54,9,1035,512,523,102.1484375
84,54,10,51,1024,-973,-95.01953125
84,54,11,1951,2048,-97,-4.736328125
84,54,12,7462,4096,3366,82.177734375
84,54,13,33669,8192,25477,310.99853515625
84,54,14,21396,16384,5012,30.5908203125
84,54,15,17652,32768,-15116,-46.13037109375
84,55,1,0,2,-2,-100.0
84,55,2,1,4,-3,-75.0
84,55,3,2,8,-6,-75.0
84,55,4,45,16,29,181.25
84,55,5,56,32,24,75.0
84,55,6,33,64,-31,-48.4375
84,55,7,248,128,120,93.75
84,55,8,440,256,184,71.875
84,55,9,334,512,-178,-34.765625
84,55,10,604,1024,-420,-41.015625
84,55,11,3985,2048,1937,94.580078125
84,55,12,3740,4096,-356,-8.69140625
84,55,13,855,8192,-7337,-89.56298828125
84,55,14,13875,16384,-2509,-15.313720703125
84,55,15,99602,32768,66834,203.961181640625
84,56,1,0,2,-2,-100.0
84,56,2,3,4,-1,-25.0
84,56,3,3,8,-5,-62.5
84,56,4,20,16,4,25.0
84,56,5,19,32,-13,-40.625
84,56,6,17,64,-47,-73.4375
84,56,7,252,128,124,96.875
84,56,8,73,256,-183,-71.484375
84,56,9,427,512,-85,-16.6015625
84,56,10,263,1024,-761,-74.31640625
84,56,11,247,2048,-1801,-87.939453125
84,56,12,6861,4096,2765,67.5048828125
84,56,13,5879,8192,-2313,-28.23486328125
84,56,14,31919,16384,15535,94.818115234375
84,56,15,44064,32768,11296,34.47265625
84,57,1,0,2,-2,-100.0
84,57,2,2,4,-2,-50.0
84,57,3,2,8,-6,-75.0
84,57,4,6,16,-10,-62.5
84,57,5,33,32,1,3.125
84,57,6,72,64,8,12.5
84,57,7,91,128,-37,-28.90625
84,57,8,24,256,-232,-90.625
84,57,9,1714,512,1202,234.765625
84,57,10,3823,1024,2799,273.33984375
84,57,11,3363,2048,1315,64.208984375
84,57,12,6203,4096,2107,51.4404296875
84,57,13,6563,8192,-1629,-19.88525390625
84,57,14,25842,16384,9458,57.72705078125
84,57,15,4013,32768,-28755,-87.7532958984375
84,58,1,0,2,-2,-100.0
84,58,2,2,4,-2,-50.0
84,58,3,4,8,-4,-50.0
84,58,4,5,16,-11,-68.75
84,58,5,58,32,26,81.25
84,58,6,22,64,-42,-65.625
84,58,7,129,128,1,0.78125
84,58,8,62,256,-194,-75.78125
84,58,9,334,512,-178,-34.765625
84,58,10,456,1024,-568,-55.46875
84,58,11,806,2048,-1242,-60.64453125
84,58,12,12003,4096,7907,193.0419921875
84,58,13,4287,8192,-3905,-47.66845703125
84,58,14,9665,16384,-6719,-41.009521484375
84,58,15,23590,32768,-9178,-28.009033203125
84,59,1,0,2,-2,-100.0
84,59,2,2,4,-2,-50.0
84,59,3,8,8,0,0.0
84,59,4,12,16,-4,-25.0
84,59,5,24,32,-8,-25.0
84,59,6,112,64,48,75.0
84,59,7,427,128,299,233.59375
84,59,8,11,256,-245,-95.703125
84,59,9,98,512,-414,-80.859375
84,59,10,2307,1024,1283,125.29296875
84,59,11,6531,2048,4483,218.896484375
84,59,12,1760,4096,-2336,-57.03125
84,59,13,21885,8192,13693,167.15087890625
84,59,14,5857,16384,-10527,-64.251708984375
84,59,15,133579,32768,100811,307.6507568359375
84,60,1,0,2,-2,-100.0
84,60,2,2,4,-2,-50.0
84,60,3,3,8,-5,-62.5
84,60,4,9,16,-7,-43.75
84,60,5,32,32,0,0.0
84,60,6,61,64,-3,-4.6875
84,60,7,99,128,-29,-22.65625
84,60,8,473,256,217,84.765625
84,60,9,358,512,-154,-30.078125
84,60,10,413,1024,-611,-59.66796875
84,60,11,4009,2048,1961,95.751953125
84,60,12,19675,4096,15579,380.3466796875
84,60,13,11315,8192,3123,38.12255859375
84,60,14,33850,16384,17466,106.60400390625
84,60,15,3235,32768,-29533,-90.1275634765625
84,61,1,0,2,-2,-100.0
84,61,2,1,4,-3,-75.0
84,61,3,9,8,1,12.5
84,61,4,28,16,12,75.0
84,61,5,10,32,-22,-68.75
84,61,6,87,64,23,35.9375
84,61,7,80,128,-48,-37.5
84,61,8,106,256,-150,-58.59375
84,61,9,605,512,93,18.1640625
84,61,10,1027,1024,3,0.29296875
84,61,11,2465,2048,417,20.361328125
84,61,12,5060,4096,964,23.53515625
84,61,13,215,8192,-7977,-97.37548828125
84,61,14,7107,16384,-9277,-56.622314453125
84,61,15,28186,32768,-4582,-13.983154296875
84,62,1,0,2,-2,-100.0
84,62,2,3,4,-1,-25.0
84,62,3,3,8,-5,-62.5
84,62,4,17,16,1,6.25
84,62,5,26,32,-6,-18.75
84,62,6,10,64,-54,-84.375
84,62,7,142,128,14,10.9375
84,62,8,247,256,-9,-3.515625
84,62,9,444,512,-68,-13.28125
84,62,10,3397,1024,2373,231.73828125
84,62,11,4964,2048,2916,142.3828125
84,62,12,5817,4096,1721,42.0166015625
84,62,13,2000,8192,-6192,-75.5859375
84,62,14,4661,16384,-11723,-71.551513671875
84,62,15,26596,32768,-6172,-18.83544921875
84,63,1,0,2,-2,-100.0
84,63,2,1,4,-3,-75.0
84,63,3,2,8,-6,-75.0
84,63,4,3,16,-13,-81.25
84,63,5,30,32,-2,-6.25
84,63,6,65,64,1,1.5625
84,63,7,105,128,-23,-17.96875
84,63,8,10,256,-246,-96.09375
84,63,9,112,512,-400,-78.125
84,63,10,390,1024,-634,-61.9140625
84,63,11,1151,2048,-897,-43.798828125
84,63,12,607,4096,-3489,-85.1806640625
84,63,13,5590,8192,-2602,-31.7626953125
84,63,14,13356,16384,-3028,-18.4814453125
84,63,15,48170,32768,15402,47.003173828125
84,64,1,0,2,-2,-100.0
84,64,2,1,4,-3,-75.0
84,64,3,19,8,11,137.5
84,64,4,27,16,11,68.75
84,64,5,32,32,0,0.0
84,64,6,44,64,-20,-31.25
84,64,7,112,128,-16,-12.5
84,64,8,70,256,-186,-72.65625
84,64,9,365,512,-147,-28.7109375
84,64,10,603,1024,-421,-41.11328125
84,64,11,789,2048,-1259,-61.474609375
84,64,12,5631,4096,1535,37.4755859375
84,64,13,3024,8192,-5168,-63.0859375
84,64,14,16973,16384,589,3.594970703125
84,64,15,15594,32768,-17174,-52.410888671875
84,65,1,0,2,-2,-100.0
84,65,2,2,4,-2,-50.0
84,65,3,3,8,-5,-62.5
84,65,4,7,16,-9,-56.25
84,65,5,5,32,-27,-84.375
84,65,6,80,64,16,25.0
84,65,7,247,128,119,92.96875
84,65,8,510,256,254,99.21875
84,65,9,655,512,143,27.9296875
84,65,10,127,1024,-897,-87.59765625
84,65,11,3622,2048,1574,76.85546875
84,65,12,6603,4096,2507,61.2060546875
84,65,13,990,8192,-7202,-87.9150390625
84,65,14,31622,16384,15238,93.00537109375
84,65,15,57825,32768,25057,76.4678955078125
84,66,1,0,2,-2,-100.0
84,66,2,6,4,2,50.0
84,66,3,2,8,-6,-75.0
84,66,4,42,16,26,162.5
84,66,5,7,32,-25,-78.125
84,66,6,64,64,0,0.0
84,66,7,106,128,-22,-17.1875
84,66,8,35,256,-221,-86.328125
84,66,9,128,512,-384,-75.0
84,66,10,587,1024,-437,-42.67578125
84,66,11,1493,2048,-555,-27.099609375
84,66,12,3127,4096,-969,-23.6572265625
84,66,13,4706,8192,-3486,-42.5537109375
84,66,14,31895,16384,15511,94.671630859375
84,66,15,737,32768,-32031,-97.7508544921875
84,67,1,0,2,-2,-100.0
84,67,2,3,4,-1,-25.0
84,67,3,7,8,-1,-12.5
84,67,4,35,16,19,118.75
84,67,5,6,32,-26,-81.25
84,67,6,60,64,-4,-6.25
84,67,7,105,128,-23,-17.96875
84,67,8,382,256,126,49.21875
84,67,9,137,512,-375,-73.2421875
84,67,10,2034,1024,1010,98.6328125
84,67,11,4392,2048,2344,114.453125
84,67,12,9672,4096,5576,136.1328125
84,67,13,1732,8192,-6460,-78.857421875
84,67,14,11648,16384,-4736,-28.90625
84,67,15,16574,32768,-16194,-49.420166015625
84,68,1,0,2,-2,-100.0
84,68,2,1,4,-3,-75.0
84,68,3,5,8,-3,-37.5
84,68,4,10,16,-6,-37.5
84,68,5,20,32,-12,-37.5
84,68,6,116,64,52,81.25
84,68,7,27,128,-101,-78.90625
84,68,8,551,256,295,115.234375
84,68,9,404,512,-108,-21.09375
84,68,10,1191,1024,167,16.30859375
84,68,11,1102,2048,-946,-46.19140625
84,68,12,3853,4096,-243,-5.9326171875
84,68,13,31358,8192,23166,282.7880859375
84,68,14,3739,16384,-12645,-77.178955078125
84,68,15,2329,32768,-30439,-92.8924560546875
84,69,1,0,2,-2,-100.0
84,69,2,2,4,-2,-50.0
84,69,3,12,8,4,50.0
84,69,4,11,16,-5,-31.25
84,69,5,24,32,-8,-25.0
84,69,6,17,64,-47,-73.4375
84,69,7,48,128,-80,-62.5
84,69,8,329,256,73,28.515625
84,69,9,1081,512,569,111.1328125
84,69,10,658,1024,-366,-35.7421875
84,69,11,2682,2048,634,30.95703125
84,69,12,1935,4096,-2161,-52.7587890625
84,69,13,5411,8192,-2781,-33.94775390625
84,69,14,29858,16384,13474,82.23876953125
84,69,15,10455,32768,-22313,-68.0938720703125
84,70,1,0,2,-2,-100.0
84,70,2,1,4,-3,-75.0
84,70,3,4,8,-4,-50.0
84,70,4,14,16,-2,-12.5
84,70,5,9,32,-23,-71.875
84,70,6,12,64,-52,-81.25
84,70,7,134,128,6,4.6875
84,70,8,743,256,487,190.234375
84,70,9,813,512,301,58.7890625
84,70,10,1882,1024,858,83.7890625
84,70,11,1923,2048,-125,-6.103515625
84,70,12,11401,4096,7305,178.3447265625
84,70,13,5732,8192,-2460,-30.029296875
84,70,14,6428,16384,-9956,-60.7666015625
84,70,15,25684,32768,-7084,-21.61865234375
84,71,1,0,2,-2,-100.0
84,71,2,2,4,-2,-50.0
84,71,3,2,8,-6,-75.0
84,71,4,9,16,-7,-43.75
84,71,5,37,32,5,15.625
84,71,6,31,64,-33,-51.5625
84,71,7,11,128,-117,-91.40625
84,71,8,262,256,6,2.34375
84,71,9,217,512,-295,-57.6171875
84,71,10,162,1024,-862,-84.1796875
84,71,11,5535,2048,3487,170.263671875
84,71,12,189,4096,-3907,-95.3857421875
84,71,13,7260,8192,-932,-11.376953125
84,71,14,12732,16384,-3652,-22.2900390625
84,71,15,1426,32768,-31342,-95.648193359375
84,72,1,0,2,-2,-100.0
84,72,2,1,4,-3,-75.0
84,72,3,2,8,-6,-75.0
84,72,4,11,16,-5,-31.25
84,72,5,21,32,-11,-34.375
84,72,6,101,64,37,57.8125
84,72,7,209,128,81,63.28125
84,72,8,718,256,462,180.46875
84,72,9,33,512,-479,-93.5546875
84,72,10,180,1024,-844,-82.421875
84,72,11,166,2048,-1882,-91.89453125
84,72,12,1952,4096,-2144,-52.34375
84,72,13,887,8192,-7305,-89.17236328125
84,72,14,24462,16384,8078,49.30419921875
84,72,15,5378,32768,-27390,-83.587646484375
84,73,1,0,2,-2,-100.0
84,73,2,1,4,-3,-75.0
84,73,3,2,8,-6,-75.0
84,73,4,3,16,-13,-81.25
84,73,5,26,32,-6,-18.75
84,73,6,89,64,25,39.0625
84,73,7,64,128,-64,-50.0
84,73,8,73,256,-183,-71.484375
84,73,9,390,512,-122,-23.828125
84,73,10,612,1024,-412,-40.234375
84,73,11,376,2048,-1672,-81.640625
84,73,12,1382,4096,-2714,-66.259765625
84,73,13,2108,8192,-6084,-74.267578125
84,73,14,16833,16384,449,2.740478515625
84,73,15,20365,32768,-12403,-37.8509521484375
84,74,1,0,2,-2,-100.0
84,74,2,2,4,-2,-50.0
84,74,3,12,8,4,50.0
84,74,4,10,16,-6,-37.5
84,74,5,4,32,-28,-87.5
84,74,6,64,64,0,0.0
84,74,7,61,128,-67,-52.34375
84,74,8,601,256,345,134.765625
84,74,9,87,512,-425,-83.0078125
84,74,10,166,1024,-858,-83.7890625
84,74,11,1918,2048,-130,-6.34765625
84,74,12,10200,4096,6104,149.0234375
84,74,13,8317,8192,125,1.52587890625
84,74,14,1515,16384,-14869,-90.753173828125
84,74,15,8105,32768,-24663,-75.2655029296875
84,75,1,0,2,-2,-100.0
84,75,2,3,4,-1,-25.0
84,75,3,5,8,-3,-37.5
84,75,4,11,16,-5,-31.25
84,75,5,97,32,65,203.125
84,75,6,6,64,-58,-90.625
84,75,7,102,128,-26,-20.3125
84,75,8,1414,256,1158,452.34375
84,75,9,35,512,-477,-93.1640625
84,75,10,48,1024,-976,-95.3125
84,75,11,1300,2048,-748,-36.5234375
84,75,12,2330,4096,-1766,-43.115234375
84,75,13,16751,8192,8559,104.47998046875
84,75,14,14646,16384,-1738,-10.60791015625
84,75,15,27221,32768,-5547,-16.9281005859375
84,76,1,0,2,-2,-100.0
84,76,2,1,4,-3,-75.0
84,76,3,4,8,-4,-50.0
84,76,4,20,16,4,25.0
84,76,5,41,32,9,28.125
84,76,6,25,64,-39,-60.9375
84,76,7,182,128,54,42.1875
84,76,8,49,256,-207,-80.859375
84,76,9,266,512,-246,-48.046875
84,76,10,1136,1024,112,10.9375
84,76,11,1965,2048,-83,-4.052734375
84,76,12,4257,4096,161,3.9306640625
84,76,13,6143,8192,-2049,-25.01220703125
84,76,14,3328,16384,-13056,-79.6875
84,76,15,71326,32768,38558,117.669677734375
84,77,1,0,2,-2,-100.0
84,77,2,1,4,-3,-75.0
84,77,3,22,8,14,175.0
84,77,4,47,16,31,193.75
84,77,5,14,32,-18,-56.25
84,77,6,27,64,-37,-57.8125
84,77,7,47,128,-81,-63.28125
84,77,8,330,256,74,28.90625
84,77,9,2257,512,1745,340.8203125
84,77,10,347,1024,-677,-66.11328125
84,77,11,3183,2048,1135,55.419921875
84,77,12,3701,4096,-395,-9.6435546875
84,77,13,11279,8192,3087,37.68310546875
84,77,14,32808,16384,16424,100.244140625
84,77,15,27219,32768,-5549,-16.9342041015625
84,78,1,0,2,-2,-100.0
84,78,2,1,4,-3,-75.0
84,78,3,2,8,-6,-75.0
84,78,4,3,16,-13,-81.25
84,78,5,7,32,-25,-78.125
84,78,6,19,64,-45,-70.3125
84,78,7,98,128,-30,-23.4375
84,78,8,80,256,-176,-68.75
84,78,9,510,512,-2,-0.390625
84,78,10,508,1024,-516,-50.390625
84,78,11,830,2048,-1218,-59.47265625
84,78,12,538,4096,-3558,-86.865234375
84,78,13,2410,8192,-5782,-70.5810546875
84,78,14,9280,16384,-7104,-43.359375
84,78,15,31124,32768,-1644,-5.01708984375
84,79,1,0,2,-2,-100.0
84,79,2,1,4,-3,-75.0
84,79,3,2,8,-6,-75.0
84,79,4,11,16,-5,-31.25
84,79,5,4,32,-28,-87.5
84,79,6,34,64,-30,-46.875
84,79,7,65,128,-63,-49.21875
84,79,8,77,256,-179,-69.921875
84,79,9,53,512,-459,-89.6484375
84,79,10,1216,1024,192,18.75
84,79,11,500,2048,-1548,-75.5859375
84,79,12,7641,4096,3545,86.5478515625
84,79,13,6365,8192,-1827,-22.30224609375
84,79,14,1321,16384,-15063,-91.937255859375
84,79,15,61493,32768,28725,87.6617431640625
84,80,1,0,2,-2,-100.0
84,80,2,3,4,-1,-25.0
84,80,3,5,8,-3,-37.5
84,80,4,17,16,1,6.25
84,80,5,19,32,-13,-40.625
84,80,6,5,64,-59,-92.1875
84,80,7,107,128,-21,-16.40625
84,80,8,399,256,143,55.859375
84,80,9,170,512,-342,-66.796875
84,80,10,5775,1024,4751,463.96484375
84,80,11,444,2048,-1604,-78.3203125
84,80,12,2026,4096,-2070,-50.537109375
84,80,13,26716,8192,18524,226.123046875
84,80,14,330,16384,-16054,-97.98583984375
84,80,15,56760,32768,23992,73.2177734375
84,81,1,0,2,-2,-100.0
84,81,2,2,4,-2,-50.0
84,81,3,3,8,-5,-62.5
84,81,4,9,16,-7,-43.75
84,81,5,19,32,-13,-40.625
84,81,6,25,64,-39,-60.9375
84,81,7,178,128,50,39.0625
84,81,8,282,256,26,10.15625
84,81,9,381,512,-131,-25.5859375
84,81,10,528,1024,-496,-48.4375
84,81,11,1711,2048,-337,-16.455078125
84,81,12,5987,4096,1891,46.1669921875
84,81,13,6664,8192,-1528,-18.65234375
84,81,14,23209,16384,6825,41.656494140625
84,81,15,2789,32768,-29979,-91.4886474609375
84,82,1,0,2,-2,-100.0
84,82,2,5,4,1,25.0
84,82,3,14,8,6,75.0
84,82,4,3,16,-13,-81.25
84,82,5,23,32,-9,-28.125
84,82,6,8,64,-56,-87.5
84,82,7,33,128,-95,-74.21875
84,82,8,55,256,-201,-78.515625
84,82,9,52,512,-460,-89.84375
84,82,10,1575,1024,551,53.80859375
84,82,11,2754,2048,706,34.47265625
84,82,12,1965,4096,-2131,-52.0263671875
84,82,13,1769,8192,-6423,-78.40576171875
84,82,14,10869,16384,-5515,-33.660888671875
84,82,15,71725,32768,38957,118.8873291015625
84,83,1,0,2,-2,-100.0
84,83,2,2,4,-2,-50.0
84,83,3,4,8,-4,-50.0
84,83,4,13,16,-3,-18.75
84,83,5,65,32,33,103.125
84,83,6,28,64,-36,-56.25
84,83,7,55,128,-73,-57.03125
84,83,8,717,256,461,180.078125
84,83,9,228,512,-284,-55.46875
84,83,10,1527,1024,503,49.12109375
84,83,11,970,2048,-1078,-52.63671875
84,83,12,2403,4096,-1693,-41.3330078125
84,83,13,16495,8192,8303,101.35498046875
84,83,14,5330,16384,-11054,-67.46826171875
84,83,15,5767,32768,-27001,-82.4005126953125
84,84,1,0,2,-2,-100.0
84,84,2,2,4,-2,-50.0
84,84,3,5,8,-3,-37.5
84,84,4,31,16,15,93.75
84,84,5,22,32,-10,-31.25
84,84,6,90,64,26,40.625
84,84,7,303,128,175,136.71875
84,84,8,8,256,-248,-96.875
84,84,9,27,512,-485,-94.7265625
84,84,10,916,1024,-108,-10.546875
84,84,11,4018,2048,1970,96.19140625
84,84,12,9635,4096,5539,135.2294921875
84,84,13,15444,8192,7252,88.525390625
84,84,14,6965,16384,-9419,-57.489013671875
84,84,15,90006,32768,57238,174.676513671875
85,1,1,0,2,-2,-100.0
85,1,2,1,4,-3,-75.0
85,1,3,4,8,-4,-50.0
85,1,4,5,16,-11,-68.75
85,1,5,12,32,-20,-62.5
85,1,6,31,64,-33,-51.5625
85,1,7,90,128,-38,-29.6875
85,1,8,263,256,7,2.734375
85,1,9,16,512,-496,-96.875
85,1,10,419,1024,-605,-59.08203125
85,1,11,2099,2048,51,2.490234375
85,1,12,2644,4096,-1452,-35.44921875
85,1,13,11468,8192,3276,39.990234375
85,1,14,24267,16384,7883,48.114013671875
85,1,15,13618,32768,-19150,-58.441162109375
85,2,1,0,2,-2,-100.0
85,2,2,3,4,-1,-25.0
85,2,3,2,8,-6,-75.0
85,2,4,14,16,-2,-12.5
85,2,5,12,32,-20,-62.5
85,2,6,89,64,25,39.0625
85,2,7,33,128,-95,-74.21875
85,2,8,126,256,-130,-50.78125
85,2,9,1042,512,530,103.515625
85,2,10,1703,1024,679,66.30859375
85,2,11,2546,2048,498,24.31640625
85,2,12,1176,4096,-2920,-71.2890625
85,2,13,11863,8192,3671,44.81201171875
85,2,14,8359,16384,-8025,-48.980712890625
85,2,15,41319,32768,8551,26.0955810546875
85,3,1,0,2,-2,-100.0
85,3,2,1,4,-3,-75.0
85,3,3,12,8,4,50.0
85,3,4,15,16,-1,-6.25
85,3,5,76,32,44,137.5
85,3,6,134,64,70,109.375
85,3,7,327,128,199,155.46875
85,3,8,71,256,-185,-72.265625
85,3,9,643,512,131,25.5859375
85,3,10,342,1024,-682,-66.6015625
85,3,11,5743,2048,3695,180.419921875
85,3,12,11437,4096,7341,179.2236328125
85,3,13,15612,8192,7420,90.576171875
85,3,14,131,16384,-16253,-99.200439453125
85,3,15,6729,32768,-26039,-79.4647216796875
85,4,1,0,2,-2,-100.0
85,4,2,1,4,-3,-75.0
85,4,3,2,8,-6,-75.0
85,4,4,28,16,12,75.0
85,4,5,30,32,-2,-6.25
85,4,6,46,64,-18,-28.125
85,4,7,27,128,-101,-78.90625
85,4,8,18,256,-238,-92.96875
85,4,9,33,512,-479,-93.5546875
85,4,10,862,1024,-162,-15.8203125
85,4,11,3118,2048,1070,52.24609375
85,4,12,2536,4096,-1560,-38.0859375
85,4,13,15902,8192,7710,94.1162109375
85,4,14,11104,16384,-5280,-32.2265625
85,4,15,922,32768,-31846,-97.186279296875
85,5,1,0,2,-2,-100.0
85,5,2,2,4,-2,-50.0
85,5,3,3,8,-5,-62.5
85,5,4,25,16,9,56.25
85,5,5,7,32,-25,-78.125
85,5,6,49,64,-15,-23.4375
85,5,7,22,128,-106,-82.8125
85,5,8,115,256,-141,-55.078125
85,5,9,407,512,-105,-20.5078125
85,5,10,20,1024,-1004,-98.046875
85,5,11,180,2048,-1868,-91.2109375
85,5,12,271,4096,-3825,-93.3837890625
85,5,13,455,8192,-7737,-94.44580078125
85,5,14,61846,16384,45462,277.47802734375
85,5,15,11289,32768,-21479,-65.5487060546875
85,6,1,0,2,-2,-100.0
85,6,2,2,4,-2,-50.0
85,6,3,9,8,1,12.5
85,6,4,20,16,4,25.0
85,6,5,36,32,4,12.5
85,6,6,62,64,-2,-3.125
85,6,7,229,128,101,78.90625
85,6,8,299,256,43,16.796875
85,6,9,269,512,-243,-47.4609375
85,6,10,575,1024,-449,-43.84765625
85,6,11,1451,2048,-597,-29.150390625
85,6,12,6234,4096,2138,52.197265625
85,6,13,7795,8192,-397,-4.84619140625
85,6,14,13943,16384,-2441,-14.898681640625
85,6,15,71165,32768,38397,117.1783447265625
85,7,1,0,2,-2,-100.0
85,7,2,1,4,-3,-75.0
85,7,3,3,8,-5,-62.5
85,7,4,4,16,-12,-75.0
85,7,5,22,32,-10,-31.25
85,7,6,8,64,-56,-87.5
85,7,7,135,128,7,5.46875
85,7,8,224,256,-32,-12.5
85,7,9,146,512,-366,-71.484375
85,7,10,2032,1024,1008,98.4375
85,7,11,798,2048,-1250,-61.03515625
85,7,12,2691,4096,-1405,-34.3017578125
85,7,13,2137,8192,-6055,-73.91357421875
85,7,14,9219,16384,-7165,-43.731689453125
85,7,15,4218,32768,-28550,-87.127685546875
85,8,1,0,2,-2,-100.0
85,8,2,2,4,-2,-50.0
85,8,3,10,8,2,25.0
85,8,4,5,16,-11,-68.75
85,8,5,20,32,-12,-37.5
85,8,6,100,64,36,56.25
85,8,7,111,128,-17,-13.28125
85,8,8,389,256,133,51.953125
85,8,9,652,512,140,27.34375
85,8,10,1364,1024,340,33.203125
85,8,11,263,2048,-1785,-87.158203125
85,8,12,3102,4096,-994,-24.267578125
85,8,13,7666,8192,-526,-6.4208984375
85,8,14,9372,16384,-7012,-42.7978515625
85,8,15,20194,32768,-12574,-38.372802734375
85,9,1,0,2,-2,-100.0
85,9,2,1,4,-3,-75.0
85,9,3,9,8,1,12.5
85,9,4,12,16,-4,-25.0
85,9,5,11,32,-21,-65.625
85,9,6,165,64,101,157.8125
85,9,7,43,128,-85,-66.40625
85,9,8,571,256,315,123.046875
85,9,9,132,512,-380,-74.21875
85,9,10,1164,1024,140,13.671875
85,9,11,3120,2048,1072,52.34375
85,9,12,2048,4096,-2048,-50.0
85,9,13,5644,8192,-2548,-31.103515625
85,9,14,6785,16384,-9599,-58.587646484375
85,9,15,1840,32768,-30928,-94.384765625
85,10,1,0,2,-2,-100.0
85,10,2,1,4,-3,-75.0
85,10,3,16,8,8,100.0
85,10,4,3,16,-13,-81.25
85,10,5,36,32,4,12.5
85,10,6,60,64,-4,-6.25
85,10,7,157,128,29,22.65625
85,10,8,411,256,155,60.546875
85,10,9,258,512,-254,-49.609375
85,10,10,316,1024,-708,-69.140625
85,10,11,473,2048,-1575,-76.904296875
85,10,12,10104,4096,6008,146.6796875
85,10,13,17953,8192,9761,119.15283203125
85,10,14,41487,16384,25103,153.216552734375
85,10,15,31183,32768,-1585,-4.8370361328125
85,11,1,0,2,-2,-100.0
85,11,2,5,4,1,25.0
85,11,3,2,8,-6,-75.0
85,11,4,20,16,4,25.0
85,11,5,113,32,81,253.125
85,11,6,37,64,-27,-42.1875
85,11,7,107,128,-21,-16.40625
85,11,8,340,256,84,32.8125
85,11,9,322,512,-190,-37.109375
85,11,10,1036,1024,12,1.171875
85,11,11,3633,2048,1585,77.392578125
85,11,12,2829,4096,-1267,-30.9326171875
85,11,13,14836,8192,6644,81.103515625
85,11,14,3930,16384,-12454,-76.01318359375
85,11,15,14875,32768,-17893,-54.6051025390625
85,12,1,0,2,-2,-100.0
85,12,2,1,4,-3,-75.0
85,12,3,2,8,-6,-75.0
85,12,4,11,16,-5,-31.25
85,12,5,49,32,17,53.125
85,12,6,169,64,105,164.0625
85,12,7,441,128,313,244.53125
85,12,8,109,256,-147,-57.421875
85,12,9,186,512,-326,-63.671875
85,12,10,1269,1024,245,23.92578125
85,12,11,3371,2048,1323,64.599609375
85,12,12,1553,4096,-2543,-62.0849609375
85,12,13,7776,8192,-416,-5.078125
85,12,14,9705,16384,-6679,-40.765380859375
85,12,15,17488,32768,-15280,-46.630859375
85,13,1,0,2,-2,-100.0
85,13,2,3,4,-1,-25.0
85,13,3,20,8,12,150.0
85,13,4,37,16,21,131.25
85,13,5,23,32,-9,-28.125
85,13,6,38,64,-26,-40.625
85,13,7,317,128,189,147.65625
85,13,8,105,256,-151,-58.984375
85,13,9,435,512,-77,-15.0390625
85,13,10,167,1024,-857,-83.69140625
85,13,11,216,2048,-1832,-89.453125
85,13,12,6340,4096,2244,54.78515625
85,13,13,1409,8192,-6783,-82.80029296875
85,13,14,34155,16384,17771,108.465576171875
85,13,15,87874,32768,55106,168.170166015625
85,14,1,0,2,-2,-100.0
85,14,2,3,4,-1,-25.0
85,14,3,2,8,-6,-75.0
85,14,4,14,16,-2,-12.5
85,14,5,29,32,-3,-9.375
85,14,6,7,64,-57,-89.0625
85,14,7,137,128,9,7.03125
85,14,8,596,256,340,132.8125
85,14,9,99,512,-413,-80.6640625
85,14,10,107,1024,-917,-89.55078125
85,14,11,384,2048,-1664,-81.25
85,14,12,5314,4096,1218,29.736328125
85,14,13,34954,8192,26762,326.6845703125
85,14,14,18947,16384,2563,15.643310546875
85,14,15,1861,32768,-30907,-94.3206787109375
85,15,1,0,2,-2,-100.0
85,15,2,1,4,-3,-75.0
85,15,3,2,8,-6,-75.0
85,15,4,7,16,-9,-56.25
85,15,5,4,32,-28,-87.5
85,15,6,10,64,-54,-84.375
85,15,7,11,128,-117,-91.40625
85,15,8,209,256,-47,-18.359375
85,15,9,1973,512,1461,285.3515625
85,15,10,427,1024,-597,-58.30078125
85,15,11,4228,2048,2180,106.4453125
85,15,12,1215,4096,-2881,-70.3369140625
85,15,13,1135,8192,-7057,-86.14501953125
85,15,14,19408,16384,3024,18.45703125
85,15,15,93440,32768,60672,185.15625
85,16,1,0,2,-2,-100.0
85,16,2,1,4,-3,-75.0
85,16,3,3,8,-5,-62.5
85,16,4,5,16,-11,-68.75
85,16,5,40,32,8,25.0
85,16,6,59,64,-5,-7.8125
85,16,7,12,128,-116,-90.625
85,16,8,574,256,318,124.21875
85,16,9,942,512,430,83.984375
85,16,10,1795,1024,771,75.29296875
85,16,11,1208,2048,-840,-41.015625
85,16,12,4961,4096,865,21.1181640625
85,16,13,9965,8192,1773,21.64306640625
85,16,14,3810,16384,-12574,-76.74560546875
85,16,15,96711,32768,63943,195.1385498046875
85,17,1,0,2,-2,-100.0
85,17,2,1,4,-3,-75.0
85,17,3,12,8,4,50.0
85,17,4,3,16,-13,-81.25
85,17,5,20,32,-12,-37.5
85,17,6,42,64,-22,-34.375
85,17,7,102,128,-26,-20.3125
85,17,8,11,256,-245,-95.703125
85,17,9,897,512,385,75.1953125
85,17,10,519,1024,-505,-49.31640625
85,17,11,5159,2048,3111,151.904296875
85,17,12,265,4096,-3831,-93.5302734375
85,17,13,1874,8192,-6318,-77.1240234375
85,17,14,22891,16384,6507,39.715576171875
85,17,15,81465,32768,48697,148.6114501953125
85,18,1,0,2,-2,-100.0
85,18,2,2,4,-2,-50.0
85,18,3,7,8,-1,-12.5
85,18,4,20,16,4,25.0
85,18,5,27,32,-5,-15.625
85,18,6,5,64,-59,-92.1875
85,18,7,19,128,-109,-85.15625
85,18,8,185,256,-71,-27.734375
85,18,9,199,512,-313,-61.1328125
85,18,10,489,1024,-535,-52.24609375
85,18,11,4734,2048,2686,131.15234375
85,18,12,1099,4096,-2997,-73.1689453125
85,18,13,6687,8192,-1505,-18.37158203125
85,18,14,17979,16384,1595,9.735107421875
85,18,15,21380,32768,-11388,-34.75341796875
85,19,1,0,2,-2,-100.0
85,19,2,2,4,-2,-50.0
85,19,3,2,8,-6,-75.0
85,19,4,4,16,-12,-75.0
85,19,5,60,32,28,87.5
85,19,6,43,64,-21,-32.8125
85,19,7,76,128,-52,-40.625
85,19,8,458,256,202,78.90625
85,19,9,614,512,102,19.921875
85,19,10,289,1024,-735,-71.77734375
85,19,11,2571,2048,523,25.537109375
85,19,12,1270,4096,-2826,-68.994140625
85,19,13,23496,8192,15304,186.81640625
85,19,14,6004,16384,-10380,-63.3544921875
85,19,15,13033,32768,-19735,-60.2264404296875
85,20,1,0,2,-2,-100.0
85,20,2,1,4,-3,-75.0
85,20,3,2,8,-6,-75.0
85,20,4,7,16,-9,-56.25
85,20,5,48,32,16,50.0
85,20,6,82,64,18,28.125
85,20,7,41,128,-87,-67.96875
85,20,8,187,256,-69,-26.953125
85,20,9,19,512,-493,-96.2890625
85,20,10,222,1024,-802,-78.3203125
85,20,11,4997,2048,2949,143.994140625
85,20,12,4437,4096,341,8.3251953125
85,20,13,7890,8192,-302,-3.6865234375
85,20,14,10434,16384,-5950,-36.31591796875
85,20,15,23113,32768,-9655,-29.4647216796875
85,21,1,0,2,-2,-100.0
85,21,2,1,4,-3,-75.0
85,21,3,4,8,-4,-50.0
85,21,4,7,16,-9,-56.25
85,21,5,8,32,-24,-75.0
85,21,6,76,64,12,18.75
85,21,7,44,128,-84,-65.625
85,21,8,498,256,242,94.53125
85,21,9,495,512,-17,-3.3203125
85,21,10,3656,1024,2632,257.03125
85,21,11,2363,2048,315,15.380859375
85,21,12,858,4096,-3238,-79.052734375
85,21,13,1358,8192,-6834,-83.4228515625
85,21,14,14469,16384,-1915,-11.688232421875
85,21,15,56372,32768,23604,72.03369140625
85,22,1,0,2,-2,-100.0
85,22,2,2,4,-2,-50.0
85,22,3,3,8,-5,-62.5
85,22,4,10,16,-6,-37.5
85,22,5,32,32,0,0.0
85,22,6,121,64,57,89.0625
85,22,7,460,128,332,259.375
85,22,8,93,256,-163,-63.671875
85,22,9,1081,512,569,111.1328125
85,22,10,25,1024,-999,-97.55859375
85,22,11,1211,2048,-837,-40.869140625
85,22,12,4037,4096,-59,-1.4404296875
85,22,13,1449,8192,-6743,-82.31201171875
85,22,14,4747,16384,-11637,-71.026611328125
85,22,15,57484,32768,24716,75.42724609375
85,23,1,0,2,-2,-100.0
85,23,2,3,4,-1,-25.0
85,23,3,3,8,-5,-62.5
85,23,4,25,16,9,56.25
85,23,5,22,32,-10,-31.25
85,23,6,82,64,18,28.125
85,23,7,316,128,188,146.875
85,23,8,14,256,-242,-94.53125
85,23,9,8,512,-504,-98.4375
85,23,10,356,1024,-668,-65.234375
85,23,11,2478,2048,430,20.99609375
85,23,12,818,4096,-3278,-80.029296875
85,23,13,6510,8192,-1682,-20.5322265625
85,23,14,13308,16384,-3076,-18.7744140625
85,23,15,88781,32768,56013,170.9381103515625
85,24,1,0,2,-2,-100.0
85,24,2,3,4,-1,-25.0
85,24,3,11,8,3,37.5
85,24,4,7,16,-9,-56.25
85,24,5,11,32,-21,-65.625
85,24,6,239,64,175,273.4375
85,24,7,396,128,268,209.375
85,24,8,139,256,-117,-45.703125
85,24,9,919,512,407,79.4921875
85,24,10,1155,1024,131,12.79296875
85,24,11,555,2048,-1493,-72.900390625
85,24,12,5835,4096,1739,42.4560546875
85,24,13,1443,8192,-6749,-82.38525390625
85,24,14,10950,16384,-5434,-33.16650390625
85,24,15,43096,32768,10328,31.5185546875
85,25,1,0,2,-2,-100.0
85,25,2,1,4,-3,-75.0
85,25,3,2,8,-6,-75.0
85,25,4,10,16,-6,-37.5
85,25,5,39,32,7,21.875
85,25,6,38,64,-26,-40.625
85,25,7,93,128,-35,-27.34375
85,25,8,392,256,136,53.125
85,25,9,99,512,-413,-80.6640625
85,25,10,76,1024,-948,-92.578125
85,25,11,2534,2048,486,23.73046875
85,25,12,3611,4096,-485,-11.8408203125
85,25,13,824,8192,-7368,-89.94140625
85,25,14,38401,16384,22017,134.381103515625
85,25,15,16000,32768,-16768,-51.171875
85,26,1,0,2,-2,-100.0
85,26,2,2,4,-2,-50.0
85,26,3,7,8,-1,-12.5
85,26,4,15,16,-1,-6.25
85,26,5,51,32,19,59.375
85,26,6,130,64,66,103.125
85,26,7,52,128,-76,-59.375
85,26,8,93,256,-163,-63.671875
85,26,9,515,512,3,0.5859375
85,26,10,1721,1024,697,68.06640625
85,26,11,651,2048,-1397,-68.212890625
85,26,12,1897,4096,-2199,-53.6865234375
85,26,13,2511,8192,-5681,-69.34814453125
85,26,14,7054,16384,-9330,-56.94580078125
85,26,15,35001,32768,2233,6.8145751953125
85,27,1,0,2,-2,-100.0
85,27,2,1,4,-3,-75.0
85,27,3,2,8,-6,-75.0
85,27,4,17,16,1,6.25
85,27,5,17,32,-15,-46.875
85,27,6,12,64,-52,-81.25
85,27,7,229,128,101,78.90625
85,27,8,221,256,-35,-13.671875
85,27,9,148,512,-364,-71.09375
85,27,10,1149,1024,125,12.20703125
85,27,11,635,2048,-1413,-68.994140625
85,27,12,7141,4096,3045,74.3408203125
85,27,13,13433,8192,5241,63.97705078125
85,27,14,14888,16384,-1496,-9.130859375
85,27,15,3832,32768,-28936,-88.3056640625
85,28,1,0,2,-2,-100.0
85,28,2,2,4,-2,-50.0
85,28,3,2,8,-6,-75.0
85,28,4,11,16,-5,-31.25
85,28,5,14,32,-18,-56.25
85,28,6,154,64,90,140.625
85,28,7,68,128,-60,-46.875
85,28,8,23,256,-233,-91.015625
85,28,9,157,512,-355,-69.3359375
85,28,10,388,1024,-636,-62.109375
85,28,11,1463,2048,-585,-28.564453125
85,28,12,2976,4096,-1120,-27.34375
85,28,13,3387,8192,-4805,-58.65478515625
85,28,14,4135,16384,-12249,-74.761962890625
85,28,15,28354,32768,-4414,-13.470458984375
85,29,1,0,2,-2,-100.0
85,29,2,2,4,-2,-50.0
85,29,3,3,8,-5,-62.5
85,29,4,4,16,-12,-75.0
85,29,5,66,32,34,106.25
85,29,6,41,64,-23,-35.9375
85,29,7,17,128,-111,-86.71875
85,29,8,105,256,-151,-58.984375
85,29,9,398,512,-114,-22.265625
85,29,10,614,1024,-410,-40.0390625
85,29,11,1038,2048,-1010,-49.31640625
85,29,12,940,4096,-3156,-77.05078125
85,29,13,3513,8192,-4679,-57.11669921875
85,29,14,669,16384,-15715,-95.916748046875
85,29,15,14131,32768,-18637,-56.8756103515625
85,30,1,0,2,-2,-100.0
85,30,2,1,4,-3,-75.0
85,30,3,14,8,6,75.0
85,30,4,6,16,-10,-62.5
85,30,5,21,32,-11,-34.375
85,30,6,109,64,45,70.3125
85,30,7,111,128,-17,-13.28125
85,30,8,11,256,-245,-95.703125
85,30,9,124,512,-388,-75.78125
85,30,10,481,1024,-543,-53.02734375
85,30,11,3035,2048,987,48.193359375
85,30,12,350,4096,-3746,-91.455078125
85,30,13,1530,8192,-6662,-81.3232421875
85,30,14,44520,16384,28136,171.728515625
85,30,15,5044,32768,-27724,-84.60693359375
85,31,1,0,2,-2,-100.0
85,31,2,1,4,-3,-75.0
85,31,3,4,8,-4,-50.0
85,31,4,5,16,-11,-68.75
85,31,5,10,32,-22,-68.75
85,31,6,5,64,-59,-92.1875
85,31,7,100,128,-28,-21.875
85,31,8,47,256,-209,-81.640625
85,31,9,141,512,-371,-72.4609375
85,31,10,1022,1024,-2,-0.1953125
85,31,11,4145,2048,2097,102.392578125
85,31,12,1222,4096,-2874,-70.166015625
85,31,13,5686,8192,-2506,-30.5908203125
85,31,14,39163,16384,22779,139.031982421875
85,31,15,7426,32768,-25342,-77.337646484375
85,32,1,0,2,-2,-100.0
85,32,2,1,4,-3,-75.0
85,32,3,14,8,6,75.0
85,32,4,14,16,-2,-12.5
85,32,5,141,32,109,340.625
85,32,6,82,64,18,28.125
85,32,7,102,128,-26,-20.3125
85,32,8,188,256,-68,-26.5625
85,32,9,439,512,-73,-14.2578125
85,32,10,2631,1024,1607,156.93359375
85,32,11,2179,2048,131,6.396484375
85,32,12,1216,4096,-2880,-70.3125
85,32,13,2792,8192,-5400,-65.91796875
85,32,14,9896,16384,-6488,-39.599609375
85,32,15,51308,32768,18540,56.57958984375
85,33,1,0,2,-2,-100.0
85,33,2,1,4,-3,-75.0
85,33,3,8,8,0,0.0
85,33,4,5,16,-11,-68.75
85,33,5,46,32,14,43.75
85,33,6,154,64,90,140.625
85,33,7,37,128,-91,-71.09375
85,33,8,593,256,337,131.640625
85,33,9,340,512,-172,-33.59375
85,33,10,1102,1024,78,7.6171875
85,33,11,245,2048,-1803,-88.037109375
85,33,12,817,4096,-3279,-80.0537109375
85,33,13,18860,8192,10668,130.224609375
85,33,14,704,16384,-15680,-95.703125
85,33,15,6810,32768,-25958,-79.217529296875
85,34,1,0,2,-2,-100.0
85,34,2,1,4,-3,-75.0
85,34,3,10,8,2,25.0
85,34,4,22,16,6,37.5
85,34,5,104,32,72,225.0
85,34,6,29,64,-35,-54.6875
85,34,7,140,128,12,9.375
85,34,8,7,256,-249,-97.265625
85,34,9,983,512,471,91.9921875
85,34,10,71,1024,-953,-93.06640625
85,34,11,383,2048,-1665,-81.298828125
85,34,12,3954,4096,-142,-3.466796875
85,34,13,605,8192,-7587,-92.61474609375
85,34,14,28075,16384,11691,71.356201171875
85,34,15,52906,32768,20138,61.456298828125
85,35,1,0,2,-2,-100.0
85,35,2,1,4,-3,-75.0
85,35,3,5,8,-3,-37.5
85,35,4,28,16,12,75.0
85,35,5,21,32,-11,-34.375
85,35,6,88,64,24,37.5
85,35,7,37,128,-91,-71.09375
85,35,8,39,256,-217,-84.765625
85,35,9,126,512,-386,-75.390625
85,35,10,2060,1024,1036,101.171875
85,35,11,768,2048,-1280,-62.5
85,35,12,2071,4096,-2025,-49.4384765625
85,35,13,7503,8192,-689,-8.41064453125
85,35,14,33053,16384,16669,101.739501953125
85,35,15,18599,32768,-14169,-43.2403564453125
85,36,1,0,2,-2,-100.0
85,36,2,3,4,-1,-25.0
85,36,3,11,8,3,37.5
85,36,4,13,16,-3,-18.75
85,36,5,16,32,-16,-50.0
85,36,6,78,64,14,21.875
85,36,7,78,128,-50,-39.0625
85,36,8,172,256,-84,-32.8125
85,36,9,34,512,-478,-93.359375
85,36,10,1205,1024,181,17.67578125
85,36,11,1626,2048,-422,-20.60546875
85,36,12,2366,4096,-1730,-42.236328125
85,36,13,998,8192,-7194,-87.8173828125
85,36,14,12865,16384,-3519,-21.478271484375
85,36,15,36303,32768,3535,10.7879638671875
85,37,1,0,2,-2,-100.0
85,37,2,4,4,0,0.0
85,37,3,5,8,-3,-37.5
85,37,4,5,16,-11,-68.75
85,37,5,7,32,-25,-78.125
85,37,6,30,64,-34,-53.125
85,37,7,86,128,-42,-32.8125
85,37,8,242,256,-14,-5.46875
85,37,9,129,512,-383,-74.8046875
85,37,10,2353,1024,1329,129.78515625
85,37,11,3540,2048,1492,72.8515625
85,37,12,1291,4096,-2805,-68.4814453125
85,37,13,1012,8192,-7180,-87.646484375
85,37,14,2932,16384,-13452,-82.1044921875
85,37,15,28601,32768,-4167,-12.7166748046875
85,38,1,0,2,-2,-100.0
85,38,2,2,4,-2,-50.0
85,38,3,13,8,5,62.5
85,38,4,3,16,-13,-81.25
85,38,5,11,32,-21,-65.625
85,38,6,34,64,-30,-46.875
85,38,7,136,128,8,6.25
85,38,8,110,256,-146,-57.03125
85,38,9,53,512,-459,-89.6484375
85,38,10,2597,1024,1573,153.61328125
85,38,11,1472,2048,-576,-28.125
85,38,12,11185,4096,7089,173.0712890625
85,38,13,5746,8192,-2446,-29.8583984375
85,38,14,47223,16384,30839,188.226318359375
85,38,15,20314,32768,-12454,-38.006591796875
85,39,1,0,2,-2,-100.0
85,39,2,1,4,-3,-75.0
85,39,3,3,8,-5,-62.5
85,39,4,15,16,-1,-6.25
85,39,5,12,32,-20,-62.5
85,39,6,31,64,-33,-51.5625
85,39,7,30,128,-98,-76.5625
85,39,8,316,256,60,23.4375
85,39,9,93,512,-419,-81.8359375
85,39,10,3368,1024,2344,228.90625
85,39,11,1527,2048,-521,-25.439453125
85,39,12,10629,4096,6533,159.4970703125
85,39,13,4317,8192,-3875,-47.30224609375
85,39,14,3742,16384,-12642,-77.16064453125
85,39,15,30226,32768,-2542,-7.757568359375
85,40,1,0,2,-2,-100.0
85,40,2,1,4,-3,-75.0
85,40,3,5,8,-3,-37.5
85,40,4,11,16,-5,-31.25
85,40,5,78,32,46,143.75
85,40,6,5,64,-59,-92.1875
85,40,7,147,128,19,14.84375
85,40,8,198,256,-58,-22.65625
85,40,9,258,512,-254,-49.609375
85,40,10,2267,1024,1243,121.38671875
85,40,11,749,2048,-1299,-63.427734375
85,40,12,10754,4096,6658,162.548828125
85,40,13,7232,8192,-960,-11.71875
85,40,14,9048,16384,-7336,-44.775390625
85,40,15,13872,32768,-18896,-57.666015625
85,41,1,0,2,-2,-100.0
85,41,2,2,4,-2,-50.0
85,41,3,13,8,5,62.5
85,41,4,45,16,29,181.25
85,41,5,50,32,18,56.25
85,41,6,32,64,-32,-50.0
85,41,7,29,128,-99,-77.34375
85,41,8,63,256,-193,-75.390625
85,41,9,147,512,-365,-71.2890625
85,41,10,905,1024,-119,-11.62109375
85,41,11,1352,2048,-696,-33.984375
85,41,12,9650,4096,5554,135.595703125
85,41,13,4485,8192,-3707,-45.25146484375
85,41,14,14434,16384,-1950,-11.90185546875
85,41,15,95898,32768,63130,192.657470703125
85,42,1,0,2,-2,-100.0
85,42,2,4,4,0,0.0
85,42,3,4,8,-4,-50.0
85,42,4,3,16,-13,-81.25
85,42,5,26,32,-6,-18.75
85,42,6,65,64,1,1.5625
85,42,7,9,128,-119,-92.96875
85,42,8,108,256,-148,-57.8125
85,42,9,241,512,-271,-52.9296875
85,42,10,290,1024,-734,-71.6796875
85,42,11,2899,2048,851,41.552734375
85,42,12,12350,4096,8254,201.513671875
85,42,13,10653,8192,2461,30.04150390625
85,42,14,34415,16384,18031,110.052490234375
85,42,15,17267,32768,-15501,-47.3052978515625
85,43,1,0,2,-2,-100.0
85,43,2,4,4,0,0.0
85,43,3,2,8,-6,-75.0
85,43,4,8,16,-8,-50.0
85,43,5,10,32,-22,-68.75
85,43,6,16,64,-48,-75.0
85,43,7,20,128,-108,-84.375
85,43,8,186,256,-70,-27.34375
85,43,9,278,512,-234,-45.703125
85,43,10,559,1024,-465,-45.41015625
85,43,11,4741,2048,2693,131.494140625
85,43,12,2462,4096,-1634,-39.892578125
85,43,13,28680,8192,20488,250.09765625
85,43,14,689,16384,-15695,-95.794677734375
85,43,15,12452,32768,-20316,-61.99951171875
85,44,1,0,2,-2,-100.0
85,44,2,1,4,-3,-75.0
85,44,3,3,8,-5,-62.5
85,44,4,4,16,-12,-75.0
85,44,5,21,32,-11,-34.375
85,44,6,118,64,54,84.375
85,44,7,67,128,-61,-47.65625
85,44,8,72,256,-184,-71.875
85,44,9,328,512,-184,-35.9375
85,44,10,340,1024,-684,-66.796875
85,44,11,249,2048,-1799,-87.841796875
85,44,12,5002,4096,906,22.119140625
85,44,13,3537,8192,-4655,-56.82373046875
85,44,14,5747,16384,-10637,-64.923095703125
85,44,15,54504,32768,21736,66.3330078125
85,45,1,0,2,-2,-100.0
85,45,2,1,4,-3,-75.0
85,45,3,5,8,-3,-37.5
85,45,4,19,16,3,18.75
85,45,5,29,32,-3,-9.375
85,45,6,12,64,-52,-81.25
85,45,7,370,128,242,189.0625
85,45,8,205,256,-51,-19.921875
85,45,9,1851,512,1339,261.5234375
85,45,10,3703,1024,2679,261.62109375
85,45,11,2167,2048,119,5.810546875
85,45,12,5232,4096,1136,27.734375
85,45,13,5494,8192,-2698,-32.9345703125
85,45,14,57133,16384,40749,248.712158203125
85,45,15,30646,32768,-2122,-6.475830078125
85,46,1,0,2,-2,-100.0
85,46,2,6,4,2,50.0
85,46,3,7,8,-1,-12.5
85,46,4,8,16,-8,-50.0
85,46,5,6,32,-26,-81.25
85,46,6,79,64,15,23.4375
85,46,7,94,128,-34,-26.5625
85,46,8,366,256,110,42.96875
85,46,9,777,512,265,51.7578125
85,46,10,66,1024,-958,-93.5546875
85,46,11,1326,2048,-722,-35.25390625
85,46,12,1410,4096,-2686,-65.576171875
85,46,13,10754,8192,2562,31.2744140625
85,46,14,22545,16384,6161,37.603759765625
85,46,15,29613,32768,-3155,-9.6282958984375
85,47,1,0,2,-2,-100.0
85,47,2,1,4,-3,-75.0
85,47,3,2,8,-6,-75.0
85,47,4,9,16,-7,-43.75
85,47,5,7,32,-25,-78.125
85,47,6,132,64,68,106.25
85,47,7,195,128,67,52.34375
85,47,8,114,256,-142,-55.46875
85,47,9,21,512,-491,-95.8984375
85,47,10,333,1024,-691,-67.48046875
85,47,11,476,2048,-1572,-76.7578125
85,47,12,1720,4096,-2376,-58.0078125
85,47,13,13680,8192,5488,66.9921875
85,47,14,14533,16384,-1851,-11.297607421875
85,47,15,4891,32768,-27877,-85.0738525390625
85,48,1,0,2,-2,-100.0
85,48,2,2,4,-2,-50.0
85,48,3,6,8,-2,-25.0
85,48,4,12,16,-4,-25.0
85,48,5,7,32,-25,-78.125
85,48,6,184,64,120,187.5
85,48,7,45,128,-83,-64.84375
85,48,8,283,256,27,10.546875
85,48,9,144,512,-368,-71.875
85,48,10,823,1024,-201,-19.62890625
85,48,11,8156,2048,6108,298.2421875
85,48,12,1731,4096,-2365,-57.7392578125
85,48,13,4777,8192,-3415,-41.68701171875
85,48,14,23522,16384,7138,43.56689453125
85,48,15,7547,32768,-25221,-76.9683837890625
85,49,1,0,2,-2,-100.0
85,49,2,2,4,-2,-50.0
85,49,3,16,8,8,100.0
85,49,4,3,16,-13,-81.25
85,49,5,71,32,39,121.875
85,49,6,26,64,-38,-59.375
85,49,7,26,128,-102,-79.6875
85,49,8,206,256,-50,-19.53125
85,49,9,133,512,-379,-74.0234375
85,49,10,1194,1024,170,16.6015625
85,49,11,1433,2048,-615,-30.029296875
85,49,12,2683,4096,-1413,-34.4970703125
85,49,13,8595,8192,403,4.91943359375
85,49,14,6320,16384,-10064,-61.42578125
85,49,15,19884,32768,-12884,-39.31884765625
85,50,1,0,2,-2,-100.0
85,50,2,1,4,-3,-75.0
85,50,3,3,8,-5,-62.5
85,50,4,13,16,-3,-18.75
85,50,5,92,32,60,187.5
85,50,6,26,64,-38,-59.375
85,50,7,59,128,-69,-53.90625
85,50,8,41,256,-215,-83.984375
85,50,9,41,512,-471,-91.9921875
85,50,10,510,1024,-514,-50.1953125
85,50,11,129,2048,-1919,-93.701171875
85,50,12,3161,4096,-935,-22.8271484375
85,50,13,20235,8192,12043,147.00927734375
85,50,14,20980,16384,4596,28.0517578125
85,50,15,64730,32768,31962,97.540283203125
85,51,1,0,2,-2,-100.0
85,51,2,1,4,-3,-75.0
85,51,3,10,8,2,25.0
85,51,4,8,16,-8,-50.0
85,51,5,48,32,16,50.0
85,51,6,22,64,-42,-65.625
85,51,7,434,128,306,239.0625
85,51,8,829,256,573,223.828125
85,51,9,533,512,21,4.1015625
85,51,10,717,1024,-307,-29.98046875
85,51,11,1603,2048,-445,-21.728515625
85,51,12,1887,4096,-2209,-53.9306640625
85,51,13,34188,8192,25996,317.333984375
85,51,14,35891,16384,19507,119.061279296875
85,51,15,67987,32768,35219,107.4798583984375
85,52,1,0,2,-2,-100.0
85,52,2,3,4,-1,-25.0
85,52,3,3,8,-5,-62.5
85,52,4,3,16,-13,-81.25
85,52,5,29,32,-3,-9.375
85,52,6,133,64,69,107.8125
85,52,7,288,128,160,125.0
85,52,8,22,256,-234,-91.40625
85,52,9,537,512,25,4.8828125
85,52,10,1424,1024,400,39.0625
85,52,11,840,2048,-1208,-58.984375
85,52,12,8718,4096,4622,112.841796875
85,52,13,4000,8192,-4192,-51.171875
85,52,14,20706,16384,4322,26.37939453125
85,52,15,24415,32768,-8353,-25.4913330078125
85,53,1,0,2,-2,-100.0
85,53,2,1,4,-3,-75.0
85,53,3,2,8,-6,-75.0
85,53,4,10,16,-6,-37.5
85,53,5,138,32,106,331.25
85,53,6,41,64,-23,-35.9375
85,53,7,300,128,172,134.375
85,53,8,567,256,311,121.484375
85,53,9,647,512,135,26.3671875
85,53,10,1725,1024,701,68.45703125
85,53,11,1446,2048,-602,-29.39453125
85,53,12,1369,4096,-2727,-66.5771484375
85,53,13,1931,8192,-6261,-76.42822265625
85,53,14,43305,16384,26921,164.312744140625
85,53,15,30796,32768,-1972,-6.01806640625
85,54,1,0,2,-2,-100.0
85,54,2,1,4,-3,-75.0
85,54,3,7,8,-1,-12.5
85,54,4,3,16,-13,-81.25
85,54,5,18,32,-14,-43.75
85,54,6,24,64,-40,-62.5
85,54,7,71,128,-57,-44.53125
85,54,8,67,256,-189,-73.828125
85,54,9,435,512,-77,-15.0390625
85,54,10,452,1024,-572,-55.859375
85,54,11,21,2048,-2027,-98.974609375
85,54,12,3581,4096,-515,-12.5732421875
85,54,13,19794,8192,11602,141.6259765625
85,54,14,48992,16384,32608,199.0234375
85,54,15,958,32768,-31810,-97.076416015625
85,55,1,0,2,-2,-100.0
85,55,2,2,4,-2,-50.0
85,55,3,4,8,-4,-50.0
85,55,4,12,16,-4,-25.0
85,55,5,16,32,-16,-50.0
85,55,6,112,64,48,75.0
85,55,7,28,128,-100,-78.125
85,55,8,77,256,-179,-69.921875
85,55,9,797,512,285,55.6640625
85,55,10,465,1024,-559,-54.58984375
85,55,11,835,2048,-1213,-59.228515625
85,55,12,7239,4096,3143,76.7333984375
85,55,13,164,8192,-8028,-97.998046875
85,55,14,60116,16384,43732,266.9189453125
85,55,15,6352,32768,-26416,-80.615234375
85,56,1,0,2,-2,-100.0
85,56,2,3,4,-1,-25.0
85,56,3,8,8,0,0.0
85,56,4,24,16,8,50.0
85,56,5,41,32,9,28.125
85,56,6,96,64,32,50.0
85,56,7,107,128,-21,-16.40625
85,56,8,258,256,2,0.78125
85,56,9,369,512,-143,-27.9296875
85,56,10,410,1024,-614,-59.9609375
85,56,11,6240,2048,4192,204.6875
85,56,12,2477,4096,-1619,-39.5263671875
85,56,13,6410,8192,-1782,-21.7529296875
85,56,14,13712,16384,-2672,-16.30859375
85,56,15,26572,32768,-6196,-18.90869140625
85,57,1,0,2,-2,-100.0
85,57,2,4,4,0,0.0
85,57,3,5,8,-3,-37.5
85,57,4,4,16,-12,-75.0
85,57,5,17,32,-15,-46.875
85,57,6,12,64,-52,-81.25
85,57,7,101,128,-27,-21.09375
85,57,8,83,256,-173,-67.578125
85,57,9,837,512,325,63.4765625
85,57,10,109,1024,-915,-89.35546875
85,57,11,144,2048,-1904,-92.96875
85,57,12,380,4096,-3716,-90.72265625
85,57,13,2510,8192,-5682,-69.3603515625
85,57,14,51754,16384,35370,215.88134765625
85,57,15,104308,32768,71540,218.32275390625
85,58,1,0,2,-2,-100.0
85,58,2,1,4,-3,-75.0
85,58,3,20,8,12,150.0
85,58,4,3,16,-13,-81.25
85,58,5,34,32,2,6.25
85,58,6,75,64,11,17.1875
85,58,7,37,128,-91,-71.09375
85,58,8,25,256,-231,-90.234375
85,58,9,376,512,-136,-26.5625
85,58,10,327,1024,-697,-68.06640625
85,58,11,310,2048,-1738,-84.86328125
85,58,12,3880,4096,-216,-5.2734375
85,58,13,19732,8192,11540,140.869140625
85,58,14,24387,16384,8003,48.846435546875
85,58,15,31001,32768,-1767,-5.3924560546875
85,59,1,0,2,-2,-100.0
85,59,2,1,4,-3,-75.0
85,59,3,3,8,-5,-62.5
85,59,4,13,16,-3,-18.75
85,59,5,5,32,-27,-84.375
85,59,6,114,64,50,78.125
85,59,7,405,128,277,216.40625
85,59,8,20,256,-236,-92.1875
85,59,9,212,512,-300,-58.59375
85,59,10,429,1024,-595,-58.10546875
85,59,11,3144,2048,1096,53.515625
85,59,12,6778,4096,2682,65.478515625
85,59,13,11779,8192,3587,43.78662109375
85,59,14,7402,16384,-8982,-54.82177734375
85,59,15,9003,32768,-23765,-72.5250244140625
85,60,1,0,2,-2,-100.0
85,60,2,3,4,-1,-25.0
85,60,3,2,8,-6,-75.0
85,60,4,11,16,-5,-31.25
85,60,5,54,32,22,68.75
85,60,6,220,64,156,243.75
85,60,7,158,128,30,23.4375
85,60,8,157,256,-99,-38.671875
85,60,9,309,512,-203,-39.6484375
85,60,10,506,1024,-518,-50.5859375
85,60,11,2309,2048,261,12.744140625
85,60,12,4321,4096,225,5.4931640625
85,60,13,18461,8192,10269,125.35400390625
85,60,14,2527,16384,-13857,-84.576416015625
85,60,15,45366,32768,12598,38.446044921875
85,61,1,0,2,-2,-100.0
85,61,2,1,4,-3,-75.0
85,61,3,2,8,-6,-75.0
85,61,4,24,16,8,50.0
85,61,5,30,32,-2,-6.25
85,61,6,100,64,36,56.25
85,61,7,51,128,-77,-60.15625
85,61,8,691,256,435,169.921875
85,61,9,301,512,-211,-41.2109375
85,61,10,9555,1024,8531,833.10546875
85,61,11,7510,2048,5462,266.69921875
85,61,12,3666,4096,-430,-10.498046875
85,61,13,16572,8192,8380,102.294921875
85,61,14,4351,16384,-12033,-73.443603515625
85,61,15,10228,32768,-22540,-68.78662109375
85,62,1,0,2,-2,-100.0
85,62,2,1,4,-3,-75.0
85,62,3,4,8,-4,-50.0
85,62,4,3,16,-13,-81.25
85,62,5,11,32,-21,-65.625
85,62,6,18,64,-46,-71.875
85,62,7,15,128,-113,-88.28125
85,62,8,163,256,-93,-36.328125
85,62,9,722,512,210,41.015625
85,62,10,153,1024,-871,-85.05859375
85,62,11,1020,2048,-1028,-50.1953125
85,62,12,6743,4096,2647,64.6240234375
85,62,13,172,8192,-8020,-97.900390625
85,62,14,6608,16384,-9776,-59.66796875
85,62,15,45695,32768,12927,39.4500732421875
85,63,1,0,2,-2,-100.0
85,63,2,2,4,-2,-50.0
85,63,3,4,8,-4,-50.0
85,63,4,7,16,-9,-56.25
85,63,5,43,32,11,34.375
85,63,6,45,64,-19,-29.6875
85,63,7,322,128,194,151.5625
85,63,8,245,256,-11,-4.296875
85,63,9,711,512,199,38.8671875
85,63,10,477,1024,-547,-53.41796875
85,63,11,55,2048,-1993,-97.314453125
85,63,12,6038,4096,1942,47.412109375
85,63,13,16214,8192,8022,97.9248046875
85,63,14,49460,16384,33076,201.8798828125
85,63,15,45721,32768,12953,39.5294189453125
85,64,1,0,2,-2,-100.0
85,64,2,2,4,-2,-50.0
85,64,3,4,8,-4,-50.0
85,64,4,24,16,8,50.0
85,64,5,9,32,-23,-71.875
85,64,6,75,64,11,17.1875
85,64,7,335,128,207,161.71875
85,64,8,58,256,-198,-77.34375
85,64,9,452,512,-60,-11.71875
85,64,10,247,1024,-777,-75.87890625
85,64,11,2884,2048,836,40.8203125
85,64,12,9589,4096,5493,134.1064453125
85,64,13,4915,8192,-3277,-40.00244140625
85,64,14,3212,16384,-13172,-80.3955078125
85,64,15,1740,32768,-31028,-94.68994140625
85,65,1,0,2,-2,-100.0
85,65,2,1,4,-3,-75.0
85,65,3,3,8,-5,-62.5
85,65,4,17,16,1,6.25
85,65,5,76,32,44,137.5
85,65,6,15,64,-49,-76.5625
85,65,7,10,128,-118,-92.1875
85,65,8,440,256,184,71.875
85,65,9,505,512,-7,-1.3671875
85,65,10,687,1024,-337,-32.91015625
85,65,11,2434,2048,386,18.84765625
85,65,12,3788,4096,-308,-7.51953125
85,65,13,19093,8192,10901,133.06884765625
85,65,14,9114,16384,-7270,-44.37255859375
85,65,15,24542,32768,-8226,-25.103759765625
85,66,1,0,2,-2,-100.0
85,66,2,2,4,-2,-50.0
85,66,3,16,8,8,100.0
85,66,4,47,16,31,193.75
85,66,5,5,32,-27,-84.375
85,66,6,76,64,12,18.75
85,66,7,385,128,257,200.78125
85,66,8,17,256,-239,-93.359375
85,66,9,135,512,-377,-73.6328125
85,66,10,230,1024,-794,-77.5390625
85,66,11,2334,2048,286,13.96484375
85,66,12,8744,4096,4648,113.4765625
85,66,13,3854,8192,-4338,-52.9541015625
85,66,14,6360,16384,-10024,-61.181640625
85,66,15,5451,32768,-27317,-83.3648681640625
85,67,1,0,2,-2,-100.0
85,67,2,2,4,-2,-50.0
85,67,3,10,8,2,25.0
85,67,4,19,16,3,18.75
85,67,5,49,32,17,53.125
85,67,6,5,64,-59,-92.1875
85,67,7,120,128,-8,-6.25
85,67,8,236,256,-20,-7.8125
85,67,9,91,512,-421,-82.2265625
85,67,10,512,1024,-512,-50.0
85,67,11,1535,2048,-513,-25.048828125
85,67,12,15563,4096,11467,279.9560546875
85,67,13,722,8192,-7470,-91.1865234375
85,67,14,14845,16384,-1539,-9.393310546875
85,67,15,41108,32768,8340,25.45166015625
85,68,1,0,2,-2,-100.0
85,68,2,3,4,-1,-25.0
85,68,3,5,8,-3,-37.5
85,68,4,15,16,-1,-6.25
85,68,5,16,32,-16,-50.0
85,68,6,18,64,-46,-71.875
85,68,7,308,128,180,140.625
85,68,8,277,256,21,8.203125
85,68,9,678,512,166,32.421875
85,68,10,77,1024,-947,-92.48046875
85,68,11,732,2048,-1316,-64.2578125
85,68,12,3706,4096,-390,-9.521484375
85,68,13,11711,8192,3519,42.95654296875
85,68,14,4226,16384,-12158,-74.20654296875
85,68,15,41072,32768,8304,25.341796875
85,69,1,0,2,-2,-100.0
85,69,2,3,4,-1,-25.0
85,69,3,5,8,-3,-37.5
85,69,4,16,16,0,0.0
85,69,5,6,32,-26,-81.25
85,69,6,28,64,-36,-56.25
85,69,7,207,128,79,61.71875
85,69,8,180,256,-76,-29.6875
85,69,9,171,512,-341,-66.6015625
85,69,10,129,1024,-895,-87.40234375
85,69,11,2060,2048,12,0.5859375
85,69,12,678,4096,-3418,-83.447265625
85,69,13,5518,8192,-2674,-32.6416015625
85,69,14,10875,16384,-5509,-33.624267578125
85,69,15,61816,32768,29048,88.6474609375
85,70,1,0,2,-2,-100.0
85,70,2,2,4,-2,-50.0
85,70,3,16,8,8,100.0
85,70,4,8,16,-8,-50.0
85,70,5,77,32,45,140.625
85,70,6,6,64,-58,-90.625
85,70,7,19,128,-109,-85.15625
85,70,8,81,256,-175,-68.359375
85,70,9,1872,512,1360,265.625
85,70,10,720,1024,-304,-29.6875
85,70,11,3460,2048,1412,68.9453125
85,70,12,2247,4096,-1849,-45.1416015625
85,70,13,6833,8192,-1359,-16.58935546875
85,70,14,31470,16384,15086,92.07763671875
85,70,15,70335,32768,37567,114.6453857421875
85,71,1,0,2,-2,-100.0
85,71,2,1,4,-3,-75.0
85,71,3,21,8,13,162.5
85,71,4,12,16,-4,-25.0
85,71,5,6,32,-26,-81.25
85,71,6,97,64,33,51.5625
85,71,7,250,128,122,95.3125
85,71,8,60,256,-196,-76.5625
85,71,9,225,512,-287,-56.0546875
85,71,10,1799,1024,775,75.68359375
85,71,11,205,2048,-1843,-89.990234375
85,71,12,4000,4096,-96,-2.34375
85,71,13,8597,8192,405,4.94384765625
85,71,14,7617,16384,-8767,-53.509521484375
85,71,15,53150,32768,20382,62.200927734375
85,72,1,0,2,-2,-100.0
85,72,2,2,4,-2,-50.0
85,72,3,6,8,-2,-25.0
85,72,4,8,16,-8,-50.0
85,72,5,5,32,-27,-84.375
85,72,6,15,64,-49,-76.5625
85,72,7,35,128,-93,-72.65625
85,72,8,28,256,-228,-89.0625
85,72,9,991,512,479,93.5546875
85,72,10,208,1024,-816,-79.6875
85,72,11,749,2048,-1299,-63.427734375
85,72,12,4510,4096,414,10.107421875
85,72,13,12760,8192,4568,55.76171875
85,72,14,24009,16384,7625,46.539306640625
85,72,15,5872,32768,-26896,-82.080078125
85,73,1,0,2,-2,-100.0
85,73,2,6,4,2,50.0
85,73,3,6,8,-2,-25.0
85,73,4,3,16,-13,-81.25
85,73,5,23,32,-9,-28.125
85,73,6,134,64,70,109.375
85,73,7,76,128,-52,-40.625
85,73,8,251,256,-5,-1.953125
85,73,9,1732,512,1220,238.28125
85,73,10,490,1024,-534,-52.1484375
85,73,11,1111,2048,-937,-45.751953125
85,73,12,11527,4096,7431,181.4208984375
85,73,13,22444,8192,14252,173.974609375
85,73,14,3271,16384,-13113,-80.035400390625
85,73,15,63892,32768,31124,94.98291015625
85,74,1,0,2,-2,-100.0
85,74,2,1,4,-3,-75.0
85,74,3,2,8,-6,-75.0
85,74,4,6,16,-10,-62.5
85,74,5,74,32,42,131.25
85,74,6,64,64,0,0.0
85,74,7,178,128,50,39.0625
85,74,8,402,256,146,57.03125
85,74,9,55,512,-457,-89.2578125
85,74,10,411,1024,-613,-59.86328125
85,74,11,1581,2048,-467,-22.802734375
85,74,12,1375,4096,-2721,-66.4306640625
85,74,13,5587,8192,-2605,-31.79931640625
85,74,14,160,16384,-16224,-99.0234375
85,74,15,8924,32768,-23844,-72.76611328125
85,75,1,0,2,-2,-100.0
85,75,2,2,4,-2,-50.0
85,75,3,3,8,-5,-62.5
85,75,4,25,16,9,56.25
85,75,5,4,32,-28,-87.5
85,75,6,10,64,-54,-84.375
85,75,7,99,128,-29,-22.65625
85,75,8,48,256,-208,-81.25
85,75,9,222,512,-290,-56.640625
85,75,10,974,1024,-50,-4.8828125
85,75,11,1295,2048,-753,-36.767578125
85,75,12,13798,4096,9702,236.865234375
85,75,13,22981,8192,14789,180.52978515625
85,75,14,6071,16384,-10313,-62.945556640625
85,75,15,43998,32768,11230,34.271240234375
85,76,1,0,2,-2,-100.0
85,76,2,9,4,5,125.0
85,76,3,2,8,-6,-75.0
85,76,4,8,16,-8,-50.0
85,76,5,18,32,-14,-43.75
85,76,6,31,64,-33,-51.5625
85,76,7,77,128,-51,-39.84375
85,76,8,454,256,198,77.34375
85,76,9,968,512,456,89.0625
85,76,10,2014,1024,990,96.6796875
85,76,11,411,2048,-1637,-79.931640625
85,76,12,1496,4096,-2600,-63.4765625
85,76,13,11839,8192,3647,44.51904296875
85,76,14,24728,16384,8344,50.927734375
85,76,15,15859,32768,-16909,-51.6021728515625
85,77,1,0,2,-2,-100.0
85,77,2,2,4,-2,-50.0
85,77,3,14,8,6,75.0
85,77,4,21,16,5,31.25
85,77,5,20,32,-12,-37.5
85,77,6,54,64,-10,-15.625
85,77,7,20,128,-108,-84.375
85,77,8,19,256,-237,-92.578125
85,77,9,228,512,-284,-55.46875
85,77,10,931,1024,-93,-9.08203125
85,77,11,2512,2048,464,22.65625
85,77,12,58,4096,-4038,-98.583984375
85,77,13,14175,8192,5983,73.03466796875
85,77,14,36107,16384,19723,120.379638671875
85,77,15,68054,32768,35286,107.684326171875
85,78,1,0,2,-2,-100.0
85,78,2,1,4,-3,-75.0
85,78,3,2,8,-6,-75.0
85,78,4,4,16,-12,-75.0
85,78,5,20,32,-12,-37.5
85,78,6,96,64,32,50.0
85,78,7,198,128,70,54.6875
85,78,8,89,256,-167,-65.234375
85,78,9,21,512,-491,-95.8984375
85,78,10,763,1024,-261,-25.48828125
85,78,11,12906,2048,10858,530.17578125
85,78,12,4432,4096,336,8.203125
85,78,13,11473,8192,3281,40.05126953125
85,78,14,6902,16384,-9482,-57.87353515625
85,78,15,116383,32768,83615,255.1727294921875
85,79,1,0,2,-2,-100.0
85,79,2,1,4,-3,-75.0
85,79,3,13,8,5,62.5
85,79,4,6,16,-10,-62.5
85,79,5,19,32,-13,-40.625
85,79,6,54,64,-10,-15.625
85,79,7,18,128,-110,-85.9375
85,79,8,49,256,-207,-80.859375
85,79,9,548,512,36,7.03125
85,79,10,1027,1024,3,0.29296875
85,79,11,4797,2048,2749,134.228515625
85,79,12,3253,4096,-843,-20.5810546875
85,79,13,4799,8192,-3393,-41.41845703125
85,79,14,4367,16384,-12017,-73.345947265625
85,79,15,2928,32768,-29840,-91.064453125
85,80,1,0,2,-2,-100.0
85,80,2,1,4,-3,-75.0
85,80,3,3,8,-5,-62.5
85,80,4,11,16,-5,-31.25
85,80,5,79,32,47,146.875
85,80,6,86,64,22,34.375
85,80,7,49,128,-79,-61.71875
85,80,8,176,256,-80,-31.25
85,80,9,530,512,18,3.515625
85,80,10,1130,1024,106,10.3515625
85,80,11,2387,2048,339,16.552734375
85,80,12,5050,4096,954,23.291015625
85,80,13,4351,8192,-3841,-46.88720703125
85,80,14,3202,16384,-13182,-80.45654296875
85,80,15,57385,32768,24617,75.1251220703125
85,81,1,0,2,-2,-100.0
85,81,2,1,4,-3,-75.0
85,81,3,8,8,0,0.0
85,81,4,23,16,7,43.75
85,81,5,12,32,-20,-62.5
85,81,6,226,64,162,253.125
85,81,7,96,128,-32,-25.0
85,81,8,73,256,-183,-71.484375
85,81,9,205,512,-307,-59.9609375
85,81,10,813,1024,-211,-20.60546875
85,81,11,1757,2048,-291,-14.208984375
85,81,12,6678,4096,2582,63.037109375
85,81,13,3954,8192,-4238,-51.7333984375
85,81,14,16561,16384,177,1.080322265625
85,81,15,13830,32768,-18938,-57.794189453125
85,82,1,0,2,-2,-100.0
85,82,2,2,4,-2,-50.0
85,82,3,10,8,2,25.0
85,82,4,39,16,23,143.75
85,82,5,12,32,-20,-62.5
85,82,6,56,64,-8,-12.5
85,82,7,23,128,-105,-82.03125
85,82,8,18,256,-238,-92.96875
85,82,9,1734,512,1222,238.671875
85,82,10,2771,1024,1747,170.60546875
85,82,11,2524,2048,476,23.2421875
85,82,12,3291,4096,-805,-19.6533203125
85,82,13,3100,8192,-5092,-62.158203125
85,82,14,9400,16384,-6984,-42.626953125
85,82,15,49336,32768,16568,50.5615234375
85,83,1,0,2,-2,-100.0
85,83,2,3,4,-1,-25.0
85,83,3,5,8,-3,-37.5
85,83,4,3,16,-13,-81.25
85,83,5,17,32,-15,-46.875
85,83,6,54,64,-10,-15.625
85,83,7,192,128,64,50.0
85,83,8,117,256,-139,-54.296875
85,83,9,371,512,-141,-27.5390625
85,83,10,554,1024,-470,-45.8984375
85,83,11,738,2048,-1310,-63.96484375
85,83,12,6390,4096,2294,56.005859375
85,83,13,13518,8192,5326,65.0146484375
85,83,14,25887,16384,9503,58.001708984375
85,83,15,8643,32768,-24125,-73.6236572265625
85,84,1,0,2,-2,-100.0
85,84,2,2,4,-2,-50.0
85,84,3,5,8,-3,-37.5
85,84,4,20,16,4,25.0
85,84,5,96,32,64,200.0
85,84,6,158,64,94,146.875
85,84,7,325,128,197,153.90625
85,84,8,74,256,-182,-71.09375
85,84,9,386,512,-126,-24.609375
85,84,10,4450,1024,3426,334.5703125
85,84,11,1252,2048,-796,-38.8671875
85,84,12,8915,4096,4819,117.6513671875
85,84,13,4130,8192,-4062,-49.5849609375
85,84,14,25117,16384,8733,53.302001953125
85,84,15,16036,32768,-16732,-51.06201171875
85,85,1,0,2,-2,-100.0
85,85,2,1,4,-3,-75.0
85,85,3,5,8,-3,-37.5
85,85,4,5,16,-11,-68.75
85,85,5,17,32,-15,-46.875
85,85,6,116,64,52,81.25
85,85,7,93,128,-35,-27.34375
85,85,8,39,256,-217,-84.765625
85,85,9,37,512,-475,-92.7734375
85,85,10,933,1024,-91,-8.88671875
85,85,11,420,2048,-1628,-79.4921875
85,85,12,2996,4096,-1100,-26.85546875
85,85,13,8785,8192,593,7.23876953125
85,85,14,14133,16384,-2251,-13.739013671875
85,85,15,25126,32768,-7642,-23.321533203125
86,1,1,0,2,-2,-100.0
86,1,2,8,4,4,100.0
86,1,3,10,8,2,25.0
86,1,4,13,16,-3,-18.75
86,1,5,30,32,-2,-6.25
86,1,6,7,64,-57,-89.0625
86,1,7,132,128,4,3.125
86,1,8,129,256,-127,-49.609375
86,1,9,638,512,126,24.609375
86,1,10,33,1024,-991,-96.77734375
86,1,11,2498,2048,450,21.97265625
86,1,12,369,4096,-3727,-90.9912109375
86,1,13,3700,8192,-4492,-54.833984375
86,1,14,1224,16384,-15160,-92.529296875
86,1,15,139636,32768,106868,326.13525390625
86,2,1,0,2,-2,-100.0
86,2,2,1,4,-3,-75.0
86,2,3,5,8,-3,-37.5
86,2,4,17,16,1,6.25
86,2,5,32,32,0,0.0
86,2,6,17,64,-47,-73.4375
86,2,7,21,128,-107,-83.59375
86,2,8,364,256,108,42.1875
86,2,9,177,512,-335,-65.4296875
86,2,10,1338,1024,314,30.6640625
86,2,11,862,2048,-1186,-57.91015625
86,2,12,8848,4096,4752,116.015625
86,2,13,3532,8192,-4660,-56.884765625
86,2,14,267,16384,-16117,-98.370361328125
86,2,15,16087,32768,-16681,-50.9063720703125
86,3,1,0,2,-2,-100.0
86,3,2,2,4,-2,-50.0
86,3,3,9,8,1,12.5
86,3,4,12,16,-4,-25.0
86,3,5,40,32,8,25.0
86,3,6,127,64,63,98.4375
86,3,7,111,128,-17,-13.28125
86,3,8,138,256,-118,-46.09375
86,3,9,154,512,-358,-69.921875
86,3,10,1641,1024,617,60.25390625
86,3,11,2423,2048,375,18.310546875
86,3,12,2532,4096,-1564,-38.18359375
86,3,13,8130,8192,-62,-0.7568359375
86,3,14,932,16384,-15452,-94.3115234375
86,3,15,28752,32768,-4016,-12.255859375
86,4,1,0,2,-2,-100.0
86,4,2,2,4,-2,-50.0
86,4,3,4,8,-4,-50.0
86,4,4,18,16,2,12.5
86,4,5,6,32,-26,-81.25
86,4,6,31,64,-33,-51.5625
86,4,7,49,128,-79,-61.71875
86,4,8,165,256,-91,-35.546875
86,4,9,896,512,384,75.0
86,4,10,182,1024,-842,-82.2265625
86,4,11,1223,2048,-825,-40.283203125
86,4,12,328,4096,-3768,-91.9921875
86,4,13,20802,8192,12610,153.9306640625
86,4,14,30202,16384,13818,84.33837890625
86,4,15,18370,32768,-14398,-43.939208984375
86,5,1,0,2,-2,-100.0
86,5,2,1,4,-3,-75.0
86,5,3,10,8,2,25.0
86,5,4,4,16,-12,-75.0
86,5,5,26,32,-6,-18.75
86,5,6,32,64,-32,-50.0
86,5,7,210,128,82,64.0625
86,5,8,517,256,261,101.953125
86,5,9,317,512,-195,-38.0859375
86,5,10,681,1024,-343,-33.49609375
86,5,11,3300,2048,1252,61.1328125
86,5,12,5792,4096,1696,41.40625
86,5,13,26364,8192,18172,221.826171875
86,5,14,6664,16384,-9720,-59.326171875
86,5,15,7370,32768,-25398,-77.508544921875
86,6,1,0,2,-2,-100.0
86,6,2,1,4,-3,-75.0
86,6,3,6,8,-2,-25.0
86,6,4,19,16,3,18.75
86,6,5,27,32,-5,-15.625
86,6,6,74,64,10,15.625
86,6,7,133,128,5,3.90625
86,6,8,846,256,590,230.46875
86,6,9,596,512,84,16.40625
86,6,10,592,1024,-432,-42.1875
86,6,11,1130,2048,-918,-44.82421875
86,6,12,461,4096,-3635,-88.7451171875
86,6,13,3304,8192,-4888,-59.66796875
86,6,14,13084,16384,-3300,-20.1416015625
86,6,15,9617,32768,-23151,-70.6512451171875
86,7,1,0,2,-2,-100.0
86,7,2,1,4,-3,-75.0
86,7,3,12,8,4,50.0
86,7,4,11,16,-5,-31.25
86,7,5,15,32,-17,-53.125
86,7,6,57,64,-7,-10.9375
86,7,7,107,128,-21,-16.40625
86,7,8,159,256,-97,-37.890625
86,7,9,49,512,-463,-90.4296875
86,7,10,655,1024,-369,-36.03515625
86,7,11,1299,2048,-749,-36.572265625
86,7,12,3430,4096,-666,-16.259765625
86,7,13,1398,8192,-6794,-82.9345703125
86,7,14,50048,16384,33664,205.46875
86,7,15,27905,32768,-4863,-14.8406982421875
86,8,1,0,2,-2,-100.0
86,8,2,3,4,-1,-25.0
86,8,3,7,8,-1,-12.5
86,8,4,16,16,0,0.0
86,8,5,25,32,-7,-21.875
86,8,6,41,64,-23,-35.9375
86,8,7,7,128,-121,-94.53125
86,8,8,65,256,-191,-74.609375
86,8,9,563,512,51,9.9609375
86,8,10,725,1024,-299,-29.19921875
86,8,11,3818,2048,1770,86.42578125
86,8,12,10780,4096,6684,163.18359375
86,8,13,3271,8192,-4921,-60.07080078125
86,8,14,20800,16384,4416,26.953125
86,8,15,27317,32768,-5451,-16.6351318359375
86,9,1,0,2,-2,-100.0
86,9,2,1,4,-3,-75.0
86,9,3,5,8,-3,-37.5
86,9,4,3,16,-13,-81.25
86,9,5,4,32,-28,-87.5
86,9,6,11,64,-53,-82.8125
86,9,7,40,128,-88,-68.75
86,9,8,424,256,168,65.625
86,9,9,635,512,123,24.0234375
86,9,10,3216,1024,2192,214.0625
86,9,11,1273,2048,-775,-37.841796875
86,9,12,5425,4096,1329,32.4462890625
86,9,13,10644,8192,2452,29.931640625
86,9,14,14733,16384,-1651,-10.076904296875
86,9,15,9797,32768,-22971,-70.1019287109375
86,10,1,0,2,-2,-100.0
86,10,2,1,4,-3,-75.0
86,10,3,3,8,-5,-62.5
86,10,4,35,16,19,118.75
86,10,5,7,32,-25,-78.125
86,10,6,44,64,-20,-31.25
86,10,7,271,128,143,111.71875
86,10,8,404,256,148,57.8125
86,10,9,404,512,-108,-21.09375
86,10,10,236,1024,-788,-76.953125
86,10,11,2277,2048,229,11.181640625
86,10,12,2351,4096,-1745,-42.6025390625
86,10,13,13360,8192,5168,63.0859375
86,10,14,7864,16384,-8520,-52.001953125
86,10,15,3549,32768,-29219,-89.1693115234375
86,11,1,0,2,-2,-100.0
86,11,2,2,4,-2,-50.0
86,11,3,5,8,-3,-37.5
86,11,4,14,16,-2,-12.5
86,11,5,5,32,-27,-84.375
86,11,6,57,64,-7,-10.9375
86,11,7,77,128,-51,-39.84375
86,11,8,187,256,-69,-26.953125
86,11,9,568,512,56,10.9375
86,11,10,325,1024,-699,-68.26171875
86,11,11,676,2048,-1372,-66.9921875
86,11,12,245,4096,-3851,-94.0185546875
86,11,13,1569,8192,-6623,-80.84716796875
86,11,14,10695,16384,-5689,-34.722900390625
86,11,15,5044,32768,-27724,-84.60693359375
86,12,1,0,2,-2,-100.0
86,12,2,1,4,-3,-75.0
86,12,3,3,8,-5,-62.5
86,12,4,6,16,-10,-62.5
86,12,5,74,32,42,131.25
86,12,6,88,64,24,37.5
86,12,7,239,128,111,86.71875
86,12,8,39,256,-217,-84.765625
86,12,9,103,512,-409,-79.8828125
86,12,10,1339,1024,315,30.76171875
86,12,11,597,2048,-1451,-70.849609375
86,12,12,9910,4096,5814,141.943359375
86,12,13,23984,8192,15792,192.7734375
86,12,14,3008,16384,-13376,-81.640625
86,12,15,23167,32768,-9601,-29.2999267578125
86,13,1,0,2,-2,-100.0
86,13,2,1,4,-3,-75.0
86,13,3,4,8,-4,-50.0
86,13,4,9,16,-7,-43.75
86,13,5,35,32,3,9.375
86,13,6,23,64,-41,-64.0625
86,13,7,91,128,-37,-28.90625
86,13,8,143,256,-113,-44.140625
86,13,9,1560,512,1048,204.6875
86,13,10,1055,1024,31,3.02734375
86,13,11,2278,2048,230,11.23046875
86,13,12,936,4096,-3160,-77.1484375
86,13,13,3985,8192,-4207,-51.35498046875
86,13,14,6352,16384,-10032,-61.23046875
86,13,15,44769,32768,12001,36.6241455078125
86,14,1,0,2,-2,-100.0
86,14,2,2,4,-2,-50.0
86,14,3,6,8,-2,-25.0
86,14,4,5,16,-11,-68.75
86,14,5,12,32,-20,-62.5
86,14,6,12,64,-52,-81.25
86,14,7,132,128,4,3.125
86,14,8,315,256,59,23.046875
86,14,9,432,512,-80,-15.625
86,14,10,1338,1024,314,30.6640625
86,14,11,1915,2048,-133,-6.494140625
86,14,12,10697,4096,6601,161.1572265625
86,14,13,5298,8192,-2894,-35.3271484375
86,14,14,97571,16384,81187,495.526123046875
86,14,15,33821,32768,1053,3.2135009765625
86,15,1,0,2,-2,-100.0
86,15,2,1,4,-3,-75.0
86,15,3,5,8,-3,-37.5
86,15,4,9,16,-7,-43.75
86,15,5,56,32,24,75.0
86,15,6,49,64,-15,-23.4375
86,15,7,422,128,294,229.6875
86,15,8,30,256,-226,-88.28125
86,15,9,220,512,-292,-57.03125
86,15,10,354,1024,-670,-65.4296875
86,15,11,160,2048,-1888,-92.1875
86,15,12,1324,4096,-2772,-67.67578125
86,15,13,3213,8192,-4979,-60.77880859375
86,15,14,3557,16384,-12827,-78.289794921875
86,15,15,32550,32768,-218,-0.665283203125
86,16,1,0,2,-2,-100.0
86,16,2,2,4,-2,-50.0
86,16,3,4,8,-4,-50.0
86,16,4,23,16,7,43.75
86,16,5,100,32,68,212.5
86,16,6,25,64,-39,-60.9375
86,16,7,9,128,-119,-92.96875
86,16,8,435,256,179,69.921875
86,16,9,384,512,-128,-25.0
86,16,10,557,1024,-467,-45.60546875
86,16,11,1166,2048,-882,-43.06640625
86,16,12,4930,4096,834,20.361328125
86,16,13,4415,8192,-3777,-46.10595703125
86,16,14,6333,16384,-10051,-61.346435546875
86,16,15,5368,32768,-27400,-83.6181640625
86,17,1,0,2,-2,-100.0
86,17,2,2,4,-2,-50.0
86,17,3,13,8,5,62.5
86,17,4,3,16,-13,-81.25
86,17,5,49,32,17,53.125
86,17,6,125,64,61,95.3125
86,17,7,68,128,-60,-46.875
86,17,8,159,256,-97,-37.890625
86,17,9,128,512,-384,-75.0
86,17,10,556,1024,-468,-45.703125
86,17,11,1043,2048,-1005,-49.072265625
86,17,12,2874,4096,-1222,-29.833984375
86,17,13,1020,8192,-7172,-87.548828125
86,17,14,734,16384,-15650,-95.52001953125
86,17,15,16153,32768,-16615,-50.7049560546875
86,18,1,0,2,-2,-100.0
86,18,2,2,4,-2,-50.0
86,18,3,3,8,-5,-62.5
86,18,4,12,16,-4,-25.0
86,18,5,39,32,7,21.875
86,18,6,8,64,-56,-87.5
86,18,7,184,128,56,43.75
86,18,8,472,256,216,84.375
86,18,9,922,512,410,80.078125
86,18,10,130,1024,-894,-87.3046875
86,18,11,996,2048,-1052,-51.3671875
86,18,12,1730,4096,-2366,-57.763671875
86,18,13,10658,8192,2466,30.1025390625
86,18,14,9662,16384,-6722,-41.02783203125
86,18,15,1084,32768,-31684,-96.69189453125
86,19,1,0,2,-2,-100.0
86,19,2,2,4,-2,-50.0
86,19,3,9,8,1,12.5
86,19,4,35,16,19,118.75
86,19,5,69,32,37,115.625
86,19,6,30,64,-34,-53.125
86,19,7,165,128,37,28.90625
86,19,8,174,256,-82,-32.03125
86,19,9,67,512,-445,-86.9140625
86,19,10,748,1024,-276,-26.953125
86,19,11,2660,2048,612,29.8828125
86,19,12,12394,4096,8298,202.587890625
86,19,13,2866,8192,-5326,-65.0146484375
86,19,14,3538,16384,-12846,-78.40576171875
86,19,15,14184,32768,-18584,-56.7138671875
86,20,1,0,2,-2,-100.0
86,20,2,2,4,-2,-50.0
86,20,3,5,8,-3,-37.5
86,20,4,29,16,13,81.25
86,20,5,8,32,-24,-75.0
86,20,6,64,64,0,0.0
86,20,7,339,128,211,164.84375
86,20,8,137,256,-119,-46.484375
86,20,9,83,512,-429,-83.7890625
86,20,10,419,1024,-605,-59.08203125
86,20,11,2148,2048,100,4.8828125
86,20,12,1504,4096,-2592,-63.28125
86,20,13,5136,8192,-3056,-37.3046875
86,20,14,2549,16384,-13835,-84.442138671875
86,20,15,12687,32768,-20081,-61.2823486328125
86,21,1,0,2,-2,-100.0
86,21,2,1,4,-3,-75.0
86,21,3,13,8,5,62.5
86,21,4,20,16,4,25.0
86,21,5,4,32,-28,-87.5
86,21,6,45,64,-19,-29.6875
86,21,7,23,128,-105,-82.03125
86,21,8,23,256,-233,-91.015625
86,21,9,767,512,255,49.8046875
86,21,10,319,1024,-705,-68.84765625
86,21,11,451,2048,-1597,-77.978515625
86,21,12,4883,4096,787,19.2138671875
86,21,13,10151,8192,1959,23.91357421875
86,21,14,13396,16384,-2988,-18.2373046875
86,21,15,45473,32768,12705,38.7725830078125
86,22,1,0,2,-2,-100.0
86,22,2,1,4,-3,-75.0
86,22,3,6,8,-2,-25.0
86,22,4,12,16,-4,-25.0
86,22,5,14,32,-18,-56.25
86,22,6,45,64,-19,-29.6875
86,22,7,77,128,-51,-39.84375
86,22,8,21,256,-235,-91.796875
86,22,9,1291,512,779,152.1484375
86,22,10,152,1024,-872,-85.15625
86,22,11,4532,2048,2484,121.2890625
86,22,12,8161,4096,4065,99.2431640625
86,22,13,3461,8192,-4731,-57.75146484375
86,22,14,2522,16384,-13862,-84.60693359375
86,22,15,50361,32768,17593,53.6895751953125
86,23,1,0,2,-2,-100.0
86,23,2,1,4,-3,-75.0
86,23,3,15,8,7,87.5
86,23,4,19,16,3,18.75
86,23,5,33,32,1,3.125
86,23,6,76,64,12,18.75
86,23,7,322,128,194,151.5625
86,23,8,834,256,578,225.78125
86,23,9,310,512,-202,-39.453125
86,23,10,1158,1024,134,13.0859375
86,23,11,163,2048,-1885,-92.041015625
86,23,12,2068,4096,-2028,-49.51171875
86,23,13,15522,8192,7330,89.4775390625
86,23,14,23750,16384,7366,44.95849609375
86,23,15,29442,32768,-3326,-10.150146484375
86,24,1,0,2,-2,-100.0
86,24,2,2,4,-2,-50.0
86,24,3,2,8,-6,-75.0
86,24,4,23,16,7,43.75
86,24,5,35,32,3,9.375
86,24,6,70,64,6,9.375
86,24,7,148,128,20,15.625
86,24,8,30,256,-226,-88.28125
86,24,9,1658,512,1146,223.828125
86,24,10,864,1024,-160,-15.625
86,24,11,1756,2048,-292,-14.2578125
86,24,12,816,4096,-3280,-80.078125
86,24,13,16700,8192,8508,103.857421875
86,24,14,8476,16384,-7908,-48.2666015625
86,24,15,29234,32768,-3534,-10.784912109375
86,25,1,0,2,-2,-100.0
86,25,2,5,4,1,25.0
86,25,3,12,8,4,50.0
86,25,4,3,16,-13,-81.25
86,25,5,43,32,11,34.375
86,25,6,26,64,-38,-59.375
86,25,7,21,128,-107,-83.59375
86,25,8,65,256,-191,-74.609375
86,25,9,162,512,-350,-68.359375
86,25,10,265,1024,-759,-74.12109375
86,25,11,1961,2048,-87,-4.248046875
86,25,12,5566,4096,1470,35.888671875
86,25,13,175,8192,-8017,-97.86376953125
86,25,14,70272,16384,53888,328.90625
86,25,15,25867,32768,-6901,-21.0601806640625
86,26,1,0,2,-2,-100.0
86,26,2,1,4,-3,-75.0
86,26,3,3,8,-5,-62.5
86,26,4,10,16,-6,-37.5
86,26,5,42,32,10,31.25
86,26,6,145,64,81,126.5625
86,26,7,68,128,-60,-46.875
86,26,8,569,256,313,122.265625
86,26,9,258,512,-254,-49.609375
86,26,10,760,1024,-264,-25.78125
86,26,11,696,2048,-1352,-66.015625
86,26,12,2178,4096,-1918,-46.826171875
86,26,13,2480,8192,-5712,-69.7265625
86,26,14,19145,16384,2761,16.851806640625
86,26,15,45755,32768,12987,39.6331787109375
86,27,1,0,2,-2,-100.0
86,27,2,2,4,-2,-50.0
86,27,3,7,8,-1,-12.5
86,27,4,19,16,3,18.75
86,27,5,5,32,-27,-84.375
86,27,6,68,64,4,6.25
86,27,7,34,128,-94,-73.4375
86,27,8,260,256,4,1.5625
86,27,9,1120,512,608,118.75
86,27,10,580,1024,-444,-43.359375
86,27,11,1215,2048,-833,-40.673828125
86,27,12,1324,4096,-2772,-67.67578125
86,27,13,2433,8192,-5759,-70.30029296875
86,27,14,6990,16384,-9394,-57.33642578125
86,27,15,45406,32768,12638,38.568115234375
86,28,1,0,2,-2,-100.0
86,28,2,2,4,-2,-50.0
86,28,3,2,8,-6,-75.0
86,28,4,25,16,9,56.25
86,28,5,70,32,38,118.75
86,28,6,29,64,-35,-54.6875
86,28,7,19,128,-109,-85.15625
86,28,8,71,256,-185,-72.265625
86,28,9,1020,512,508,99.21875
86,28,10,1886,1024,862,84.1796875
86,28,11,2013,2048,-35,-1.708984375
86,28,12,1456,4096,-2640,-64.453125
86,28,13,7970,8192,-222,-2.7099609375
86,28,14,6485,16384,-9899,-60.418701171875
86,28,15,15014,32768,-17754,-54.180908203125
86,29,1,0,2,-2,-100.0
86,29,2,1,4,-3,-75.0
86,29,3,8,8,0,0.0
86,29,4,20,16,4,25.0
86,29,5,22,32,-10,-31.25
86,29,6,19,64,-45,-70.3125
86,29,7,127,128,-1,-0.78125
86,29,8,219,256,-37,-14.453125
86,29,9,1659,512,1147,224.0234375
86,29,10,368,1024,-656,-64.0625
86,29,11,5600,2048,3552,173.4375
86,29,12,8499,4096,4403,107.4951171875
86,29,13,18621,8192,10429,127.30712890625
86,29,14,40405,16384,24021,146.612548828125
86,29,15,62523,32768,29755,90.8050537109375
86,30,1,0,2,-2,-100.0
86,30,2,2,4,-2,-50.0
86,30,3,2,8,-6,-75.0
86,30,4,12,16,-4,-25.0
86,30,5,4,32,-28,-87.5
86,30,6,414,64,350,546.875
86,30,7,26,128,-102,-79.6875
86,30,8,117,256,-139,-54.296875
86,30,9,528,512,16,3.125
86,30,10,223,1024,-801,-78.22265625
86,30,11,798,2048,-1250,-61.03515625
86,30,12,177,4096,-3919,-95.6787109375
86,30,13,16754,8192,8562,104.5166015625
86,30,14,811,16384,-15573,-95.050048828125
86,30,15,26362,32768,-6406,-19.549560546875
86,31,1,0,2,-2,-100.0
86,31,2,1,4,-3,-75.0
86,31,3,12,8,4,50.0
86,31,4,5,16,-11,-68.75
86,31,5,22,32,-10,-31.25
86,31,6,187,64,123,192.1875
86,31,7,248,128,120,93.75
86,31,8,244,256,-12,-4.6875
86,31,9,265,512,-247,-48.2421875
86,31,10,455,1024,-569,-55.56640625
86,31,11,534,2048,-1514,-73.92578125
86,31,12,2132,4096,-1964,-47.94921875
86,31,13,267,8192,-7925,-96.74072265625
86,31,14,5474,16384,-10910,-66.58935546875
86,31,15,33359,32768,591,1.8035888671875
86,32,1,0,2,-2,-100.0
86,32,2,1,4,-3,-75.0
86,32,3,2,8,-6,-75.0
86,32,4,6,16,-10,-62.5
86,32,5,130,32,98,306.25
86,32,6,72,64,8,12.5
86,32,7,146,128,18,14.0625
86,32,8,682,256,426,166.40625
86,32,9,214,512,-298,-58.203125
86,32,10,1420,1024,396,38.671875
86,32,11,2026,2048,-22,-1.07421875
86,32,12,9134,4096,5038,122.998046875
86,32,13,24978,8192,16786,204.9072265625
86,32,14,5784,16384,-10600,-64.697265625
86,32,15,6452,32768,-26316,-80.31005859375
86,33,1,0,2,-2,-100.0
86,33,2,3,4,-1,-25.0
86,33,3,13,8,5,62.5
86,33,4,3,16,-13,-81.25
86,33,5,4,32,-28,-87.5
86,33,6,25,64,-39,-60.9375
86,33,7,17,128,-111,-86.71875
86,33,8,1052,256,796,310.9375
86,33,9,1082,512,570,111.328125
86,33,10,685,1024,-339,-33.10546875
86,33,11,42,2048,-2006,-97.94921875
86,33,12,256,4096,-3840,-93.75
86,33,13,1866,8192,-6326,-77.2216796875
86,33,14,24176,16384,7792,47.55859375
86,33,15,43325,32768,10557,32.2174072265625
86,34,1,0,2,-2,-100.0
86,34,2,1,4,-3,-75.0
86,34,3,2,8,-6,-75.0
86,34,4,25,16,9,56.25
86,34,5,48,32,16,50.0
86,34,6,72,64,8,12.5
86,34,7,91,128,-37,-28.90625
86,34,8,805,256,549,214.453125
86,34,9,759,512,247,48.2421875
86,34,10,918,1024,-106,-10.3515625
86,34,11,900,2048,-1148,-56.0546875
86,34,12,1448,4096,-2648,-64.6484375
86,34,13,6777,8192,-1415,-17.27294921875
86,34,14,2432,16384,-13952,-85.15625
86,34,15,10606,32768,-22162,-67.633056640625
86,35,1,0,2,-2,-100.0
86,35,2,1,4,-3,-75.0
86,35,3,7,8,-1,-12.5
86,35,4,9,16,-7,-43.75
86,35,5,87,32,55,171.875
86,35,6,17,64,-47,-73.4375
86,35,7,149,128,21,16.40625
86,35,8,78,256,-178,-69.53125
86,35,9,449,512,-63,-12.3046875
86,35,10,755,1024,-269,-26.26953125
86,35,11,92,2048,-1956,-95.5078125
86,35,12,223,4096,-3873,-94.5556640625
86,35,13,10234,8192,2042,24.9267578125
86,35,14,10510,16384,-5874,-35.85205078125
86,35,15,21833,32768,-10935,-33.3709716796875
86,36,1,0,2,-2,-100.0
86,36,2,2,4,-2,-50.0
86,36,3,2,8,-6,-75.0
86,36,4,22,16,6,37.5
86,36,5,9,32,-23,-71.875
86,36,6,6,64,-58,-90.625
86,36,7,164,128,36,28.125
86,36,8,491,256,235,91.796875
86,36,9,42,512,-470,-91.796875
86,36,10,2752,1024,1728,168.75
86,36,11,442,2048,-1606,-78.41796875
86,36,12,1471,4096,-2625,-64.0869140625
86,36,13,11724,8192,3532,43.115234375
86,36,14,12840,16384,-3544,-21.630859375
86,36,15,19333,32768,-13435,-41.0003662109375
86,37,1,0,2,-2,-100.0
86,37,2,1,4,-3,-75.0
86,37,3,10,8,2,25.0
86,37,4,4,16,-12,-75.0
86,37,5,45,32,13,40.625
86,37,6,85,64,21,32.8125
86,37,7,296,128,168,131.25
86,37,8,121,256,-135,-52.734375
86,37,9,171,512,-341,-66.6015625
86,37,10,229,1024,-795,-77.63671875
86,37,11,3008,2048,960,46.875
86,37,12,792,4096,-3304,-80.6640625
86,37,13,11596,8192,3404,41.552734375
86,37,14,4692,16384,-11692,-71.3623046875
86,37,15,9796,32768,-22972,-70.10498046875
86,38,1,0,2,-2,-100.0
86,38,2,1,4,-3,-75.0
86,38,3,2,8,-6,-75.0
86,38,4,3,16,-13,-81.25
86,38,5,34,32,2,6.25
86,38,6,23,64,-41,-64.0625
86,38,7,56,128,-72,-56.25
86,38,8,571,256,315,123.046875
86,38,9,883,512,371,72.4609375
86,38,10,1168,1024,144,14.0625
86,38,11,828,2048,-1220,-59.5703125
86,38,12,1056,4096,-3040,-74.21875
86,38,13,9330,8192,1138,13.8916015625
86,38,14,11895,16384,-4489,-27.398681640625
86,38,15,64493,32768,31725,96.8170166015625
86,39,1,0,2,-2,-100.0
86,39,2,1,4,-3,-75.0
86,39,3,2,8,-6,-75.0
86,39,4,12,16,-4,-25.0
86,39,5,69,32,37,115.625
86,39,6,72,64,8,12.5
86,39,7,11,128,-117,-91.40625
86,39,8,305,256,49,19.140625
86,39,9,380,512,-132,-25.78125
86,39,10,1251,1024,227,22.16796875
86,39,11,2383,2048,335,16.357421875
86,39,12,1098,4096,-2998,-73.193359375
86,39,13,7501,8192,-691,-8.43505859375
86,39,14,5166,16384,-11218,-68.46923828125
86,39,15,55191,32768,22423,68.4295654296875
86,40,1,0,2,-2,-100.0
86,40,2,1,4,-3,-75.0
86,40,3,4,8,-4,-50.0
86,40,4,10,16,-6,-37.5
86,40,5,11,32,-21,-65.625
86,40,6,34,64,-30,-46.875
86,40,7,35,128,-93,-72.65625
86,40,8,134,256,-122,-47.65625
86,40,9,2264,512,1752,342.1875
86,40,10,369,1024,-655,-63.96484375
86,40,11,1046,2048,-1002,-48.92578125
86,40,12,2520,4096,-1576,-38.4765625
86,40,13,745,8192,-7447,-90.90576171875
86,40,14,8570,16384,-7814,-47.69287109375
86,40,15,8437,32768,-24331,-74.2523193359375
86,41,1,0,2,-2,-100.0
86,41,2,4,4,0,0.0
86,41,3,6,8,-2,-25.0
86,41,4,11,16,-5,-31.25
86,41,5,16,32,-16,-50.0
86,41,6,37,64,-27,-42.1875
86,41,7,257,128,129,100.78125
86,41,8,66,256,-190,-74.21875
86,41,9,179,512,-333,-65.0390625
86,41,10,894,1024,-130,-12.6953125
86,41,11,1993,2048,-55,-2.685546875
86,41,12,5098,4096,1002,24.462890625
86,41,13,5689,8192,-2503,-30.55419921875
86,41,14,18897,16384,2513,15.338134765625
86,41,15,130275,32768,97507,297.5677490234375
86,42,1,0,2,-2,-100.0
86,42,2,5,4,1,25.0
86,42,3,6,8,-2,-25.0
86,42,4,3,16,-13,-81.25
86,42,5,13,32,-19,-59.375
86,42,6,22,64,-42,-65.625
86,42,7,243,128,115,89.84375
86,42,8,303,256,47,18.359375
86,42,9,745,512,233,45.5078125
86,42,10,423,1024,-601,-58.69140625
86,42,11,1131,2048,-917,-44.775390625
86,42,12,2894,4096,-1202,-29.345703125
86,42,13,7353,8192,-839,-10.24169921875
86,42,14,2688,16384,-13696,-83.59375
86,42,15,7040,32768,-25728,-78.515625
86,43,1,0,2,-2,-100.0
86,43,2,1,4,-3,-75.0
86,43,3,3,8,-5,-62.5
86,43,4,9,16,-7,-43.75
86,43,5,36,32,4,12.5
86,43,6,79,64,15,23.4375
86,43,7,16,128,-112,-87.5
86,43,8,286,256,30,11.71875
86,43,9,17,512,-495,-96.6796875
86,43,10,358,1024,-666,-65.0390625
86,43,11,1096,2048,-952,-46.484375
86,43,12,3377,4096,-719,-17.5537109375
86,43,13,7909,8192,-283,-3.45458984375
86,43,14,431,16384,-15953,-97.369384765625
86,43,15,18497,32768,-14271,-43.5516357421875
86,44,1,0,2,-2,-100.0
86,44,2,4,4,0,0.0
86,44,3,2,8,-6,-75.0
86,44,4,14,16,-2,-12.5
86,44,5,75,32,43,134.375
86,44,6,15,64,-49,-76.5625
86,44,7,128,128,0,0.0
86,44,8,587,256,331,129.296875
86,44,9,466,512,-46,-8.984375
86,44,10,2057,1024,1033,100.87890625
86,44,11,5767,2048,3719,181.591796875
86,44,12,8679,4096,4583,111.8896484375
86,44,13,15738,8192,7546,92.1142578125
86,44,14,30084,16384,13700,83.6181640625
86,44,15,54309,32768,21541,65.7379150390625
86,45,1,0,2,-2,-100.0
86,45,2,8,4,4,100.0
86,45,3,2,8,-6,-75.0
86,45,4,3,16,-13,-81.25
86,45,5,21,32,-11,-34.375
86,45,6,112,64,48,75.0
86,45,7,182,128,54,42.1875
86,45,8,174,256,-82,-32.03125
86,45,9,935,512,423,82.6171875
86,45,10,38,1024,-986,-96.2890625
86,45,11,3500,2048,1452,70.8984375
86,45,12,365,4096,-3731,-91.0888671875
86,45,13,9001,8192,809,9.87548828125
86,45,14,27137,16384,10753,65.631103515625
86,45,15,52628,32768,19860,60.60791015625
86,46,1,0,2,-2,-100.0
86,46,2,3,4,-1,-25.0
86,46,3,2,8,-6,-75.0
86,46,4,27,16,11,68.75
86,46,5,90,32,58,181.25
86,46,6,38,64,-26,-40.625
86,46,7,32,128,-96,-75.0
86,46,8,233,256,-23,-8.984375
86,46,9,360,512,-152,-29.6875
86,46,10,222,1024,-802,-78.3203125
86,46,11,1837,2048,-211,-10.302734375
86,46,12,2527,4096,-1569,-38.3056640625
86,46,13,7498,8192,-694,-8.4716796875
86,46,14,14040,16384,-2344,-14.306640625
86,46,15,4193,32768,-28575,-87.2039794921875
86,47,1,0,2,-2,-100.0
86,47,2,2,4,-2,-50.0
86,47,3,5,8,-3,-37.5
86,47,4,10,16,-6,-37.5
86,47,5,29,32,-3,-9.375
86,47,6,43,64,-21,-32.8125
86,47,7,184,128,56,43.75
86,47,8,658,256,402,157.03125
86,47,9,158,512,-354,-69.140625
86,47,10,1764,1024,740,72.265625
86,47,11,2555,2048,507,24.755859375
86,47,12,453,4096,-3643,-88.9404296875
86,47,13,2460,8192,-5732,-69.970703125
86,47,14,8564,16384,-7820,-47.7294921875
86,47,15,2223,32768,-30545,-93.2159423828125
86,48,1,0,2,-2,-100.0
86,48,2,1,4,-3,-75.0
86,48,3,2,8,-6,-75.0
86,48,4,17,16,1,6.25
86,48,5,9,32,-23,-71.875
86,48,6,14,64,-50,-78.125
86,48,7,427,128,299,233.59375
86,48,8,282,256,26,10.15625
86,48,9,714,512,202,39.453125
86,48,10,2196,1024,1172,114.453125
86,48,11,608,2048,-1440,-70.3125
86,48,12,10160,4096,6064,148.046875
86,48,13,15641,8192,7449,90.93017578125
86,48,14,3299,16384,-13085,-79.864501953125
86,48,15,82317,32768,49549,151.2115478515625
86,49,1,0,2,-2,-100.0
86,49,2,3,4,-1,-25.0
86,49,3,6,8,-2,-25.0
86,49,4,11,16,-5,-31.25
86,49,5,17,32,-15,-46.875
86,49,6,106,64,42,65.625
86,49,7,27,128,-101,-78.90625
86,49,8,63,256,-193,-75.390625
86,49,9,260,512,-252,-49.21875
86,49,10,744,1024,-280,-27.34375
86,49,11,2802,2048,754,36.81640625
86,49,12,3043,4096,-1053,-25.7080078125
86,49,13,41699,8192,33507,409.02099609375
86,49,14,18727,16384,2343,14.300537109375
86,49,15,11776,32768,-20992,-64.0625
86,50,1,0,2,-2,-100.0
86,50,2,2,4,-2,-50.0
86,50,3,7,8,-1,-12.5
86,50,4,20,16,4,25.0
86,50,5,46,32,14,43.75
86,50,6,209,64,145,226.5625
86,50,7,78,128,-50,-39.0625
86,50,8,18,256,-238,-92.96875
86,50,9,109,512,-403,-78.7109375
86,50,10,729,1024,-295,-28.80859375
86,50,11,1613,2048,-435,-21.240234375
86,50,12,16889,4096,12793,312.3291015625
86,50,13,431,8192,-7761,-94.73876953125
86,50,14,1287,16384,-15097,-92.144775390625
86,50,15,45072,32768,12304,37.548828125
86,51,1,0,2,-2,-100.0
86,51,2,1,4,-3,-75.0
86,51,3,4,8,-4,-50.0
86,51,4,18,16,2,12.5
86,51,5,100,32,68,212.5
86,51,6,77,64,13,20.3125
86,51,7,251,128,123,96.09375
86,51,8,430,256,174,67.96875
86,51,9,577,512,65,12.6953125
86,51,10,932,1024,-92,-8.984375
86,51,11,811,2048,-1237,-60.400390625
86,51,12,36,4096,-4060,-99.12109375
86,51,13,7983,8192,-209,-2.55126953125
86,51,14,3002,16384,-13382,-81.67724609375
86,51,15,14636,32768,-18132,-55.33447265625
86,52,1,0,2,-2,-100.0
86,52,2,2,4,-2,-50.0
86,52,3,9,8,1,12.5
86,52,4,27,16,11,68.75
86,52,5,36,32,4,12.5
86,52,6,42,64,-22,-34.375
86,52,7,166,128,38,29.6875
86,52,8,70,256,-186,-72.65625
86,52,9,1061,512,549,107.2265625
86,52,10,658,1024,-366,-35.7421875
86,52,11,3585,2048,1537,75.048828125
86,52,12,7083,4096,2987,72.9248046875
86,52,13,13450,8192,5258,64.1845703125
86,52,14,42140,16384,25756,157.2021484375
86,52,15,46646,32768,13878,42.352294921875
86,53,1,0,2,-2,-100.0
86,53,2,1,4,-3,-75.0
86,53,3,5,8,-3,-37.5
86,53,4,6,16,-10,-62.5
86,53,5,16,32,-16,-50.0
86,53,6,27,64,-37,-57.8125
86,53,7,7,128,-121,-94.53125
86,53,8,564,256,308,120.3125
86,53,9,1292,512,780,152.34375
86,53,10,857,1024,-167,-16.30859375
86,53,11,4802,2048,2754,134.47265625
86,53,12,6400,4096,2304,56.25
86,53,13,9663,8192,1471,17.95654296875
86,53,14,29264,16384,12880,78.61328125
86,53,15,9185,32768,-23583,-71.9696044921875
86,54,1,0,2,-2,-100.0
86,54,2,1,4,-3,-75.0
86,54,3,5,8,-3,-37.5
86,54,4,3,16,-13,-81.25
86,54,5,24,32,-8,-25.0
86,54,6,41,64,-23,-35.9375
86,54,7,315,128,187,146.09375
86,54,8,10,256,-246,-96.09375
86,54,9,780,512,268,52.34375
86,54,10,514,1024,-510,-49.8046875
86,54,11,1479,2048,-569,-27.783203125
86,54,12,6041,4096,1945,47.4853515625
86,54,13,14906,8192,6714,81.9580078125
86,54,14,4220,16384,-12164,-74.2431640625
86,54,15,14476,32768,-18292,-55.82275390625
86,55,1,0,2,-2,-100.0
86,55,2,1,4,-3,-75.0
86,55,3,5,8,-3,-37.5
86,55,4,19,16,3,18.75
86,55,5,8,32,-24,-75.0
86,55,6,26,64,-38,-59.375
86,55,7,205,128,77,60.15625
86,55,8,260,256,4,1.5625
86,55,9,526,512,14,2.734375
86,55,10,410,1024,-614,-59.9609375
86,55,11,3529,2048,1481,72.314453125
86,55,12,2177,4096,-1919,-46.8505859375
86,55,13,26370,8192,18178,221.8994140625
86,55,14,87454,16384,71070,433.77685546875
86,55,15,12893,32768,-19875,-60.6536865234375
86,56,1,0,2,-2,-100.0
86,56,2,2,4,-2,-50.0
86,56,3,2,8,-6,-75.0
86,56,4,3,16,-13,-81.25
86,56,5,10,32,-22,-68.75
86,56,6,126,64,62,96.875
86,56,7,27,128,-101,-78.90625
86,56,8,80,256,-176,-68.75
86,56,9,493,512,-19,-3.7109375
86,56,10,2117,1024,1093,106.73828125
86,56,11,352,2048,-1696,-82.8125
86,56,12,242,4096,-3854,-94.091796875
86,56,13,17505,8192,9313,113.68408203125
86,56,14,1319,16384,-15065,-91.949462890625
86,56,15,18410,32768,-14358,-43.817138671875
86,57,1,0,2,-2,-100.0
86,57,2,1,4,-3,-75.0
86,57,3,3,8,-5,-62.5
86,57,4,21,16,5,31.25
86,57,5,55,32,23,71.875
86,57,6,92,64,28,43.75
86,57,7,70,128,-58,-45.3125
86,57,8,45,256,-211,-82.421875
86,57,9,252,512,-260,-50.78125
86,57,10,288,1024,-736,-71.875
86,57,11,1207,2048,-841,-41.064453125
86,57,12,5509,4096,1413,34.4970703125
86,57,13,1349,8192,-6843,-83.53271484375
86,57,14,23625,16384,7241,44.195556640625
86,57,15,44866,32768,12098,36.920166015625
86,58,1,0,2,-2,-100.0
86,58,2,1,4,-3,-75.0
86,58,3,5,8,-3,-37.5
86,58,4,6,16,-10,-62.5
86,58,5,40,32,8,25.0
86,58,6,184,64,120,187.5
86,58,7,64,128,-64,-50.0
86,58,8,459,256,203,79.296875
86,58,9,1316,512,804,157.03125
86,58,10,340,1024,-684,-66.796875
86,58,11,152,2048,-1896,-92.578125
86,58,12,6950,4096,2854,69.677734375
86,58,13,1234,8192,-6958,-84.9365234375
86,58,14,3934,16384,-12450,-75.98876953125
86,58,15,12465,32768,-20303,-61.9598388671875
86,59,1,0,2,-2,-100.0
86,59,2,2,4,-2,-50.0
86,59,3,7,8,-1,-12.5
86,59,4,3,16,-13,-81.25
86,59,5,22,32,-10,-31.25
86,59,6,70,64,6,9.375
86,59,7,666,128,538,420.3125
86,59,8,71,256,-185,-72.265625
86,59,9,113,512,-399,-77.9296875
86,59,10,2731,1024,1707,166.69921875
86,59,11,2395,2048,347,16.943359375
86,59,12,3860,4096,-236,-5.76171875
86,59,13,741,8192,-7451,-90.95458984375
86,59,14,10317,16384,-6067,-37.030029296875
86,59,15,11136,32768,-21632,-66.015625
86,60,1,0,2,-2,-100.0
86,60,2,2,4,-2,-50.0
86,60,3,6,8,-2,-25.0
86,60,4,8,16,-8,-50.0
86,60,5,19,32,-13,-40.625
86,60,6,31,64,-33,-51.5625
86,60,7,30,128,-98,-76.5625
86,60,8,395,256,139,54.296875
86,60,9,578,512,66,12.890625
86,60,10,152,1024,-872,-85.15625
86,60,11,429,2048,-1619,-79.052734375
86,60,12,1195,4096,-2901,-70.8251953125
86,60,13,26782,8192,18590,226.9287109375
86,60,14,26795,16384,10411,63.543701171875
86,60,15,9112,32768,-23656,-72.1923828125
86,61,1,0,2,-2,-100.0
86,61,2,1,4,-3,-75.0
86,61,3,6,8,-2,-25.0
86,61,4,12,16,-4,-25.0
86,61,5,19,32,-13,-40.625
86,61,6,140,64,76,118.75
86,61,7,40,128,-88,-68.75
86,61,8,334,256,78,30.46875
86,61,9,377,512,-135,-26.3671875
86,61,10,916,1024,-108,-10.546875
86,61,11,1466,2048,-582,-28.41796875
86,61,12,1974,4096,-2122,-51.806640625
86,61,13,7301,8192,-891,-10.87646484375
86,61,14,14607,16384,-1777,-10.845947265625
86,61,15,31889,32768,-879,-2.6824951171875
86,62,1,0,2,-2,-100.0
86,62,2,2,4,-2,-50.0
86,62,3,27,8,19,237.5
86,62,4,23,16,7,43.75
86,62,5,4,32,-28,-87.5
86,62,6,61,64,-3,-4.6875
86,62,7,10,128,-118,-92.1875
86,62,8,470,256,214,83.59375
86,62,9,277,512,-235,-45.8984375
86,62,10,2398,1024,1374,134.1796875
86,62,11,79,2048,-1969,-96.142578125
86,62,12,4929,4096,833,20.3369140625
86,62,13,1017,8192,-7175,-87.58544921875
86,62,14,5172,16384,-11212,-68.4326171875
86,62,15,35922,32768,3154,9.625244140625
86,63,1,0,2,-2,-100.0
86,63,2,5,4,1,25.0
86,63,3,5,8,-3,-37.5
86,63,4,14,16,-2,-12.5
86,63,5,12,32,-20,-62.5
86,63,6,24,64,-40,-62.5
86,63,7,14,128,-114,-89.0625
86,63,8,142,256,-114,-44.53125
86,63,9,225,512,-287,-56.0546875
86,63,10,404,1024,-620,-60.546875
86,63,11,2586,2048,538,26.26953125
86,63,12,13173,4096,9077,221.6064453125
86,63,13,2575,8192,-5617,-68.56689453125
86,63,14,12333,16384,-4051,-24.725341796875
86,63,15,30008,32768,-2760,-8.4228515625
86,64,1,0,2,-2,-100.0
86,64,2,5,4,1,25.0
86,64,3,3,8,-5,-62.5
86,64,4,3,16,-13,-81.25
86,64,5,12,32,-20,-62.5
86,64,6,66,64,2,3.125
86,64,7,33,128,-95,-74.21875
86,64,8,136,256,-120,-46.875
86,64,9,136,512,-376,-73.4375
86,64,10,229,1024,-795,-77.63671875
86,64,11,1972,2048,-76,-3.7109375
86,64,12,3508,4096,-588,-14.35546875
86,64,13,1170,8192,-7022,-85.7177734375
86,64,14,9837,16384,-6547,-39.959716796875
86,64,15,35239,32768,2471,7.5408935546875
86,65,1,0,2,-2,-100.0
86,65,2,2,4,-2,-50.0
86,65,3,4,8,-4,-50.0
86,65,4,5,16,-11,-68.75
86,65,5,17,32,-15,-46.875
86,65,6,60,64,-4,-6.25
86,65,7,104,128,-24,-18.75
86,65,8,81,256,-175,-68.359375
86,65,9,1474,512,962,187.890625
86,65,10,1971,1024,947,92.48046875
86,65,11,3596,2048,1548,75.5859375
86,65,12,1155,4096,-2941,-71.8017578125
86,65,13,42252,8192,34060,415.771484375
86,65,14,24394,16384,8010,48.88916015625
86,65,15,13200,32768,-19568,-59.716796875
86,66,1,0,2,-2,-100.0
86,66,2,1,4,-3,-75.0
86,66,3,12,8,4,50.0
86,66,4,4,16,-12,-75.0
86,66,5,14,32,-18,-56.25
86,66,6,351,64,287,448.4375
86,66,7,326,128,198,154.6875
86,66,8,243,256,-13,-5.078125
86,66,9,287,512,-225,-43.9453125
86,66,10,287,1024,-737,-71.97265625
86,66,11,635,2048,-1413,-68.994140625
86,66,12,2737,4096,-1359,-33.1787109375
86,66,13,7134,8192,-1058,-12.9150390625
86,66,14,29398,16384,13014,79.43115234375
86,66,15,16865,32768,-15903,-48.5321044921875
86,67,1,0,2,-2,-100.0
86,67,2,2,4,-2,-50.0
86,67,3,7,8,-1,-12.5
86,67,4,24,16,8,50.0
86,67,5,5,32,-27,-84.375
86,67,6,26,64,-38,-59.375
86,67,7,189,128,61,47.65625
86,67,8,12,256,-244,-95.3125
86,67,9,89,512,-423,-82.6171875
86,67,10,269,1024,-755,-73.73046875
86,67,11,943,2048,-1105,-53.955078125
86,67,12,2504,4096,-1592,-38.8671875
86,67,13,799,8192,-7393,-90.24658203125
86,67,14,68394,16384,52010,317.44384765625
86,67,15,17622,32768,-15146,-46.221923828125
86,68,1,0,2,-2,-100.0
86,68,2,3,4,-1,-25.0
86,68,3,2,8,-6,-75.0
86,68,4,11,16,-5,-31.25
86,68,5,19,32,-13,-40.625
86,68,6,74,64,10,15.625
86,68,7,6,128,-122,-95.3125
86,68,8,82,256,-174,-67.96875
86,68,9,1874,512,1362,266.015625
86,68,10,1020,1024,-4,-0.390625
86,68,11,1318,2048,-730,-35.64453125
86,68,12,10358,4096,6262,152.880859375
86,68,13,9480,8192,1288,15.72265625
86,68,14,16348,16384,-36,-0.2197265625
86,68,15,45681,32768,12913,39.4073486328125
86,69,1,0,2,-2,-100.0
86,69,2,1,4,-3,-75.0
86,69,3,3,8,-5,-62.5
86,69,4,6,16,-10,-62.5
86,69,5,4,32,-28,-87.5
86,69,6,22,64,-42,-65.625
86,69,7,32,128,-96,-75.0
86,69,8,432,256,176,68.75
86,69,9,690,512,178,34.765625
86,69,10,622,1024,-402,-39.2578125
86,69,11,757,2048,-1291,-63.037109375
86,69,12,58,4096,-4038,-98.583984375
86,69,13,18572,8192,10380,126.708984375
86,69,14,1337,16384,-15047,-91.839599609375
86,69,15,9144,32768,-23624,-72.0947265625
86,70,1,0,2,-2,-100.0
86,70,2,1,4,-3,-75.0
86,70,3,6,8,-2,-25.0
86,70,4,13,16,-3,-18.75
86,70,5,22,32,-10,-31.25
86,70,6,174,64,110,171.875
86,70,7,36,128,-92,-71.875
86,70,8,94,256,-162,-63.28125
86,70,9,1032,512,520,101.5625
86,70,10,106,1024,-918,-89.6484375
86,70,11,3538,2048,1490,72.75390625
86,70,12,1970,4096,-2126,-51.904296875
86,70,13,2851,8192,-5341,-65.19775390625
86,70,14,8516,16384,-7868,-48.0224609375
86,70,15,32341,32768,-427,-1.3031005859375
86,71,1,0,2,-2,-100.0
86,71,2,2,4,-2,-50.0
86,71,3,6,8,-2,-25.0
86,71,4,10,16,-6,-37.5
86,71,5,57,32,25,78.125
86,71,6,114,64,50,78.125
86,71,7,61,128,-67,-52.34375
86,71,8,48,256,-208,-81.25
86,71,9,404,512,-108,-21.09375
86,71,10,1057,1024,33,3.22265625
86,71,11,1844,2048,-204,-9.9609375
86,71,12,4958,4096,862,21.044921875
86,71,13,7550,8192,-642,-7.8369140625
86,71,14,17938,16384,1554,9.48486328125
86,71,15,3737,32768,-29031,-88.5955810546875
86,72,1,0,2,-2,-100.0
86,72,2,2,4,-2,-50.0
86,72,3,2,8,-6,-75.0
86,72,4,9,16,-7,-43.75
86,72,5,4,32,-28,-87.5
86,72,6,14,64,-50,-78.125
86,72,7,77,128,-51,-39.84375
86,72,8,108,256,-148,-57.8125
86,72,9,694,512,182,35.546875
86,72,10,118,1024,-906,-88.4765625
86,72,11,462,2048,-1586,-77.44140625
86,72,12,101,4096,-3995,-97.5341796875
86,72,13,6985,8192,-1207,-14.73388671875
86,72,14,9635,16384,-6749,-41.192626953125
86,72,15,53024,32768,20256,61.81640625
86,73,1,0,2,-2,-100.0
86,73,2,2,4,-2,-50.0
86,73,3,2,8,-6,-75.0
86,73,4,3,16,-13,-81.25
86,73,5,123,32,91,284.375
86,73,6,140,64,76,118.75
86,73,7,9,128,-119,-92.96875
86,73,8,138,256,-118,-46.09375
86,73,9,85,512,-427,-83.3984375
86,73,10,2355,1024,1331,129.98046875
86,73,11,5176,2048,3128,152.734375
86,73,12,1228,4096,-2868,-70.01953125
86,73,13,8443,8192,251,3.06396484375
86,73,14,22887,16384,6503,39.691162109375
86,73,15,56191,32768,23423,71.4813232421875
86,74,1,0,2,-2,-100.0
86,74,2,1,4,-3,-75.0
86,74,3,2,8,-6,-75.0
86,74,4,9,16,-7,-43.75
86,74,5,8,32,-24,-75.0
86,74,6,51,64,-13,-20.3125
86,74,7,131,128,3,2.34375
86,74,8,525,256,269,105.078125
86,74,9,418,512,-94,-18.359375
86,74,10,370,1024,-654,-63.8671875
86,74,11,1689,2048,-359,-17.529296875
86,74,12,3661,4096,-435,-10.6201171875
86,74,13,654,8192,-7538,-92.0166015625
86,74,14,17164,16384,780,4.7607421875
86,74,15,17010,32768,-15758,-48.089599609375
86,75,1,0,2,-2,-100.0
86,75,2,2,4,-2,-50.0
86,75,3,19,8,11,137.5
86,75,4,7,16,-9,-56.25
86,75,5,43,32,11,34.375
86,75,6,132,64,68,106.25
86,75,7,32,128,-96,-75.0
86,75,8,547,256,291,113.671875
86,75,9,441,512,-71,-13.8671875
86,75,10,91,1024,-933,-91.11328125
86,75,11,1008,2048,-1040,-50.78125
86,75,12,18235,4096,14139,345.1904296875
86,75,13,40575,8192,32383,395.30029296875
86,75,14,13342,16384,-3042,-18.56689453125
86,75,15,25711,32768,-7057,-21.5362548828125
86,76,1,0,2,-2,-100.0
86,76,2,3,4,-1,-25.0
86,76,3,3,8,-5,-62.5
86,76,4,27,16,11,68.75
86,76,5,69,32,37,115.625
86,76,6,38,64,-26,-40.625
86,76,7,196,128,68,53.125
86,76,8,18,256,-238,-92.96875
86,76,9,149,512,-363,-70.8984375
86,76,10,563,1024,-461,-45.01953125
86,76,11,555,2048,-1493,-72.900390625
86,76,12,2640,4096,-1456,-35.546875
86,76,13,13714,8192,5522,67.4072265625
86,76,14,20408,16384,4024,24.560546875
86,76,15,2423,32768,-30345,-92.6055908203125
86,77,1,0,2,-2,-100.0
86,77,2,4,4,0,0.0
86,77,3,10,8,2,25.0
86,77,4,17,16,1,6.25
86,77,5,75,32,43,134.375
86,77,6,13,64,-51,-79.6875
86,77,7,40,128,-88,-68.75
86,77,8,314,256,58,22.65625
86,77,9,210,512,-302,-58.984375
86,77,10,379,1024,-645,-62.98828125
86,77,11,1027,2048,-1021,-49.853515625
86,77,12,347,4096,-3749,-91.5283203125
86,77,13,22541,8192,14349,175.15869140625
86,77,14,3128,16384,-13256,-80.908203125
86,77,15,34603,32768,1835,5.5999755859375
86,78,1,0,2,-2,-100.0
86,78,2,2,4,-2,-50.0
86,78,3,8,8,0,0.0
86,78,4,23,16,7,43.75
86,78,5,13,32,-19,-59.375
86,78,6,11,64,-53,-82.8125
86,78,7,15,128,-113,-88.28125
86,78,8,150,256,-106,-41.40625
86,78,9,135,512,-377,-73.6328125
86,78,10,3714,1024,2690,262.6953125
86,78,11,1834,2048,-214,-10.44921875
86,78,12,5284,4096,1188,29.00390625
86,78,13,200,8192,-7992,-97.55859375
86,78,14,42076,16384,25692,156.8115234375
86,78,15,88635,32768,55867,170.4925537109375
86,79,1,0,2,-2,-100.0
86,79,2,1,4,-3,-75.0
86,79,3,15,8,7,87.5
86,79,4,4,16,-12,-75.0
86,79,5,33,32,1,3.125
86,79,6,80,64,16,25.0
86,79,7,72,128,-56,-43.75
86,79,8,313,256,57,22.265625
86,79,9,423,512,-89,-17.3828125
86,79,10,398,1024,-626,-61.1328125
86,79,11,6679,2048,4631,226.123046875
86,79,12,14249,4096,10153,247.8759765625
86,79,13,9389,8192,1197,14.61181640625
86,79,14,17822,16384,1438,8.77685546875
86,79,15,55011,32768,22243,67.8802490234375
86,80,1,0,2,-2,-100.0
86,80,2,1,4,-3,-75.0
86,80,3,20,8,12,150.0
86,80,4,10,16,-6,-37.5
86,80,5,44,32,12,37.5
86,80,6,6,64,-58,-90.625
86,80,7,61,128,-67,-52.34375
86,80,8,85,256,-171,-66.796875
86,80,9,253,512,-259,-50.5859375
86,80,10,137,1024,-887,-86.62109375
86,80,11,1576,2048,-472,-23.046875
86,80,12,5312,4096,1216,29.6875
86,80,13,2204,8192,-5988,-73.095703125
86,80,14,37997,16384,21613,131.915283203125
86,80,15,9752,32768,-23016,-70.2392578125
86,81,1,0,2,-2,-100.0
86,81,2,1,4,-3,-75.0
86,81,3,12,8,4,50.0
86,81,4,25,16,9,56.25
86,81,5,4,32,-28,-87.5
86,81,6,77,64,13,20.3125
86,81,7,193,128,65,50.78125
86,81,8,31,256,-225,-87.890625
86,81,9,238,512,-274,-53.515625
86,81,10,1339,1024,315,30.76171875
86,81,11,207,2048,-1841,-89.892578125
86,81,12,3589,4096,-507,-12.3779296875
86,81,13,14141,8192,5949,72.61962890625
86,81,14,16032,16384,-352,-2.1484375
86,81,15,73425,32768,40657,124.0753173828125
86,82,1,0,2,-2,-100.0
86,82,2,1,4,-3,-75.0
86,82,3,2,8,-6,-75.0
86,82,4,23,16,7,43.75
86,82,5,75,32,43,134.375
86,82,6,53,64,-11,-17.1875
86,82,7,32,128,-96,-75.0
86,82,8,150,256,-106,-41.40625
86,82,9,280,512,-232,-45.3125
86,82,10,1093,1024,69,6.73828125
86,82,11,227,2048,-1821,-88.916015625
86,82,12,4799,4096,703,17.1630859375
86,82,13,3022,8192,-5170,-63.1103515625
86,82,14,11008,16384,-5376,-32.8125
86,82,15,76132,32768,43364,132.33642578125
86,83,1,0,2,-2,-100.0
86,83,2,1,4,-3,-75.0
86,83,3,5,8,-3,-37.5
86,83,4,8,16,-8,-50.0
86,83,5,16,32,-16,-50.0
86,83,6,40,64,-24,-37.5
86,83,7,65,128,-63,-49.21875
86,83,8,50,256,-206,-80.46875
86,83,9,60,512,-452,-88.28125
86,83,10,769,1024,-255,-24.90234375
86,83,11,837,2048,-1211,-59.130859375
86,83,12,4125,4096,29,0.7080078125
86,83,13,3915,8192,-4277,-52.20947265625
86,83,14,29633,16384,13249,80.865478515625
86,83,15,28507,32768,-4261,-13.0035400390625
86,84,1,0,2,-2,-100.0
86,84,2,2,4,-2,-50.0
86,84,3,2,8,-6,-75.0
86,84,4,7,16,-9,-56.25
86,84,5,13,32,-19,-59.375
86,84,6,50,64,-14,-21.875
86,84,7,170,128,42,32.8125
86,84,8,624,256,368,143.75
86,84,9,1785,512,1273,248.6328125
86,84,10,624,1024,-400,-39.0625
86,84,11,1608,2048,-440,-21.484375
86,84,12,1119,4096,-2977,-72.6806640625
86,84,13,3291,8192,-4901,-59.82666015625
86,84,14,28994,16384,12610,76.96533203125
86,84,15,91853,32768,59085,180.3131103515625
86,85,1,0,2,-2,-100.0
86,85,2,2,4,-2,-50.0
86,85,3,3,8,-5,-62.5
86,85,4,3,16,-13,-81.25
86,85,5,18,32,-14,-43.75
86,85,6,32,64,-32,-50.0
86,85,7,52,128,-76,-59.375
86,85,8,336,256,80,31.25
86,85,9,188,512,-324,-63.28125
86,85,10,56,1024,-968,-94.53125
86,85,11,3615,2048,1567,76.513671875
86,85,12,8879,4096,4783,116.7724609375
86,85,13,551,8192,-7641,-93.27392578125
86,85,14,3396,16384,-12988,-79.2724609375
86,85,15,9034,32768,-23734,-72.430419921875
86,86,1,0,2,-2,-100.0
86,86,2,3,4,-1,-25.0
86,86,3,7,8,-1,-12.5
86,86,4,7,16,-9,-56.25
86,86,5,5,32,-27,-84.375
86,86,6,7,64,-57,-89.0625
86,86,7,7,128,-121,-94.53125
86,86,8,255,256,-1,-0.390625
86,86,9,504,512,-8,-1.5625
86,86,10,2525,1024,1501,146.58203125
86,86,11,2088,2048,40,1.953125
86,86,12,3516,4096,-580,-14.16015625
86,86,13,6270,8192,-1922,-23.4619140625
86,86,14,1572,16384,-14812,-90.4052734375
86,86,15,20925,32768,-11843,-36.1419677734375
87,1,1,0,2,-2,-100.0
87,1,2,2,4,-2,-50.0
87,1,3,2,8,-6,-75.0
87,1,4,6,16,-10,-62.5
87,1,5,64,32,32,100.0
87,1,6,8,64,-56,-87.5
87,1,7,191,128,63,49.21875
87,1,8,353,256,97,37.890625
87,1,9,2113,512,1601,312.6953125
87,1,10,648,1024,-376,-36.71875
87,1,11,1003,2048,-1045,-51.025390625
87,1,12,16288,4096,12192,297.65625
87,1,13,6272,8192,-1920,-23.4375
87,1,14,5038,16384,-11346,-69.25048828125
87,1,15,12691,32768,-20077,-61.2701416015625
87,2,1,0,2,-2,-100.0
87,2,2,4,4,0,0.0
87,2,3,11,8,3,37.5
87,2,4,11,16,-5,-31.25
87,2,5,137,32,105,328.125
87,2,6,9,64,-55,-85.9375
87,2,7,24,128,-104,-81.25
87,2,8,465,256,209,81.640625
87,2,9,52,512,-460,-89.84375
87,2,10,85,1024,-939,-91.69921875
87,2,11,970,2048,-1078,-52.63671875
87,2,12,9343,4096,5247,128.1005859375
87,2,13,5162,8192,-3030,-36.9873046875
87,2,14,78,16384,-16306,-99.52392578125
87,2,15,64352,32768,31584,96.38671875
87,3,1,0,2,-2,-100.0
87,3,2,1,4,-3,-75.0
87,3,3,3,8,-5,-62.5
87,3,4,7,16,-9,-56.25
87,3,5,20,32,-12,-37.5
87,3,6,25,64,-39,-60.9375
87,3,7,373,128,245,191.40625
87,3,8,337,256,81,31.640625
87,3,9,351,512,-161,-31.4453125
87,3,10,531,1024,-493,-48.14453125
87,3,11,1406,2048,-642,-31.34765625
87,3,12,2168,4096,-1928,-47.0703125
87,3,13,5577,8192,-2615,-31.92138671875
87,3,14,37184,16384,20800,126.953125
87,3,15,14342,32768,-18426,-56.231689453125
87,4,1,0,2,-2,-100.0
87,4,2,1,4,-3,-75.0
87,4,3,2,8,-6,-75.0
87,4,4,3,16,-13,-81.25
87,4,5,84,32,52,162.5
87,4,6,43,64,-21,-32.8125
87,4,7,131,128,3,2.34375
87,4,8,563,256,307,119.921875
87,4,9,285,512,-227,-44.3359375
87,4,10,456,1024,-568,-55.46875
87,4,11,423,2048,-1625,-79.345703125
87,4,12,1652,4096,-2444,-59.66796875
87,4,13,1495,8192,-6697,-81.75048828125
87,4,14,12792,16384,-3592,-21.923828125
87,4,15,42187,32768,9419,28.7445068359375
87,5,1,0,2,-2,-100.0
87,5,2,4,4,0,0.0
87,5,3,6,8,-2,-25.0
87,5,4,30,16,14,87.5
87,5,5,5,32,-27,-84.375
87,5,6,41,64,-23,-35.9375
87,5,7,75,128,-53,-41.40625
87,5,8,153,256,-103,-40.234375
87,5,9,1002,512,490,95.703125
87,5,10,1497,1024,473,46.19140625
87,5,11,192,2048,-1856,-90.625
87,5,12,14008,4096,9912,241.9921875
87,5,13,15717,8192,7525,91.85791015625
87,5,14,55101,16384,38717,236.309814453125
87,5,15,67719,32768,34951,106.6619873046875
87,6,1,0,2,-2,-100.0
87,6,2,3,4,-1,-25.0
87,6,3,5,8,-3,-37.5
87,6,4,7,16,-9,-56.25
87,6,5,7,32,-25,-78.125
87,6,6,18,64,-46,-71.875
87,6,7,430,128,302,235.9375
87,6,8,169,256,-87,-33.984375
87,6,9,257,512,-255,-49.8046875
87,6,10,1926,1024,902,88.0859375
87,6,11,698,2048,-1350,-65.91796875
87,6,12,891,4096,-3205,-78.2470703125
87,6,13,4734,8192,-3458,-42.2119140625
87,6,14,17058,16384,674,4.11376953125
87,6,15,25079,32768,-7689,-23.4649658203125
87,7,1,0,2,-2,-100.0
87,7,2,2,4,-2,-50.0
87,7,3,17,8,9,112.5
87,7,4,22,16,6,37.5
87,7,5,5,32,-27,-84.375
87,7,6,101,64,37,57.8125
87,7,7,474,128,346,270.3125
87,7,8,131,256,-125,-48.828125
87,7,9,497,512,-15,-2.9296875
87,7,10,472,1024,-552,-53.90625
87,7,11,3248,2048,1200,58.59375
87,7,12,4798,4096,702,17.138671875
87,7,13,291,8192,-7901,-96.44775390625
87,7,14,42038,16384,25654,156.57958984375
87,7,15,56104,32768,23336,71.2158203125
87,8,1,0,2,-2,-100.0
87,8,2,1,4,-3,-75.0
87,8,3,13,8,5,62.5
87,8,4,4,16,-12,-75.0
87,8,5,7,32,-25,-78.125
87,8,6,12,64,-52,-81.25
87,8,7,15,128,-113,-88.28125
87,8,8,225,256,-31,-12.109375
87,8,9,668,512,156,30.46875
87,8,10,1598,1024,574,56.0546875
87,8,11,1632,2048,-416,-20.3125
87,8,12,196,4096,-3900,-95.21484375
87,8,13,3117,8192,-5075,-61.95068359375
87,8,14,5279,16384,-11105,-67.779541015625
87,8,15,88583,32768,55815,170.3338623046875
87,9,1,0,2,-2,-100.0
87,9,2,1,4,-3,-75.0
87,9,3,7,8,-1,-12.5
87,9,4,17,16,1,6.25
87,9,5,14,32,-18,-56.25
87,9,6,44,64,-20,-31.25
87,9,7,118,128,-10,-7.8125
87,9,8,912,256,656,256.25
87,9,9,126,512,-386,-75.390625
87,9,10,328,1024,-696,-67.96875
87,9,11,1555,2048,-493,-24.072265625
87,9,12,2976,4096,-1120,-27.34375
87,9,13,1405,8192,-6787,-82.84912109375
87,9,14,32133,16384,15749,96.124267578125
87,9,15,25682,32768,-7086,-21.624755859375
87,10,1,0,2,-2,-100.0
87,10,2,2,4,-2,-50.0
87,10,3,10,8,2,25.0
87,10,4,5,16,-11,-68.75
87,10,5,13,32,-19,-59.375
87,10,6,71,64,7,10.9375
87,10,7,529,128,401,313.28125
87,10,8,291,256,35,13.671875
87,10,9,13,512,-499,-97.4609375
87,10,10,5690,1024,4666,455.6640625
87,10,11,4461,2048,2413,117.822265625
87,10,12,6669,4096,2573,62.8173828125
87,10,13,27481,8192,19289,235.46142578125
87,10,14,16403,16384,19,0.115966796875
87,10,15,14931,32768,-17837,-54.4342041015625
87,11,1,0,2,-2,-100.0
87,11,2,1,4,-3,-75.0
87,11,3,2,8,-6,-75.0
87,11,4,24,16,8,50.0
87,11,5,19,32,-13,-40.625
87,11,6,68,64,4,6.25
87,11,7,45,128,-83,-64.84375
87,11,8,1592,256,1336,521.875
87,11,9,270,512,-242,-47.265625
87,11,10,1082,1024,58,5.6640625
87,11,11,9035,2048,6987,341.162109375
87,11,12,243,4096,-3853,-94.0673828125
87,11,13,6470,8192,-1722,-21.0205078125
87,11,14,8457,16384,-7927,-48.382568359375
87,11,15,4855,32768,-27913,-85.1837158203125
87,12,1,0,2,-2,-100.0
87,12,2,2,4,-2,-50.0
87,12,3,4,8,-4,-50.0
87,12,4,27,16,11,68.75
87,12,5,10,32,-22,-68.75
87,12,6,11,64,-53,-82.8125
87,12,7,12,128,-116,-90.625
87,12,8,41,256,-215,-83.984375
87,12,9,1545,512,1033,201.7578125
87,12,10,412,1024,-612,-59.765625
87,12,11,91,2048,-1957,-95.556640625
87,12,12,1072,4096,-3024,-73.828125
87,12,13,20431,8192,12239,149.40185546875
87,12,14,37936,16384,21552,131.54296875
87,12,15,39761,32768,6993,21.3409423828125
87,13,1,0,2,-2,-100.0
87,13,2,2,4,-2,-50.0
87,13,3,2,8,-6,-75.0
87,13,4,10,16,-6,-37.5
87,13,5,6,32,-26,-81.25
87,13,6,64,64,0,0.0
87,13,7,70,128,-58,-45.3125
87,13,8,87,256,-169,-66.015625
87,13,9,276,512,-236,-46.09375
87,13,10,201,1024,-823,-80.37109375
87,13,11,152,2048,-1896,-92.578125
87,13,12,116,4096,-3980,-97.16796875
87,13,13,426,8192,-7766,-94.7998046875
87,13,14,41949,16384,25565,156.036376953125
87,13,15,6610,32768,-26158,-79.827880859375
87,14,1,0,2,-2,-100.0
87,14,2,3,4,-1,-25.0
87,14,3,2,8,-6,-75.0
87,14,4,7,16,-9,-56.25
87,14,5,60,32,28,87.5
87,14,6,74,64,10,15.625
87,14,7,68,128,-60,-46.875
87,14,8,354,256,98,38.28125
87,14,9,728,512,216,42.1875
87,14,10,1579,1024,555,54.19921875
87,14,11,967,2048,-1081,-52.783203125
87,14,12,2706,4096,-1390,-33.935546875
87,14,13,3431,8192,-4761,-58.11767578125
87,14,14,9930,16384,-6454,-39.39208984375
87,14,15,48376,32768,15608,47.6318359375
87,15,1,0,2,-2,-100.0
87,15,2,1,4,-3,-75.0
87,15,3,4,8,-4,-50.0
87,15,4,21,16,5,31.25
87,15,5,13,32,-19,-59.375
87,15,6,26,64,-38,-59.375
87,15,7,111,128,-17,-13.28125
87,15,8,35,256,-221,-86.328125
87,15,9,111,512,-401,-78.3203125
87,15,10,406,1024,-618,-60.3515625
87,15,11,604,2048,-1444,-70.5078125
87,15,12,275,4096,-3821,-93.2861328125
87,15,13,8799,8192,607,7.40966796875
87,15,14,6675,16384,-9709,-59.259033203125
87,15,15,24087,32768,-8681,-26.4923095703125
87,16,1,0,2,-2,-100.0
87,16,2,2,4,-2,-50.0
87,16,3,10,8,2,25.0
87,16,4,10,16,-6,-37.5
87,16,5,42,32,10,31.25
87,16,6,77,64,13,20.3125
87,16,7,6,128,-122,-95.3125
87,16,8,837,256,581,226.953125
87,16,9,636,512,124,24.21875
87,16,10,644,1024,-380,-37.109375
87,16,11,6367,2048,4319,210.888671875
87,16,12,2328,4096,-1768,-43.1640625
87,16,13,2834,8192,-5358,-65.4052734375
87,16,14,6491,16384,-9893,-60.382080078125
87,16,15,50421,32768,17653,53.8726806640625
87,17,1,0,2,-2,-100.0
87,17,2,1,4,-3,-75.0
87,17,3,2,8,-6,-75.0
87,17,4,5,16,-11,-68.75
87,17,5,8,32,-24,-75.0
87,17,6,12,64,-52,-81.25
87,17,7,514,128,386,301.5625
87,17,8,116,256,-140,-54.6875
87,17,9,716,512,204,39.84375
87,17,10,603,1024,-421,-41.11328125
87,17,11,1844,2048,-204,-9.9609375
87,17,12,2833,4096,-1263,-30.8349609375
87,17,13,2746,8192,-5446,-66.4794921875
87,17,14,5672,16384,-10712,-65.380859375
87,17,15,38507,32768,5739,17.5140380859375
87,18,1,0,2,-2,-100.0
87,18,2,2,4,-2,-50.0
87,18,3,8,8,0,0.0
87,18,4,5,16,-11,-68.75
87,18,5,29,32,-3,-9.375
87,18,6,131,64,67,104.6875
87,18,7,45,128,-83,-64.84375
87,18,8,16,256,-240,-93.75
87,18,9,970,512,458,89.453125
87,18,10,1633,1024,609,59.47265625
87,18,11,1010,2048,-1038,-50.68359375
87,18,12,4937,4096,841,20.5322265625
87,18,13,10738,8192,2546,31.0791015625
87,18,14,47944,16384,31560,192.626953125
87,18,15,105591,32768,72823,222.2381591796875
87,19,1,0,2,-2,-100.0
87,19,2,1,4,-3,-75.0
87,19,3,6,8,-2,-25.0
87,19,4,9,16,-7,-43.75
87,19,5,12,32,-20,-62.5
87,19,6,26,64,-38,-59.375
87,19,7,128,128,0,0.0
87,19,8,339,256,83,32.421875
87,19,9,343,512,-169,-33.0078125
87,19,10,770,1024,-254,-24.8046875
87,19,11,670,2048,-1378,-67.28515625
87,19,12,4242,4096,146,3.564453125
87,19,13,4917,8192,-3275,-39.97802734375
87,19,14,21352,16384,4968,30.322265625
87,19,15,14515,32768,-18253,-55.7037353515625
87,20,1,0,2,-2,-100.0
87,20,2,2,4,-2,-50.0
87,20,3,2,8,-6,-75.0
87,20,4,8,16,-8,-50.0
87,20,5,50,32,18,56.25
87,20,6,89,64,25,39.0625
87,20,7,125,128,-3,-2.34375
87,20,8,222,256,-34,-13.28125
87,20,9,334,512,-178,-34.765625
87,20,10,1311,1024,287,28.02734375
87,20,11,3320,2048,1272,62.109375
87,20,12,6700,4096,2604,63.57421875
87,20,13,1751,8192,-6441,-78.62548828125
87,20,14,9374,16384,-7010,-42.78564453125
87,20,15,13976,32768,-18792,-57.3486328125
87,21,1,0,2,-2,-100.0
87,21,2,3,4,-1,-25.0
87,21,3,3,8,-5,-62.5
87,21,4,12,16,-4,-25.0
87,21,5,27,32,-5,-15.625
87,21,6,51,64,-13,-20.3125
87,21,7,258,128,130,101.5625
87,21,8,281,256,25,9.765625
87,21,9,286,512,-226,-44.140625
87,21,10,529,1024,-495,-48.33984375
87,21,11,922,2048,-1126,-54.98046875
87,21,12,3575,4096,-521,-12.7197265625
87,21,13,451,8192,-7741,-94.49462890625
87,21,14,72929,16384,56545,345.123291015625
87,21,15,65299,32768,32531,99.2767333984375
87,22,1,0,2,-2,-100.0
87,22,2,1,4,-3,-75.0
87,22,3,5,8,-3,-37.5
87,22,4,30,16,14,87.5
87,22,5,11,32,-21,-65.625
87,22,6,11,64,-53,-82.8125
87,22,7,172,128,44,34.375
87,22,8,101,256,-155,-60.546875
87,22,9,144,512,-368,-71.875
87,22,10,516,1024,-508,-49.609375
87,22,11,304,2048,-1744,-85.15625
87,22,12,326,4096,-3770,-92.041015625
87,22,13,14578,8192,6386,77.9541015625
87,22,14,14693,16384,-1691,-10.321044921875
87,22,15,47277,32768,14509,44.2779541015625
87,23,1,0,2,-2,-100.0
87,23,2,5,4,1,25.0
87,23,3,2,8,-6,-75.0
87,23,4,5,16,-11,-68.75
87,23,5,101,32,69,215.625
87,23,6,9,64,-55,-85.9375
87,23,7,35,128,-93,-72.65625
87,23,8,188,256,-68,-26.5625
87,23,9,386,512,-126,-24.609375
87,23,10,570,1024,-454,-44.3359375
87,23,11,2825,2048,777,37.939453125
87,23,12,4700,4096,604,14.74609375
87,23,13,2709,8192,-5483,-66.93115234375
87,23,14,25282,16384,8898,54.30908203125
87,23,15,3992,32768,-28776,-87.8173828125
87,24,1,0,2,-2,-100.0
87,24,2,3,4,-1,-25.0
87,24,3,4,8,-4,-50.0
87,24,4,15,16,-1,-6.25
87,24,5,30,32,-2,-6.25
87,24,6,22,64,-42,-65.625
87,24,7,87,128,-41,-32.03125
87,24,8,74,256,-182,-71.09375
87,24,9,509,512,-3,-0.5859375
87,24,10,236,1024,-788,-76.953125
87,24,11,418,2048,-1630,-79.58984375
87,24,12,5369,4096,1273,31.0791015625
87,24,13,15739,8192,7547,92.12646484375
87,24,14,50036,16384,33652,205.3955078125
87,24,15,12495,32768,-20273,-61.8682861328125
87,25,1,0,2,-2,-100.0
87,25,2,2,4,-2,-50.0
87,25,3,6,8,-2,-25.0
87,25,4,41,16,25,156.25
87,25,5,18,32,-14,-43.75
87,25,6,36,64,-28,-43.75
87,25,7,27,128,-101,-78.90625
87,25,8,443,256,187,73.046875
87,25,9,319,512,-193,-37.6953125
87,25,10,318,1024,-706,-68.9453125
87,25,11,234,2048,-1814,-88.57421875
87,25,12,4699,4096,603,14.7216796875
87,25,13,2685,8192,-5507,-67.22412109375
87,25,14,20291,16384,3907,23.846435546875
87,25,15,49020,32768,16252,49.59716796875
87,26,1,0,2,-2,-100.0
87,26,2,1,4,-3,-75.0
87,26,3,3,8,-5,-62.5
87,26,4,22,16,6,37.5
87,26,5,27,32,-5,-15.625
87,26,6,156,64,92,143.75
87,26,7,36,128,-92,-71.875
87,26,8,156,256,-100,-39.0625
87,26,9,90,512,-422,-82.421875
87,26,10,1369,1024,345,33.69140625
87,26,11,995,2048,-1053,-51.416015625
87,26,12,4468,4096,372,9.08203125
87,26,13,1889,8192,-6303,-76.94091796875
87,26,14,23863,16384,7479,45.648193359375
87,26,15,9069,32768,-23699,-72.3236083984375
87,27,1,0,2,-2,-100.0
87,27,2,1,4,-3,-75.0
87,27,3,2,8,-6,-75.0
87,27,4,37,16,21,131.25
87,27,5,9,32,-23,-71.875
87,27,6,19,64,-45,-70.3125
87,27,7,39,128,-89,-69.53125
87,27,8,914,256,658,257.03125
87,27,9,300,512,-212,-41.40625
87,27,10,1585,1024,561,54.78515625
87,27,11,1330,2048,-718,-35.05859375
87,27,12,13508,4096,9412,229.78515625
87,27,13,18038,8192,9846,120.1904296875
87,27,14,22504,16384,6120,37.353515625
87,27,15,21073,32768,-11695,-35.6903076171875
87,28,1,0,2,-2,-100.0
87,28,2,1,4,-3,-75.0
87,28,3,4,8,-4,-50.0
87,28,4,18,16,2,12.5
87,28,5,17,32,-15,-46.875
87,28,6,192,64,128,200.0
87,28,7,250,128,122,95.3125
87,28,8,84,256,-172,-67.1875
87,28,9,68,512,-444,-86.71875
87,28,10,343,1024,-681,-66.50390625
87,28,11,3639,2048,1591,77.685546875
87,28,12,1228,4096,-2868,-70.01953125
87,28,13,1565,8192,-6627,-80.89599609375
87,28,14,3593,16384,-12791,-78.070068359375
87,28,15,6986,32768,-25782,-78.680419921875
87,29,1,0,2,-2,-100.0
87,29,2,2,4,-2,-50.0
87,29,3,6,8,-2,-25.0
87,29,4,13,16,-3,-18.75
87,29,5,6,32,-26,-81.25
87,29,6,5,64,-59,-92.1875
87,29,7,96,128,-32,-25.0
87,29,8,189,256,-67,-26.171875
87,29,9,175,512,-337,-65.8203125
87,29,10,234,1024,-790,-77.1484375
87,29,11,119,2048,-1929,-94.189453125
87,29,12,736,4096,-3360,-82.03125
87,29,13,7779,8192,-413,-5.04150390625
87,29,14,33458,16384,17074,104.21142578125
87,29,15,7601,32768,-25167,-76.8035888671875
87,30,1,0,2,-2,-100.0
87,30,2,4,4,0,0.0
87,30,3,2,8,-6,-75.0
87,30,4,15,16,-1,-6.25
87,30,5,9,32,-23,-71.875
87,30,6,32,64,-32,-50.0
87,30,7,106,128,-22,-17.1875
87,30,8,153,256,-103,-40.234375
87,30,9,348,512,-164,-32.03125
87,30,10,412,1024,-612,-59.765625
87,30,11,3269,2048,1221,59.619140625
87,30,12,141,4096,-3955,-96.5576171875
87,30,13,883,8192,-7309,-89.22119140625
87,30,14,6457,16384,-9927,-60.589599609375
87,30,15,18611,32768,-14157,-43.2037353515625
87,31,1,0,2,-2,-100.0
87,31,2,3,4,-1,-25.0
87,31,3,9,8,1,12.5
87,31,4,24,16,8,50.0
87,31,5,24,32,-8,-25.0
87,31,6,23,64,-41,-64.0625
87,31,7,52,128,-76,-59.375
87,31,8,391,256,135,52.734375
87,31,9,35,512,-477,-93.1640625
87,31,10,3556,1024,2532,247.265625
87,31,11,1554,2048,-494,-24.12109375
87,31,12,1698,4096,-2398,-58.544921875
87,31,13,971,8192,-7221,-88.14697265625
87,31,14,3430,16384,-12954,-79.06494140625
87,31,15,25994,32768,-6774,-20.672607421875
87,32,1,0,2,-2,-100.0
87,32,2,1,4,-3,-75.0
87,32,3,15,8,7,87.5
87,32,4,21,16,5,31.25
87,32,5,73,32,41,128.125
87,32,6,76,64,12,18.75
87,32,7,38,128,-90,-70.3125
87,32,8,417,256,161,62.890625
87,32,9,79,512,-433,-84.5703125
87,32,10,2596,1024,1572,153.515625
87,32,11,435,2048,-1613,-78.759765625
87,32,12,712,4096,-3384,-82.6171875
87,32,13,20171,8192,11979,146.22802734375
87,32,14,19561,16384,3177,19.390869140625
87,32,15,42445,32768,9677,29.5318603515625
87,33,1,0,2,-2,-100.0
87,33,2,4,4,0,0.0
87,33,3,3,8,-5,-62.5
87,33,4,4,16,-12,-75.0
87,33,5,26,32,-6,-18.75
87,33,6,18,64,-46,-71.875
87,33,7,35,128,-93,-72.65625
87,33,8,60,256,-196,-76.5625
87,33,9,376,512,-136,-26.5625
87,33,10,633,1024,-391,-38.18359375
87,33,11,297,2048,-1751,-85.498046875
87,33,12,3096,4096,-1000,-24.4140625
87,33,13,14342,8192,6150,75.0732421875
87,33,14,15221,16384,-1163,-7.098388671875
87,33,15,4024,32768,-28744,-87.7197265625
87,34,1,0,2,-2,-100.0
87,34,2,1,4,-3,-75.0
87,34,3,2,8,-6,-75.0
87,34,4,17,16,1,6.25
87,34,5,69,32,37,115.625
87,34,6,10,64,-54,-84.375
87,34,7,197,128,69,53.90625
87,34,8,52,256,-204,-79.6875
87,34,9,124,512,-388,-75.78125
87,34,10,37,1024,-987,-96.38671875
87,34,11,1192,2048,-856,-41.796875
87,34,12,18327,4096,14231,347.4365234375
87,34,13,15791,8192,7599,92.76123046875
87,34,14,5193,16384,-11191,-68.304443359375
87,34,15,4345,32768,-28423,-86.7401123046875
87,35,1,0,2,-2,-100.0
87,35,2,1,4,-3,-75.0
87,35,3,3,8,-5,-62.5
87,35,4,5,16,-11,-68.75
87,35,5,8,32,-24,-75.0
87,35,6,39,64,-25,-39.0625
87,35,7,73,128,-55,-42.96875
87,35,8,29,256,-227,-88.671875
87,35,9,126,512,-386,-75.390625
87,35,10,2895,1024,1871,182.71484375
87,35,11,2866,2048,818,39.94140625
87,35,12,25084,4096,20988,512.40234375
87,35,13,943,8192,-7249,-88.48876953125
87,35,14,12562,16384,-3822,-23.32763671875
87,35,15,20810,32768,-11958,-36.492919921875
87,36,1,0,2,-2,-100.0
87,36,2,1,4,-3,-75.0
87,36,3,2,8,-6,-75.0
87,36,4,3,16,-13,-81.25
87,36,5,4,32,-28,-87.5
87,36,6,7,64,-57,-89.0625
87,36,7,173,128,45,35.15625
87,36,8,269,256,13,5.078125
87,36,9,1086,512,574,112.109375
87,36,10,176,1024,-848,-82.8125
87,36,11,1750,2048,-298,-14.55078125
87,36,12,196,4096,-3900,-95.21484375
87,36,13,2123,8192,-6069,-74.08447265625
87,36,14,18344,16384,1960,11.962890625
87,36,15,41180,32768,8412,25.67138671875
87,37,1,0,2,-2,-100.0
87,37,2,1,4,-3,-75.0
87,37,3,11,8,3,37.5
87,37,4,28,16,12,75.0
87,37,5,13,32,-19,-59.375
87,37,6,225,64,161,251.5625
87,37,7,21,128,-107,-83.59375
87,37,8,224,256,-32,-12.5
87,37,9,85,512,-427,-83.3984375
87,37,10,1114,1024,90,8.7890625
87,37,11,1078,2048,-970,-47.36328125
87,37,12,602,4096,-3494,-85.302734375
87,37,13,7365,8192,-827,-10.09521484375
87,37,14,8118,16384,-8266,-50.45166015625
87,37,15,12286,32768,-20482,-62.506103515625
87,38,1,0,2,-2,-100.0
87,38,2,2,4,-2,-50.0
87,38,3,2,8,-6,-75.0
87,38,4,32,16,16,100.0
87,38,5,21,32,-11,-34.375
87,38,6,54,64,-10,-15.625
87,38,7,93,128,-35,-27.34375
87,38,8,430,256,174,67.96875
87,38,9,1023,512,511,99.8046875
87,38,10,201,1024,-823,-80.37109375
87,38,11,2113,2048,65,3.173828125
87,38,12,99,4096,-3997,-97.5830078125
87,38,13,4422,8192,-3770,-46.0205078125
87,38,14,14053,16384,-2331,-14.227294921875
87,38,15,48333,32768,15565,47.5006103515625
87,39,1,0,2,-2,-100.0
87,39,2,1,4,-3,-75.0
87,39,3,2,8,-6,-75.0
87,39,4,11,16,-5,-31.25
87,39,5,34,32,2,6.25
87,39,6,65,64,1,1.5625
87,39,7,190,128,62,48.4375
87,39,8,136,256,-120,-46.875
87,39,9,770,512,258,50.390625
87,39,10,1365,1024,341,33.30078125
87,39,11,5239,2048,3191,155.810546875
87,39,12,4412,4096,316,7.71484375
87,39,13,15874,8192,7682,93.7744140625
87,39,14,46998,16384,30614,186.85302734375
87,39,15,2655,32768,-30113,-91.8975830078125
87,40,1,0,2,-2,-100.0
87,40,2,1,4,-3,-75.0
87,40,3,2,8,-6,-75.0
87,40,4,9,16,-7,-43.75
87,40,5,21,32,-11,-34.375
87,40,6,132,64,68,106.25
87,40,7,324,128,196,153.125
87,40,8,185,256,-71,-27.734375
87,40,9,883,512,371,72.4609375
87,40,10,1502,1024,478,46.6796875
87,40,11,797,2048,-1251,-61.083984375
87,40,12,748,4096,-3348,-81.73828125
87,40,13,10491,8192,2299,28.06396484375
87,40,14,2299,16384,-14085,-85.968017578125
87,40,15,15639,32768,-17129,-52.2735595703125
87,41,1,0,2,-2,-100.0
87,41,2,1,4,-3,-75.0
87,41,3,7,8,-1,-12.5
87,41,4,19,16,3,18.75
87,41,5,14,32,-18,-56.25
87,41,6,176,64,112,175.0
87,41,7,72,128,-56,-43.75
87,41,8,20,256,-236,-92.1875
87,41,9,434,512,-78,-15.234375
87,41,10,284,1024,-740,-72.265625
87,41,11,7579,2048,5531,270.068359375
87,41,12,1173,4096,-2923,-71.3623046875
87,41,13,4216,8192,-3976,-48.53515625
87,41,14,8497,16384,-7887,-48.138427734375
87,41,15,51955,32768,19187,58.5540771484375
87,42,1,0,2,-2,-100.0
87,42,2,2,4,-2,-50.0
87,42,3,2,8,-6,-75.0
87,42,4,13,16,-3,-18.75
87,42,5,4,32,-28,-87.5
87,42,6,47,64,-17,-26.5625
87,42,7,143,128,15,11.71875
87,42,8,249,256,-7,-2.734375
87,42,9,927,512,415,81.0546875
87,42,10,651,1024,-373,-36.42578125
87,42,11,2806,2048,758,37.01171875
87,42,12,7042,4096,2946,71.923828125
87,42,13,2911,8192,-5281,-64.46533203125
87,42,14,19853,16384,3469,21.173095703125
87,42,15,20436,32768,-12332,-37.63427734375
87,43,1,0,2,-2,-100.0
87,43,2,4,4,0,0.0
87,43,3,3,8,-5,-62.5
87,43,4,12,16,-4,-25.0
87,43,5,10,32,-22,-68.75
87,43,6,13,64,-51,-79.6875
87,43,7,145,128,17,13.28125
87,43,8,505,256,249,97.265625
87,43,9,230,512,-282,-55.078125
87,43,10,186,1024,-838,-81.8359375
87,43,11,711,2048,-1337,-65.283203125
87,43,12,1419,4096,-2677,-65.3564453125
87,43,13,19334,8192,11142,136.0107421875
87,43,14,2341,16384,-14043,-85.711669921875
87,43,15,163365,32768,130597,398.5504150390625
87,44,1,0,2,-2,-100.0
87,44,2,1,4,-3,-75.0
87,44,3,2,8,-6,-75.0
87,44,4,14,16,-2,-12.5
87,44,5,9,32,-23,-71.875
87,44,6,121,64,57,89.0625
87,44,7,47,128,-81,-63.28125
87,44,8,258,256,2,0.78125
87,44,9,226,512,-286,-55.859375
87,44,10,471,1024,-553,-54.00390625
87,44,11,2246,2048,198,9.66796875
87,44,12,4719,4096,623,15.2099609375
87,44,13,1859,8192,-6333,-77.30712890625
87,44,14,6291,16384,-10093,-61.602783203125
87,44,15,1024,32768,-31744,-96.875
87,45,1,0,2,-2,-100.0
87,45,2,3,4,-1,-25.0
87,45,3,4,8,-4,-50.0
87,45,4,8,16,-8,-50.0
87,45,5,21,32,-11,-34.375
87,45,6,26,64,-38,-59.375
87,45,7,57,128,-71,-55.46875
87,45,8,24,256,-232,-90.625
87,45,9,401,512,-111,-21.6796875
87,45,10,132,1024,-892,-87.109375
87,45,11,3796,2048,1748,85.3515625
87,45,12,3949,4096,-147,-3.5888671875
87,45,13,830,8192,-7362,-89.8681640625
87,45,14,25145,16384,8761,53.472900390625
87,45,15,63019,32768,30251,92.3187255859375
87,46,1,0,2,-2,-100.0
87,46,2,3,4,-1,-25.0
87,46,3,4,8,-4,-50.0
87,46,4,21,16,5,31.25
87,46,5,4,32,-28,-87.5
87,46,6,124,64,60,93.75
87,46,7,160,128,32,25.0
87,46,8,256,256,0,0.0
87,46,9,625,512,113,22.0703125
87,46,10,899,1024,-125,-12.20703125
87,46,11,4837,2048,2789,136.181640625
87,46,12,3549,4096,-547,-13.3544921875
87,46,13,4401,8192,-3791,-46.27685546875
87,46,14,23548,16384,7164,43.7255859375
87,46,15,501,32768,-32267,-98.4710693359375
87,47,1,0,2,-2,-100.0
87,47,2,2,4,-2,-50.0
87,47,3,4,8,-4,-50.0
87,47,4,9,16,-7,-43.75
87,47,5,20,32,-12,-37.5
87,47,6,19,64,-45,-70.3125
87,47,7,58,128,-70,-54.6875
87,47,8,207,256,-49,-19.140625
87,47,9,1114,512,602,117.578125
87,47,10,686,1024,-338,-33.0078125
87,47,11,5289,2048,3241,158.251953125
87,47,12,1240,4096,-2856,-69.7265625
87,47,13,24480,8192,16288,198.828125
87,47,14,5296,16384,-11088,-67.67578125
87,47,15,48245,32768,15477,47.2320556640625
87,48,1,0,2,-2,-100.0
87,48,2,2,4,-2,-50.0
87,48,3,2,8,-6,-75.0
87,48,4,4,16,-12,-75.0
87,48,5,12,32,-20,-62.5
87,48,6,65,64,1,1.5625
87,48,7,520,128,392,306.25
87,48,8,507,256,251,98.046875
87,48,9,484,512,-28,-5.46875
87,48,10,131,1024,-893,-87.20703125
87,48,11,3045,2048,997,48.681640625
87,48,12,5987,4096,1891,46.1669921875
87,48,13,1284,8192,-6908,-84.326171875
87,48,14,12301,16384,-4083,-24.920654296875
87,48,15,60032,32768,27264,83.203125
87,49,1,0,2,-2,-100.0
87,49,2,1,4,-3,-75.0
87,49,3,7,8,-1,-12.5
87,49,4,10,16,-6,-37.5
87,49,5,33,32,1,3.125
87,49,6,42,64,-22,-34.375
87,49,7,9,128,-119,-92.96875
87,49,8,41,256,-215,-83.984375
87,49,9,1205,512,693,135.3515625
87,49,10,204,1024,-820,-80.078125
87,49,11,788,2048,-1260,-61.5234375
87,49,12,10060,4096,5964,145.60546875
87,49,13,4332,8192,-3860,-47.119140625
87,49,14,9961,16384,-6423,-39.202880859375
87,49,15,56283,32768,23515,71.7620849609375
87,50,1,0,2,-2,-100.0
87,50,2,4,4,0,0.0
87,50,3,3,8,-5,-62.5
87,50,4,6,16,-10,-62.5
87,50,5,19,32,-13,-40.625
87,50,6,6,64,-58,-90.625
87,50,7,37,128,-91,-71.09375
87,50,8,104,256,-152,-59.375
87,50,9,62,512,-450,-87.890625
87,50,10,193,1024,-831,-81.15234375
87,50,11,819,2048,-1229,-60.009765625
87,50,12,1905,4096,-2191,-53.4912109375
87,50,13,1004,8192,-7188,-87.744140625
87,50,14,85281,16384,68897,420.513916015625
87,50,15,17121,32768,-15647,-47.7508544921875
87,51,1,0,2,-2,-100.0
87,51,2,3,4,-1,-25.0
87,51,3,5,8,-3,-37.5
87,51,4,21,16,5,31.25
87,51,5,8,32,-24,-75.0
87,51,6,21,64,-43,-67.1875
87,51,7,21,128,-107,-83.59375
87,51,8,479,256,223,87.109375
87,51,9,166,512,-346,-67.578125
87,51,10,747,1024,-277,-27.05078125
87,51,11,3466,2048,1418,69.23828125
87,51,12,6439,4096,2343,57.2021484375
87,51,13,3151,8192,-5041,-61.53564453125
87,51,14,8967,16384,-7417,-45.269775390625
87,51,15,20507,32768,-12261,-37.4176025390625
87,52,1,0,2,-2,-100.0
87,52,2,1,4,-3,-75.0
87,52,3,4,8,-4,-50.0
87,52,4,12,16,-4,-25.0
87,52,5,8,32,-24,-75.0
87,52,6,21,64,-43,-67.1875
87,52,7,105,128,-23,-17.96875
87,52,8,575,256,319,124.609375
87,52,9,8,512,-504,-98.4375
87,52,10,155,1024,-869,-84.86328125
87,52,11,878,2048,-1170,-57.12890625
87,52,12,489,4096,-3607,-88.0615234375
87,52,13,11792,8192,3600,43.9453125
87,52,14,56669,16384,40285,245.880126953125
87,52,15,14431,32768,-18337,-55.9600830078125
87,53,1,0,2,-2,-100.0
87,53,2,5,4,1,25.0
87,53,3,2,8,-6,-75.0
87,53,4,3,16,-13,-81.25
87,53,5,9,32,-23,-71.875
87,53,6,16,64,-48,-75.0
87,53,7,117,128,-11,-8.59375
87,53,8,97,256,-159,-62.109375
87,53,9,692,512,180,35.15625
87,53,10,12,1024,-1012,-98.828125
87,53,11,633,2048,-1415,-69.091796875
87,53,12,3586,4096,-510,-12.451171875
87,53,13,2430,8192,-5762,-70.3369140625
87,53,14,8793,16384,-7591,-46.331787109375
87,53,15,73296,32768,40528,123.681640625
87,54,1,0,2,-2,-100.0
87,54,2,2,4,-2,-50.0
87,54,3,2,8,-6,-75.0
87,54,4,4,16,-12,-75.0
87,54,5,64,32,32,100.0
87,54,6,8,64,-56,-87.5
87,54,7,258,128,130,101.5625
87,54,8,34,256,-222,-86.71875
87,54,9,1521,512,1009,197.0703125
87,54,10,184,1024,-840,-82.03125
87,54,11,5746,2048,3698,180.56640625
87,54,12,1554,4096,-2542,-62.060546875
87,54,13,17101,8192,8909,108.75244140625
87,54,14,13712,16384,-2672,-16.30859375
87,54,15,12537,32768,-20231,-61.7401123046875
87,55,1,0,2,-2,-100.0
87,55,2,1,4,-3,-75.0
87,55,3,2,8,-6,-75.0
87,55,4,7,16,-9,-56.25
87,55,5,10,32,-22,-68.75
87,55,6,49,64,-15,-23.4375
87,55,7,82,128,-46,-35.9375
87,55,8,53,256,-203,-79.296875
87,55,9,43,512,-469,-91.6015625
87,55,10,575,1024,-449,-43.84765625
87,55,11,1290,2048,-758,-37.01171875
87,55,12,4499,4096,403,9.8388671875
87,55,13,8720,8192,528,6.4453125
87,55,14,19489,16384,3105,18.951416015625
87,55,15,90955,32768,58187,177.5726318359375
87,56,1,0,2,-2,-100.0
87,56,2,2,4,-2,-50.0
87,56,3,3,8,-5,-62.5
87,56,4,16,16,0,0.0
87,56,5,122,32,90,281.25
87,56,6,33,64,-31,-48.4375
87,56,7,25,128,-103,-80.46875
87,56,8,298,256,42,16.40625
87,56,9,821,512,309,60.3515625
87,56,10,201,1024,-823,-80.37109375
87,56,11,451,2048,-1597,-77.978515625
87,56,12,1305,4096,-2791,-68.1396484375
87,56,13,701,8192,-7491,-91.44287109375
87,56,14,3755,16384,-12629,-77.081298828125
87,56,15,115193,32768,82425,251.5411376953125
87,57,1,0,2,-2,-100.0
87,57,2,2,4,-2,-50.0
87,57,3,2,8,-6,-75.0
87,57,4,4,16,-12,-75.0
87,57,5,10,32,-22,-68.75
87,57,6,35,64,-29,-45.3125
87,57,7,35,128,-93,-72.65625
87,57,8,16,256,-240,-93.75
87,57,9,305,512,-207,-40.4296875
87,57,10,1518,1024,494,48.2421875
87,57,11,398,2048,-1650,-80.56640625
87,57,12,2326,4096,-1770,-43.212890625
87,57,13,12595,8192,4403,53.74755859375
87,57,14,7553,16384,-8831,-53.900146484375
87,57,15,3679,32768,-29089,-88.7725830078125
87,58,1,0,2,-2,-100.0
87,58,2,1,4,-3,-75.0
87,58,3,2,8,-6,-75.0
87,58,4,3,16,-13,-81.25
87,58,5,52,32,20,62.5
87,58,6,58,64,-6,-9.375
87,58,7,78,128,-50,-39.0625
87,58,8,871,256,615,240.234375
87,58,9,133,512,-379,-74.0234375
87,58,10,1283,1024,259,25.29296875
87,58,11,723,2048,-1325,-64.697265625
87,58,12,4374,4096,278,6.787109375
87,58,13,6128,8192,-2064,-25.1953125
87,58,14,1952,16384,-14432,-88.0859375
87,58,15,581,32768,-32187,-98.2269287109375
87,59,1,0,2,-2,-100.0
87,59,2,2,4,-2,-50.0
87,59,3,10,8,2,25.0
87,59,4,75,16,59,368.75
87,59,5,53,32,21,65.625
87,59,6,33,64,-31,-48.4375
87,59,7,71,128,-57,-44.53125
87,59,8,35,256,-221,-86.328125
87,59,9,4480,512,3968,775.0
87,59,10,1648,1024,624,60.9375
87,59,11,1084,2048,-964,-47.0703125
87,59,12,7068,4096,2972,72.55859375
87,59,13,14573,8192,6381,77.89306640625
87,59,14,20977,16384,4593,28.033447265625
87,59,15,10641,32768,-22127,-67.5262451171875
87,60,1,0,2,-2,-100.0
87,60,2,6,4,2,50.0
87,60,3,2,8,-6,-75.0
87,60,4,4,16,-12,-75.0
87,60,5,51,32,19,59.375
87,60,6,44,64,-20,-31.25
87,60,7,26,128,-102,-79.6875
87,60,8,195,256,-61,-23.828125
87,60,9,1051,512,539,105.2734375
87,60,10,413,1024,-611,-59.66796875
87,60,11,245,2048,-1803,-88.037109375
87,60,12,1082,4096,-3014,-73.583984375
87,60,13,314,8192,-7878,-96.1669921875
87,60,14,11182,16384,-5202,-31.75048828125
87,60,15,54896,32768,22128,67.529296875
87,61,1,0,2,-2,-100.0
87,61,2,7,4,3,75.0
87,61,3,3,8,-5,-62.5
87,61,4,9,16,-7,-43.75
87,61,5,12,32,-20,-62.5
87,61,6,6,64,-58,-90.625
87,61,7,64,128,-64,-50.0
87,61,8,1048,256,792,309.375
87,61,9,619,512,107,20.8984375
87,61,10,2363,1024,1339,130.76171875
87,61,11,930,2048,-1118,-54.58984375
87,61,12,6361,4096,2265,55.2978515625
87,61,13,18370,8192,10178,124.2431640625
87,61,14,14435,16384,-1949,-11.895751953125
87,61,15,101647,32768,68879,210.2020263671875
87,62,1,0,2,-2,-100.0
87,62,2,1,4,-3,-75.0
87,62,3,4,8,-4,-50.0
87,62,4,23,16,7,43.75
87,62,5,6,32,-26,-81.25
87,62,6,27,64,-37,-57.8125
87,62,7,46,128,-82,-64.0625
87,62,8,378,256,122,47.65625
87,62,9,552,512,40,7.8125
87,62,10,1045,1024,21,2.05078125
87,62,11,3045,2048,997,48.681640625
87,62,12,5719,4096,1623,39.6240234375
87,62,13,22685,8192,14493,176.91650390625
87,62,14,42852,16384,26468,161.5478515625
87,62,15,4093,32768,-28675,-87.5091552734375
87,63,1,0,2,-2,-100.0
87,63,2,2,4,-2,-50.0
87,63,3,2,8,-6,-75.0
87,63,4,28,16,12,75.0
87,63,5,28,32,-4,-12.5
87,63,6,40,64,-24,-37.5
87,63,7,97,128,-31,-24.21875
87,63,8,253,256,-3,-1.171875
87,63,9,1290,512,778,151.953125
87,63,10,444,1024,-580,-56.640625
87,63,11,115,2048,-1933,-94.384765625
87,63,12,4679,4096,583,14.2333984375
87,63,13,13464,8192,5272,64.35546875
87,63,14,22366,16384,5982,36.51123046875
87,63,15,20055,32768,-12713,-38.7969970703125
87,64,1,0,2,-2,-100.0
87,64,2,1,4,-3,-75.0
87,64,3,3,8,-5,-62.5
87,64,4,22,16,6,37.5
87,64,5,11,32,-21,-65.625
87,64,6,11,64,-53,-82.8125
87,64,7,101,128,-27,-21.09375
87,64,8,97,256,-159,-62.109375
87,64,9,272,512,-240,-46.875
87,64,10,282,1024,-742,-72.4609375
87,64,11,362,2048,-1686,-82.32421875
87,64,12,3837,4096,-259,-6.3232421875
87,64,13,5195,8192,-2997,-36.58447265625
87,64,14,9128,16384,-7256,-44.287109375
87,64,15,28815,32768,-3953,-12.0635986328125
87,65,1,0,2,-2,-100.0
87,65,2,2,4,-2,-50.0
87,65,3,14,8,6,75.0
87,65,4,10,16,-6,-37.5
87,65,5,23,32,-9,-28.125
87,65,6,34,64,-30,-46.875
87,65,7,84,128,-44,-34.375
87,65,8,1785,256,1529,597.265625
87,65,9,265,512,-247,-48.2421875
87,65,10,822,1024,-202,-19.7265625
87,65,11,968,2048,-1080,-52.734375
87,65,12,379,4096,-3717,-90.7470703125
87,65,13,22136,8192,13944,170.21484375
87,65,14,41521,16384,25137,153.424072265625
87,65,15,29850,32768,-2918,-8.905029296875
87,66,1,0,2,-2,-100.0
87,66,2,3,4,-1,-25.0
87,66,3,2,8,-6,-75.0
87,66,4,14,16,-2,-12.5
87,66,5,28,32,-4,-12.5
87,66,6,24,64,-40,-62.5
87,66,7,247,128,119,92.96875
87,66,8,341,256,85,33.203125
87,66,9,1348,512,836,163.28125
87,66,10,148,1024,-876,-85.546875
87,66,11,1331,2048,-717,-35.009765625
87,66,12,7299,4096,3203,78.1982421875
87,66,13,3052,8192,-5140,-62.744140625
87,66,14,5971,16384,-10413,-63.555908203125
87,66,15,68163,32768,35395,108.0169677734375
87,67,1,0,2,-2,-100.0
87,67,2,2,4,-2,-50.0
87,67,3,4,8,-4,-50.0
87,67,4,14,16,-2,-12.5
87,67,5,31,32,-1,-3.125
87,67,6,97,64,33,51.5625
87,67,7,109,128,-19,-14.84375
87,67,8,173,256,-83,-32.421875
87,67,9,433,512,-79,-15.4296875
87,67,10,1502,1024,478,46.6796875
87,67,11,195,2048,-1853,-90.478515625
87,67,12,2852,4096,-1244,-30.37109375
87,67,13,1153,8192,-7039,-85.92529296875
87,67,14,6688,16384,-9696,-59.1796875
87,67,15,24063,32768,-8705,-26.5655517578125
87,68,1,0,2,-2,-100.0
87,68,2,2,4,-2,-50.0
87,68,3,2,8,-6,-75.0
87,68,4,3,16,-13,-81.25
87,68,5,8,32,-24,-75.0
87,68,6,32,64,-32,-50.0
87,68,7,76,128,-52,-40.625
87,68,8,7,256,-249,-97.265625
87,68,9,190,512,-322,-62.890625
87,68,10,356,1024,-668,-65.234375
87,68,11,1493,2048,-555,-27.099609375
87,68,12,9115,4096,5019,122.5341796875
87,68,13,8261,8192,69,0.84228515625
87,68,14,5496,16384,-10888,-66.455078125
87,68,15,84633,32768,51865,158.2794189453125
87,69,1,0,2,-2,-100.0
87,69,2,1,4,-3,-75.0
87,69,3,9,8,1,12.5
87,69,4,3,16,-13,-81.25
87,69,5,15,32,-17,-53.125
87,69,6,56,64,-8,-12.5
87,69,7,224,128,96,75.0
87,69,8,75,256,-181,-70.703125
87,69,9,1036,512,524,102.34375
87,69,10,83,1024,-941,-91.89453125
87,69,11,815,2048,-1233,-60.205078125
87,69,12,4346,4096,250,6.103515625
87,69,13,2453,8192,-5739,-70.05615234375
87,69,14,20445,16384,4061,24.786376953125
87,69,15,10106,32768,-22662,-69.158935546875
87,70,1,0,2,-2,-100.0
87,70,2,1,4,-3,-75.0
87,70,3,7,8,-1,-12.5
87,70,4,12,16,-4,-25.0
87,70,5,36,32,4,12.5
87,70,6,9,64,-55,-85.9375
87,70,7,67,128,-61,-47.65625
87,70,8,146,256,-110,-42.96875
87,70,9,496,512,-16,-3.125
87,70,10,2319,1024,1295,126.46484375
87,70,11,2908,2048,860,41.9921875
87,70,12,2140,4096,-1956,-47.75390625
87,70,13,301,8192,-7891,-96.32568359375
87,70,14,43706,16384,27322,166.76025390625
87,70,15,61625,32768,28857,88.0645751953125
87,71,1,0,2,-2,-100.0
87,71,2,2,4,-2,-50.0
87,71,3,3,8,-5,-62.5
87,71,4,4,16,-12,-75.0
87,71,5,9,32,-23,-71.875
87,71,6,95,64,31,48.4375
87,71,7,404,128,276,215.625
87,71,8,204,256,-52,-20.3125
87,71,9,2065,512,1553,303.3203125
87,71,10,920,1024,-104,-10.15625
87,71,11,3855,2048,1807,88.232421875
87,71,12,7984,4096,3888,94.921875
87,71,13,280,8192,-7912,-96.58203125
87,71,14,9907,16384,-6477,-39.532470703125
87,71,15,68216,32768,35448,108.1787109375
87,72,1,0,2,-2,-100.0
87,72,2,4,4,0,0.0
87,72,3,4,8,-4,-50.0
87,72,4,7,16,-9,-56.25
87,72,5,5,32,-27,-84.375
87,72,6,20,64,-44,-68.75
87,72,7,153,128,25,19.53125
87,72,8,365,256,109,42.578125
87,72,9,352,512,-160,-31.25
87,72,10,325,1024,-699,-68.26171875
87,72,11,1372,2048,-676,-33.0078125
87,72,12,2660,4096,-1436,-35.05859375
87,72,13,7502,8192,-690,-8.4228515625
87,72,14,16315,16384,-69,-0.421142578125
87,72,15,23952,32768,-8816,-26.904296875
87,73,1,0,2,-2,-100.0
87,73,2,1,4,-3,-75.0
87,73,3,13,8,5,62.5
87,73,4,10,16,-6,-37.5
87,73,5,5,32,-27,-84.375
87,73,6,10,64,-54,-84.375
87,73,7,130,128,2,1.5625
87,73,8,186,256,-70,-27.34375
87,73,9,254,512,-258,-50.390625
87,73,10,247,1024,-777,-75.87890625
87,73,11,1195,2048,-853,-41.650390625
87,73,12,4457,4096,361,8.8134765625
87,73,13,2444,8192,-5748,-70.166015625
87,73,14,9483,16384,-6901,-42.120361328125
87,73,15,16076,32768,-16692,-50.93994140625
87,74,1,0,2,-2,-100.0
87,74,2,4,4,0,0.0
87,74,3,22,8,14,175.0
87,74,4,29,16,13,81.25
87,74,5,13,32,-19,-59.375
87,74,6,111,64,47,73.4375
87,74,7,89,128,-39,-30.46875
87,74,8,59,256,-197,-76.953125
87,74,9,392,512,-120,-23.4375
87,74,10,1869,1024,845,82.51953125
87,74,11,46,2048,-2002,-97.75390625
87,74,12,131,4096,-3965,-96.8017578125
87,74,13,5981,8192,-2211,-26.98974609375
87,74,14,45770,16384,29386,179.35791015625
87,74,15,89708,32768,56940,173.76708984375
87,75,1,0,2,-2,-100.0
87,75,2,2,4,-2,-50.0
87,75,3,5,8,-3,-37.5
87,75,4,5,16,-11,-68.75
87,75,5,52,32,20,62.5
87,75,6,11,64,-53,-82.8125
87,75,7,346,128,218,170.3125
87,75,8,55,256,-201,-78.515625
87,75,9,75,512,-437,-85.3515625
87,75,10,511,1024,-513,-50.09765625
87,75,11,3236,2048,1188,58.0078125
87,75,12,586,4096,-3510,-85.693359375
87,75,13,11137,8192,2945,35.94970703125
87,75,14,31259,16384,14875,90.789794921875
87,75,15,150690,32768,117922,359.869384765625
87,76,1,0,2,-2,-100.0
87,76,2,1,4,-3,-75.0
87,76,3,5,8,-3,-37.5
87,76,4,9,16,-7,-43.75
87,76,5,13,32,-19,-59.375
87,76,6,8,64,-56,-87.5
87,76,7,139,128,11,8.59375
87,76,8,376,256,120,46.875
87,76,9,79,512,-433,-84.5703125
87,76,10,1784,1024,760,74.21875
87,76,11,40,2048,-2008,-98.046875
87,76,12,940,4096,-3156,-77.05078125
87,76,13,31046,8192,22854,278.9794921875
87,76,14,13141,16384,-3243,-19.793701171875
87,76,15,1261,32768,-31507,-96.1517333984375
87,77,1,0,2,-2,-100.0
87,77,2,1,4,-3,-75.0
87,77,3,4,8,-4,-50.0
87,77,4,15,16,-1,-6.25
87,77,5,39,32,7,21.875
87,77,6,104,64,40,62.5
87,77,7,25,128,-103,-80.46875
87,77,8,748,256,492,192.1875
87,77,9,597,512,85,16.6015625
87,77,10,597,1024,-427,-41.69921875
87,77,11,3095,2048,1047,51.123046875
87,77,12,421,4096,-3675,-89.7216796875
87,77,13,8683,8192,491,5.99365234375
87,77,14,34060,16384,17676,107.8857421875
87,77,15,35391,32768,2623,8.0047607421875
87,78,1,0,2,-2,-100.0
87,78,2,1,4,-3,-75.0
87,78,3,2,8,-6,-75.0
87,78,4,10,16,-6,-37.5
87,78,5,34,32,2,6.25
87,78,6,11,64,-53,-82.8125
87,78,7,35,128,-93,-72.65625
87,78,8,493,256,237,92.578125
87,78,9,105,512,-407,-79.4921875
87,78,10,933,1024,-91,-8.88671875
87,78,11,171,2048,-1877,-91.650390625
87,78,12,6560,4096,2464,60.15625
87,78,13,15735,8192,7543,92.07763671875
87,78,14,6468,16384,-9916,-60.5224609375
87,78,15,16250,32768,-16518,-50.408935546875
87,79,1,0,2,-2,-100.0
87,79,2,4,4,0,0.0
87,79,3,10,8,2,25.0
87,79,4,11,16,-5,-31.25
87,79,5,7,32,-25,-78.125
87,79,6,103,64,39,60.9375
87,79,7,357,128,229,178.90625
87,79,8,141,256,-115,-44.921875
87,79,9,587,512,75,14.6484375
87,79,10,1394,1024,370,36.1328125
87,79,11,196,2048,-1852,-90.4296875
87,79,12,7641,4096,3545,86.5478515625
87,79,13,1588,8192,-6604,-80.615234375
87,79,14,911,16384,-15473,-94.439697265625
87,79,15,46284,32768,13516,41.24755859375
87,80,1,0,2,-2,-100.0
87,80,2,2,4,-2,-50.0
87,80,3,2,8,-6,-75.0
87,80,4,21,16,5,31.25
87,80,5,4,32,-28,-87.5
87,80,6,68,64,4,6.25
87,80,7,124,128,-4,-3.125
87,80,8,232,256,-24,-9.375
87,80,9,924,512,412,80.46875
87,80,10,2299,1024,1275,124.51171875
87,80,11,1858,2048,-190,-9.27734375
87,80,12,10695,4096,6599,161.1083984375
87,80,13,2952,8192,-5240,-63.96484375
87,80,14,27826,16384,11442,69.83642578125
87,80,15,47311,32768,14543,44.3817138671875
87,81,1,0,2,-2,-100.0
87,81,2,3,4,-1,-25.0
87,81,3,2,8,-6,-75.0
87,81,4,18,16,2,12.5
87,81,5,25,32,-7,-21.875
87,81,6,7,64,-57,-89.0625
87,81,7,79,128,-49,-38.28125
87,81,8,369,256,113,44.140625
87,81,9,104,512,-408,-79.6875
87,81,10,708,1024,-316,-30.859375
87,81,11,4156,2048,2108,102.9296875
87,81,12,2572,4096,-1524,-37.20703125
87,81,13,12393,8192,4201,51.28173828125
87,81,14,2870,16384,-13514,-82.48291015625
87,81,15,5129,32768,-27639,-84.3475341796875
87,82,1,0,2,-2,-100.0
87,82,2,1,4,-3,-75.0
87,82,3,4,8,-4,-50.0
87,82,4,8,16,-8,-50.0
87,82,5,15,32,-17,-53.125
87,82,6,60,64,-4,-6.25
87,82,7,50,128,-78,-60.9375
87,82,8,219,256,-37,-14.453125
87,82,9,406,512,-106,-20.703125
87,82,10,1417,1024,393,38.37890625
87,82,11,980,2048,-1068,-52.1484375
87,82,12,266,4096,-3830,-93.505859375
87,82,13,3774,8192,-4418,-53.9306640625
87,82,14,11867,16384,-4517,-27.569580078125
87,82,15,13626,32768,-19142,-58.416748046875
87,83,1,0,2,-2,-100.0
87,83,2,3,4,-1,-25.0
87,83,3,5,8,-3,-37.5
87,83,4,28,16,12,75.0
87,83,5,41,32,9,28.125
87,83,6,50,64,-14,-21.875
87,83,7,135,128,7,5.46875
87,83,8,529,256,273,106.640625
87,83,9,407,512,-105,-20.5078125
87,83,10,129,1024,-895,-87.40234375
87,83,11,3801,2048,1753,85.595703125
87,83,12,2084,4096,-2012,-49.12109375
87,83,13,13241,8192,5049,61.63330078125
87,83,14,6367,16384,-10017,-61.138916015625
87,83,15,42468,32768,9700,29.60205078125
87,84,1,0,2,-2,-100.0
87,84,2,1,4,-3,-75.0
87,84,3,4,8,-4,-50.0
87,84,4,17,16,1,6.25
87,84,5,21,32,-11,-34.375
87,84,6,12,64,-52,-81.25
87,84,7,292,128,164,128.125
87,84,8,365,256,109,42.578125
87,84,9,227,512,-285,-55.6640625
87,84,10,1266,1024,242,23.6328125
87,84,11,2708,2048,660,32.2265625
87,84,12,2282,4096,-1814,-44.287109375
87,84,13,33294,8192,25102,306.4208984375
87,84,14,4444,16384,-11940,-72.8759765625
87,84,15,37774,32768,5006,15.277099609375
87,85,1,0,2,-2,-100.0
87,85,2,2,4,-2,-50.0
87,85,3,7,8,-1,-12.5
87,85,4,7,16,-9,-56.25
87,85,5,23,32,-9,-28.125
87,85,6,5,64,-59,-92.1875
87,85,7,40,128,-88,-68.75
87,85,8,626,256,370,144.53125
87,85,9,546,512,34,6.640625
87,85,10,809,1024,-215,-20.99609375
87,85,11,362,2048,-1686,-82.32421875
87,85,12,738,4096,-3358,-81.982421875
87,85,13,6662,8192,-1530,-18.6767578125
87,85,14,10274,16384,-6110,-37.29248046875
87,85,15,66287,32768,33519,102.2918701171875
87,86,1,0,2,-2,-100.0
87,86,2,2,4,-2,-50.0
87,86,3,6,8,-2,-25.0
87,86,4,23,16,7,43.75
87,86,5,44,32,12,37.5
87,86,6,111,64,47,73.4375
87,86,7,78,128,-50,-39.0625
87,86,8,37,256,-219,-85.546875
87,86,9,19,512,-493,-96.2890625
87,86,10,1526,1024,502,49.0234375
87,86,11,4611,2048,2563,125.146484375
87,86,12,3282,4096,-814,-19.873046875
87,86,13,12422,8192,4230,51.6357421875
87,86,14,16270,16384,-114,-0.69580078125
87,86,15,30866,32768,-1902,-5.804443359375
87,87,1,0,2,-2,-100.0
87,87,2,1,4,-3,-75.0
87,87,3,6,8,-2,-25.0
87,87,4,9,16,-7,-43.75
87,87,5,60,32,28,87.5
87,87,6,36,64,-28,-43.75
87,87,7,29,128,-99,-77.34375
87,87,8,295,256,39,15.234375
87,87,9,376,512,-136,-26.5625
87,87,10,248,1024,-776,-75.78125
87,87,11,2174,2048,126,6.15234375
87,87,12,3730,4096,-366,-8.935546875
87,87,13,1428,8192,-6764,-82.568359375
87,87,14,512,16384,-15872,-96.875
87,87,15,2763,32768,-30005,-91.5679931640625
88,1,1,0,2,-2,-100.0
88,1,2,1,4,-3,-75.0
88,1,3,2,8,-6,-75.0
88,1,4,3,16,-13,-81.25
88,1,5,82,32,50,156.25
88,1,6,49,64,-15,-23.4375
88,1,7,290,128,162,126.5625
88,1,8,144,256,-112,-43.75
88,1,9,236,512,-276,-53.90625
88,1,10,27,1024,-997,-97.36328125
88,1,11,8392,2048,6344,309.765625
88,1,12,1885,4096,-2211,-53.9794921875
88,1,13,2740,8192,-5452,-66.552734375
88,1,14,13678,16384,-2706,-16.51611328125
88,1,15,13803,32768,-18965,-57.8765869140625
88,2,1,0,2,-2,-100.0
88,2,2,2,4,-2,-50.0
88,2,3,5,8,-3,-37.5
88,2,4,16,16,0,0.0
88,2,5,45,32,13,40.625
88,2,6,25,64,-39,-60.9375
88,2,7,23,128,-105,-82.03125
88,2,8,25,256,-231,-90.234375
88,2,9,131,512,-381,-74.4140625
88,2,10,290,1024,-734,-71.6796875
88,2,11,21,2048,-2027,-98.974609375
88,2,12,376,4096,-3720,-90.8203125
88,2,13,14842,8192,6650,81.1767578125
88,2,14,52330,16384,35946,219.39697265625
88,2,15,11967,32768,-20801,-63.4796142578125
88,3,1,0,2,-2,-100.0
88,3,2,1,4,-3,-75.0
88,3,3,11,8,3,37.5
88,3,4,25,16,9,56.25
88,3,5,17,32,-15,-46.875
88,3,6,14,64,-50,-78.125
88,3,7,37,128,-91,-71.09375
88,3,8,359,256,103,40.234375
88,3,9,289,512,-223,-43.5546875
88,3,10,615,1024,-409,-39.94140625
88,3,11,3727,2048,1679,81.982421875
88,3,12,10374,4096,6278,153.271484375
88,3,13,10338,8192,2146,26.1962890625
88,3,14,13332,16384,-3052,-18.6279296875
88,3,15,11656,32768,-21112,-64.4287109375
88,4,1,0,2,-2,-100.0
88,4,2,1,4,-3,-75.0
88,4,3,2,8,-6,-75.0
88,4,4,5,16,-11,-68.75
88,4,5,33,32,1,3.125
88,4,6,94,64,30,46.875
88,4,7,152,128,24,18.75
88,4,8,501,256,245,95.703125
88,4,9,545,512,33,6.4453125
88,4,10,105,1024,-919,-89.74609375
88,4,11,563,2048,-1485,-72.509765625
88,4,12,846,4096,-3250,-79.345703125
88,4,13,2637,8192,-5555,-67.81005859375
88,4,14,41586,16384,25202,153.82080078125
88,4,15,307,32768,-32461,-99.0631103515625
88,5,1,0,2,-2,-100.0
88,5,2,2,4,-2,-50.0
88,5,3,23,8,15,187.5
88,5,4,14,16,-2,-12.5
88,5,5,49,32,17,53.125
88,5,6,13,64,-51,-79.6875
88,5,7,183,128,55,42.96875
88,5,8,69,256,-187,-73.046875
88,5,9,21,512,-491,-95.8984375
88,5,10,382,1024,-642,-62.6953125
88,5,11,1430,2048,-618,-30.17578125
88,5,12,1898,4096,-2198,-53.662109375
88,5,13,3390,8192,-4802,-58.6181640625
88,5,14,41609,16384,25225,153.961181640625
88,5,15,33650,32768,882,2.691650390625
88,6,1,0,2,-2,-100.0
88,6,2,1,4,-3,-75.0
88,6,3,2,8,-6,-75.0
88,6,4,24,16,8,50.0
88,6,5,110,32,78,243.75
88,6,6,190,64,126,196.875
88,6,7,108,128,-20,-15.625
88,6,8,170,256,-86,-33.59375
88,6,9,323,512,-189,-36.9140625
88,6,10,1640,1024,616,60.15625
88,6,11,281,2048,-1767,-86.279296875
88,6,12,7238,4096,3142,76.708984375
88,6,13,354,8192,-7838,-95.6787109375
88,6,14,6114,16384,-10270,-62.68310546875
88,6,15,13690,32768,-19078,-58.221435546875
88,7,1,0,2,-2,-100.0
88,7,2,1,4,-3,-75.0
88,7,3,4,8,-4,-50.0
88,7,4,6,16,-10,-62.5
88,7,5,44,32,12,37.5
88,7,6,73,64,9,14.0625
88,7,7,29,128,-99,-77.34375
88,7,8,215,256,-41,-16.015625
88,7,9,20,512,-492,-96.09375
88,7,10,1091,1024,67,6.54296875
88,7,11,540,2048,-1508,-73.6328125
88,7,12,14855,4096,10759,262.6708984375
88,7,13,7846,8192,-346,-4.2236328125
88,7,14,10974,16384,-5410,-33.02001953125
88,7,15,29085,32768,-3683,-11.2396240234375
88,8,1,0,2,-2,-100.0
88,8,2,1,4,-3,-75.0
88,8,3,7,8,-1,-12.5
88,8,4,13,16,-3,-18.75
88,8,5,5,32,-27,-84.375
88,8,6,73,64,9,14.0625
88,8,7,14,128,-114,-89.0625
88,8,8,63,256,-193,-75.390625
88,8,9,266,512,-246,-48.046875
88,8,10,119,1024,-905,-88.37890625
88,8,11,379,2048,-1669,-81.494140625
88,8,12,7353,4096,3257,79.5166015625
88,8,13,1249,8192,-6943,-84.75341796875
88,8,14,19955,16384,3571,21.795654296875
88,8,15,13863,32768,-18905,-57.6934814453125
88,9,1,0,2,-2,-100.0
88,9,2,4,4,0,0.0
88,9,3,2,8,-6,-75.0
88,9,4,6,16,-10,-62.5
88,9,5,22,32,-10,-31.25
88,9,6,85,64,21,32.8125
88,9,7,55,128,-73,-57.03125
88,9,8,8,256,-248,-96.875
88,9,9,649,512,137,26.7578125
88,9,10,749,1024,-275,-26.85546875
88,9,11,860,2048,-1188,-58.0078125
88,9,12,8732,4096,4636,113.18359375
88,9,13,8291,8192,99,1.20849609375
88,9,14,14856,16384,-1528,-9.326171875
88,9,15,67425,32768,34657,105.7647705078125
88,10,1,0,2,-2,-100.0
88,10,2,1,4,-3,-75.0
88,10,3,2,8,-6,-75.0
88,10,4,7,16,-9,-56.25
88,10,5,21,32,-11,-34.375
88,10,6,17,64,-47,-73.4375
88,10,7,99,128,-29,-22.65625
88,10,8,365,256,109,42.578125
88,10,9,927,512,415,81.0546875
88,10,10,1813,1024,789,77.05078125
88,10,11,2360,2048,312,15.234375
88,10,12,3662,4096,-434,-10.595703125
88,10,13,14569,8192,6377,77.84423828125
88,10,14,368,16384,-16016,-97.75390625
88,10,15,64204,32768,31436,95.93505859375
88,11,1,0,2,-2,-100.0
88,11,2,1,4,-3,-75.0
88,11,3,3,8,-5,-62.5
88,11,4,5,16,-11,-68.75
88,11,5,15,32,-17,-53.125
88,11,6,182,64,118,184.375
88,11,7,187,128,59,46.09375
88,11,8,186,256,-70,-27.34375
88,11,9,608,512,96,18.75
88,11,10,32,1024,-992,-96.875
88,11,11,929,2048,-1119,-54.638671875
88,11,12,658,4096,-3438,-83.935546875
88,11,13,918,8192,-7274,-88.7939453125
88,11,14,23719,16384,7335,44.769287109375
88,11,15,16640,32768,-16128,-49.21875
88,12,1,0,2,-2,-100.0
88,12,2,1,4,-3,-75.0
88,12,3,2,8,-6,-75.0
88,12,4,3,16,-13,-81.25
88,12,5,36,32,4,12.5
88,12,6,142,64,78,121.875
88,12,7,314,128,186,145.3125
88,12,8,122,256,-134,-52.34375
88,12,9,118,512,-394,-76.953125
88,12,10,607,1024,-417,-40.72265625
88,12,11,544,2048,-1504,-73.4375
88,12,12,1019,4096,-3077,-75.1220703125
88,12,13,8109,8192,-83,-1.01318359375
88,12,14,36633,16384,20249,123.590087890625
88,12,15,39052,32768,6284,19.17724609375
88,13,1,0,2,-2,-100.0
88,13,2,1,4,-3,-75.0
88,13,3,7,8,-1,-12.5
88,13,4,4,16,-12,-75.0
88,13,5,24,32,-8,-25.0
88,13,6,9,64,-55,-85.9375
88,13,7,228,128,100,78.125
88,13,8,1466,256,1210,472.65625
88,13,9,161,512,-351,-68.5546875
88,13,10,613,1024,-411,-40.13671875
88,13,11,3945,2048,1897,92.626953125
88,13,12,11247,4096,7151,174.5849609375
88,13,13,155,8192,-8037,-98.10791015625
88,13,14,8838,16384,-7546,-46.05712890625
88,13,15,127411,32768,94643,288.8275146484375
88,14,1,0,2,-2,-100.0
88,14,2,1,4,-3,-75.0
88,14,3,6,8,-2,-25.0
88,14,4,30,16,14,87.5
88,14,5,24,32,-8,-25.0
88,14,6,75,64,11,17.1875
88,14,7,157,128,29,22.65625
88,14,8,37,256,-219,-85.546875
88,14,9,509,512,-3,-0.5859375
88,14,10,226,1024,-798,-77.9296875
88,14,11,640,2048,-1408,-68.75
88,14,12,23237,4096,19141,467.3095703125
88,14,13,9199,8192,1007,12.29248046875
88,14,14,7430,16384,-8954,-54.65087890625
88,14,15,46888,32768,14120,43.0908203125
88,15,1,0,2,-2,-100.0
88,15,2,1,4,-3,-75.0
88,15,3,4,8,-4,-50.0
88,15,4,6,16,-10,-62.5
88,15,5,23,32,-9,-28.125
88,15,6,6,64,-58,-90.625
88,15,7,103,128,-25,-19.53125
88,15,8,238,256,-18,-7.03125
88,15,9,8,512,-504,-98.4375
88,15,10,1101,1024,77,7.51953125
88,15,11,1650,2048,-398,-19.43359375
88,15,12,5770,4096,1674,40.869140625
88,15,13,3110,8192,-5082,-62.0361328125
88,15,14,42920,16384,26536,161.962890625
88,15,15,39814,32768,7046,21.502685546875
88,16,1,0,2,-2,-100.0
88,16,2,1,4,-3,-75.0
88,16,3,5,8,-3,-37.5
88,16,4,4,16,-12,-75.0
88,16,5,28,32,-4,-12.5
88,16,6,70,64,6,9.375
88,16,7,45,128,-83,-64.84375
88,16,8,7,256,-249,-97.265625
88,16,9,267,512,-245,-47.8515625
88,16,10,1451,1024,427,41.69921875
88,16,11,267,2048,-1781,-86.962890625
88,16,12,1112,4096,-2984,-72.8515625
88,16,13,6005,8192,-2187,-26.69677734375
88,16,14,12094,16384,-4290,-26.18408203125
88,16,15,21545,32768,-11223,-34.2498779296875
88,17,1,0,2,-2,-100.0
88,17,2,2,4,-2,-50.0
88,17,3,5,8,-3,-37.5
88,17,4,11,16,-5,-31.25
88,17,5,49,32,17,53.125
88,17,6,39,64,-25,-39.0625
88,17,7,166,128,38,29.6875
88,17,8,695,256,439,171.484375
88,17,9,854,512,342,66.796875
88,17,10,1458,1024,434,42.3828125
88,17,11,1700,2048,-348,-16.9921875
88,17,12,16980,4096,12884,314.55078125
88,17,13,19797,8192,11605,141.66259765625
88,17,14,7354,16384,-9030,-55.11474609375
88,17,15,7673,32768,-25095,-76.5838623046875
88,18,1,0,2,-2,-100.0
88,18,2,2,4,-2,-50.0
88,18,3,8,8,0,0.0
88,18,4,3,16,-13,-81.25
88,18,5,137,32,105,328.125
88,18,6,78,64,14,21.875
88,18,7,6,128,-122,-95.3125
88,18,8,281,256,25,9.765625
88,18,9,152,512,-360,-70.3125
88,18,10,787,1024,-237,-23.14453125
88,18,11,539,2048,-1509,-73.681640625
88,18,12,1092,4096,-3004,-73.33984375
88,18,13,21474,8192,13282,162.1337890625
88,18,14,43461,16384,27077,165.264892578125
88,18,15,54681,32768,21913,66.8731689453125
88,19,1,0,2,-2,-100.0
88,19,2,1,4,-3,-75.0
88,19,3,8,8,0,0.0
88,19,4,14,16,-2,-12.5
88,19,5,8,32,-24,-75.0
88,19,6,16,64,-48,-75.0
88,19,7,207,128,79,61.71875
88,19,8,741,256,485,189.453125
88,19,9,537,512,25,4.8828125
88,19,10,792,1024,-232,-22.65625
88,19,11,4232,2048,2184,106.640625
88,19,12,1262,4096,-2834,-69.189453125
88,19,13,15406,8192,7214,88.0615234375
88,19,14,26669,16384,10285,62.774658203125
88,19,15,1726,32768,-31042,-94.732666015625
88,20,1,0,2,-2,-100.0
88,20,2,1,4,-3,-75.0
88,20,3,13,8,5,62.5
88,20,4,6,16,-10,-62.5
88,20,5,94,32,62,193.75
88,20,6,10,64,-54,-84.375
88,20,7,151,128,23,17.96875
88,20,8,145,256,-111,-43.359375
88,20,9,1409,512,897,175.1953125
88,20,10,1969,1024,945,92.28515625
88,20,11,228,2048,-1820,-88.8671875
88,20,12,5527,4096,1431,34.9365234375
88,20,13,22722,8192,14530,177.3681640625
88,20,14,1633,16384,-14751,-90.032958984375
88,20,15,15272,32768,-17496,-53.3935546875
88,21,1,0,2,-2,-100.0
88,21,2,7,4,3,75.0
88,21,3,5,8,-3,-37.5
88,21,4,35,16,19,118.75
88,21,5,30,32,-2,-6.25
88,21,6,192,64,128,200.0
88,21,7,147,128,19,14.84375
88,21,8,137,256,-119,-46.484375
88,21,9,158,512,-354,-69.140625
88,21,10,538,1024,-486,-47.4609375
88,21,11,1489,2048,-559,-27.294921875
88,21,12,1740,4096,-2356,-57.51953125
88,21,13,5500,8192,-2692,-32.861328125
88,21,14,5347,16384,-11037,-67.364501953125
88,21,15,15425,32768,-17343,-52.9266357421875
88,22,1,0,2,-2,-100.0
88,22,2,2,4,-2,-50.0
88,22,3,2,8,-6,-75.0
88,22,4,4,16,-12,-75.0
88,22,5,9,32,-23,-71.875
88,22,6,32,64,-32,-50.0
88,22,7,82,128,-46,-35.9375
88,22,8,92,256,-164,-64.0625
88,22,9,191,512,-321,-62.6953125
88,22,10,390,1024,-634,-61.9140625
88,22,11,2248,2048,200,9.765625
88,22,12,742,4096,-3354,-81.884765625
88,22,13,3310,8192,-4882,-59.5947265625
88,22,14,41882,16384,25498,155.62744140625
88,22,15,18244,32768,-14524,-44.32373046875
88,23,1,0,2,-2,-100.0
88,23,2,2,4,-2,-50.0
88,23,3,2,8,-6,-75.0
88,23,4,7,16,-9,-56.25
88,23,5,8,32,-24,-75.0
88,23,6,53,64,-11,-17.1875
88,23,7,148,128,20,15.625
88,23,8,255,256,-1,-0.390625
88,23,9,234,512,-278,-54.296875
88,23,10,297,1024,-727,-70.99609375
88,23,11,1165,2048,-883,-43.115234375
88,23,12,7830,4096,3734,91.162109375
88,23,13,1522,8192,-6670,-81.4208984375
88,23,14,896,16384,-15488,-94.53125
88,23,15,76818,32768,44050,134.429931640625
88,24,1,0,2,-2,-100.0
88,24,2,1,4,-3,-75.0
88,24,3,21,8,13,162.5
88,24,4,3,16,-13,-81.25
88,24,5,39,32,7,21.875
88,24,6,37,64,-27,-42.1875
88,24,7,54,128,-74,-57.8125
88,24,8,582,256,326,127.34375
88,24,9,29,512,-483,-94.3359375
88,24,10,183,1024,-841,-82.12890625
88,24,11,582,2048,-1466,-71.58203125
88,24,12,5609,4096,1513,36.9384765625
88,24,13,2657,8192,-5535,-67.56591796875
88,24,14,922,16384,-15462,-94.37255859375
88,24,15,48157,32768,15389,46.9635009765625
88,25,1,0,2,-2,-100.0
88,25,2,2,4,-2,-50.0
88,25,3,2,8,-6,-75.0
88,25,4,6,16,-10,-62.5
88,25,5,19,32,-13,-40.625
88,25,6,96,64,32,50.0
88,25,7,544,128,416,325.0
88,25,8,403,256,147,57.421875
88,25,9,585,512,73,14.2578125
88,25,10,1307,1024,283,27.63671875
88,25,11,7395,2048,5347,261.083984375
88,25,12,1320,4096,-2776,-67.7734375
88,25,13,14991,8192,6799,82.99560546875
88,25,14,2770,16384,-13614,-83.09326171875
88,25,15,10937,32768,-21831,-66.6229248046875
88,26,1,0,2,-2,-100.0
88,26,2,1,4,-3,-75.0
88,26,3,4,8,-4,-50.0
88,26,4,5,16,-11,-68.75
88,26,5,18,32,-14,-43.75
88,26,6,64,64,0,0.0
88,26,7,41,128,-87,-67.96875
88,26,8,525,256,269,105.078125
88,26,9,631,512,119,23.2421875
88,26,10,808,1024,-216,-21.09375
88,26,11,3677,2048,1629,79.541015625
88,26,12,3435,4096,-661,-16.1376953125
88,26,13,3908,8192,-4284,-52.294921875
88,26,14,37166,16384,20782,126.84326171875
88,26,15,101741,32768,68973,210.4888916015625
88,27,1,0,2,-2,-100.0
88,27,2,2,4,-2,-50.0
88,27,3,2,8,-6,-75.0
88,27,4,6,16,-10,-62.5
88,27,5,9,32,-23,-71.875
88,27,6,61,64,-3,-4.6875
88,27,7,346,128,218,170.3125
88,27,8,492,256,236,92.1875
88,27,9,1015,512,503,98.2421875
88,27,10,176,1024,-848,-82.8125
88,27,11,5788,2048,3740,182.6171875
88,27,12,2221,4096,-1875,-45.7763671875
88,27,13,1611,8192,-6581,-80.33447265625
88,27,14,1104,16384,-15280,-93.26171875
88,27,15,9957,32768,-22811,-69.6136474609375
88,28,1,0,2,-2,-100.0
88,28,2,1,4,-3,-75.0
88,28,3,10,8,2,25.0
88,28,4,10,16,-6,-37.5
88,28,5,24,32,-8,-25.0
88,28,6,10,64,-54,-84.375
88,28,7,22,128,-106,-82.8125
88,28,8,571,256,315,123.046875
88,28,9,554,512,42,8.203125
88,28,10,989,1024,-35,-3.41796875
88,28,11,1512,2048,-536,-26.171875
88,28,12,2923,4096,-1173,-28.6376953125
88,28,13,70,8192,-8122,-99.1455078125
88,28,14,372,16384,-16012,-97.7294921875
88,28,15,3740,32768,-29028,-88.58642578125
88,29,1,0,2,-2,-100.0
88,29,2,2,4,-2,-50.0
88,29,3,10,8,2,25.0
88,29,4,6,16,-10,-62.5
88,29,5,64,32,32,100.0
88,29,6,36,64,-28,-43.75
88,29,7,55,128,-73,-57.03125
88,29,8,291,256,35,13.671875
88,29,9,1737,512,1225,239.2578125
88,29,10,374,1024,-650,-63.4765625
88,29,11,392,2048,-1656,-80.859375
88,29,12,2478,4096,-1618,-39.501953125
88,29,13,4949,8192,-3243,-39.58740234375
88,29,14,8027,16384,-8357,-51.007080078125
88,29,15,141108,32768,108340,330.62744140625
88,30,1,0,2,-2,-100.0
88,30,2,4,4,0,0.0
88,30,3,2,8,-6,-75.0
88,30,4,5,16,-11,-68.75
88,30,5,28,32,-4,-12.5
88,30,6,12,64,-52,-81.25
88,30,7,112,128,-16,-12.5
88,30,8,184,256,-72,-28.125
88,30,9,301,512,-211,-41.2109375
88,30,10,17,1024,-1007,-98.33984375
88,30,11,201,2048,-1847,-90.185546875
88,30,12,2414,4096,-1682,-41.064453125
88,30,13,263,8192,-7929,-96.78955078125
88,30,14,9009,16384,-7375,-45.013427734375
88,30,15,8309,32768,-24459,-74.6429443359375
88,31,1,0,2,-2,-100.0
88,31,2,1,4,-3,-75.0
88,31,3,2,8,-6,-75.0
88,31,4,4,16,-12,-75.0
88,31,5,84,32,52,162.5
88,31,6,23,64,-41,-64.0625
88,31,7,73,128,-55,-42.96875
88,31,8,370,256,114,44.53125
88,31,9,42,512,-470,-91.796875
88,31,10,505,1024,-519,-50.68359375
88,31,11,188,2048,-1860,-90.8203125
88,31,12,1166,4096,-2930,-71.533203125
88,31,13,2141,8192,-6051,-73.86474609375
88,31,14,18531,16384,2147,13.104248046875
88,31,15,47212,32768,14444,44.07958984375
88,32,1,0,2,-2,-100.0
88,32,2,1,4,-3,-75.0
88,32,3,13,8,5,62.5
88,32,4,7,16,-9,-56.25
88,32,5,32,32,0,0.0
88,32,6,112,64,48,75.0
88,32,7,166,128,38,29.6875
88,32,8,340,256,84,32.8125
88,32,9,772,512,260,50.78125
88,32,10,1284,1024,260,25.390625
88,32,11,635,2048,-1413,-68.994140625
88,32,12,1960,4096,-2136,-52.1484375
88,32,13,14720,8192,6528,79.6875
88,32,14,8484,16384,-7900,-48.2177734375
88,32,15,15808,32768,-16960,-51.7578125
88,33,1,0,2,-2,-100.0
88,33,2,1,4,-3,-75.0
88,33,3,11,8,3,37.5
88,33,4,26,16,10,62.5
88,33,5,31,32,-1,-3.125
88,33,6,284,64,220,343.75
88,33,7,170,128,42,32.8125
88,33,8,95,256,-161,-62.890625
88,33,9,20,512,-492,-96.09375
88,33,10,82,1024,-942,-91.9921875
88,33,11,59,2048,-1989,-97.119140625
88,33,12,887,4096,-3209,-78.3447265625
88,33,13,37,8192,-8155,-99.54833984375
88,33,14,16921,16384,537,3.277587890625
88,33,15,139467,32768,106699,325.6195068359375
88,34,1,0,2,-2,-100.0
88,34,2,1,4,-3,-75.0
88,34,3,3,8,-5,-62.5
88,34,4,5,16,-11,-68.75
88,34,5,18,32,-14,-43.75
88,34,6,28,64,-36,-56.25
88,34,7,317,128,189,147.65625
88,34,8,286,256,30,11.71875
88,34,9,41,512,-471,-91.9921875
88,34,10,377,1024,-647,-63.18359375
88,34,11,679,2048,-1369,-66.845703125
88,34,12,513,4096,-3583,-87.4755859375
88,34,13,2500,8192,-5692,-69.482421875
88,34,14,27908,16384,11524,70.3369140625
88,34,15,34623,32768,1855,5.6610107421875
88,35,1,0,2,-2,-100.0
88,35,2,1,4,-3,-75.0
88,35,3,3,8,-5,-62.5
88,35,4,33,16,17,106.25
88,35,5,26,32,-6,-18.75
88,35,6,154,64,90,140.625
88,35,7,478,128,350,273.4375
88,35,8,141,256,-115,-44.921875
88,35,9,20,512,-492,-96.09375
88,35,10,327,1024,-697,-68.06640625
88,35,11,2143,2048,95,4.638671875
88,35,12,1128,4096,-2968,-72.4609375
88,35,13,4639,8192,-3553,-43.37158203125
88,35,14,12369,16384,-4015,-24.505615234375
88,35,15,13818,32768,-18950,-57.830810546875
88,36,1,0,2,-2,-100.0
88,36,2,3,4,-1,-25.0
88,36,3,6,8,-2,-25.0
88,36,4,11,16,-5,-31.25
88,36,5,11,32,-21,-65.625
88,36,6,72,64,8,12.5
88,36,7,256,128,128,100.0
88,36,8,245,256,-11,-4.296875
88,36,9,101,512,-411,-80.2734375
88,36,10,1427,1024,403,39.35546875
88,36,11,2754,2048,706,34.47265625
88,36,12,1590,4096,-2506,-61.181640625
88,36,13,2227,8192,-5965,-72.81494140625
88,36,14,3105,16384,-13279,-81.048583984375
88,36,15,70533,32768,37765,115.2496337890625
88,37,1,0,2,-2,-100.0
88,37,2,5,4,1,25.0
88,37,3,11,8,3,37.5
88,37,4,4,16,-12,-75.0
88,37,5,4,32,-28,-87.5
88,37,6,39,64,-25,-39.0625
88,37,7,380,128,252,196.875
88,37,8,487,256,231,90.234375
88,37,9,380,512,-132,-25.78125
88,37,10,124,1024,-900,-87.890625
88,37,11,1835,2048,-213,-10.400390625
88,37,12,845,4096,-3251,-79.3701171875
88,37,13,4103,8192,-4089,-49.91455078125
88,37,14,3046,16384,-13338,-81.40869140625
88,37,15,10303,32768,-22465,-68.5577392578125
88,38,1,0,2,-2,-100.0
88,38,2,1,4,-3,-75.0
88,38,3,2,8,-6,-75.0
88,38,4,17,16,1,6.25
88,38,5,21,32,-11,-34.375
88,38,6,63,64,-1,-1.5625
88,38,7,109,128,-19,-14.84375
88,38,8,28,256,-228,-89.0625
88,38,9,1269,512,757,147.8515625
88,38,10,631,1024,-393,-38.37890625
88,38,11,2060,2048,12,0.5859375
88,38,12,1912,4096,-2184,-53.3203125
88,38,13,2216,8192,-5976,-72.94921875
88,38,14,5259,16384,-11125,-67.901611328125
88,38,15,76306,32768,43538,132.867431640625
88,39,1,0,2,-2,-100.0
88,39,2,1,4,-3,-75.0
88,39,3,12,8,4,50.0
88,39,4,8,16,-8,-50.0
88,39,5,7,32,-25,-78.125
88,39,6,29,64,-35,-54.6875
88,39,7,687,128,559,436.71875
88,39,8,66,256,-190,-74.21875
88,39,9,626,512,114,22.265625
88,39,10,2229,1024,1205,117.67578125
88,39,11,3009,2048,961,46.923828125
88,39,12,2898,4096,-1198,-29.248046875
88,39,13,4390,8192,-3802,-46.4111328125
88,39,14,25063,16384,8679,52.972412109375
88,39,15,74550,32768,41782,127.508544921875
88,40,1,0,2,-2,-100.0
88,40,2,2,4,-2,-50.0
88,40,3,14,8,6,75.0
88,40,4,17,16,1,6.25
88,40,5,35,32,3,9.375
88,40,6,24,64,-40,-62.5
88,40,7,70,128,-58,-45.3125
88,40,8,119,256,-137,-53.515625
88,40,9,520,512,8,1.5625
88,40,10,745,1024,-279,-27.24609375
88,40,11,1057,2048,-991,-48.388671875
88,40,12,5631,4096,1535,37.4755859375
88,40,13,1152,8192,-7040,-85.9375
88,40,14,10234,16384,-6150,-37.53662109375
88,40,15,30437,32768,-2331,-7.1136474609375
88,41,1,0,2,-2,-100.0
88,41,2,2,4,-2,-50.0
88,41,3,2,8,-6,-75.0
88,41,4,11,16,-5,-31.25
88,41,5,11,32,-21,-65.625
88,41,6,12,64,-52,-81.25
88,41,7,49,128,-79,-61.71875
88,41,8,253,256,-3,-1.171875
88,41,9,517,512,5,0.9765625
88,41,10,2003,1024,979,95.60546875
88,41,11,472,2048,-1576,-76.953125
88,41,12,2829,4096,-1267,-30.9326171875
88,41,13,3280,8192,-4912,-59.9609375
88,41,14,73845,16384,57461,350.714111328125
88,41,15,8730,32768,-24038,-73.358154296875
88,42,1,0,2,-2,-100.0
88,42,2,1,4,-3,-75.0
88,42,3,4,8,-4,-50.0
88,42,4,4,16,-12,-75.0
88,42,5,29,32,-3,-9.375
88,42,6,13,64,-51,-79.6875
88,42,7,9,128,-119,-92.96875
88,42,8,635,256,379,148.046875
88,42,9,79,512,-433,-84.5703125
88,42,10,1449,1024,425,41.50390625
88,42,11,1156,2048,-892,-43.5546875
88,42,12,54,4096,-4042,-98.681640625
88,42,13,21255,8192,13063,159.46044921875
88,42,14,1109,16384,-15275,-93.231201171875
88,42,15,3222,32768,-29546,-90.167236328125
88,43,1,0,2,-2,-100.0
88,43,2,1,4,-3,-75.0
88,43,3,8,8,0,0.0
88,43,4,45,16,29,181.25
88,43,5,26,32,-6,-18.75
88,43,6,33,64,-31,-48.4375
88,43,7,40,128,-88,-68.75
88,43,8,49,256,-207,-80.859375
88,43,9,619,512,107,20.8984375
88,43,10,766,1024,-258,-25.1953125
88,43,11,1196,2048,-852,-41.6015625
88,43,12,12016,4096,7920,193.359375
88,43,13,7132,8192,-1060,-12.939453125
88,43,14,27949,16384,11565,70.587158203125
88,43,15,3688,32768,-29080,-88.7451171875
88,44,1,0,2,-2,-100.0
88,44,2,1,4,-3,-75.0
88,44,3,8,8,0,0.0
88,44,4,5,16,-11,-68.75
88,44,5,111,32,79,246.875
88,44,6,66,64,2,3.125
88,44,7,82,128,-46,-35.9375
88,44,8,266,256,10,3.90625
88,44,9,117,512,-395,-77.1484375
88,44,10,1143,1024,119,11.62109375
88,44,11,1369,2048,-679,-33.154296875
88,44,12,3606,4096,-490,-11.962890625
88,44,13,280,8192,-7912,-96.58203125
88,44,14,5418,16384,-10966,-66.93115234375
88,44,15,8305,32768,-24463,-74.6551513671875
88,45,1,0,2,-2,-100.0
88,45,2,1,4,-3,-75.0
88,45,3,4,8,-4,-50.0
88,45,4,3,16,-13,-81.25
88,45,5,91,32,59,184.375
88,45,6,34,64,-30,-46.875
88,45,7,87,128,-41,-32.03125
88,45,8,147,256,-109,-42.578125
88,45,9,915,512,403,78.7109375
88,45,10,177,1024,-847,-82.71484375
88,45,11,4085,2048,2037,99.462890625
88,45,12,4127,4096,31,0.7568359375
88,45,13,973,8192,-7219,-88.12255859375
88,45,14,9163,16384,-7221,-44.073486328125
88,45,15,55844,32768,23076,70.42236328125
88,46,1,0,2,-2,-100.0
88,46,2,1,4,-3,-75.0
88,46,3,2,8,-6,-75.0
88,46,4,18,16,2,12.5
88,46,5,10,32,-22,-68.75
88,46,6,45,64,-19,-29.6875
88,46,7,26,128,-102,-79.6875
88,46,8,114,256,-142,-55.46875
88,46,9,140,512,-372,-72.65625
88,46,10,631,1024,-393,-38.37890625
88,46,11,4174,2048,2126,103.80859375
88,46,12,3001,4096,-1095,-26.7333984375
88,46,13,1838,8192,-6354,-77.5634765625
88,46,14,14861,16384,-1523,-9.295654296875
88,46,15,11067,32768,-21701,-66.2261962890625
88,47,1,0,2,-2,-100.0
88,47,2,3,4,-1,-25.0
88,47,3,2,8,-6,-75.0
88,47,4,11,16,-5,-31.25
88,47,5,93,32,61,190.625
88,47,6,134,64,70,109.375
88,47,7,103,128,-25,-19.53125
88,47,8,94,256,-162,-63.28125
88,47,9,2445,512,1933,377.5390625
88,47,10,1442,1024,418,40.8203125
88,47,11,91,2048,-1957,-95.556640625
88,47,12,3313,4096,-783,-19.1162109375
88,47,13,9604,8192,1412,17.236328125
88,47,14,15257,16384,-1127,-6.878662109375
88,47,15,23080,32768,-9688,-29.5654296875
88,48,1,0,2,-2,-100.0
88,48,2,2,4,-2,-50.0
88,48,3,4,8,-4,-50.0
88,48,4,18,16,2,12.5
88,48,5,12,32,-20,-62.5
88,48,6,50,64,-14,-21.875
88,48,7,169,128,41,32.03125
88,48,8,1425,256,1169,456.640625
88,48,9,195,512,-317,-61.9140625
88,48,10,1627,1024,603,58.88671875
88,48,11,1371,2048,-677,-33.056640625
88,48,12,13007,4096,8911,217.5537109375
88,48,13,2027,8192,-6165,-75.25634765625
88,48,14,3229,16384,-13155,-80.291748046875
88,48,15,704,32768,-32064,-97.8515625
88,49,1,0,2,-2,-100.0
88,49,2,2,4,-2,-50.0
88,49,3,5,8,-3,-37.5
88,49,4,25,16,9,56.25
88,49,5,35,32,3,9.375
88,49,6,8,64,-56,-87.5
88,49,7,79,128,-49,-38.28125
88,49,8,680,256,424,165.625
88,49,9,355,512,-157,-30.6640625
88,49,10,7132,1024,6108,596.484375
88,49,11,15659,2048,13611,664.599609375
88,49,12,396,4096,-3700,-90.33203125
88,49,13,188,8192,-8004,-97.705078125
88,49,14,11186,16384,-5198,-31.72607421875
88,49,15,10366,32768,-22402,-68.365478515625
88,50,1,0,2,-2,-100.0
88,50,2,2,4,-2,-50.0
88,50,3,15,8,7,87.5
88,50,4,15,16,-1,-6.25
88,50,5,23,32,-9,-28.125
88,50,6,67,64,3,4.6875
88,50,7,68,128,-60,-46.875
88,50,8,267,256,11,4.296875
88,50,9,252,512,-260,-50.78125
88,50,10,1128,1024,104,10.15625
88,50,11,2912,2048,864,42.1875
88,50,12,4082,4096,-14,-0.341796875
88,50,13,19840,8192,11648,142.1875
88,50,14,15879,16384,-505,-3.082275390625
88,50,15,1285,32768,-31483,-96.0784912109375
88,51,1,0,2,-2,-100.0
88,51,2,6,4,2,50.0
88,51,3,3,8,-5,-62.5
88,51,4,12,16,-4,-25.0
88,51,5,4,32,-28,-87.5
88,51,6,21,64,-43,-67.1875
88,51,7,91,128,-37,-28.90625
88,51,8,107,256,-149,-58.203125
88,51,9,426,512,-86,-16.796875
88,51,10,2358,1024,1334,130.2734375
88,51,11,2064,2048,16,0.78125
88,51,12,14031,4096,9935,242.5537109375
88,51,13,7367,8192,-825,-10.07080078125
88,51,14,31230,16384,14846,90.61279296875
88,51,15,29985,32768,-2783,-8.4930419921875
88,52,1,0,2,-2,-100.0
88,52,2,2,4,-2,-50.0
88,52,3,4,8,-4,-50.0
88,52,4,50,16,34,212.5
88,52,5,11,32,-21,-65.625
88,52,6,22,64,-42,-65.625
88,52,7,31,128,-97,-75.78125
88,52,8,364,256,108,42.1875
88,52,9,363,512,-149,-29.1015625
88,52,10,790,1024,-234,-22.8515625
88,52,11,2458,2048,410,20.01953125
88,52,12,968,4096,-3128,-76.3671875
88,52,13,1250,8192,-6942,-84.7412109375
88,52,14,566,16384,-15818,-96.54541015625
88,52,15,11611,32768,-21157,-64.5660400390625
88,53,1,0,2,-2,-100.0
88,53,2,1,4,-3,-75.0
88,53,3,3,8,-5,-62.5
88,53,4,28,16,12,75.0
88,53,5,48,32,16,50.0
88,53,6,50,64,-14,-21.875
88,53,7,47,128,-81,-63.28125
88,53,8,120,256,-136,-53.125
88,53,9,496,512,-16,-3.125
88,53,10,1704,1024,680,66.40625
88,53,11,8197,2048,6149,300.244140625
88,53,12,7268,4096,3172,77.44140625
88,53,13,1425,8192,-6767,-82.60498046875
88,53,14,21503,16384,5119,31.243896484375
88,53,15,44918,32768,12150,37.078857421875
88,54,1,0,2,-2,-100.0
88,54,2,2,4,-2,-50.0
88,54,3,2,8,-6,-75.0
88,54,4,7,16,-9,-56.25
88,54,5,4,32,-28,-87.5
88,54,6,5,64,-59,-92.1875
88,54,7,99,128,-29,-22.65625
88,54,8,66,256,-190,-74.21875
88,54,9,113,512,-399,-77.9296875
88,54,10,1626,1024,602,58.7890625
88,54,11,1297,2048,-751,-36.669921875
88,54,12,4025,4096,-71,-1.7333984375
88,54,13,19001,8192,10809,131.94580078125
88,54,14,9118,16384,-7266,-44.34814453125
88,54,15,32092,32768,-676,-2.06298828125
88,55,1,0,2,-2,-100.0
88,55,2,1,4,-3,-75.0
88,55,3,11,8,3,37.5
88,55,4,42,16,26,162.5
88,55,5,95,32,63,196.875
88,55,6,5,64,-59,-92.1875
88,55,7,8,128,-120,-93.75
88,55,8,149,256,-107,-41.796875
88,55,9,500,512,-12,-2.34375
88,55,10,546,1024,-478,-46.6796875
88,55,11,524,2048,-1524,-74.4140625
88,55,12,2593,4096,-1503,-36.6943359375
88,55,13,8962,8192,770,9.3994140625
88,55,14,8393,16384,-7991,-48.773193359375
88,55,15,32302,32768,-466,-1.422119140625
88,56,1,0,2,-2,-100.0
88,56,2,1,4,-3,-75.0
88,56,3,7,8,-1,-12.5
88,56,4,57,16,41,256.25
88,56,5,4,32,-28,-87.5
88,56,6,83,64,19,29.6875
88,56,7,384,128,256,200.0
88,56,8,102,256,-154,-60.15625
88,56,9,644,512,132,25.78125
88,56,10,879,1024,-145,-14.16015625
88,56,11,2018,2048,-30,-1.46484375
88,56,12,9086,4096,4990,121.826171875
88,56,13,11740,8192,3548,43.310546875
88,56,14,38961,16384,22577,137.799072265625
88,56,15,57402,32768,24634,75.177001953125
88,57,1,0,2,-2,-100.0
88,57,2,5,4,1,25.0
88,57,3,24,8,16,200.0
88,57,4,17,16,1,6.25
88,57,5,117,32,85,265.625
88,57,6,129,64,65,101.5625
88,57,7,167,128,39,30.46875
88,57,8,547,256,291,113.671875
88,57,9,368,512,-144,-28.125
88,57,10,1738,1024,714,69.7265625
88,57,11,431,2048,-1617,-78.955078125
88,57,12,5707,4096,1611,39.3310546875
88,57,13,20653,8192,12461,152.11181640625
88,57,14,15500,16384,-884,-5.3955078125
88,57,15,42864,32768,10096,30.810546875
88,58,1,0,2,-2,-100.0
88,58,2,3,4,-1,-25.0
88,58,3,7,8,-1,-12.5
88,58,4,12,16,-4,-25.0
88,58,5,96,32,64,200.0
88,58,6,29,64,-35,-54.6875
88,58,7,25,128,-103,-80.46875
88,58,8,368,256,112,43.75
88,58,9,347,512,-165,-32.2265625
88,58,10,582,1024,-442,-43.1640625
88,58,11,93,2048,-1955,-95.458984375
88,58,12,632,4096,-3464,-84.5703125
88,58,13,12460,8192,4268,52.099609375
88,58,14,3590,16384,-12794,-78.08837890625
88,58,15,7282,32768,-25486,-77.777099609375
88,59,1,0,2,-2,-100.0
88,59,2,1,4,-3,-75.0
88,59,3,3,8,-5,-62.5
88,59,4,13,16,-3,-18.75
88,59,5,17,32,-15,-46.875
88,59,6,233,64,169,264.0625
88,59,7,14,128,-114,-89.0625
88,59,8,922,256,666,260.15625
88,59,9,468,512,-44,-8.59375
88,59,10,338,1024,-686,-66.9921875
88,59,11,473,2048,-1575,-76.904296875
88,59,12,2574,4096,-1522,-37.158203125
88,59,13,1400,8192,-6792,-82.91015625
88,59,14,30254,16384,13870,84.65576171875
88,59,15,37982,32768,5214,15.911865234375
88,60,1,0,2,-2,-100.0
88,60,2,1,4,-3,-75.0
88,60,3,3,8,-5,-62.5
88,60,4,4,16,-12,-75.0
88,60,5,71,32,39,121.875
88,60,6,120,64,56,87.5
88,60,7,44,128,-84,-65.625
88,60,8,250,256,-6,-2.34375
88,60,9,1118,512,606,118.359375
88,60,10,89,1024,-935,-91.30859375
88,60,11,2377,2048,329,16.064453125
88,60,12,2421,4096,-1675,-40.8935546875
88,60,13,7472,8192,-720,-8.7890625
88,60,14,47958,16384,31574,192.71240234375
88,60,15,65452,32768,32684,99.74365234375
88,61,1,0,2,-2,-100.0
88,61,2,1,4,-3,-75.0
88,61,3,4,8,-4,-50.0
88,61,4,4,16,-12,-75.0
88,61,5,4,32,-28,-87.5
88,61,6,43,64,-21,-32.8125
88,61,7,10,128,-118,-92.1875
88,61,8,949,256,693,270.703125
88,61,9,967,512,455,88.8671875
88,61,10,821,1024,-203,-19.82421875
88,61,11,3014,2048,966,47.16796875
88,61,12,2829,4096,-1267,-30.9326171875
88,61,13,2616,8192,-5576,-68.06640625
88,61,14,13944,16384,-2440,-14.892578125
88,61,15,107436,32768,74668,227.86865234375
88,62,1,0,2,-2,-100.0
88,62,2,1,4,-3,-75.0
88,62,3,8,8,0,0.0
88,62,4,6,16,-10,-62.5
88,62,5,109,32,77,240.625
88,62,6,7,64,-57,-89.0625
88,62,7,158,128,30,23.4375
88,62,8,143,256,-113,-44.140625
88,62,9,34,512,-478,-93.359375
88,62,10,760,1024,-264,-25.78125
88,62,11,1070,2048,-978,-47.75390625
88,62,12,5275,4096,1179,28.7841796875
88,62,13,601,8192,-7591,-92.66357421875
88,62,14,5139,16384,-11245,-68.634033203125
88,62,15,11976,32768,-20792,-63.4521484375
88,63,1,0,2,-2,-100.0
88,63,2,1,4,-3,-75.0
88,63,3,6,8,-2,-25.0
88,63,4,6,16,-10,-62.5
88,63,5,9,32,-23,-71.875
88,63,6,31,64,-33,-51.5625
88,63,7,65,128,-63,-49.21875
88,63,8,13,256,-243,-94.921875
88,63,9,226,512,-286,-55.859375
88,63,10,288,1024,-736,-71.875
88,63,11,1284,2048,-764,-37.3046875
88,63,12,1292,4096,-2804,-68.45703125
88,63,13,1040,8192,-7152,-87.3046875
88,63,14,57184,16384,40800,249.0234375
88,63,15,61383,32768,28615,87.3260498046875
88,64,1,0,2,-2,-100.0
88,64,2,1,4,-3,-75.0
88,64,3,4,8,-4,-50.0
88,64,4,3,16,-13,-81.25
88,64,5,10,32,-22,-68.75
88,64,6,224,64,160,250.0
88,64,7,56,128,-72,-56.25
88,64,8,227,256,-29,-11.328125
88,64,9,215,512,-297,-58.0078125
88,64,10,591,1024,-433,-42.28515625
88,64,11,9744,2048,7696,375.78125
88,64,12,1709,4096,-2387,-58.2763671875
88,64,13,20779,8192,12587,153.64990234375
88,64,14,11744,16384,-4640,-28.3203125
88,64,15,10386,32768,-22382,-68.304443359375
88,65,1,0,2,-2,-100.0
88,65,2,1,4,-3,-75.0
88,65,3,4,8,-4,-50.0
88,65,4,13,16,-3,-18.75
88,65,5,29,32,-3,-9.375
88,65,6,45,64,-19,-29.6875
88,65,7,231,128,103,80.46875
88,65,8,563,256,307,119.921875
88,65,9,262,512,-250,-48.828125
88,65,10,1976,1024,952,92.96875
88,65,11,1664,2048,-384,-18.75
88,65,12,3888,4096,-208,-5.078125
88,65,13,23816,8192,15624,190.72265625
88,65,14,29522,16384,13138,80.18798828125
88,65,15,69011,32768,36243,110.6048583984375
88,66,1,0,2,-2,-100.0
88,66,2,2,4,-2,-50.0
88,66,3,2,8,-6,-75.0
88,66,4,7,16,-9,-56.25
88,66,5,55,32,23,71.875
88,66,6,77,64,13,20.3125
88,66,7,37,128,-91,-71.09375
88,66,8,92,256,-164,-64.0625
88,66,9,538,512,26,5.078125
88,66,10,383,1024,-641,-62.59765625
88,66,11,1642,2048,-406,-19.82421875
88,66,12,3684,4096,-412,-10.05859375
88,66,13,6520,8192,-1672,-20.41015625
88,66,14,24293,16384,7909,48.272705078125
88,66,15,56224,32768,23456,71.58203125
88,67,1,0,2,-2,-100.0
88,67,2,2,4,-2,-50.0
88,67,3,6,8,-2,-25.0
88,67,4,5,16,-11,-68.75
88,67,5,7,32,-25,-78.125
88,67,6,24,64,-40,-62.5
88,67,7,182,128,54,42.1875
88,67,8,354,256,98,38.28125
88,67,9,93,512,-419,-81.8359375
88,67,10,584,1024,-440,-42.96875
88,67,11,1513,2048,-535,-26.123046875
88,67,12,6379,4096,2283,55.7373046875
88,67,13,43887,8192,35695,435.72998046875
88,67,14,5454,16384,-10930,-66.71142578125
88,67,15,118931,32768,86163,262.9486083984375
88,68,1,0,2,-2,-100.0
88,68,2,2,4,-2,-50.0
88,68,3,5,8,-3,-37.5
88,68,4,9,16,-7,-43.75
88,68,5,70,32,38,118.75
88,68,6,23,64,-41,-64.0625
88,68,7,94,128,-34,-26.5625
88,68,8,194,256,-62,-24.21875
88,68,9,462,512,-50,-9.765625
88,68,10,3239,1024,2215,216.30859375
88,68,11,4633,2048,2585,126.220703125
88,68,12,2821,4096,-1275,-31.1279296875
88,68,13,2413,8192,-5779,-70.54443359375
88,68,14,47961,16384,31577,192.730712890625
88,68,15,7099,32768,-25669,-78.3355712890625
88,69,1,0,2,-2,-100.0
88,69,2,2,4,-2,-50.0
88,69,3,3,8,-5,-62.5
88,69,4,38,16,22,137.5
88,69,5,8,32,-24,-75.0
88,69,6,156,64,92,143.75
88,69,7,117,128,-11,-8.59375
88,69,8,89,256,-167,-65.234375
88,69,9,1285,512,773,150.9765625
88,69,10,103,1024,-921,-89.94140625
88,69,11,3418,2048,1370,66.89453125
88,69,12,6758,4096,2662,64.990234375
88,69,13,3244,8192,-4948,-60.400390625
88,69,14,7466,16384,-8918,-54.43115234375
88,69,15,10965,32768,-21803,-66.5374755859375
88,70,1,0,2,-2,-100.0
88,70,2,3,4,-1,-25.0
88,70,3,10,8,2,25.0
88,70,4,4,16,-12,-75.0
88,70,5,36,32,4,12.5
88,70,6,95,64,31,48.4375
88,70,7,284,128,156,121.875
88,70,8,82,256,-174,-67.96875
88,70,9,436,512,-76,-14.84375
88,70,10,1017,1024,-7,-0.68359375
88,70,11,563,2048,-1485,-72.509765625
88,70,12,3724,4096,-372,-9.08203125
88,70,13,816,8192,-7376,-90.0390625
88,70,14,783,16384,-15601,-95.220947265625
88,70,15,157296,32768,124528,380.029296875
88,71,1,0,2,-2,-100.0
88,71,2,2,4,-2,-50.0
88,71,3,2,8,-6,-75.0
88,71,4,3,16,-13,-81.25
88,71,5,13,32,-19,-59.375
88,71,6,45,64,-19,-29.6875
88,71,7,168,128,40,31.25
88,71,8,32,256,-224,-87.5
88,71,9,1667,512,1155,225.5859375
88,71,10,602,1024,-422,-41.2109375
88,71,11,2182,2048,134,6.54296875
88,71,12,10911,4096,6815,166.3818359375
88,71,13,7158,8192,-1034,-12.6220703125
88,71,14,2280,16384,-14104,-86.083984375
88,71,15,15241,32768,-17527,-53.4881591796875
88,72,1,0,2,-2,-100.0
88,72,2,2,4,-2,-50.0
88,72,3,12,8,4,50.0
88,72,4,51,16,35,218.75
88,72,5,68,32,36,112.5
88,72,6,28,64,-36,-56.25
88,72,7,6,128,-122,-95.3125
88,72,8,38,256,-218,-85.15625
88,72,9,3249,512,2737,534.5703125
88,72,10,286,1024,-738,-72.0703125
88,72,11,3785,2048,1737,84.814453125
88,72,12,1031,4096,-3065,-74.8291015625
88,72,13,2865,8192,-5327,-65.02685546875
88,72,14,3776,16384,-12608,-76.953125
88,72,15,31801,32768,-967,-2.9510498046875
88,73,1,0,2,-2,-100.0
88,73,2,1,4,-3,-75.0
88,73,3,4,8,-4,-50.0
88,73,4,38,16,22,137.5
88,73,5,30,32,-2,-6.25
88,73,6,38,64,-26,-40.625
88,73,7,232,128,104,81.25
88,73,8,320,256,64,25.0
88,73,9,96,512,-416,-81.25
88,73,10,335,1024,-689,-67.28515625
88,73,11,2782,2048,734,35.83984375
88,73,12,4125,4096,29,0.7080078125
88,73,13,13539,8192,5347,65.27099609375
88,73,14,28270,16384,11886,72.54638671875
88,73,15,22026,32768,-10742,-32.781982421875
88,74,1,0,2,-2,-100.0
88,74,2,1,4,-3,-75.0
88,74,3,20,8,12,150.0
88,74,4,9,16,-7,-43.75
88,74,5,10,32,-22,-68.75
88,74,6,280,64,216,337.5
88,74,7,186,128,58,45.3125
88,74,8,96,256,-160,-62.5
88,74,9,1159,512,647,126.3671875
88,74,10,89,1024,-935,-91.30859375
88,74,11,323,2048,-1725,-84.228515625
88,74,12,4153,4096,57,1.3916015625
88,74,13,74,8192,-8118,-99.0966796875
88,74,14,32552,16384,16168,98.681640625
88,74,15,14440,32768,-18328,-55.9326171875
88,75,1,0,2,-2,-100.0
88,75,2,1,4,-3,-75.0
88,75,3,11,8,3,37.5
88,75,4,3,16,-13,-81.25
88,75,5,14,32,-18,-56.25
88,75,6,44,64,-20,-31.25
88,75,7,96,128,-32,-25.0
88,75,8,79,256,-177,-69.140625
88,75,9,525,512,13,2.5390625
88,75,10,870,1024,-154,-15.0390625
88,75,11,2393,2048,345,16.845703125
88,75,12,3402,4096,-694,-16.943359375
88,75,13,7414,8192,-778,-9.4970703125
88,75,14,14109,16384,-2275,-13.885498046875
88,75,15,3061,32768,-29707,-90.6585693359375
88,76,1,0,2,-2,-100.0
88,76,2,2,4,-2,-50.0
88,76,3,2,8,-6,-75.0
88,76,4,19,16,3,18.75
88,76,5,5,32,-27,-84.375
88,76,6,167,64,103,160.9375
88,76,7,162,128,34,26.5625
88,76,8,23,256,-233,-91.015625
88,76,9,194,512,-318,-62.109375
88,76,10,324,1024,-700,-68.359375
88,76,11,302,2048,-1746,-85.25390625
88,76,12,5726,4096,1630,39.794921875
88,76,13,2116,8192,-6076,-74.169921875
88,76,14,9971,16384,-6413,-39.141845703125
88,76,15,872,32768,-31896,-97.3388671875
88,77,1,0,2,-2,-100.0
88,77,2,3,4,-1,-25.0
88,77,3,2,8,-6,-75.0
88,77,4,14,16,-2,-12.5
88,77,5,6,32,-26,-81.25
88,77,6,18,64,-46,-71.875
88,77,7,65,128,-63,-49.21875
88,77,8,159,256,-97,-37.890625
88,77,9,33,512,-479,-93.5546875
88,77,10,987,1024,-37,-3.61328125
88,77,11,850,2048,-1198,-58.49609375
88,77,12,1351,4096,-2745,-67.0166015625
88,77,13,9023,8192,831,10.14404296875
88,77,14,13619,16384,-2765,-16.876220703125
88,77,15,1391,32768,-31377,-95.7550048828125
88,78,1,0,2,-2,-100.0
88,78,2,1,4,-3,-75.0
88,78,3,4,8,-4,-50.0
88,78,4,13,16,-3,-18.75
88,78,5,4,32,-28,-87.5
88,78,6,25,64,-39,-60.9375
88,78,7,277,128,149,116.40625
88,78,8,8,256,-248,-96.875
88,78,9,25,512,-487,-95.1171875
88,78,10,1285,1024,261,25.48828125
88,78,11,2837,2048,789,38.525390625
88,78,12,2086,4096,-2010,-49.072265625
88,78,13,3143,8192,-5049,-61.63330078125
88,78,14,186,16384,-16198,-98.86474609375
88,78,15,1970,32768,-30798,-93.988037109375
88,79,1,0,2,-2,-100.0
88,79,2,1,4,-3,-75.0
88,79,3,6,8,-2,-25.0
88,79,4,4,16,-12,-75.0
88,79,5,8,32,-24,-75.0
88,79,6,40,64,-24,-37.5
88,79,7,9,128,-119,-92.96875
88,79,8,98,256,-158,-61.71875
88,79,9,290,512,-222,-43.359375
88,79,10,238,1024,-786,-76.7578125
88,79,11,4032,2048,1984,96.875
88,79,12,418,4096,-3678,-89.794921875
88,79,13,1181,8192,-7011,-85.58349609375
88,79,14,33957,16384,17573,107.257080078125
88,79,15,2756,32768,-30012,-91.58935546875
88,80,1,0,2,-2,-100.0
88,80,2,1,4,-3,-75.0
88,80,3,2,8,-6,-75.0
88,80,4,4,16,-12,-75.0
88,80,5,10,32,-22,-68.75
88,80,6,96,64,32,50.0
88,80,7,254,128,126,98.4375
88,80,8,364,256,108,42.1875
88,80,9,52,512,-460,-89.84375
88,80,10,220,1024,-804,-78.515625
88,80,11,2254,2048,206,10.05859375
88,80,12,3830,4096,-266,-6.494140625
88,80,13,210,8192,-7982,-97.4365234375
88,80,14,19488,16384,3104,18.9453125
88,80,15,4171,32768,-28597,-87.2711181640625
88,81,1,0,2,-2,-100.0
88,81,2,5,4,1,25.0
88,81,3,5,8,-3,-37.5
88,81,4,15,16,-1,-6.25
88,81,5,61,32,29,90.625
88,81,6,321,64,257,401.5625
88,81,7,66,128,-62,-48.4375
88,81,8,258,256,2,0.78125
88,81,9,168,512,-344,-67.1875
88,81,10,64,1024,-960,-93.75
88,81,11,2098,2048,50,2.44140625
88,81,12,2198,4096,-1898,-46.337890625
88,81,13,4541,8192,-3651,-44.56787109375
88,81,14,3169,16384,-13215,-80.657958984375
88,81,15,36485,32768,3717,11.3433837890625
88,82,1,0,2,-2,-100.0
88,82,2,2,4,-2,-50.0
88,82,3,3,8,-5,-62.5
88,82,4,12,16,-4,-25.0
88,82,5,24,32,-8,-25.0
88,82,6,90,64,26,40.625
88,82,7,42,128,-86,-67.1875
88,82,8,212,256,-44,-17.1875
88,82,9,94,512,-418,-81.640625
88,82,10,759,1024,-265,-25.87890625
88,82,11,5401,2048,3353,163.720703125
88,82,12,3994,4096,-102,-2.490234375
88,82,13,6887,8192,-1305,-15.93017578125
88,82,14,1379,16384,-15005,-91.583251953125
88,82,15,29367,32768,-3401,-10.3790283203125
88,83,1,0,2,-2,-100.0
88,83,2,2,4,-2,-50.0
88,83,3,14,8,6,75.0
88,83,4,16,16,0,0.0
88,83,5,4,32,-28,-87.5
88,83,6,30,64,-34,-53.125
88,83,7,73,128,-55,-42.96875
88,83,8,24,256,-232,-90.625
88,83,9,782,512,270,52.734375
88,83,10,70,1024,-954,-93.1640625
88,83,11,450,2048,-1598,-78.02734375
88,83,12,3185,4096,-911,-22.2412109375
88,83,13,1083,8192,-7109,-86.77978515625
88,83,14,9311,16384,-7073,-43.170166015625
88,83,15,1856,32768,-30912,-94.3359375
88,84,1,0,2,-2,-100.0
88,84,2,1,4,-3,-75.0
88,84,3,10,8,2,25.0
88,84,4,7,16,-9,-56.25
88,84,5,6,32,-26,-81.25
88,84,6,36,64,-28,-43.75
88,84,7,172,128,44,34.375
88,84,8,264,256,8,3.125
88,84,9,1216,512,704,137.5
88,84,10,1488,1024,464,45.3125
88,84,11,1151,2048,-897,-43.798828125
88,84,12,4106,4096,10,0.244140625
88,84,13,1245,8192,-6947,-84.80224609375
88,84,14,7380,16384,-9004,-54.9560546875
88,84,15,29475,32768,-3293,-10.0494384765625
88,85,1,0,2,-2,-100.0
88,85,2,4,4,0,0.0
88,85,3,2,8,-6,-75.0
88,85,4,8,16,-8,-50.0
88,85,5,28,32,-4,-12.5
88,85,6,157,64,93,145.3125
88,85,7,51,128,-77,-60.15625
88,85,8,66,256,-190,-74.21875
88,85,9,204,512,-308,-60.15625
88,85,10,825,1024,-199,-19.43359375
88,85,11,2341,2048,293,14.306640625
88,85,12,4115,4096,19,0.4638671875
88,85,13,12815,8192,4623,56.43310546875
88,85,14,13171,16384,-3213,-19.610595703125
88,85,15,5618,32768,-27150,-82.855224609375
88,86,1,0,2,-2,-100.0
88,86,2,1,4,-3,-75.0
88,86,3,6,8,-2,-25.0
88,86,4,9,16,-7,-43.75
88,86,5,4,32,-28,-87.5
88,86,6,67,64,3,4.6875
88,86,7,120,128,-8,-6.25
88,86,8,175,256,-81,-31.640625
88,86,9,1026,512,514,100.390625
88,86,10,4388,1024,3364,328.515625
88,86,11,2919,2048,871,42.529296875
88,86,12,10053,4096,5957,145.4345703125
88,86,13,7624,8192,-568,-6.93359375
88,86,14,4417,16384,-11967,-73.040771484375
88,86,15,56662,32768,23894,72.918701171875
88,87,1,0,2,-2,-100.0
88,87,2,1,4,-3,-75.0
88,87,3,12,8,4,50.0
88,87,4,12,16,-4,-25.0
88,87,5,30,32,-2,-6.25
88,87,6,16,64,-48,-75.0
88,87,7,10,128,-118,-92.1875
88,87,8,196,256,-60,-23.4375
88,87,9,217,512,-295,-57.6171875
88,87,10,571,1024,-453,-44.23828125
88,87,11,179,2048,-1869,-91.259765625
88,87,12,5275,4096,1179,28.7841796875
88,87,13,17539,8192,9347,114.09912109375
88,87,14,17625,16384,1241,7.574462890625
88,87,15,29380,32768,-3388,-10.33935546875
88,88,1,0,2,-2,-100.0
88,88,2,1,4,-3,-75.0
88,88,3,7,8,-1,-12.5
88,88,4,12,16,-4,-25.0
88,88,5,13,32,-19,-59.375
88,88,6,51,64,-13,-20.3125
88,88,7,17,128,-111,-86.71875
88,88,8,1103,256,847,330.859375
88,88,9,386,512,-126,-24.609375
88,88,10,1675,1024,651,63.57421875
88,88,11,2479,2048,431,21.044921875
88,88,12,3698,4096,-398,-9.716796875
88,88,13,1286,8192,-6906,-84.3017578125
88,88,14,553,16384,-15831,-96.624755859375
88,88,15,23379,32768,-9389,-28.6529541015625
89,1,1,0,2,-2,-100.0
89,1,2,1,4,-3,-75.0
89,1,3,3,8,-5,-62.5
89,1,4,4,16,-12,-75.0
89,1,5,21,32,-11,-34.375
89,1,6,12,64,-52,-81.25
89,1,7,111,128,-17,-13.28125
89,1,8,630,256,374,146.09375
89,1,9,998,512,486,94.921875
89,1,10,480,1024,-544,-53.125
89,1,11,3526,2048,1478,72.16796875
89,1,12,640,4096,-3456,-84.375
89,1,13,12615,8192,4423,53.99169921875
89,1,14,16317,16384,-67,-0.408935546875
89,1,15,28999,32768,-3769,-11.5020751953125
89,2,1,0,2,-2,-100.0
89,2,2,1,4,-3,-75.0
89,2,3,3,8,-5,-62.5
89,2,4,9,16,-7,-43.75
89,2,5,30,32,-2,-6.25
89,2,6,165,64,101,157.8125
89,2,7,222,128,94,73.4375
89,2,8,85,256,-171,-66.796875
89,2,9,1092,512,580,113.28125
89,2,10,87,1024,-937,-91.50390625
89,2,11,4682,2048,2634,128.61328125
89,2,12,3065,4096,-1031,-25.1708984375
89,2,13,2218,8192,-5974,-72.9248046875
89,2,14,21476,16384,5092,31.0791015625
89,2,15,72626,32768,39858,121.636962890625
89,3,1,0,2,-2,-100.0
89,3,2,7,4,3,75.0
89,3,3,2,8,-6,-75.0
89,3,4,6,16,-10,-62.5
89,3,5,4,32,-28,-87.5
89,3,6,26,64,-38,-59.375
89,3,7,143,128,15,11.71875
89,3,8,57,256,-199,-77.734375
89,3,9,264,512,-248,-48.4375
89,3,10,106,1024,-918,-89.6484375
89,3,11,4629,2048,2581,126.025390625
89,3,12,378,4096,-3718,-90.771484375
89,3,13,21011,8192,12819,156.48193359375
89,3,14,13036,16384,-3348,-20.4345703125
89,3,15,12891,32768,-19877,-60.6597900390625
89,4,1,0,2,-2,-100.0
89,4,2,2,4,-2,-50.0
89,4,3,10,8,2,25.0
89,4,4,14,16,-2,-12.5
89,4,5,10,32,-22,-68.75
89,4,6,19,64,-45,-70.3125
89,4,7,54,128,-74,-57.8125
89,4,8,43,256,-213,-83.203125
89,4,9,600,512,88,17.1875
89,4,10,320,1024,-704,-68.75
89,4,11,5615,2048,3567,174.169921875
89,4,12,889,4096,-3207,-78.2958984375
89,4,13,622,8192,-7570,-92.4072265625
89,4,14,26173,16384,9789,59.747314453125
89,4,15,4511,32768,-28257,-86.2335205078125
89,5,1,0,2,-2,-100.0
89,5,2,1,4,-3,-75.0
89,5,3,4,8,-4,-50.0
89,5,4,11,16,-5,-31.25
89,5,5,4,32,-28,-87.5
89,5,6,149,64,85,132.8125
89,5,7,294,128,166,129.6875
89,5,8,253,256,-3,-1.171875
89,5,9,69,512,-443,-86.5234375
89,5,10,886,1024,-138,-13.4765625
89,5,11,878,2048,-1170,-57.12890625
89,5,12,5421,4096,1325,32.3486328125
89,5,13,6840,8192,-1352,-16.50390625
89,5,14,4921,16384,-11463,-69.964599609375
89,5,15,46646,32768,13878,42.352294921875
89,6,1,0,2,-2,-100.0
89,6,2,1,4,-3,-75.0
89,6,3,6,8,-2,-25.0
89,6,4,19,16,3,18.75
89,6,5,11,32,-21,-65.625
89,6,6,18,64,-46,-71.875
89,6,7,86,128,-42,-32.8125
89,6,8,282,256,26,10.15625
89,6,9,184,512,-328,-64.0625
89,6,10,260,1024,-764,-74.609375
89,6,11,852,2048,-1196,-58.3984375
89,6,12,472,4096,-3624,-88.4765625
89,6,13,14249,8192,6057,73.93798828125
89,6,14,23937,16384,7553,46.099853515625
89,6,15,43652,32768,10884,33.21533203125
89,7,1,0,2,-2,-100.0
89,7,2,1,4,-3,-75.0
89,7,3,14,8,6,75.0
89,7,4,6,16,-10,-62.5
89,7,5,8,32,-24,-75.0
89,7,6,6,64,-58,-90.625
89,7,7,340,128,212,165.625
89,7,8,127,256,-129,-50.390625
89,7,9,240,512,-272,-53.125
89,7,10,1790,1024,766,74.8046875
89,7,11,3143,2048,1095,53.466796875
89,7,12,3366,4096,-730,-17.822265625
89,7,13,6784,8192,-1408,-17.1875
89,7,14,6342,16384,-10042,-61.29150390625
89,7,15,34365,32768,1597,4.8736572265625
89,8,1,0,2,-2,-100.0
89,8,2,1,4,-3,-75.0
89,8,3,4,8,-4,-50.0
89,8,4,34,16,18,112.5
89,8,5,17,32,-15,-46.875
89,8,6,64,64,0,0.0
89,8,7,133,128,5,3.90625
89,8,8,15,256,-241,-94.140625
89,8,9,1881,512,1369,267.3828125
89,8,10,419,1024,-605,-59.08203125
89,8,11,1913,2048,-135,-6.591796875
89,8,12,14789,4096,10693,261.0595703125
89,8,13,95,8192,-8097,-98.84033203125
89,8,14,1624,16384,-14760,-90.087890625
89,8,15,97895,32768,65127,198.7518310546875
89,9,1,0,2,-2,-100.0
89,9,2,4,4,0,0.0
89,9,3,5,8,-3,-37.5
89,9,4,25,16,9,56.25
89,9,5,32,32,0,0.0
89,9,6,82,64,18,28.125
89,9,7,25,128,-103,-80.46875
89,9,8,154,256,-102,-39.84375
89,9,9,230,512,-282,-55.078125
89,9,10,34,1024,-990,-96.6796875
89,9,11,2665,2048,617,30.126953125
89,9,12,3606,4096,-490,-11.962890625
89,9,13,8288,8192,96,1.171875
89,9,14,12973,16384,-3411,-20.819091796875
89,9,15,16685,32768,-16083,-49.0814208984375
89,10,1,0,2,-2,-100.0
89,10,2,4,4,0,0.0
89,10,3,4,8,-4,-50.0
89,10,4,23,16,7,43.75
89,10,5,10,32,-22,-68.75
89,10,6,142,64,78,121.875
89,10,7,35,128,-93,-72.65625
89,10,8,530,256,274,107.03125
89,10,9,1066,512,554,108.203125
89,10,10,474,1024,-550,-53.7109375
89,10,11,304,2048,-1744,-85.15625
89,10,12,23087,4096,18991,463.6474609375
89,10,13,3110,8192,-5082,-62.0361328125
89,10,14,40928,16384,24544,149.8046875
89,10,15,2771,32768,-29997,-91.5435791015625
89,11,1,0,2,-2,-100.0
89,11,2,4,4,0,0.0
89,11,3,4,8,-4,-50.0
89,11,4,11,16,-5,-31.25
89,11,5,40,32,8,25.0
89,11,6,17,64,-47,-73.4375
89,11,7,50,128,-78,-60.9375
89,11,8,499,256,243,94.921875
89,11,9,349,512,-163,-31.8359375
89,11,10,1888,1024,864,84.375
89,11,11,3383,2048,1335,65.185546875
89,11,12,2790,4096,-1306,-31.884765625
89,11,13,1935,8192,-6257,-76.37939453125
89,11,14,23036,16384,6652,40.6005859375
89,11,15,88195,32768,55427,169.1497802734375
89,12,1,0,2,-2,-100.0
89,12,2,4,4,0,0.0
89,12,3,12,8,4,50.0
89,12,4,16,16,0,0.0
89,12,5,168,32,136,425.0
89,12,6,20,64,-44,-68.75
89,12,7,10,128,-118,-92.1875
89,12,8,129,256,-127,-49.609375
89,12,9,283,512,-229,-44.7265625
89,12,10,194,1024,-830,-81.0546875
89,12,11,2792,2048,744,36.328125
89,12,12,6886,4096,2790,68.115234375
89,12,13,1608,8192,-6584,-80.37109375
89,12,14,8801,16384,-7583,-46.282958984375
89,12,15,1788,32768,-30980,-94.54345703125
89,13,1,0,2,-2,-100.0
89,13,2,2,4,-2,-50.0
89,13,3,8,8,0,0.0
89,13,4,3,16,-13,-81.25
89,13,5,15,32,-17,-53.125
89,13,6,77,64,13,20.3125
89,13,7,127,128,-1,-0.78125
89,13,8,217,256,-39,-15.234375
89,13,9,20,512,-492,-96.09375
89,13,10,922,1024,-102,-9.9609375
89,13,11,437,2048,-1611,-78.662109375
89,13,12,6216,4096,2120,51.7578125
89,13,13,15314,8192,7122,86.9384765625
89,13,14,8610,16384,-7774,-47.44873046875
89,13,15,5862,32768,-26906,-82.110595703125
89,14,1,0,2,-2,-100.0
89,14,2,4,4,0,0.0
89,14,3,5,8,-3,-37.5
89,14,4,3,16,-13,-81.25
89,14,5,9,32,-23,-71.875
89,14,6,18,64,-46,-71.875
89,14,7,32,128,-96,-75.0
89,14,8,30,256,-226,-88.28125
89,14,9,647,512,135,26.3671875
89,14,10,1372,1024,348,33.984375
89,14,11,228,2048,-1820,-88.8671875
89,14,12,537,4096,-3559,-86.8896484375
89,14,13,5148,8192,-3044,-37.158203125
89,14,14,24181,16384,7797,47.589111328125
89,14,15,4560,32768,-28208,-86.083984375
89,15,1,0,2,-2,-100.0
89,15,2,2,4,-2,-50.0
89,15,3,8,8,0,0.0
89,15,4,30,16,14,87.5
89,15,5,36,32,4,12.5
89,15,6,16,64,-48,-75.0
89,15,7,41,128,-87,-67.96875
89,15,8,366,256,110,42.96875
89,15,9,518,512,6,1.171875
89,15,10,1182,1024,158,15.4296875
89,15,11,1259,2048,-789,-38.525390625
89,15,12,891,4096,-3205,-78.2470703125
89,15,13,590,8192,-7602,-92.7978515625
89,15,14,16590,16384,206,1.25732421875
89,15,15,133271,32768,100503,306.7108154296875
89,16,1,0,2,-2,-100.0
89,16,2,1,4,-3,-75.0
89,16,3,11,8,3,37.5
89,16,4,34,16,18,112.5
89,16,5,12,32,-20,-62.5
89,16,6,16,64,-48,-75.0
89,16,7,290,128,162,126.5625
89,16,8,900,256,644,251.5625
89,16,9,1915,512,1403,274.0234375
89,16,10,1564,1024,540,52.734375
89,16,11,115,2048,-1933,-94.384765625
89,16,12,4248,4096,152,3.7109375
89,16,13,3858,8192,-4334,-52.9052734375
89,16,14,14625,16384,-1759,-10.736083984375
89,16,15,7422,32768,-25346,-77.349853515625
89,17,1,0,2,-2,-100.0
89,17,2,2,4,-2,-50.0
89,17,3,22,8,14,175.0
89,17,4,3,16,-13,-81.25
89,17,5,40,32,8,25.0
89,17,6,71,64,7,10.9375
89,17,7,291,128,163,127.34375
89,17,8,708,256,452,176.5625
89,17,9,889,512,377,73.6328125
89,17,10,2185,1024,1161,113.37890625
89,17,11,103,2048,-1945,-94.970703125
89,17,12,1675,4096,-2421,-59.1064453125
89,17,13,3207,8192,-4985,-60.85205078125
89,17,14,2289,16384,-14095,-86.029052734375
89,17,15,3264,32768,-29504,-90.0390625
89,18,1,0,2,-2,-100.0
89,18,2,3,4,-1,-25.0
89,18,3,3,8,-5,-62.5
89,18,4,17,16,1,6.25
89,18,5,46,32,14,43.75
89,18,6,32,64,-32,-50.0
89,18,7,368,128,240,187.5
89,18,8,31,256,-225,-87.890625
89,18,9,117,512,-395,-77.1484375
89,18,10,478,1024,-546,-53.3203125
89,18,11,838,2048,-1210,-59.08203125
89,18,12,2055,4096,-2041,-49.8291015625
89,18,13,9879,8192,1687,20.59326171875
89,18,14,25849,16384,9465,57.769775390625
89,18,15,2445,32768,-30323,-92.5384521484375
89,19,1,0,2,-2,-100.0
89,19,2,1,4,-3,-75.0
89,19,3,5,8,-3,-37.5
89,19,4,14,16,-2,-12.5
89,19,5,18,32,-14,-43.75
89,19,6,50,64,-14,-21.875
89,19,7,326,128,198,154.6875
89,19,8,87,256,-169,-66.015625
89,19,9,1201,512,689,134.5703125
89,19,10,1569,1024,545,53.22265625
89,19,11,658,2048,-1390,-67.87109375
89,19,12,466,4096,-3630,-88.623046875
89,19,13,17561,8192,9369,114.36767578125
89,19,14,6243,16384,-10141,-61.895751953125
89,19,15,77845,32768,45077,137.5640869140625
89,20,1,0,2,-2,-100.0
89,20,2,1,4,-3,-75.0
89,20,3,6,8,-2,-25.0
89,20,4,8,16,-8,-50.0
89,20,5,32,32,0,0.0
89,20,6,79,64,15,23.4375
89,20,7,60,128,-68,-53.125
89,20,8,19,256,-237,-92.578125
89,20,9,398,512,-114,-22.265625
89,20,10,3007,1024,1983,193.65234375
89,20,11,6215,2048,4167,203.466796875
89,20,12,1691,4096,-2405,-58.7158203125
89,20,13,23511,8192,15319,186.99951171875
89,20,14,3955,16384,-12429,-75.860595703125
89,20,15,5248,32768,-27520,-83.984375
89,21,1,0,2,-2,-100.0
89,21,2,1,4,-3,-75.0
89,21,3,2,8,-6,-75.0
89,21,4,25,16,9,56.25
89,21,5,12,32,-20,-62.5
89,21,6,58,64,-6,-9.375
89,21,7,120,128,-8,-6.25
89,21,8,232,256,-24,-9.375
89,21,9,171,512,-341,-66.6015625
89,21,10,540,1024,-484,-47.265625
89,21,11,168,2048,-1880,-91.796875
89,21,12,2056,4096,-2040,-49.8046875
89,21,13,2920,8192,-5272,-64.35546875
89,21,14,5641,16384,-10743,-65.570068359375
89,21,15,2702,32768,-30066,-91.754150390625
89,22,1,0,2,-2,-100.0
89,22,2,2,4,-2,-50.0
89,22,3,3,8,-5,-62.5
89,22,4,20,16,4,25.0
89,22,5,9,32,-23,-71.875
89,22,6,11,64,-53,-82.8125
89,22,7,11,128,-117,-91.40625
89,22,8,243,256,-13,-5.078125
89,22,9,315,512,-197,-38.4765625
89,22,10,2119,1024,1095,106.93359375
89,22,11,5048,2048,3000,146.484375
89,22,12,12745,4096,8649,211.1572265625
89,22,13,7853,8192,-339,-4.13818359375
89,22,14,17156,16384,772,4.7119140625
89,22,15,237775,32768,205007,625.6317138671875
89,23,1,0,2,-2,-100.0
89,23,2,1,4,-3,-75.0
89,23,3,5,8,-3,-37.5
89,23,4,16,16,0,0.0
89,23,5,22,32,-10,-31.25
89,23,6,11,64,-53,-82.8125
89,23,7,208,128,80,62.5
89,23,8,147,256,-109,-42.578125
89,23,9,167,512,-345,-67.3828125
89,23,10,953,1024,-71,-6.93359375
89,23,11,1798,2048,-250,-12.20703125
89,23,12,6660,4096,2564,62.59765625
89,23,13,52,8192,-8140,-99.365234375
89,23,14,6028,16384,-10356,-63.2080078125
89,23,15,55225,32768,22457,68.5333251953125
89,24,1,0,2,-2,-100.0
89,24,2,1,4,-3,-75.0
89,24,3,16,8,8,100.0
89,24,4,37,16,21,131.25
89,24,5,88,32,56,175.0
89,24,6,84,64,20,31.25
89,24,7,42,128,-86,-67.1875
89,24,8,357,256,101,39.453125
89,24,9,678,512,166,32.421875
89,24,10,3217,1024,2193,214.16015625
89,24,11,29,2048,-2019,-98.583984375
89,24,12,6015,4096,1919,46.8505859375
89,24,13,6571,8192,-1621,-19.78759765625
89,24,14,5570,16384,-10814,-66.00341796875
89,24,15,19840,32768,-12928,-39.453125
89,25,1,0,2,-2,-100.0
89,25,2,3,4,-1,-25.0
89,25,3,2,8,-6,-75.0
89,25,4,25,16,9,56.25
89,25,5,46,32,14,43.75
89,25,6,49,64,-15,-23.4375
89,25,7,24,128,-104,-81.25
89,25,8,199,256,-57,-22.265625
89,25,9,554,512,42,8.203125
89,25,10,34,1024,-990,-96.6796875
89,25,11,2293,2048,245,11.962890625
89,25,12,7017,4096,2921,71.3134765625
89,25,13,7552,8192,-640,-7.8125
89,25,14,8037,16384,-8347,-50.946044921875
89,25,15,11174,32768,-21594,-65.899658203125
89,26,1,0,2,-2,-100.0
89,26,2,2,4,-2,-50.0
89,26,3,7,8,-1,-12.5
89,26,4,11,16,-5,-31.25
89,26,5,91,32,59,184.375
89,26,6,11,64,-53,-82.8125
89,26,7,11,128,-117,-91.40625
89,26,8,320,256,64,25.0
89,26,9,548,512,36,7.03125
89,26,10,1966,1024,942,91.9921875
89,26,11,1886,2048,-162,-7.91015625
89,26,12,3489,4096,-607,-14.8193359375
89,26,13,7380,8192,-812,-9.912109375
89,26,14,23595,16384,7211,44.012451171875
89,26,15,23661,32768,-9107,-27.7923583984375
89,27,1,0,2,-2,-100.0
89,27,2,1,4,-3,-75.0
89,27,3,12,8,4,50.0
89,27,4,3,16,-13,-81.25
89,27,5,6,32,-26,-81.25
89,27,6,8,64,-56,-87.5
89,27,7,76,128,-52,-40.625
89,27,8,314,256,58,22.65625
89,27,9,610,512,98,19.140625
89,27,10,528,1024,-496,-48.4375
89,27,11,215,2048,-1833,-89.501953125
89,27,12,7714,4096,3618,88.330078125
89,27,13,18949,8192,10757,131.31103515625
89,27,14,1355,16384,-15029,-91.729736328125
89,27,15,68105,32768,35337,107.8399658203125
89,28,1,0,2,-2,-100.0
89,28,2,1,4,-3,-75.0
89,28,3,2,8,-6,-75.0
89,28,4,4,16,-12,-75.0
89,28,5,17,32,-15,-46.875
89,28,6,10,64,-54,-84.375
89,28,7,129,128,1,0.78125
89,28,8,42,256,-214,-83.59375
89,28,9,231,512,-281,-54.8828125
89,28,10,845,1024,-179,-17.48046875
89,28,11,598,2048,-1450,-70.80078125
89,28,12,18844,4096,14748,360.05859375
89,28,13,6067,8192,-2125,-25.93994140625
89,28,14,4763,16384,-11621,-70.928955078125
89,28,15,45151,32768,12383,37.7899169921875
89,29,1,0,2,-2,-100.0
89,29,2,6,4,2,50.0
89,29,3,4,8,-4,-50.0
89,29,4,17,16,1,6.25
89,29,5,4,32,-28,-87.5
89,29,6,88,64,24,37.5
89,29,7,146,128,18,14.0625
89,29,8,98,256,-158,-61.71875
89,29,9,284,512,-228,-44.53125
89,29,10,1395,1024,371,36.23046875
89,29,11,148,2048,-1900,-92.7734375
89,29,12,942,4096,-3154,-77.001953125
89,29,13,4946,8192,-3246,-39.6240234375
89,29,14,6888,16384,-9496,-57.958984375
89,29,15,6380,32768,-26388,-80.52978515625
89,30,1,0,2,-2,-100.0
89,30,2,1,4,-3,-75.0
89,30,3,13,8,5,62.5
89,30,4,11,16,-5,-31.25
89,30,5,6,32,-26,-81.25
89,30,6,109,64,45,70.3125
89,30,7,130,128,2,1.5625
89,30,8,607,256,351,137.109375
89,30,9,476,512,-36,-7.03125
89,30,10,1314,1024,290,28.3203125
89,30,11,10,2048,-2038,-99.51171875
89,30,12,7312,4096,3216,78.515625
89,30,13,5234,8192,-2958,-36.1083984375
89,30,14,663,16384,-15721,-95.953369140625
89,30,15,51589,32768,18821,57.4371337890625
89,31,1,0,2,-2,-100.0
89,31,2,1,4,-3,-75.0
89,31,3,2,8,-6,-75.0
89,31,4,6,16,-10,-62.5
89,31,5,37,32,5,15.625
89,31,6,25,64,-39,-60.9375
89,31,7,298,128,170,132.8125
89,31,8,112,256,-144,-56.25
89,31,9,1014,512,502,98.046875
89,31,10,183,1024,-841,-82.12890625
89,31,11,187,2048,-1861,-90.869140625
89,31,12,2248,4096,-1848,-45.1171875
89,31,13,5920,8192,-2272,-27.734375
89,31,14,12943,16384,-3441,-21.002197265625
89,31,15,14385,32768,-18383,-56.1004638671875
89,32,1,0,2,-2,-100.0
89,32,2,3,4,-1,-25.0
89,32,3,2,8,-6,-75.0
89,32,4,10,16,-6,-37.5
89,32,5,10,32,-22,-68.75
89,32,6,99,64,35,54.6875
89,32,7,110,128,-18,-14.0625
89,32,8,114,256,-142,-55.46875
89,32,9,991,512,479,93.5546875
89,32,10,1646,1024,622,60.7421875
89,32,11,794,2048,-1254,-61.23046875
89,32,12,1957,4096,-2139,-52.2216796875
89,32,13,4431,8192,-3761,-45.91064453125
89,32,14,6323,16384,-10061,-61.407470703125
89,32,15,9849,32768,-22919,-69.9432373046875
89,33,1,0,2,-2,-100.0
89,33,2,2,4,-2,-50.0
89,33,3,2,8,-6,-75.0
89,33,4,19,16,3,18.75
89,33,5,16,32,-16,-50.0
89,33,6,6,64,-58,-90.625
89,33,7,18,128,-110,-85.9375
89,33,8,302,256,46,17.96875
89,33,9,210,512,-302,-58.984375
89,33,10,412,1024,-612,-59.765625
89,33,11,8466,2048,6418,313.37890625
89,33,12,5626,4096,1530,37.353515625
89,33,13,6082,8192,-2110,-25.7568359375
89,33,14,11336,16384,-5048,-30.810546875
89,33,15,17630,32768,-15138,-46.197509765625
89,34,1,0,2,-2,-100.0
89,34,2,1,4,-3,-75.0
89,34,3,3,8,-5,-62.5
89,34,4,3,16,-13,-81.25
89,34,5,46,32,14,43.75
89,34,6,56,64,-8,-12.5
89,34,7,90,128,-38,-29.6875
89,34,8,87,256,-169,-66.015625
89,34,9,965,512,453,88.4765625
89,34,10,1243,1024,219,21.38671875
89,34,11,49,2048,-1999,-97.607421875
89,34,12,824,4096,-3272,-79.8828125
89,34,13,4746,8192,-3446,-42.0654296875
89,34,14,18895,16384,2511,15.325927734375
89,34,15,88289,32768,55521,169.4366455078125
89,35,1,0,2,-2,-100.0
89,35,2,1,4,-3,-75.0
89,35,3,2,8,-6,-75.0
89,35,4,41,16,25,156.25
89,35,5,23,32,-9,-28.125
89,35,6,8,64,-56,-87.5
89,35,7,53,128,-75,-58.59375
89,35,8,35,256,-221,-86.328125
89,35,9,657,512,145,28.3203125
89,35,10,1573,1024,549,53.61328125
89,35,11,363,2048,-1685,-82.275390625
89,35,12,5328,4096,1232,30.078125
89,35,13,19413,8192,11221,136.97509765625
89,35,14,38629,16384,22245,135.772705078125
89,35,15,31181,32768,-1587,-4.8431396484375
89,36,1,0,2,-2,-100.0
89,36,2,1,4,-3,-75.0
89,36,3,7,8,-1,-12.5
89,36,4,3,16,-13,-81.25
89,36,5,5,32,-27,-84.375
89,36,6,14,64,-50,-78.125
89,36,7,116,128,-12,-9.375
89,36,8,158,256,-98,-38.28125
89,36,9,446,512,-66,-12.890625
89,36,10,2271,1024,1247,121.77734375
89,36,11,4306,2048,2258,110.25390625
89,36,12,920,4096,-3176,-77.5390625
89,36,13,3225,8192,-4967,-60.63232421875
89,36,14,3450,16384,-12934,-78.94287109375
89,36,15,74253,32768,41485,126.6021728515625
89,37,1,0,2,-2,-100.0
89,37,2,2,4,-2,-50.0
89,37,3,12,8,4,50.0
89,37,4,8,16,-8,-50.0
89,37,5,19,32,-13,-40.625
89,37,6,82,64,18,28.125
89,37,7,22,128,-106,-82.8125
89,37,8,254,256,-2,-0.78125
89,37,9,1788,512,1276,249.21875
89,37,10,2499,1024,1475,144.04296875
89,37,11,7621,2048,5573,272.119140625
89,37,12,3912,4096,-184,-4.4921875
89,37,13,18440,8192,10248,125.09765625
89,37,14,43932,16384,27548,168.1396484375
89,37,15,57397,32768,24629,75.1617431640625
89,38,1,0,2,-2,-100.0
89,38,2,5,4,1,25.0
89,38,3,2,8,-6,-75.0
89,38,4,51,16,35,218.75
89,38,5,19,32,-13,-40.625
89,38,6,6,64,-58,-90.625
89,38,7,320,128,192,150.0
89,38,8,68,256,-188,-73.4375
89,38,9,438,512,-74,-14.453125
89,38,10,895,1024,-129,-12.59765625
89,38,11,1722,2048,-326,-15.91796875
89,38,12,1313,4096,-2783,-67.9443359375
89,38,13,627,8192,-7565,-92.34619140625
89,38,14,1459,16384,-14925,-91.094970703125
89,38,15,3192,32768,-29576,-90.2587890625
89,39,1,0,2,-2,-100.0
89,39,2,7,4,3,75.0
89,39,3,2,8,-6,-75.0
89,39,4,11,16,-5,-31.25
89,39,5,29,32,-3,-9.375
89,39,6,208,64,144,225.0
89,39,7,103,128,-25,-19.53125
89,39,8,27,256,-229,-89.453125
89,39,9,2650,512,2138,417.578125
89,39,10,685,1024,-339,-33.10546875
89,39,11,1527,2048,-521,-25.439453125
89,39,12,5354,4096,1258,30.712890625
89,39,13,19915,8192,11723,143.10302734375
89,39,14,8820,16384,-7564,-46.1669921875
89,39,15,5870,32768,-26898,-82.086181640625
89,40,1,0,2,-2,-100.0
89,40,2,2,4,-2,-50.0
89,40,3,8,8,0,0.0
89,40,4,4,16,-12,-75.0
89,40,5,53,32,21,65.625
89,40,6,27,64,-37,-57.8125
89,40,7,15,128,-113,-88.28125
89,40,8,372,256,116,45.3125
89,40,9,992,512,480,93.75
89,40,10,476,1024,-548,-53.515625
89,40,11,1121,2048,-927,-45.263671875
89,40,12,1756,4096,-2340,-57.12890625
89,40,13,6196,8192,-1996,-24.365234375
89,40,14,23234,16384,6850,41.80908203125
89,40,15,30140,32768,-2628,-8.02001953125
89,41,1,0,2,-2,-100.0
89,41,2,1,4,-3,-75.0
89,41,3,9,8,1,12.5
89,41,4,5,16,-11,-68.75
89,41,5,23,32,-9,-28.125
89,41,6,41,64,-23,-35.9375
89,41,7,345,128,217,169.53125
89,41,8,36,256,-220,-85.9375
89,41,9,235,512,-277,-54.1015625
89,41,10,625,1024,-399,-38.96484375
89,41,11,1242,2048,-806,-39.35546875
89,41,12,11866,4096,7770,189.697265625
89,41,13,736,8192,-7456,-91.015625
89,41,14,19208,16384,2824,17.236328125
89,41,15,7270,32768,-25498,-77.813720703125
89,42,1,0,2,-2,-100.0
89,42,2,2,4,-2,-50.0
89,42,3,11,8,3,37.5
89,42,4,11,16,-5,-31.25
89,42,5,34,32,2,6.25
89,42,6,52,64,-12,-18.75
89,42,7,11,128,-117,-91.40625
89,42,8,72,256,-184,-71.875
89,42,9,86,512,-426,-83.203125
89,42,10,3031,1024,2007,195.99609375
89,42,11,1627,2048,-421,-20.556640625
89,42,12,7090,4096,2994,73.095703125
89,42,13,28152,8192,19960,243.65234375
89,42,14,25661,16384,9277,56.622314453125
89,42,15,52802,32768,20034,61.138916015625
89,43,1,0,2,-2,-100.0
89,43,2,3,4,-1,-25.0
89,43,3,2,8,-6,-75.0
89,43,4,6,16,-10,-62.5
89,43,5,19,32,-13,-40.625
89,43,6,70,64,6,9.375
89,43,7,237,128,109,85.15625
89,43,8,215,256,-41,-16.015625
89,43,9,863,512,351,68.5546875
89,43,10,410,1024,-614,-59.9609375
89,43,11,2397,2048,349,17.041015625
89,43,12,1454,4096,-2642,-64.501953125
89,43,13,8442,8192,250,3.0517578125
89,43,14,14591,16384,-1793,-10.943603515625
89,43,15,1145,32768,-31623,-96.5057373046875
89,44,1,0,2,-2,-100.0
89,44,2,1,4,-3,-75.0
89,44,3,19,8,11,137.5
89,44,4,52,16,36,225.0
89,44,5,13,32,-19,-59.375
89,44,6,22,64,-42,-65.625
89,44,7,49,128,-79,-61.71875
89,44,8,7,256,-249,-97.265625
89,44,9,30,512,-482,-94.140625
89,44,10,497,1024,-527,-51.46484375
89,44,11,2185,2048,137,6.689453125
89,44,12,5327,4096,1231,30.0537109375
89,44,13,2330,8192,-5862,-71.5576171875
89,44,14,27793,16384,11409,69.635009765625
89,44,15,95254,32768,62486,190.692138671875
89,45,1,0,2,-2,-100.0
89,45,2,3,4,-1,-25.0
89,45,3,4,8,-4,-50.0
89,45,4,39,16,23,143.75
89,45,5,93,32,61,190.625
89,45,6,78,64,14,21.875
89,45,7,49,128,-79,-61.71875
89,45,8,474,256,218,85.15625
89,45,9,1024,512,512,100.0
89,45,10,756,1024,-268,-26.171875
89,45,11,3623,2048,1575,76.904296875
89,45,12,5323,4096,1227,29.9560546875
89,45,13,16632,8192,8440,103.02734375
89,45,14,4695,16384,-11689,-71.343994140625
89,45,15,68561,32768,35793,109.2315673828125
89,46,1,0,2,-2,-100.0
89,46,2,1,4,-3,-75.0
89,46,3,8,8,0,0.0
89,46,4,3,16,-13,-81.25
89,46,5,22,32,-10,-31.25
89,46,6,143,64,79,123.4375
89,46,7,255,128,127,99.21875
89,46,8,24,256,-232,-90.625
89,46,9,173,512,-339,-66.2109375
89,46,10,461,1024,-563,-54.98046875
89,46,11,2155,2048,107,5.224609375
89,46,12,2986,4096,-1110,-27.099609375
89,46,13,30874,8192,22682,276.8798828125
89,46,14,10233,16384,-6151,-37.542724609375
89,46,15,23052,32768,-9716,-29.65087890625
89,47,1,0,2,-2,-100.0
89,47,2,1,4,-3,-75.0
89,47,3,4,8,-4,-50.0
89,47,4,7,16,-9,-56.25
89,47,5,26,32,-6,-18.75
89,47,6,101,64,37,57.8125
89,47,7,361,128,233,182.03125
89,47,8,168,256,-88,-34.375
89,47,9,1067,512,555,108.3984375
89,47,10,2836,1024,1812,176.953125
89,47,11,630,2048,-1418,-69.23828125
89,47,12,1499,4096,-2597,-63.4033203125
89,47,13,7941,8192,-251,-3.06396484375
89,47,14,16526,16384,142,0.86669921875
89,47,15,13522,32768,-19246,-58.734130859375
89,48,1,0,2,-2,-100.0
89,48,2,1,4,-3,-75.0
89,48,3,4,8,-4,-50.0
89,48,4,6,16,-10,-62.5
89,48,5,120,32,88,275.0
89,48,6,168,64,104,162.5
89,48,7,54,128,-74,-57.8125
89,48,8,255,256,-1,-0.390625
89,48,9,683,512,171,33.3984375
89,48,10,914,1024,-110,-10.7421875
89,48,11,2297,2048,249,12.158203125
89,48,12,6593,4096,2497,60.9619140625
89,48,13,3580,8192,-4612,-56.298828125
89,48,14,24130,16384,7746,47.27783203125
89,48,15,19622,32768,-13146,-40.118408203125
89,49,1,0,2,-2,-100.0
89,49,2,1,4,-3,-75.0
89,49,3,2,8,-6,-75.0
89,49,4,19,16,3,18.75
89,49,5,64,32,32,100.0
89,49,6,13,64,-51,-79.6875
89,49,7,252,128,124,96.875
89,49,8,337,256,81,31.640625
89,49,9,709,512,197,38.4765625
89,49,10,162,1024,-862,-84.1796875
89,49,11,1674,2048,-374,-18.26171875
89,49,12,3262,4096,-834,-20.361328125
89,49,13,6782,8192,-1410,-17.2119140625
89,49,14,18815,16384,2431,14.837646484375
89,49,15,6640,32768,-26128,-79.736328125
89,50,1,0,2,-2,-100.0
89,50,2,2,4,-2,-50.0
89,50,3,8,8,0,0.0
89,50,4,3,16,-13,-81.25
89,50,5,34,32,2,6.25
89,50,6,13,64,-51,-79.6875
89,50,7,102,128,-26,-20.3125
89,50,8,257,256,1,0.390625
89,50,9,112,512,-400,-78.125
89,50,10,1357,1024,333,32.51953125
89,50,11,184,2048,-1864,-91.015625
89,50,12,1249,4096,-2847,-69.5068359375
89,50,13,15831,8192,7639,93.24951171875
89,50,14,2206,16384,-14178,-86.53564453125
89,50,15,25185,32768,-7583,-23.1414794921875
89,51,1,0,2,-2,-100.0
89,51,2,1,4,-3,-75.0
89,51,3,5,8,-3,-37.5
89,51,4,17,16,1,6.25
89,51,5,54,32,22,68.75
89,51,6,62,64,-2,-3.125
89,51,7,67,128,-61,-47.65625
89,51,8,29,256,-227,-88.671875
89,51,9,1221,512,709,138.4765625
89,51,10,326,1024,-698,-68.1640625
89,51,11,397,2048,-1651,-80.615234375
89,51,12,5809,4096,1713,41.8212890625
89,51,13,2502,8192,-5690,-69.4580078125
89,51,14,1750,16384,-14634,-89.31884765625
89,51,15,2014,32768,-30754,-93.853759765625
89,52,1,0,2,-2,-100.0
89,52,2,1,4,-3,-75.0
89,52,3,11,8,3,37.5
89,52,4,10,16,-6,-37.5
89,52,5,59,32,27,84.375
89,52,6,13,64,-51,-79.6875
89,52,7,86,128,-42,-32.8125
89,52,8,97,256,-159,-62.109375
89,52,9,522,512,10,1.953125
89,52,10,590,1024,-434,-42.3828125
89,52,11,813,2048,-1235,-60.302734375
89,52,12,30,4096,-4066,-99.267578125
89,52,13,32489,8192,24297,296.59423828125
89,52,14,25230,16384,8846,53.99169921875
89,52,15,1273,32768,-31495,-96.1151123046875
89,53,1,0,2,-2,-100.0
89,53,2,1,4,-3,-75.0
89,53,3,14,8,6,75.0
89,53,4,37,16,21,131.25
89,53,5,25,32,-7,-21.875
89,53,6,66,64,2,3.125
89,53,7,345,128,217,169.53125
89,53,8,90,256,-166,-64.84375
89,53,9,270,512,-242,-47.265625
89,53,10,429,1024,-595,-58.10546875
89,53,11,1278,2048,-770,-37.59765625
89,53,12,4589,4096,493,12.0361328125
89,53,13,4409,8192,-3783,-46.17919921875
89,53,14,1191,16384,-15193,-92.730712890625
89,53,15,35018,32768,2250,6.866455078125
89,54,1,0,2,-2,-100.0
89,54,2,2,4,-2,-50.0
89,54,3,9,8,1,12.5
89,54,4,4,16,-12,-75.0
89,54,5,43,32,11,34.375
89,54,6,27,64,-37,-57.8125
89,54,7,56,128,-72,-56.25
89,54,8,106,256,-150,-58.59375
89,54,9,114,512,-398,-77.734375
89,54,10,1487,1024,463,45.21484375
89,54,11,4538,2048,2490,121.58203125
89,54,12,4020,4096,-76,-1.85546875
89,54,13,1452,8192,-6740,-82.275390625
89,54,14,52466,16384,36082,220.22705078125
89,54,15,20988,32768,-11780,-35.94970703125
89,55,1,0,2,-2,-100.0
89,55,2,1,4,-3,-75.0
89,55,3,3,8,-5,-62.5
89,55,4,5,16,-11,-68.75
89,55,5,41,32,9,28.125
89,55,6,74,64,10,15.625
89,55,7,151,128,23,17.96875
89,55,8,137,256,-119,-46.484375
89,55,9,81,512,-431,-84.1796875
89,55,10,2423,1024,1399,136.62109375
89,55,11,7722,2048,5674,277.05078125
89,55,12,2953,4096,-1143,-27.9052734375
89,55,13,3011,8192,-5181,-63.24462890625
89,55,14,5483,16384,-10901,-66.534423828125
89,55,15,31683,32768,-1085,-3.3111572265625
89,56,1,0,2,-2,-100.0
89,56,2,2,4,-2,-50.0
89,56,3,5,8,-3,-37.5
89,56,4,21,16,5,31.25
89,56,5,62,32,30,93.75
89,56,6,10,64,-54,-84.375
89,56,7,48,128,-80,-62.5
89,56,8,796,256,540,210.9375
89,56,9,996,512,484,94.53125
89,56,10,1361,1024,337,32.91015625
89,56,11,145,2048,-1903,-92.919921875
89,56,12,747,4096,-3349,-81.7626953125
89,56,13,2304,8192,-5888,-71.875
89,56,14,1418,16384,-14966,-91.34521484375
89,56,15,5974,32768,-26794,-81.768798828125
89,57,1,0,2,-2,-100.0
89,57,2,3,4,-1,-25.0
89,57,3,7,8,-1,-12.5
89,57,4,15,16,-1,-6.25
89,57,5,25,32,-7,-21.875
89,57,6,5,64,-59,-92.1875
89,57,7,11,128,-117,-91.40625
89,57,8,143,256,-113,-44.140625
89,57,9,393,512,-119,-23.2421875
89,57,10,1274,1024,250,24.4140625
89,57,11,1330,2048,-718,-35.05859375
89,57,12,5234,4096,1138,27.783203125
89,57,13,1832,8192,-6360,-77.63671875
89,57,14,15838,16384,-546,-3.33251953125
89,57,15,9507,32768,-23261,-70.9869384765625
89,58,1,0,2,-2,-100.0
89,58,2,2,4,-2,-50.0
89,58,3,4,8,-4,-50.0
89,58,4,5,16,-11,-68.75
89,58,5,61,32,29,90.625
89,58,6,15,64,-49,-76.5625
89,58,7,100,128,-28,-21.875
89,58,8,291,256,35,13.671875
89,58,9,29,512,-483,-94.3359375
89,58,10,482,1024,-542,-52.9296875
89,58,11,6871,2048,4823,235.498046875
89,58,12,1207,4096,-2889,-70.5322265625
89,58,13,2802,8192,-5390,-65.7958984375
89,58,14,797,16384,-15587,-95.135498046875
89,58,15,132183,32768,99415,303.3905029296875
89,59,1,0,2,-2,-100.0
89,59,2,2,4,-2,-50.0
89,59,3,7,8,-1,-12.5
89,59,4,20,16,4,25.0
89,59,5,12,32,-20,-62.5
89,59,6,97,64,33,51.5625
89,59,7,114,128,-14,-10.9375
89,59,8,304,256,48,18.75
89,59,9,241,512,-271,-52.9296875
89,59,10,4152,1024,3128,305.46875
89,59,11,4211,2048,2163,105.615234375
89,59,12,7953,4096,3857,94.1650390625
89,59,13,230,8192,-7962,-97.1923828125
89,59,14,26527,16384,10143,61.907958984375
89,59,15,63601,32768,30833,94.0948486328125
89,60,1,0,2,-2,-100.0
89,60,2,2,4,-2,-50.0
89,60,3,19,8,11,137.5
89,60,4,27,16,11,68.75
89,60,5,27,32,-5,-15.625
89,60,6,228,64,164,256.25
89,60,7,27,128,-101,-78.90625
89,60,8,68,256,-188,-73.4375
89,60,9,30,512,-482,-94.140625
89,60,10,1657,1024,633,61.81640625
89,60,11,536,2048,-1512,-73.828125
89,60,12,1144,4096,-2952,-72.0703125
89,60,13,7989,8192,-203,-2.47802734375
89,60,14,1155,16384,-15229,-92.950439453125
89,60,15,13387,32768,-19381,-59.1461181640625
89,61,1,0,2,-2,-100.0
89,61,2,2,4,-2,-50.0
89,61,3,4,8,-4,-50.0
89,61,4,17,16,1,6.25
89,61,5,101,32,69,215.625
89,61,6,14,64,-50,-78.125
89,61,7,262,128,134,104.6875
89,61,8,61,256,-195,-76.171875
89,61,9,1679,512,1167,227.9296875
89,61,10,584,1024,-440,-42.96875
89,61,11,2801,2048,753,36.767578125
89,61,12,3193,4096,-903,-22.0458984375
89,61,13,1494,8192,-6698,-81.7626953125
89,61,14,19344,16384,2960,18.06640625
89,61,15,71515,32768,38747,118.2464599609375
89,62,1,0,2,-2,-100.0
89,62,2,7,4,3,75.0
89,62,3,19,8,11,137.5
89,62,4,11,16,-5,-31.25
89,62,5,27,32,-5,-15.625
89,62,6,8,64,-56,-87.5
89,62,7,57,128,-71,-55.46875
89,62,8,150,256,-106,-41.40625
89,62,9,1732,512,1220,238.28125
89,62,10,1303,1024,279,27.24609375
89,62,11,3268,2048,1220,59.5703125
89,62,12,1014,4096,-3082,-75.244140625
89,62,13,11551,8192,3359,41.00341796875
89,62,14,19427,16384,3043,18.572998046875
89,62,15,27666,32768,-5102,-15.570068359375
89,63,1,0,2,-2,-100.0
89,63,2,1,4,-3,-75.0
89,63,3,9,8,1,12.5
89,63,4,6,16,-10,-62.5
89,63,5,25,32,-7,-21.875
89,63,6,9,64,-55,-85.9375
89,63,7,75,128,-53,-41.40625
89,63,8,357,256,101,39.453125
89,63,9,408,512,-104,-20.3125
89,63,10,227,1024,-797,-77.83203125
89,63,11,2681,2048,633,30.908203125
89,63,12,2055,4096,-2041,-49.8291015625
89,63,13,936,8192,-7256,-88.57421875
89,63,14,37283,16384,20899,127.557373046875
89,63,15,10931,32768,-21837,-66.6412353515625
89,64,1,0,2,-2,-100.0
89,64,2,1,4,-3,-75.0
89,64,3,4,8,-4,-50.0
89,64,4,11,16,-5,-31.25
89,64,5,5,32,-27,-84.375
89,64,6,66,64,2,3.125
89,64,7,143,128,15,11.71875
89,64,8,140,256,-116,-45.3125
89,64,9,281,512,-231,-45.1171875
89,64,10,2229,1024,1205,117.67578125
89,64,11,1688,2048,-360,-17.578125
89,64,12,4301,4096,205,5.0048828125
89,64,13,21888,8192,13696,167.1875
89,64,14,19972,16384,3588,21.8994140625
89,64,15,55674,32768,22906,69.903564453125
89,65,1,0,2,-2,-100.0
89,65,2,1,4,-3,-75.0
89,65,3,9,8,1,12.5
89,65,4,4,16,-12,-75.0
89,65,5,7,32,-25,-78.125
89,65,6,32,64,-32,-50.0
89,65,7,252,128,124,96.875
89,65,8,468,256,212,82.8125
89,65,9,738,512,226,44.140625
89,65,10,35,1024,-989,-96.58203125
89,65,11,1174,2048,-874,-42.67578125
89,65,12,4812,4096,716,17.48046875
89,65,13,6232,8192,-1960,-23.92578125
89,65,14,10771,16384,-5613,-34.259033203125
89,65,15,45620,32768,12852,39.22119140625
89,66,1,0,2,-2,-100.0
89,66,2,2,4,-2,-50.0
89,66,3,2,8,-6,-75.0
89,66,4,8,16,-8,-50.0
89,66,5,49,32,17,53.125
89,66,6,62,64,-2,-3.125
89,66,7,18,128,-110,-85.9375
89,66,8,668,256,412,160.9375
89,66,9,342,512,-170,-33.203125
89,66,10,147,1024,-877,-85.64453125
89,66,11,1699,2048,-349,-17.041015625
89,66,12,276,4096,-3820,-93.26171875
89,66,13,1408,8192,-6784,-82.8125
89,66,14,5180,16384,-11204,-68.3837890625
89,66,15,1536,32768,-31232,-95.3125
89,67,1,0,2,-2,-100.0
89,67,2,2,4,-2,-50.0
89,67,3,6,8,-2,-25.0
89,67,4,23,16,7,43.75
89,67,5,5,32,-27,-84.375
89,67,6,12,64,-52,-81.25
89,67,7,225,128,97,75.78125
89,67,8,712,256,456,178.125
89,67,9,512,512,0,0.0
89,67,10,1840,1024,816,79.6875
89,67,11,7898,2048,5850,285.64453125
89,67,12,3751,4096,-345,-8.4228515625
89,67,13,7061,8192,-1131,-13.80615234375
89,67,14,14851,16384,-1533,-9.356689453125
89,67,15,6152,32768,-26616,-81.2255859375
89,68,1,0,2,-2,-100.0
89,68,2,1,4,-3,-75.0
89,68,3,11,8,3,37.5
89,68,4,18,16,2,12.5
89,68,5,88,32,56,175.0
89,68,6,95,64,31,48.4375
89,68,7,232,128,104,81.25
89,68,8,290,256,34,13.28125
89,68,9,497,512,-15,-2.9296875
89,68,10,43,1024,-981,-95.80078125
89,68,11,106,2048,-1942,-94.82421875
89,68,12,9522,4096,5426,132.470703125
89,68,13,14309,8192,6117,74.67041015625
89,68,14,196,16384,-16188,-98.8037109375
89,68,15,48903,32768,16135,49.2401123046875
89,69,1,0,2,-2,-100.0
89,69,2,1,4,-3,-75.0
89,69,3,6,8,-2,-25.0
89,69,4,15,16,-1,-6.25
89,69,5,6,32,-26,-81.25
89,69,6,17,64,-47,-73.4375
89,69,7,52,128,-76,-59.375
89,69,8,36,256,-220,-85.9375
89,69,9,480,512,-32,-6.25
89,69,10,38,1024,-986,-96.2890625
89,69,11,5143,2048,3095,151.123046875
89,69,12,5195,4096,1099,26.8310546875
89,69,13,12369,8192,4177,50.98876953125
89,69,14,8061,16384,-8323,-50.799560546875
89,69,15,34076,32768,1308,3.99169921875
89,70,1,0,2,-2,-100.0
89,70,2,1,4,-3,-75.0
89,70,3,2,8,-6,-75.0
89,70,4,12,16,-4,-25.0
89,70,5,41,32,9,28.125
89,70,6,7,64,-57,-89.0625
89,70,7,10,128,-118,-92.1875
89,70,8,1219,256,963,376.171875
89,70,9,48,512,-464,-90.625
89,70,10,240,1024,-784,-76.5625
89,70,11,1405,2048,-643,-31.396484375
89,70,12,1137,4096,-2959,-72.2412109375
89,70,13,4544,8192,-3648,-44.53125
89,70,14,24341,16384,7957,48.565673828125
89,70,15,46427,32768,13659,41.6839599609375
89,71,1,0,2,-2,-100.0
89,71,2,1,4,-3,-75.0
89,71,3,2,8,-6,-75.0
89,71,4,7,16,-9,-56.25
89,71,5,31,32,-1,-3.125
89,71,6,116,64,52,81.25
89,71,7,135,128,7,5.46875
89,71,8,246,256,-10,-3.90625
89,71,9,457,512,-55,-10.7421875
89,71,10,523,1024,-501,-48.92578125
89,71,11,1238,2048,-810,-39.55078125
89,71,12,494,4096,-3602,-87.939453125
89,71,13,2341,8192,-5851,-71.42333984375
89,71,14,14596,16384,-1788,-10.9130859375
89,71,15,3759,32768,-29009,-88.5284423828125
89,72,1,0,2,-2,-100.0
89,72,2,2,4,-2,-50.0
89,72,3,7,8,-1,-12.5
89,72,4,5,16,-11,-68.75
89,72,5,35,32,3,9.375
89,72,6,40,64,-24,-37.5
89,72,7,209,128,81,63.28125
89,72,8,50,256,-206,-80.46875
89,72,9,470,512,-42,-8.203125
89,72,10,1012,1024,-12,-1.171875
89,72,11,1570,2048,-478,-23.33984375
89,72,12,11487,4096,7391,180.4443359375
89,72,13,278,8192,-7914,-96.6064453125
89,72,14,2325,16384,-14059,-85.809326171875
89,72,15,31428,32768,-1340,-4.08935546875
89,73,1,0,2,-2,-100.0
89,73,2,6,4,2,50.0
89,73,3,2,8,-6,-75.0
89,73,4,6,16,-10,-62.5
89,73,5,4,32,-28,-87.5
89,73,6,184,64,120,187.5
89,73,7,88,128,-40,-31.25
89,73,8,342,256,86,33.59375
89,73,9,1100,512,588,114.84375
89,73,10,2012,1024,988,96.484375
89,73,11,6369,2048,4321,210.986328125
89,73,12,2432,4096,-1664,-40.625
89,73,13,3874,8192,-4318,-52.7099609375
89,73,14,42396,16384,26012,158.7646484375
89,73,15,37817,32768,5049,15.4083251953125
89,74,1,0,2,-2,-100.0
89,74,2,1,4,-3,-75.0
89,74,3,4,8,-4,-50.0
89,74,4,6,16,-10,-62.5
89,74,5,6,32,-26,-81.25
89,74,6,148,64,84,131.25
89,74,7,57,128,-71,-55.46875
89,74,8,346,256,90,35.15625
89,74,9,190,512,-322,-62.890625
89,74,10,72,1024,-952,-92.96875
89,74,11,5118,2048,3070,149.90234375
89,74,12,1027,4096,-3069,-74.9267578125
89,74,13,18246,8192,10054,122.7294921875
89,74,14,59538,16384,43154,263.39111328125
89,74,15,7376,32768,-25392,-77.490234375
89,75,1,0,2,-2,-100.0
89,75,2,1,4,-3,-75.0
89,75,3,2,8,-6,-75.0
89,75,4,17,16,1,6.25
89,75,5,12,32,-20,-62.5
89,75,6,11,64,-53,-82.8125
89,75,7,9,128,-119,-92.96875
89,75,8,126,256,-130,-50.78125
89,75,9,250,512,-262,-51.171875
89,75,10,301,1024,-723,-70.60546875
89,75,11,1862,2048,-186,-9.08203125
89,75,12,7644,4096,3548,86.62109375
89,75,13,110,8192,-8082,-98.6572265625
89,75,14,32778,16384,16394,100.06103515625
89,75,15,19739,32768,-13029,-39.7613525390625
89,76,1,0,2,-2,-100.0
89,76,2,1,4,-3,-75.0
89,76,3,14,8,6,75.0
89,76,4,26,16,10,62.5
89,76,5,10,32,-22,-68.75
89,76,6,11,64,-53,-82.8125
89,76,7,41,128,-87,-67.96875
89,76,8,32,256,-224,-87.5
89,76,9,766,512,254,49.609375
89,76,10,25,1024,-999,-97.55859375
89,76,11,2995,2048,947,46.240234375
89,76,12,3587,4096,-509,-12.4267578125
89,76,13,9854,8192,1662,20.2880859375
89,76,14,15516,16384,-868,-5.2978515625
89,76,15,26723,32768,-6045,-18.4478759765625
89,77,1,0,2,-2,-100.0
89,77,2,2,4,-2,-50.0
89,77,3,4,8,-4,-50.0
89,77,4,17,16,1,6.25
89,77,5,89,32,57,178.125
89,77,6,13,64,-51,-79.6875
89,77,7,38,128,-90,-70.3125
89,77,8,336,256,80,31.25
89,77,9,602,512,90,17.578125
89,77,10,414,1024,-610,-59.5703125
89,77,11,980,2048,-1068,-52.1484375
89,77,12,6593,4096,2497,60.9619140625
89,77,13,3451,8192,-4741,-57.87353515625
89,77,14,72469,16384,56085,342.315673828125
89,77,15,36498,32768,3730,11.383056640625
89,78,1,0,2,-2,-100.0
89,78,2,2,4,-2,-50.0
89,78,3,15,8,7,87.5
89,78,4,15,16,-1,-6.25
89,78,5,76,32,44,137.5
89,78,6,94,64,30,46.875
89,78,7,43,128,-85,-66.40625
89,78,8,10,256,-246,-96.09375
89,78,9,617,512,105,20.5078125
89,78,10,944,1024,-80,-7.8125
89,78,11,1200,2048,-848,-41.40625
89,78,12,370,4096,-3726,-90.966796875
89,78,13,12026,8192,3834,46.8017578125
89,78,14,6094,16384,-10290,-62.80517578125
89,78,15,20852,32768,-11916,-36.36474609375
89,79,1,0,2,-2,-100.0
89,79,2,1,4,-3,-75.0
89,79,3,3,8,-5,-62.5
89,79,4,3,16,-13,-81.25
89,79,5,8,32,-24,-75.0
89,79,6,173,64,109,170.3125
89,79,7,41,128,-87,-67.96875
89,79,8,58,256,-198,-77.34375
89,79,9,491,512,-21,-4.1015625
89,79,10,4166,1024,3142,306.8359375
89,79,11,3859,2048,1811,88.427734375
89,79,12,1527,4096,-2569,-62.7197265625
89,79,13,18495,8192,10303,125.76904296875
89,79,14,84512,16384,68128,415.8203125
89,79,15,8323,32768,-24445,-74.6002197265625
89,80,1,0,2,-2,-100.0
89,80,2,2,4,-2,-50.0
89,80,3,6,8,-2,-25.0
89,80,4,5,16,-11,-68.75
89,80,5,33,32,1,3.125
89,80,6,35,64,-29,-45.3125
89,80,7,64,128,-64,-50.0
89,80,8,312,256,56,21.875
89,80,9,1343,512,831,162.3046875
89,80,10,443,1024,-581,-56.73828125
89,80,11,570,2048,-1478,-72.16796875
89,80,12,7457,4096,3361,82.0556640625
89,80,13,1319,8192,-6873,-83.89892578125
89,80,14,5496,16384,-10888,-66.455078125
89,80,15,18402,32768,-14366,-43.841552734375
89,81,1,0,2,-2,-100.0
89,81,2,3,4,-1,-25.0
89,81,3,5,8,-3,-37.5
89,81,4,17,16,1,6.25
89,81,5,4,32,-28,-87.5
89,81,6,40,64,-24,-37.5
89,81,7,207,128,79,61.71875
89,81,8,191,256,-65,-25.390625
89,81,9,698,512,186,36.328125
89,81,10,1843,1024,819,79.98046875
89,81,11,548,2048,-1500,-73.2421875
89,81,12,6269,4096,2173,53.0517578125
89,81,13,33138,8192,24946,304.5166015625
89,81,14,33816,16384,17432,106.396484375
89,81,15,26618,32768,-6150,-18.768310546875
89,82,1,0,2,-2,-100.0
89,82,2,1,4,-3,-75.0
89,82,3,5,8,-3,-37.5
89,82,4,3,16,-13,-81.25
89,82,5,20,32,-12,-37.5
89,82,6,72,64,8,12.5
89,82,7,52,128,-76,-59.375
89,82,8,545,256,289,112.890625
89,82,9,212,512,-300,-58.59375
89,82,10,1140,1024,116,11.328125
89,82,11,1499,2048,-549,-26.806640625
89,82,12,228,4096,-3868,-94.43359375
89,82,13,37873,8192,29681,362.31689453125
89,82,14,8262,16384,-8122,-49.57275390625
89,82,15,9297,32768,-23471,-71.6278076171875
89,83,1,0,2,-2,-100.0
89,83,2,1,4,-3,-75.0
89,83,3,3,8,-5,-62.5
89,83,4,8,16,-8,-50.0
89,83,5,35,32,3,9.375
89,83,6,117,64,53,82.8125
89,83,7,153,128,25,19.53125
89,83,8,901,256,645,251.953125
89,83,9,381,512,-131,-25.5859375
89,83,10,488,1024,-536,-52.34375
89,83,11,1801,2048,-247,-12.060546875
89,83,12,6325,4096,2229,54.4189453125
89,83,13,4360,8192,-3832,-46.77734375
89,83,14,1353,16384,-15031,-91.741943359375
89,83,15,11607,32768,-21161,-64.5782470703125
89,84,1,0,2,-2,-100.0
89,84,2,1,4,-3,-75.0
89,84,3,7,8,-1,-12.5
89,84,4,12,16,-4,-25.0
89,84,5,13,32,-19,-59.375
89,84,6,120,64,56,87.5
89,84,7,36,128,-92,-71.875
89,84,8,20,256,-236,-92.1875
89,84,9,205,512,-307,-59.9609375
89,84,10,1047,1024,23,2.24609375
89,84,11,4548,2048,2500,122.0703125
89,84,12,4171,4096,75,1.8310546875
89,84,13,6122,8192,-2070,-25.2685546875
89,84,14,4583,16384,-11801,-72.027587890625
89,84,15,28458,32768,-4310,-13.153076171875
89,85,1,0,2,-2,-100.0
89,85,2,1,4,-3,-75.0
89,85,3,2,8,-6,-75.0
89,85,4,5,16,-11,-68.75
89,85,5,22,32,-10,-31.25
89,85,6,91,64,27,42.1875
89,85,7,102,128,-26,-20.3125
89,85,8,14,256,-242,-94.53125
89,85,9,200,512,-312,-60.9375
89,85,10,1771,1024,747,72.94921875
89,85,11,6500,2048,4452,217.3828125
89,85,12,5796,4096,1700,41.50390625
89,85,13,2788,8192,-5404,-65.966796875
89,85,14,2622,16384,-13762,-83.99658203125
89,85,15,23948,32768,-8820,-26.91650390625
89,86,1,0,2,-2,-100.0
89,86,2,4,4,0,0.0
89,86,3,2,8,-6,-75.0
89,86,4,10,16,-6,-37.5
89,86,5,52,32,20,62.5
89,86,6,23,64,-41,-64.0625
89,86,7,293,128,165,128.90625
89,86,8,45,256,-211,-82.421875
89,86,9,105,512,-407,-79.4921875
89,86,10,4196,1024,3172,309.765625
89,86,11,316,2048,-1732,-84.5703125
89,86,12,2289,4096,-1807,-44.1162109375
89,86,13,2185,8192,-6007,-73.32763671875
89,86,14,24495,16384,8111,49.505615234375
89,86,15,9887,32768,-22881,-69.8272705078125
89,87,1,0,2,-2,-100.0
89,87,2,2,4,-2,-50.0
89,87,3,13,8,5,62.5
89,87,4,36,16,20,125.0
89,87,5,42,32,10,31.25
89,87,6,156,64,92,143.75
89,87,7,268,128,140,109.375
89,87,8,527,256,271,105.859375
89,87,9,401,512,-111,-21.6796875
89,87,10,171,1024,-853,-83.30078125
89,87,11,655,2048,-1393,-68.017578125
89,87,12,2475,4096,-1621,-39.5751953125
89,87,13,3135,8192,-5057,-61.73095703125
89,87,14,22263,16384,5879,35.882568359375
89,87,15,50477,32768,17709,54.0435791015625
89,88,1,0,2,-2,-100.0
89,88,2,2,4,-2,-50.0
89,88,3,3,8,-5,-62.5
89,88,4,9,16,-7,-43.75
89,88,5,15,32,-17,-53.125
89,88,6,23,64,-41,-64.0625
89,88,7,259,128,131,102.34375
89,88,8,379,256,123,48.046875
89,88,9,373,512,-139,-27.1484375
89,88,10,1602,1024,578,56.4453125
89,88,11,2234,2048,186,9.08203125
89,88,12,878,4096,-3218,-78.564453125
89,88,13,11402,8192,3210,39.1845703125
89,88,14,7968,16384,-8416,-51.3671875
89,88,15,24066,32768,-8702,-26.556396484375
89,89,1,0,2,-2,-100.0
89,89,2,1,4,-3,-75.0
89,89,3,15,8,7,87.5
89,89,4,21,16,5,31.25
89,89,5,13,32,-19,-59.375
89,89,6,52,64,-12,-18.75
89,89,7,338,128,210,164.0625
89,89,8,100,256,-156,-60.9375
89,89,9,123,512,-389,-75.9765625
89,89,10,269,1024,-755,-73.73046875
89,89,11,6906,2048,4858,237.20703125
89,89,12,2570,4096,-1526,-37.255859375
89,89,13,3868,8192,-4324,-52.783203125
89,89,14,2264,16384,-14120,-86.181640625
89,89,15,21026,32768,-11742,-35.833740234375
90,1,1,0,2,-2,-100.0
90,1,2,4,4,0,0.0
90,1,3,7,8,-1,-12.5
90,1,4,7,16,-9,-56.25
90,1,5,29,32,-3,-9.375
90,1,6,20,64,-44,-68.75
90,1,7,173,128,45,35.15625
90,1,8,481,256,225,87.890625
90,1,9,23,512,-489,-95.5078125
90,1,10,512,1024,-512,-50.0
90,1,11,971,2048,-1077,-52.587890625
90,1,12,1510,4096,-2586,-63.134765625
90,1,13,13825,8192,5633,68.76220703125
90,1,14,12276,16384,-4108,-25.0732421875
90,1,15,90296,32768,57528,175.5615234375
90,2,1,0,2,-2,-100.0
90,2,2,1,4,-3,-75.0
90,2,3,4,8,-4,-50.0
90,2,4,22,16,6,37.5
90,2,5,22,32,-10,-31.25
90,2,6,15,64,-49,-76.5625
90,2,7,55,128,-73,-57.03125
90,2,8,332,256,76,29.6875
90,2,9,386,512,-126,-24.609375
90,2,10,676,1024,-348,-33.984375
90,2,11,614,2048,-1434,-70.01953125
90,2,12,2510,4096,-1586,-38.720703125
90,2,13,20006,8192,11814,144.2138671875
90,2,14,86353,16384,69969,427.056884765625
90,2,15,42251,32768,9483,28.9398193359375
90,3,1,0,2,-2,-100.0
90,3,2,3,4,-1,-25.0
90,3,3,13,8,5,62.5
90,3,4,9,16,-7,-43.75
90,3,5,46,32,14,43.75
90,3,6,32,64,-32,-50.0
90,3,7,184,128,56,43.75
90,3,8,728,256,472,184.375
90,3,9,875,512,363,70.8984375
90,3,10,2183,1024,1159,113.18359375
90,3,11,3305,2048,1257,61.376953125
90,3,12,3280,4096,-816,-19.921875
90,3,13,11000,8192,2808,34.27734375
90,3,14,9957,16384,-6427,-39.227294921875
90,3,15,50856,32768,18088,55.2001953125
90,4,1,0,2,-2,-100.0
90,4,2,6,4,2,50.0
90,4,3,3,8,-5,-62.5
90,4,4,4,16,-12,-75.0
90,4,5,57,32,25,78.125
90,4,6,92,64,28,43.75
90,4,7,71,128,-57,-44.53125
90,4,8,27,256,-229,-89.453125
90,4,9,342,512,-170,-33.203125
90,4,10,691,1024,-333,-32.51953125
90,4,11,2273,2048,225,10.986328125
90,4,12,3883,4096,-213,-5.2001953125
90,4,13,1538,8192,-6654,-81.2255859375
90,4,14,17075,16384,691,4.217529296875
90,4,15,306,32768,-32462,-99.066162109375
90,5,1,0,2,-2,-100.0
90,5,2,1,4,-3,-75.0
90,5,3,5,8,-3,-37.5
90,5,4,5,16,-11,-68.75
90,5,5,48,32,16,50.0
90,5,6,262,64,198,309.375
90,5,7,116,128,-12,-9.375
90,5,8,100,256,-156,-60.9375
90,5,9,264,512,-248,-48.4375
90,5,10,130,1024,-894,-87.3046875
90,5,11,297,2048,-1751,-85.498046875
90,5,12,6958,4096,2862,69.873046875
90,5,13,837,8192,-7355,-89.78271484375
90,5,14,3886,16384,-12498,-76.28173828125
90,5,15,33313,32768,545,1.6632080078125
90,6,1,0,2,-2,-100.0
90,6,2,3,4,-1,-25.0
90,6,3,14,8,6,75.0
90,6,4,13,16,-3,-18.75
90,6,5,38,32,6,18.75
90,6,6,142,64,78,121.875
90,6,7,173,128,45,35.15625
90,6,8,85,256,-171,-66.796875
90,6,9,271,512,-241,-47.0703125
90,6,10,1788,1024,764,74.609375
90,6,11,3971,2048,1923,93.896484375
90,6,12,7042,4096,2946,71.923828125
90,6,13,1282,8192,-6910,-84.3505859375
90,6,14,31820,16384,15436,94.2138671875
90,6,15,9930,32768,-22838,-69.696044921875
90,7,1,0,2,-2,-100.0
90,7,2,1,4,-3,-75.0
90,7,3,7,8,-1,-12.5
90,7,4,25,16,9,56.25
90,7,5,34,32,2,6.25
90,7,6,14,64,-50,-78.125
90,7,7,70,128,-58,-45.3125
90,7,8,112,256,-144,-56.25
90,7,9,200,512,-312,-60.9375
90,7,10,2277,1024,1253,122.36328125
90,7,11,1370,2048,-678,-33.10546875
90,7,12,1019,4096,-3077,-75.1220703125
90,7,13,4196,8192,-3996,-48.779296875
90,7,14,11261,16384,-5123,-31.268310546875
90,7,15,5797,32768,-26971,-82.3089599609375
90,8,1,0,2,-2,-100.0
90,8,2,1,4,-3,-75.0
90,8,3,12,8,4,50.0
90,8,4,3,16,-13,-81.25
90,8,5,9,32,-23,-71.875
90,8,6,172,64,108,168.75
90,8,7,142,128,14,10.9375
90,8,8,52,256,-204,-79.6875
90,8,9,212,512,-300,-58.59375
90,8,10,2361,1024,1337,130.56640625
90,8,11,1012,2048,-1036,-50.5859375
90,8,12,2711,4096,-1385,-33.8134765625
90,8,13,1804,8192,-6388,-77.978515625
90,8,14,14257,16384,-2127,-12.982177734375
90,8,15,52329,32768,19561,59.6954345703125
90,9,1,0,2,-2,-100.0
90,9,2,1,4,-3,-75.0
90,9,3,6,8,-2,-25.0
90,9,4,12,16,-4,-25.0
90,9,5,14,32,-18,-56.25
90,9,6,238,64,174,271.875
90,9,7,54,128,-74,-57.8125
90,9,8,211,256,-45,-17.578125
90,9,9,12,512,-500,-97.65625
90,9,10,105,1024,-919,-89.74609375
90,9,11,105,2048,-1943,-94.873046875
90,9,12,4935,4096,839,20.4833984375
90,9,13,5575,8192,-2617,-31.94580078125
90,9,14,17370,16384,986,6.01806640625
90,9,15,74958,32768,42190,128.753662109375
90,10,1,0,2,-2,-100.0
90,10,2,2,4,-2,-50.0
90,10,3,2,8,-6,-75.0
90,10,4,12,16,-4,-25.0
90,10,5,15,32,-17,-53.125
90,10,6,128,64,64,100.0
90,10,7,68,128,-60,-46.875
90,10,8,470,256,214,83.59375
90,10,9,26,512,-486,-94.921875
90,10,10,149,1024,-875,-85.44921875
90,10,11,3022,2048,974,47.55859375
90,10,12,3719,4096,-377,-9.2041015625
90,10,13,5975,8192,-2217,-27.06298828125
90,10,14,2086,16384,-14298,-87.26806640625
90,10,15,1194,32768,-31574,-96.356201171875
90,11,1,0,2,-2,-100.0
90,11,2,1,4,-3,-75.0
90,11,3,2,8,-6,-75.0
90,11,4,41,16,25,156.25
90,11,5,35,32,3,9.375
90,11,6,85,64,21,32.8125
90,11,7,69,128,-59,-46.09375
90,11,8,231,256,-25,-9.765625
90,11,9,94,512,-418,-81.640625
90,11,10,7250,1024,6226,608.0078125
90,11,11,3098,2048,1050,51.26953125
90,11,12,4114,4096,18,0.439453125
90,11,13,28170,8192,19978,243.8720703125
90,11,14,927,16384,-15457,-94.342041015625
90,11,15,25190,32768,-7578,-23.126220703125
90,12,1,0,2,-2,-100.0
90,12,2,2,4,-2,-50.0
90,12,3,4,8,-4,-50.0
90,12,4,17,16,1,6.25
90,12,5,4,32,-28,-87.5
90,12,6,6,64,-58,-90.625
90,12,7,72,128,-56,-43.75
90,12,8,47,256,-209,-81.640625
90,12,9,216,512,-296,-57.8125
90,12,10,13,1024,-1011,-98.73046875
90,12,11,1596,2048,-452,-22.0703125
90,12,12,2901,4096,-1195,-29.1748046875
90,12,13,7937,8192,-255,-3.11279296875
90,12,14,6877,16384,-9507,-58.026123046875
90,12,15,65872,32768,33104,101.025390625
90,13,1,0,2,-2,-100.0
90,13,2,1,4,-3,-75.0
90,13,3,6,8,-2,-25.0
90,13,4,6,16,-10,-62.5
90,13,5,46,32,14,43.75
90,13,6,37,64,-27,-42.1875
90,13,7,105,128,-23,-17.96875
90,13,8,229,256,-27,-10.546875
90,13,9,33,512,-479,-93.5546875
90,13,10,2317,1024,1293,126.26953125
90,13,11,4255,2048,2207,107.763671875
90,13,12,1668,4096,-2428,-59.27734375
90,13,13,7198,8192,-994,-12.1337890625
90,13,14,451,16384,-15933,-97.247314453125
90,13,15,11829,32768,-20939,-63.9007568359375
90,14,1,0,2,-2,-100.0
90,14,2,1,4,-3,-75.0
90,14,3,8,8,0,0.0
90,14,4,13,16,-3,-18.75
90,14,5,7,32,-25,-78.125
90,14,6,67,64,3,4.6875
90,14,7,251,128,123,96.09375
90,14,8,259,256,3,1.171875
90,14,9,71,512,-441,-86.1328125
90,14,10,44,1024,-980,-95.703125
90,14,11,1697,2048,-351,-17.138671875
90,14,12,1833,4096,-2263,-55.2490234375
90,14,13,2351,8192,-5841,-71.30126953125
90,14,14,8417,16384,-7967,-48.626708984375
90,14,15,17910,32768,-14858,-45.343017578125
90,15,1,0,2,-2,-100.0
90,15,2,1,4,-3,-75.0
90,15,3,2,8,-6,-75.0
90,15,4,46,16,30,187.5
90,15,5,38,32,6,18.75
90,15,6,16,64,-48,-75.0
90,15,7,28,128,-100,-78.125
90,15,8,356,256,100,39.0625
90,15,9,30,512,-482,-94.140625
90,15,10,2622,1024,1598,156.0546875
90,15,11,791,2048,-1257,-61.376953125
90,15,12,1904,4096,-2192,-53.515625
90,15,13,4613,8192,-3579,-43.68896484375
90,15,14,22944,16384,6560,40.0390625
90,15,15,49372,32768,16604,50.67138671875
90,16,1,0,2,-2,-100.0
90,16,2,1,4,-3,-75.0
90,16,3,2,8,-6,-75.0
90,16,4,10,16,-6,-37.5
90,16,5,9,32,-23,-71.875
90,16,6,9,64,-55,-85.9375
90,16,7,314,128,186,145.3125
90,16,8,598,256,342,133.59375
90,16,9,1493,512,981,191.6015625
90,16,10,2016,1024,992,96.875
90,16,11,200,2048,-1848,-90.234375
90,16,12,1903,4096,-2193,-53.5400390625
90,16,13,8041,8192,-151,-1.84326171875
90,16,14,2731,16384,-13653,-83.331298828125
90,16,15,41412,32768,8644,26.37939453125
90,17,1,0,2,-2,-100.0
90,17,2,2,4,-2,-50.0
90,17,3,2,8,-6,-75.0
90,17,4,9,16,-7,-43.75
90,17,5,40,32,8,25.0
90,17,6,123,64,59,92.1875
90,17,7,285,128,157,122.65625
90,17,8,57,256,-199,-77.734375
90,17,9,329,512,-183,-35.7421875
90,17,10,591,1024,-433,-42.28515625
90,17,11,1804,2048,-244,-11.9140625
90,17,12,709,4096,-3387,-82.6904296875
90,17,13,692,8192,-7500,-91.552734375
90,17,14,11683,16384,-4701,-28.692626953125
90,17,15,13928,32768,-18840,-57.4951171875
90,18,1,0,2,-2,-100.0
90,18,2,1,4,-3,-75.0
90,18,3,6,8,-2,-25.0
90,18,4,50,16,34,212.5
90,18,5,20,32,-12,-37.5
90,18,6,28,64,-36,-56.25
90,18,7,62,128,-66,-51.5625
90,18,8,389,256,133,51.953125
90,18,9,1449,512,937,183.0078125
90,18,10,310,1024,-714,-69.7265625
90,18,11,1851,2048,-197,-9.619140625
90,18,12,79,4096,-4017,-98.0712890625
90,18,13,7263,8192,-929,-11.34033203125
90,18,14,9620,16384,-6764,-41.2841796875
90,18,15,2083,32768,-30685,-93.6431884765625
90,19,1,0,2,-2,-100.0
90,19,2,1,4,-3,-75.0
90,19,3,10,8,2,25.0
90,19,4,14,16,-2,-12.5
90,19,5,62,32,30,93.75
90,19,6,55,64,-9,-14.0625
90,19,7,140,128,12,9.375
90,19,8,374,256,118,46.09375
90,19,9,56,512,-456,-89.0625
90,19,10,2776,1024,1752,171.09375
90,19,11,2361,2048,313,15.283203125
90,19,12,3537,4096,-559,-13.6474609375
90,19,13,9122,8192,930,11.3525390625
90,19,14,5754,16384,-10630,-64.88037109375
90,19,15,3608,32768,-29160,-88.9892578125
90,20,1,0,2,-2,-100.0
90,20,2,1,4,-3,-75.0
90,20,3,2,8,-6,-75.0
90,20,4,17,16,1,6.25
90,20,5,30,32,-2,-6.25
90,20,6,16,64,-48,-75.0
90,20,7,35,128,-93,-72.65625
90,20,8,97,256,-159,-62.109375
90,20,9,1226,512,714,139.453125
90,20,10,1260,1024,236,23.046875
90,20,11,91,2048,-1957,-95.556640625
90,20,12,944,4096,-3152,-76.953125
90,20,13,3225,8192,-4967,-60.63232421875
90,20,14,28357,16384,11973,73.077392578125
90,20,15,27452,32768,-5316,-16.22314453125
90,21,1,0,2,-2,-100.0
90,21,2,1,4,-3,-75.0
90,21,3,2,8,-6,-75.0
90,21,4,3,16,-13,-81.25
90,21,5,12,32,-20,-62.5
90,21,6,21,64,-43,-67.1875
90,21,7,81,128,-47,-36.71875
90,21,8,46,256,-210,-82.03125
90,21,9,801,512,289,56.4453125
90,21,10,733,1024,-291,-28.41796875
90,21,11,778,2048,-1270,-62.01171875
90,21,12,2010,4096,-2086,-50.927734375
90,21,13,22966,8192,14774,180.3466796875
90,21,14,11620,16384,-4764,-29.0771484375
90,21,15,15697,32768,-17071,-52.0965576171875
90,22,1,0,2,-2,-100.0
90,22,2,2,4,-2,-50.0
90,22,3,6,8,-2,-25.0
90,22,4,20,16,4,25.0
90,22,5,37,32,5,15.625
90,22,6,29,64,-35,-54.6875
90,22,7,39,128,-89,-69.53125
90,22,8,267,256,11,4.296875
90,22,9,401,512,-111,-21.6796875
90,22,10,362,1024,-662,-64.6484375
90,22,11,133,2048,-1915,-93.505859375
90,22,12,5685,4096,1589,38.7939453125
90,22,13,378,8192,-7814,-95.3857421875
90,22,14,16481,16384,97,0.592041015625
90,22,15,62836,32768,30068,91.76025390625
90,23,1,0,2,-2,-100.0
90,23,2,1,4,-3,-75.0
90,23,3,7,8,-1,-12.5
90,23,4,3,16,-13,-81.25
90,23,5,70,32,38,118.75
90,23,6,30,64,-34,-53.125
90,23,7,219,128,91,71.09375
90,23,8,293,256,37,14.453125
90,23,9,470,512,-42,-8.203125
90,23,10,116,1024,-908,-88.671875
90,23,11,1121,2048,-927,-45.263671875
90,23,12,293,4096,-3803,-92.8466796875
90,23,13,2052,8192,-6140,-74.951171875
90,23,14,8020,16384,-8364,-51.0498046875
90,23,15,17386,32768,-15382,-46.942138671875
90,24,1,0,2,-2,-100.0
90,24,2,1,4,-3,-75.0
90,24,3,2,8,-6,-75.0
90,24,4,5,16,-11,-68.75
90,24,5,21,32,-11,-34.375
90,24,6,110,64,46,71.875
90,24,7,46,128,-82,-64.0625
90,24,8,44,256,-212,-82.8125
90,24,9,319,512,-193,-37.6953125
90,24,10,1993,1024,969,94.62890625
90,24,11,1691,2048,-357,-17.431640625
90,24,12,5057,4096,961,23.4619140625
90,24,13,12705,8192,4513,55.09033203125
90,24,14,6630,16384,-9754,-59.53369140625
90,24,15,20991,32768,-11777,-35.9405517578125
90,25,1,0,2,-2,-100.0
90,25,2,1,4,-3,-75.0
90,25,3,13,8,5,62.5
90,25,4,16,16,0,0.0
90,25,5,43,32,11,34.375
90,25,6,5,64,-59,-92.1875
90,25,7,321,128,193,150.78125
90,25,8,120,256,-136,-53.125
90,25,9,135,512,-377,-73.6328125
90,25,10,2658,1024,1634,159.5703125
90,25,11,4095,2048,2047,99.951171875
90,25,12,3070,4096,-1026,-25.048828125
90,25,13,6228,8192,-1964,-23.974609375
90,25,14,5542,16384,-10842,-66.17431640625
90,25,15,12018,32768,-20750,-63.323974609375
90,26,1,0,2,-2,-100.0
90,26,2,2,4,-2,-50.0
90,26,3,9,8,1,12.5
90,26,4,11,16,-5,-31.25
90,26,5,59,32,27,84.375
90,26,6,13,64,-51,-79.6875
90,26,7,105,128,-23,-17.96875
90,26,8,177,256,-79,-30.859375
90,26,9,1244,512,732,142.96875
90,26,10,1170,1024,146,14.2578125
90,26,11,3505,2048,1457,71.142578125
90,26,12,2074,4096,-2022,-49.365234375
90,26,13,15587,8192,7395,90.27099609375
90,26,14,6889,16384,-9495,-57.952880859375
90,26,15,14358,32768,-18410,-56.182861328125
90,27,1,0,2,-2,-100.0
90,27,2,1,4,-3,-75.0
90,27,3,5,8,-3,-37.5
90,27,4,33,16,17,106.25
90,27,5,7,32,-25,-78.125
90,27,6,24,64,-40,-62.5
90,27,7,47,128,-81,-63.28125
90,27,8,74,256,-182,-71.09375
90,27,9,737,512,225,43.9453125
90,27,10,1661,1024,637,62.20703125
90,27,11,5380,2048,3332,162.6953125
90,27,12,100,4096,-3996,-97.55859375
90,27,13,377,8192,-7815,-95.39794921875
90,27,14,4667,16384,-11717,-71.514892578125
90,27,15,17498,32768,-15270,-46.600341796875
90,28,1,0,2,-2,-100.0
90,28,2,1,4,-3,-75.0
90,28,3,5,8,-3,-37.5
90,28,4,46,16,30,187.5
90,28,5,117,32,85,265.625
90,28,6,21,64,-43,-67.1875
90,28,7,39,128,-89,-69.53125
90,28,8,263,256,7,2.734375
90,28,9,555,512,43,8.3984375
90,28,10,1120,1024,96,9.375
90,28,11,2761,2048,713,34.814453125
90,28,12,9515,4096,5419,132.2998046875
90,28,13,17932,8192,9740,118.896484375
90,28,14,16262,16384,-122,-0.74462890625
90,28,15,99633,32768,66865,204.0557861328125
90,29,1,0,2,-2,-100.0
90,29,2,1,4,-3,-75.0
90,29,3,9,8,1,12.5
90,29,4,22,16,6,37.5
90,29,5,24,32,-8,-25.0
90,29,6,67,64,3,4.6875
90,29,7,340,128,212,165.625
90,29,8,722,256,466,182.03125
90,29,9,105,512,-407,-79.4921875
90,29,10,550,1024,-474,-46.2890625
90,29,11,619,2048,-1429,-69.775390625
90,29,12,1485,4096,-2611,-63.7451171875
90,29,13,5858,8192,-2334,-28.4912109375
90,29,14,108699,16384,92315,563.446044921875
90,29,15,89587,32768,56819,173.3978271484375
90,30,1,0,2,-2,-100.0
90,30,2,1,4,-3,-75.0
90,30,3,13,8,5,62.5
90,30,4,36,16,20,125.0
90,30,5,4,32,-28,-87.5
90,30,6,137,64,73,114.0625
90,30,7,91,128,-37,-28.90625
90,30,8,19,256,-237,-92.578125
90,30,9,158,512,-354,-69.140625
90,30,10,190,1024,-834,-81.4453125
90,30,11,583,2048,-1465,-71.533203125
90,30,12,2505,4096,-1591,-38.8427734375
90,30,13,2406,8192,-5786,-70.6298828125
90,30,14,86442,16384,70058,427.60009765625
90,30,15,59656,32768,26888,82.0556640625
90,31,1,0,2,-2,-100.0
90,31,2,1,4,-3,-75.0
90,31,3,2,8,-6,-75.0
90,31,4,13,16,-3,-18.75
90,31,5,69,32,37,115.625
90,31,6,57,64,-7,-10.9375
90,31,7,8,128,-120,-93.75
90,31,8,556,256,300,117.1875
90,31,9,677,512,165,32.2265625
90,31,10,1471,1024,447,43.65234375
90,31,11,1417,2048,-631,-30.810546875
90,31,12,6218,4096,2122,51.806640625
90,31,13,12607,8192,4415,53.89404296875
90,31,14,8680,16384,-7704,-47.021484375
90,31,15,110971,32768,78203,238.6566162109375
90,32,1,0,2,-2,-100.0
90,32,2,4,4,0,0.0
90,32,3,5,8,-3,-37.5
90,32,4,23,16,7,43.75
90,32,5,22,32,-10,-31.25
90,32,6,18,64,-46,-71.875
90,32,7,9,128,-119,-92.96875
90,32,8,125,256,-131,-51.171875
90,32,9,162,512,-350,-68.359375
90,32,10,1125,1024,101,9.86328125
90,32,11,169,2048,-1879,-91.748046875
90,32,12,5388,4096,1292,31.54296875
90,32,13,8852,8192,660,8.056640625
90,32,14,3381,16384,-13003,-79.364013671875
90,32,15,228051,32768,195283,595.9564208984375
90,33,1,0,2,-2,-100.0
90,33,2,1,4,-3,-75.0
90,33,3,7,8,-1,-12.5
90,33,4,15,16,-1,-6.25
90,33,5,4,32,-28,-87.5
90,33,6,17,64,-47,-73.4375
90,33,7,249,128,121,94.53125
90,33,8,191,256,-65,-25.390625
90,33,9,105,512,-407,-79.4921875
90,33,10,6407,1024,5383,525.68359375
90,33,11,1855,2048,-193,-9.423828125
90,33,12,9534,4096,5438,132.763671875
90,33,13,192,8192,-8000,-97.65625
90,33,14,3411,16384,-12973,-79.180908203125
90,33,15,63356,32768,30588,93.34716796875
90,34,1,0,2,-2,-100.0
90,34,2,1,4,-3,-75.0
90,34,3,3,8,-5,-62.5
90,34,4,6,16,-10,-62.5
90,34,5,44,32,12,37.5
90,34,6,22,64,-42,-65.625
90,34,7,134,128,6,4.6875
90,34,8,478,256,222,86.71875
90,34,9,256,512,-256,-50.0
90,34,10,2100,1024,1076,105.078125
90,34,11,15,2048,-2033,-99.267578125
90,34,12,3606,4096,-490,-11.962890625
90,34,13,2063,8192,-6129,-74.81689453125
90,34,14,29317,16384,12933,78.936767578125
90,34,15,30548,32768,-2220,-6.77490234375
90,35,1,0,2,-2,-100.0
90,35,2,1,4,-3,-75.0
90,35,3,11,8,3,37.5
90,35,4,20,16,4,25.0
90,35,5,88,32,56,175.0
90,35,6,112,64,48,75.0
90,35,7,12,128,-116,-90.625
90,35,8,666,256,410,160.15625
90,35,9,213,512,-299,-58.3984375
90,35,10,1675,1024,651,63.57421875
90,35,11,2569,2048,521,25.439453125
90,35,12,2326,4096,-1770,-43.212890625
90,35,13,10092,8192,1900,23.193359375
90,35,14,8297,16384,-8087,-49.359130859375
90,35,15,2641,32768,-30127,-91.9403076171875
90,36,1,0,2,-2,-100.0
90,36,2,2,4,-2,-50.0
90,36,3,2,8,-6,-75.0
90,36,4,18,16,2,12.5
90,36,5,29,32,-3,-9.375
90,36,6,74,64,10,15.625
90,36,7,6,128,-122,-95.3125
90,36,8,225,256,-31,-12.109375
90,36,9,288,512,-224,-43.75
90,36,10,2644,1024,1620,158.203125
90,36,11,6293,2048,4245,207.275390625
90,36,12,3813,4096,-283,-6.9091796875
90,36,13,2627,8192,-5565,-67.93212890625
90,36,14,214,16384,-16170,-98.69384765625
90,36,15,26854,32768,-5914,-18.048095703125
90,37,1,0,2,-2,-100.0
90,37,2,2,4,-2,-50.0
90,37,3,2,8,-6,-75.0
90,37,4,8,16,-8,-50.0
90,37,5,35,32,3,9.375
90,37,6,13,64,-51,-79.6875
90,37,7,300,128,172,134.375
90,37,8,360,256,104,40.625
90,37,9,129,512,-383,-74.8046875
90,37,10,185,1024,-839,-81.93359375
90,37,11,720,2048,-1328,-64.84375
90,37,12,3825,4096,-271,-6.6162109375
90,37,13,6889,8192,-1303,-15.90576171875
90,37,14,5567,16384,-10817,-66.021728515625
90,37,15,29161,32768,-3607,-11.0076904296875
90,38,1,0,2,-2,-100.0
90,38,2,3,4,-1,-25.0
90,38,3,4,8,-4,-50.0
90,38,4,6,16,-10,-62.5
90,38,5,5,32,-27,-84.375
90,38,6,32,64,-32,-50.0
90,38,7,523,128,395,308.59375
90,38,8,430,256,174,67.96875
90,38,9,198,512,-314,-61.328125
90,38,10,180,1024,-844,-82.421875
90,38,11,252,2048,-1796,-87.6953125
90,38,12,1563,4096,-2533,-61.8408203125
90,38,13,13699,8192,5507,67.22412109375
90,38,14,636,16384,-15748,-96.1181640625
90,38,15,27005,32768,-5763,-17.5872802734375
90,39,1,0,2,-2,-100.0
90,39,2,1,4,-3,-75.0
90,39,3,7,8,-1,-12.5
90,39,4,3,16,-13,-81.25
90,39,5,42,32,10,31.25
90,39,6,20,64,-44,-68.75
90,39,7,31,128,-97,-75.78125
90,39,8,302,256,46,17.96875
90,39,9,44,512,-468,-91.40625
90,39,10,377,1024,-647,-63.18359375
90,39,11,2032,2048,-16,-0.78125
90,39,12,3929,4096,-167,-4.0771484375
90,39,13,2658,8192,-5534,-67.5537109375
90,39,14,12678,16384,-3706,-22.61962890625
90,39,15,58339,32768,25571,78.0364990234375
90,40,1,0,2,-2,-100.0
90,40,2,2,4,-2,-50.0
90,40,3,4,8,-4,-50.0
90,40,4,52,16,36,225.0
90,40,5,5,32,-27,-84.375
90,40,6,5,64,-59,-92.1875
90,40,7,6,128,-122,-95.3125
90,40,8,234,256,-22,-8.59375
90,40,9,327,512,-185,-36.1328125
90,40,10,279,1024,-745,-72.75390625
90,40,11,885,2048,-1163,-56.787109375
90,40,12,1310,4096,-2786,-68.017578125
90,40,13,547,8192,-7645,-93.32275390625
90,40,14,12426,16384,-3958,-24.15771484375
90,40,15,74409,32768,41641,127.0782470703125
90,41,1,0,2,-2,-100.0
90,41,2,2,4,-2,-50.0
90,41,3,5,8,-3,-37.5
90,41,4,8,16,-8,-50.0
90,41,5,44,32,12,37.5
90,41,6,93,64,29,45.3125
90,41,7,106,128,-22,-17.1875
90,41,8,9,256,-247,-96.484375
90,41,9,61,512,-451,-88.0859375
90,41,10,746,1024,-278,-27.1484375
90,41,11,634,2048,-1414,-69.04296875
90,41,12,2293,4096,-1803,-44.0185546875
90,41,13,8527,8192,335,4.08935546875
90,41,14,54868,16384,38484,234.8876953125
90,41,15,32520,32768,-248,-0.7568359375
90,42,1,0,2,-2,-100.0
90,42,2,1,4,-3,-75.0
90,42,3,2,8,-6,-75.0
90,42,4,6,16,-10,-62.5
90,42,5,19,32,-13,-40.625
90,42,6,59,64,-5,-7.8125
90,42,7,22,128,-106,-82.8125
90,42,8,97,256,-159,-62.109375
90,42,9,754,512,242,47.265625
90,42,10,249,1024,-775,-75.68359375
90,42,11,1300,2048,-748,-36.5234375
90,42,12,343,4096,-3753,-91.6259765625
90,42,13,4969,8192,-3223,-39.34326171875
90,42,14,3933,16384,-12451,-75.994873046875
90,42,15,14521,32768,-18247,-55.6854248046875
90,43,1,0,2,-2,-100.0
90,43,2,3,4,-1,-25.0
90,43,3,2,8,-6,-75.0
90,43,4,5,16,-11,-68.75
90,43,5,21,32,-11,-34.375
90,43,6,48,64,-16,-25.0
90,43,7,14,128,-114,-89.0625
90,43,8,278,256,22,8.59375
90,43,9,66,512,-446,-87.109375
90,43,10,6843,1024,5819,568.26171875
90,43,11,111,2048,-1937,-94.580078125
90,43,12,4617,4096,521,12.7197265625
90,43,13,4484,8192,-3708,-45.263671875
90,43,14,38152,16384,21768,132.861328125
90,43,15,67444,32768,34676,105.82275390625
90,44,1,0,2,-2,-100.0
90,44,2,2,4,-2,-50.0
90,44,3,3,8,-5,-62.5
90,44,4,14,16,-2,-12.5
90,44,5,34,32,2,6.25
90,44,6,28,64,-36,-56.25
90,44,7,63,128,-65,-50.78125
90,44,8,14,256,-242,-94.53125
90,44,9,1424,512,912,178.125
90,44,10,491,1024,-533,-52.05078125
90,44,11,3486,2048,1438,70.21484375
90,44,12,4901,4096,805,19.6533203125
90,44,13,14795,8192,6603,80.60302734375
90,44,14,27844,16384,11460,69.9462890625
90,44,15,35996,32768,3228,9.85107421875
90,45,1,0,2,-2,-100.0
90,45,2,2,4,-2,-50.0
90,45,3,13,8,5,62.5
90,45,4,3,16,-13,-81.25
90,45,5,21,32,-11,-34.375
90,45,6,51,64,-13,-20.3125
90,45,7,148,128,20,15.625
90,45,8,223,256,-33,-12.890625
90,45,9,366,512,-146,-28.515625
90,45,10,838,1024,-186,-18.1640625
90,45,11,1363,2048,-685,-33.447265625
90,45,12,11421,4096,7325,178.8330078125
90,45,13,17244,8192,9052,110.498046875
90,45,14,13524,16384,-2860,-17.4560546875
90,45,15,24729,32768,-8039,-24.5330810546875
90,46,1,0,2,-2,-100.0
90,46,2,4,4,0,0.0
90,46,3,2,8,-6,-75.0
90,46,4,31,16,15,93.75
90,46,5,4,32,-28,-87.5
90,46,6,60,64,-4,-6.25
90,46,7,193,128,65,50.78125
90,46,8,68,256,-188,-73.4375
90,46,9,253,512,-259,-50.5859375
90,46,10,832,1024,-192,-18.75
90,46,11,1150,2048,-898,-43.84765625
90,46,12,386,4096,-3710,-90.576171875
90,46,13,10089,8192,1897,23.15673828125
90,46,14,3982,16384,-12402,-75.69580078125
90,46,15,14060,32768,-18708,-57.09228515625
90,47,1,0,2,-2,-100.0
90,47,2,3,4,-1,-25.0
90,47,3,2,8,-6,-75.0
90,47,4,11,16,-5,-31.25
90,47,5,32,32,0,0.0
90,47,6,118,64,54,84.375
90,47,7,11,128,-117,-91.40625
90,47,8,286,256,30,11.71875
90,47,9,1480,512,968,189.0625
90,47,10,145,1024,-879,-85.83984375
90,47,11,822,2048,-1226,-59.86328125
90,47,12,1864,4096,-2232,-54.4921875
90,47,13,2775,8192,-5417,-66.12548828125
90,47,14,10831,16384,-5553,-33.892822265625
90,47,15,91814,32768,59046,180.194091796875
90,48,1,0,2,-2,-100.0
90,48,2,1,4,-3,-75.0
90,48,3,6,8,-2,-25.0
90,48,4,32,16,16,100.0
90,48,5,4,32,-28,-87.5
90,48,6,23,64,-41,-64.0625
90,48,7,457,128,329,257.03125
90,48,8,875,256,619,241.796875
90,48,9,606,512,94,18.359375
90,48,10,440,1024,-584,-57.03125
90,48,11,960,2048,-1088,-53.125
90,48,12,188,4096,-3908,-95.41015625
90,48,13,8768,8192,576,7.03125
90,48,14,12198,16384,-4186,-25.54931640625
90,48,15,73807,32768,41039,125.2410888671875
90,49,1,0,2,-2,-100.0
90,49,2,1,4,-3,-75.0
90,49,3,2,8,-6,-75.0
90,49,4,22,16,6,37.5
90,49,5,5,32,-27,-84.375
90,49,6,54,64,-10,-15.625
90,49,7,104,128,-24,-18.75
90,49,8,274,256,18,7.03125
90,49,9,145,512,-367,-71.6796875
90,49,10,136,1024,-888,-86.71875
90,49,11,632,2048,-1416,-69.140625
90,49,12,11510,4096,7414,181.005859375
90,49,13,6642,8192,-1550,-18.9208984375
90,49,14,56,16384,-16328,-99.658203125
90,49,15,5973,32768,-26795,-81.7718505859375
90,50,1,0,2,-2,-100.0
90,50,2,1,4,-3,-75.0
90,50,3,8,8,0,0.0
90,50,4,18,16,2,12.5
90,50,5,4,32,-28,-87.5
90,50,6,75,64,11,17.1875
90,50,7,95,128,-33,-25.78125
90,50,8,362,256,106,41.40625
90,50,9,224,512,-288,-56.25
90,50,10,643,1024,-381,-37.20703125
90,50,11,1960,2048,-88,-4.296875
90,50,12,1782,4096,-2314,-56.494140625
90,50,13,4350,8192,-3842,-46.8994140625
90,50,14,3787,16384,-12597,-76.885986328125
90,50,15,40986,32768,8218,25.079345703125
90,51,1,0,2,-2,-100.0
90,51,2,1,4,-3,-75.0
90,51,3,5,8,-3,-37.5
90,51,4,13,16,-3,-18.75
90,51,5,8,32,-24,-75.0
90,51,6,30,64,-34,-53.125
90,51,7,141,128,13,10.15625
90,51,8,169,256,-87,-33.984375
90,51,9,359,512,-153,-29.8828125
90,51,10,600,1024,-424,-41.40625
90,51,11,2376,2048,328,16.015625
90,51,12,9526,4096,5430,132.568359375
90,51,13,7971,8192,-221,-2.69775390625
90,51,14,7623,16384,-8761,-53.472900390625
90,51,15,10301,32768,-22467,-68.5638427734375
90,52,1,0,2,-2,-100.0
90,52,2,1,4,-3,-75.0
90,52,3,3,8,-5,-62.5
90,52,4,6,16,-10,-62.5
90,52,5,8,32,-24,-75.0
90,52,6,5,64,-59,-92.1875
90,52,7,86,128,-42,-32.8125
90,52,8,761,256,505,197.265625
90,52,9,115,512,-397,-77.5390625
90,52,10,165,1024,-859,-83.88671875
90,52,11,621,2048,-1427,-69.677734375
90,52,12,491,4096,-3605,-88.0126953125
90,52,13,1511,8192,-6681,-81.55517578125
90,52,14,12137,16384,-4247,-25.921630859375
90,52,15,83608,32768,50840,155.1513671875
90,53,1,0,2,-2,-100.0
90,53,2,1,4,-3,-75.0
90,53,3,12,8,4,50.0
90,53,4,23,16,7,43.75
90,53,5,27,32,-5,-15.625
90,53,6,63,64,-1,-1.5625
90,53,7,134,128,6,4.6875
90,53,8,770,256,514,200.78125
90,53,9,628,512,116,22.65625
90,53,10,20,1024,-1004,-98.046875
90,53,11,26,2048,-2022,-98.73046875
90,53,12,1267,4096,-2829,-69.0673828125
90,53,13,2285,8192,-5907,-72.10693359375
90,53,14,15988,16384,-396,-2.4169921875
90,53,15,11558,32768,-21210,-64.727783203125
90,54,1,0,2,-2,-100.0
90,54,2,1,4,-3,-75.0
90,54,3,11,8,3,37.5
90,54,4,24,16,8,50.0
90,54,5,21,32,-11,-34.375
90,54,6,102,64,38,59.375
90,54,7,56,128,-72,-56.25
90,54,8,22,256,-234,-91.40625
90,54,9,920,512,408,79.6875
90,54,10,883,1024,-141,-13.76953125
90,54,11,3335,2048,1287,62.841796875
90,54,12,1770,4096,-2326,-56.787109375
90,54,13,9249,8192,1057,12.90283203125
90,54,14,17774,16384,1390,8.48388671875
90,54,15,2841,32768,-29927,-91.3299560546875
90,55,1,0,2,-2,-100.0
90,55,2,1,4,-3,-75.0
90,55,3,2,8,-6,-75.0
90,55,4,3,16,-13,-81.25
90,55,5,68,32,36,112.5
90,55,6,66,64,2,3.125
90,55,7,41,128,-87,-67.96875
90,55,8,52,256,-204,-79.6875
90,55,9,269,512,-243,-47.4609375
90,55,10,875,1024,-149,-14.55078125
90,55,11,2100,2048,52,2.5390625
90,55,12,1431,4096,-2665,-65.0634765625
90,55,13,5312,8192,-2880,-35.15625
90,55,14,9798,16384,-6586,-40.19775390625
90,55,15,129247,32768,96479,294.4305419921875
90,56,1,0,2,-2,-100.0
90,56,2,1,4,-3,-75.0
90,56,3,11,8,3,37.5
90,56,4,3,16,-13,-81.25
90,56,5,12,32,-20,-62.5
90,56,6,60,64,-4,-6.25
90,56,7,43,128,-85,-66.40625
90,56,8,285,256,29,11.328125
90,56,9,1278,512,766,149.609375
90,56,10,1615,1024,591,57.71484375
90,56,11,847,2048,-1201,-58.642578125
90,56,12,2345,4096,-1751,-42.7490234375
90,56,13,8049,8192,-143,-1.74560546875
90,56,14,30572,16384,14188,86.5966796875
90,56,15,6915,32768,-25853,-78.8970947265625
90,57,1,0,2,-2,-100.0
90,57,2,3,4,-1,-25.0
90,57,3,3,8,-5,-62.5
90,57,4,7,16,-9,-56.25
90,57,5,13,32,-19,-59.375
90,57,6,25,64,-39,-60.9375
90,57,7,56,128,-72,-56.25
90,57,8,22,256,-234,-91.40625
90,57,9,679,512,167,32.6171875
90,57,10,282,1024,-742,-72.4609375
90,57,11,351,2048,-1697,-82.861328125
90,57,12,1528,4096,-2568,-62.6953125
90,57,13,10523,8192,2331,28.45458984375
90,57,14,9701,16384,-6683,-40.789794921875
90,57,15,17451,32768,-15317,-46.7437744140625
90,58,1,0,2,-2,-100.0
90,58,2,3,4,-1,-25.0
90,58,3,16,8,8,100.0
90,58,4,31,16,15,93.75
90,58,5,32,32,0,0.0
90,58,6,98,64,34,53.125
90,58,7,139,128,11,8.59375
90,58,8,22,256,-234,-91.40625
90,58,9,951,512,439,85.7421875
90,58,10,1296,1024,272,26.5625
90,58,11,1490,2048,-558,-27.24609375
90,58,12,1086,4096,-3010,-73.486328125
90,58,13,652,8192,-7540,-92.041015625
90,58,14,6479,16384,-9905,-60.455322265625
90,58,15,54305,32768,21537,65.7257080078125
90,59,1,0,2,-2,-100.0
90,59,2,1,4,-3,-75.0
90,59,3,12,8,4,50.0
90,59,4,14,16,-2,-12.5
90,59,5,28,32,-4,-12.5
90,59,6,229,64,165,257.8125
90,59,7,602,128,474,370.3125
90,59,8,139,256,-117,-45.703125
90,59,9,1482,512,970,189.453125
90,59,10,1480,1024,456,44.53125
90,59,11,2368,2048,320,15.625
90,59,12,888,4096,-3208,-78.3203125
90,59,13,2411,8192,-5781,-70.56884765625
90,59,14,4362,16384,-12022,-73.37646484375
90,59,15,18385,32768,-14383,-43.8934326171875
90,60,1,0,2,-2,-100.0
90,60,2,2,4,-2,-50.0
90,60,3,8,8,0,0.0
90,60,4,15,16,-1,-6.25
90,60,5,67,32,35,109.375
90,60,6,83,64,19,29.6875
90,60,7,72,128,-56,-43.75
90,60,8,365,256,109,42.578125
90,60,9,213,512,-299,-58.3984375
90,60,10,1783,1024,759,74.12109375
90,60,11,2028,2048,-20,-0.9765625
90,60,12,2596,4096,-1500,-36.62109375
90,60,13,4288,8192,-3904,-47.65625
90,60,14,4308,16384,-12076,-73.7060546875
90,60,15,60196,32768,27428,83.70361328125
90,61,1,0,2,-2,-100.0
90,61,2,1,4,-3,-75.0
90,61,3,3,8,-5,-62.5
90,61,4,6,16,-10,-62.5
90,61,5,11,32,-21,-65.625
90,61,6,11,64,-53,-82.8125
90,61,7,201,128,73,57.03125
90,61,8,128,256,-128,-50.0
90,61,9,471,512,-41,-8.0078125
90,61,10,228,1024,-796,-77.734375
90,61,11,101,2048,-1947,-95.068359375
90,61,12,1051,4096,-3045,-74.3408203125
90,61,13,227,8192,-7965,-97.22900390625
90,61,14,16607,16384,223,1.361083984375
90,61,15,73059,32768,40291,122.9583740234375
90,62,1,0,2,-2,-100.0
90,62,2,4,4,0,0.0
90,62,3,7,8,-1,-12.5
90,62,4,3,16,-13,-81.25
90,62,5,101,32,69,215.625
90,62,6,45,64,-19,-29.6875
90,62,7,85,128,-43,-33.59375
90,62,8,9,256,-247,-96.484375
90,62,9,229,512,-283,-55.2734375
90,62,10,835,1024,-189,-18.45703125
90,62,11,2146,2048,98,4.78515625
90,62,12,686,4096,-3410,-83.251953125
90,62,13,5183,8192,-3009,-36.73095703125
90,62,14,4502,16384,-11882,-72.52197265625
90,62,15,24993,32768,-7775,-23.7274169921875
90,63,1,0,2,-2,-100.0
90,63,2,4,4,0,0.0
90,63,3,10,8,2,25.0
90,63,4,8,16,-8,-50.0
90,63,5,19,32,-13,-40.625
90,63,6,12,64,-52,-81.25
90,63,7,236,128,108,84.375
90,63,8,17,256,-239,-93.359375
90,63,9,369,512,-143,-27.9296875
90,63,10,907,1024,-117,-11.42578125
90,63,11,912,2048,-1136,-55.46875
90,63,12,14143,4096,10047,245.2880859375
90,63,13,5382,8192,-2810,-34.3017578125
90,63,14,36161,16384,19777,120.709228515625
90,63,15,25563,32768,-7205,-21.9879150390625
90,64,1,0,2,-2,-100.0
90,64,2,2,4,-2,-50.0
90,64,3,4,8,-4,-50.0
90,64,4,3,16,-13,-81.25
90,64,5,27,32,-5,-15.625
90,64,6,29,64,-35,-54.6875
90,64,7,6,128,-122,-95.3125
90,64,8,14,256,-242,-94.53125
90,64,9,170,512,-342,-66.796875
90,64,10,2056,1024,1032,100.78125
90,64,11,1644,2048,-404,-19.7265625
90,64,12,4238,4096,142,3.466796875
90,64,13,2079,8192,-6113,-74.62158203125
90,64,14,11271,16384,-5113,-31.207275390625
90,64,15,67255,32768,34487,105.2459716796875
90,65,1,0,2,-2,-100.0
90,65,2,3,4,-1,-25.0
90,65,3,11,8,3,37.5
90,65,4,19,16,3,18.75
90,65,5,10,32,-22,-68.75
90,65,6,17,64,-47,-73.4375
90,65,7,113,128,-15,-11.71875
90,65,8,18,256,-238,-92.96875
90,65,9,22,512,-490,-95.703125
90,65,10,1616,1024,592,57.8125
90,65,11,2379,2048,331,16.162109375
90,65,12,7376,4096,3280,80.078125
90,65,13,8390,8192,198,2.4169921875
90,65,14,8722,16384,-7662,-46.76513671875
90,65,15,25966,32768,-6802,-20.758056640625
90,66,1,0,2,-2,-100.0
90,66,2,1,4,-3,-75.0
90,66,3,14,8,6,75.0
90,66,4,26,16,10,62.5
90,66,5,16,32,-16,-50.0
90,66,6,151,64,87,135.9375
90,66,7,73,128,-55,-42.96875
90,66,8,19,256,-237,-92.578125
90,66,9,1043,512,531,103.7109375
90,66,10,1353,1024,329,32.12890625
90,66,11,1048,2048,-1000,-48.828125
90,66,12,905,4096,-3191,-77.9052734375
90,66,13,12558,8192,4366,53.2958984375
90,66,14,26033,16384,9649,58.892822265625
90,66,15,8807,32768,-23961,-73.1231689453125
90,67,1,0,2,-2,-100.0
90,67,2,1,4,-3,-75.0
90,67,3,11,8,3,37.5
90,67,4,19,16,3,18.75
90,67,5,6,32,-26,-81.25
90,67,6,6,64,-58,-90.625
90,67,7,125,128,-3,-2.34375
90,67,8,34,256,-222,-86.71875
90,67,9,1687,512,1175,229.4921875
90,67,10,4333,1024,3309,323.14453125
90,67,11,1107,2048,-941,-45.947265625
90,67,12,1728,4096,-2368,-57.8125
90,67,13,2376,8192,-5816,-70.99609375
90,67,14,67690,16384,51306,313.14697265625
90,67,15,4166,32768,-28602,-87.286376953125
90,68,1,0,2,-2,-100.0
90,68,2,2,4,-2,-50.0
90,68,3,13,8,5,62.5
90,68,4,27,16,11,68.75
90,68,5,7,32,-25,-78.125
90,68,6,105,64,41,64.0625
90,68,7,88,128,-40,-31.25
90,68,8,114,256,-142,-55.46875
90,68,9,1348,512,836,163.28125
90,68,10,14,1024,-1010,-98.6328125
90,68,11,1552,2048,-496,-24.21875
90,68,12,1907,4096,-2189,-53.4423828125
90,68,13,3166,8192,-5026,-61.3525390625
90,68,14,19774,16384,3390,20.69091796875
90,68,15,84287,32768,51519,157.2235107421875
90,69,1,0,2,-2,-100.0
90,69,2,1,4,-3,-75.0
90,69,3,5,8,-3,-37.5
90,69,4,9,16,-7,-43.75
90,69,5,94,32,62,193.75
90,69,6,38,64,-26,-40.625
90,69,7,65,128,-63,-49.21875
90,69,8,181,256,-75,-29.296875
90,69,9,522,512,10,1.953125
90,69,10,469,1024,-555,-54.19921875
90,69,11,1966,2048,-82,-4.00390625
90,69,12,4656,4096,560,13.671875
90,69,13,12372,8192,4180,51.025390625
90,69,14,39153,16384,22769,138.970947265625
90,69,15,4816,32768,-27952,-85.302734375
90,70,1,0,2,-2,-100.0
90,70,2,3,4,-1,-25.0
90,70,3,13,8,5,62.5
90,70,4,13,16,-3,-18.75
90,70,5,63,32,31,96.875
90,70,6,76,64,12,18.75
90,70,7,78,128,-50,-39.0625
90,70,8,77,256,-179,-69.921875
90,70,9,114,512,-398,-77.734375
90,70,10,162,1024,-862,-84.1796875
90,70,11,3016,2048,968,47.265625
90,70,12,1617,4096,-2479,-60.5224609375
90,70,13,35074,8192,26882,328.1494140625
90,70,14,3933,16384,-12451,-75.994873046875
90,70,15,7287,32768,-25481,-77.7618408203125
90,71,1,0,2,-2,-100.0
90,71,2,2,4,-2,-50.0
90,71,3,5,8,-3,-37.5
90,71,4,13,16,-3,-18.75
90,71,5,13,32,-19,-59.375
90,71,6,227,64,163,254.6875
90,71,7,366,128,238,185.9375
90,71,8,38,256,-218,-85.15625
90,71,9,1441,512,929,181.4453125
90,71,10,776,1024,-248,-24.21875
90,71,11,455,2048,-1593,-77.783203125
90,71,12,9883,4096,5787,141.2841796875
90,71,13,9538,8192,1346,16.4306640625
90,71,14,2409,16384,-13975,-85.296630859375
90,71,15,19546,32768,-13222,-40.350341796875
90,72,1,0,2,-2,-100.0
90,72,2,2,4,-2,-50.0
90,72,3,18,8,10,125.0
90,72,4,3,16,-13,-81.25
90,72,5,17,32,-15,-46.875
90,72,6,9,64,-55,-85.9375
90,72,7,279,128,151,117.96875
90,72,8,173,256,-83,-32.421875
90,72,9,604,512,92,17.96875
90,72,10,308,1024,-716,-69.921875
90,72,11,1266,2048,-782,-38.18359375
90,72,12,3252,4096,-844,-20.60546875
90,72,13,4454,8192,-3738,-45.6298828125
90,72,14,10623,16384,-5761,-35.162353515625
90,72,15,6732,32768,-26036,-79.45556640625
90,73,1,0,2,-2,-100.0
90,73,2,3,4,-1,-25.0
90,73,3,2,8,-6,-75.0
90,73,4,10,16,-6,-37.5
90,73,5,4,32,-28,-87.5
90,73,6,46,64,-18,-28.125
90,73,7,74,128,-54,-42.1875
90,73,8,75,256,-181,-70.703125
90,73,9,1286,512,774,151.171875
90,73,10,1419,1024,395,38.57421875
90,73,11,4551,2048,2503,122.216796875
90,73,12,171,4096,-3925,-95.8251953125
90,73,13,1249,8192,-6943,-84.75341796875
90,73,14,12453,16384,-3931,-23.992919921875
90,73,15,565,32768,-32203,-98.2757568359375
90,74,1,0,2,-2,-100.0
90,74,2,1,4,-3,-75.0
90,74,3,5,8,-3,-37.5
90,74,4,4,16,-12,-75.0
90,74,5,4,32,-28,-87.5
90,74,6,86,64,22,34.375
90,74,7,11,128,-117,-91.40625
90,74,8,260,256,4,1.5625
90,74,9,1209,512,697,136.1328125
90,74,10,389,1024,-635,-62.01171875
90,74,11,4704,2048,2656,129.6875
90,74,12,4294,4096,198,4.833984375
90,74,13,1815,8192,-6377,-77.84423828125
90,74,14,12117,16384,-4267,-26.043701171875
90,74,15,21077,32768,-11691,-35.6781005859375
90,75,1,0,2,-2,-100.0
90,75,2,6,4,2,50.0
90,75,3,9,8,1,12.5
90,75,4,34,16,18,112.5
90,75,5,21,32,-11,-34.375
90,75,6,66,64,2,3.125
90,75,7,353,128,225,175.78125
90,75,8,34,256,-222,-86.71875
90,75,9,1435,512,923,180.2734375
90,75,10,824,1024,-200,-19.53125
90,75,11,3672,2048,1624,79.296875
90,75,12,10470,4096,6374,155.615234375
90,75,13,321,8192,-7871,-96.08154296875
90,75,14,11925,16384,-4459,-27.215576171875
90,75,15,56998,32768,24230,73.944091796875
90,76,1,0,2,-2,-100.0
90,76,2,2,4,-2,-50.0
90,76,3,4,8,-4,-50.0
90,76,4,11,16,-5,-31.25
90,76,5,24,32,-8,-25.0
90,76,6,25,64,-39,-60.9375
90,76,7,10,128,-118,-92.1875
90,76,8,437,256,181,70.703125
90,76,9,343,512,-169,-33.0078125
90,76,10,638,1024,-386,-37.6953125
90,76,11,876,2048,-1172,-57.2265625
90,76,12,6637,4096,2541,62.0361328125
90,76,13,14864,8192,6672,81.4453125
90,76,14,9932,16384,-6452,-39.3798828125
90,76,15,19776,32768,-12992,-39.6484375
90,77,1,0,2,-2,-100.0
90,77,2,1,4,-3,-75.0
90,77,3,5,8,-3,-37.5
90,77,4,7,16,-9,-56.25
90,77,5,21,32,-11,-34.375
90,77,6,28,64,-36,-56.25
90,77,7,190,128,62,48.4375
90,77,8,408,256,152,59.375
90,77,9,472,512,-40,-7.8125
90,77,10,438,1024,-586,-57.2265625
90,77,11,6979,2048,4931,240.771484375
90,77,12,2978,4096,-1118,-27.294921875
90,77,13,1398,8192,-6794,-82.9345703125
90,77,14,25623,16384,9239,56.390380859375
90,77,15,67631,32768,34863,106.3934326171875
90,78,1,0,2,-2,-100.0
90,78,2,1,4,-3,-75.0
90,78,3,2,8,-6,-75.0
90,78,4,43,16,27,168.75
90,78,5,35,32,3,9.375
90,78,6,129,64,65,101.5625
90,78,7,159,128,31,24.21875
90,78,8,42,256,-214,-83.59375
90,78,9,67,512,-445,-86.9140625
90,78,10,1626,1024,602,58.7890625
90,78,11,98,2048,-1950,-95.21484375
90,78,12,3346,4096,-750,-18.310546875
90,78,13,2356,8192,-5836,-71.240234375
90,78,14,5891,16384,-10493,-64.044189453125
90,78,15,189930,32768,157162,479.620361328125
90,79,1,0,2,-2,-100.0
90,79,2,1,4,-3,-75.0
90,79,3,3,8,-5,-62.5
90,79,4,14,16,-2,-12.5
90,79,5,25,32,-7,-21.875
90,79,6,30,64,-34,-53.125
90,79,7,64,128,-64,-50.0
90,79,8,143,256,-113,-44.140625
90,79,9,64,512,-448,-87.5
90,79,10,27,1024,-997,-97.36328125
90,79,11,3890,2048,1842,89.94140625
90,79,12,5207,4096,1111,27.1240234375
90,79,13,2634,8192,-5558,-67.8466796875
90,79,14,62709,16384,46325,282.745361328125
90,79,15,14846,32768,-17922,-54.693603515625
90,80,1,0,2,-2,-100.0
90,80,2,1,4,-3,-75.0
90,80,3,17,8,9,112.5
90,80,4,24,16,8,50.0
90,80,5,18,32,-14,-43.75
90,80,6,127,64,63,98.4375
90,80,7,209,128,81,63.28125
90,80,8,22,256,-234,-91.40625
90,80,9,58,512,-454,-88.671875
90,80,10,5137,1024,4113,401.66015625
90,80,11,1567,2048,-481,-23.486328125
90,80,12,490,4096,-3606,-88.037109375
90,80,13,581,8192,-7611,-92.90771484375
90,80,14,37,16384,-16347,-99.774169921875
90,80,15,13890,32768,-18878,-57.611083984375
90,81,1,0,2,-2,-100.0
90,81,2,3,4,-1,-25.0
90,81,3,3,8,-5,-62.5
90,81,4,5,16,-11,-68.75
90,81,5,13,32,-19,-59.375
90,81,6,81,64,17,26.5625
90,81,7,30,128,-98,-76.5625
90,81,8,29,256,-227,-88.671875
90,81,9,1922,512,1410,275.390625
90,81,10,285,1024,-739,-72.16796875
90,81,11,274,2048,-1774,-86.62109375
90,81,12,6740,4096,2644,64.55078125
90,81,13,10739,8192,2547,31.09130859375
90,81,14,7760,16384,-8624,-52.63671875
90,81,15,16811,32768,-15957,-48.6968994140625
90,82,1,0,2,-2,-100.0
90,82,2,1,4,-3,-75.0
90,82,3,14,8,6,75.0
90,82,4,7,16,-9,-56.25
90,82,5,13,32,-19,-59.375
90,82,6,77,64,13,20.3125
90,82,7,156,128,28,21.875
90,82,8,225,256,-31,-12.109375
90,82,9,297,512,-215,-41.9921875
90,82,10,1217,1024,193,18.84765625
90,82,11,2110,2048,62,3.02734375
90,82,12,6671,4096,2575,62.8662109375
90,82,13,54,8192,-8138,-99.3408203125
90,82,14,9663,16384,-6721,-41.021728515625
90,82,15,20264,32768,-12504,-38.1591796875
90,83,1,0,2,-2,-100.0
90,83,2,3,4,-1,-25.0
90,83,3,8,8,0,0.0
90,83,4,12,16,-4,-25.0
90,83,5,148,32,116,362.5
90,83,6,107,64,43,67.1875
90,83,7,217,128,89,69.53125
90,83,8,115,256,-141,-55.078125
90,83,9,531,512,19,3.7109375
90,83,10,134,1024,-890,-86.9140625
90,83,11,189,2048,-1859,-90.771484375
90,83,12,1260,4096,-2836,-69.23828125
90,83,13,574,8192,-7618,-92.9931640625
90,83,14,50883,16384,34499,210.565185546875
90,83,15,4558,32768,-28210,-86.090087890625
90,84,1,0,2,-2,-100.0
90,84,2,1,4,-3,-75.0
90,84,3,8,8,0,0.0
90,84,4,3,16,-13,-81.25
90,84,5,40,32,8,25.0
90,84,6,16,64,-48,-75.0
90,84,7,20,128,-108,-84.375
90,84,8,15,256,-241,-94.140625
90,84,9,311,512,-201,-39.2578125
90,84,10,1600,1024,576,56.25
90,84,11,318,2048,-1730,-84.47265625
90,84,12,41,4096,-4055,-98.9990234375
90,84,13,5634,8192,-2558,-31.2255859375
90,84,14,9816,16384,-6568,-40.087890625
90,84,15,6828,32768,-25940,-79.16259765625
90,85,1,0,2,-2,-100.0
90,85,2,2,4,-2,-50.0
90,85,3,3,8,-5,-62.5
90,85,4,42,16,26,162.5
90,85,5,6,32,-26,-81.25
90,85,6,44,64,-20,-31.25
90,85,7,42,128,-86,-67.1875
90,85,8,56,256,-200,-78.125
90,85,9,379,512,-133,-25.9765625
90,85,10,487,1024,-537,-52.44140625
90,85,11,2935,2048,887,43.310546875
90,85,12,4135,4096,39,0.9521484375
90,85,13,1856,8192,-6336,-77.34375
90,85,14,9057,16384,-7327,-44.720458984375
90,85,15,54520,32768,21752,66.3818359375
90,86,1,0,2,-2,-100.0
90,86,2,1,4,-3,-75.0
90,86,3,4,8,-4,-50.0
90,86,4,3,16,-13,-81.25
90,86,5,19,32,-13,-40.625
90,86,6,25,64,-39,-60.9375
90,86,7,132,128,4,3.125
90,86,8,179,256,-77,-30.078125
90,86,9,15,512,-497,-97.0703125
90,86,10,816,1024,-208,-20.3125
90,86,11,4828,2048,2780,135.7421875
90,86,12,1634,4096,-2462,-60.107421875
90,86,13,3134,8192,-5058,-61.7431640625
90,86,14,40705,16384,24321,148.443603515625
90,86,15,14865,32768,-17903,-54.6356201171875
90,87,1,0,2,-2,-100.0
90,87,2,4,4,0,0.0
90,87,3,9,8,1,12.5
90,87,4,42,16,26,162.5
90,87,5,25,32,-7,-21.875
90,87,6,67,64,3,4.6875
90,87,7,181,128,53,41.40625
90,87,8,449,256,193,75.390625
90,87,9,307,512,-205,-40.0390625
90,87,10,429,1024,-595,-58.10546875
90,87,11,2323,2048,275,13.427734375
90,87,12,7344,4096,3248,79.296875
90,87,13,13451,8192,5259,64.19677734375
90,87,14,739,16384,-15645,-95.489501953125
90,87,15,67385,32768,34617,105.6427001953125
90,88,1,0,2,-2,-100.0
90,88,2,1,4,-3,-75.0
90,88,3,4,8,-4,-50.0
90,88,4,9,16,-7,-43.75
90,88,5,29,32,-3,-9.375
90,88,6,101,64,37,57.8125
90,88,7,55,128,-73,-57.03125
90,88,8,100,256,-156,-60.9375
90,88,9,402,512,-110,-21.484375
90,88,10,776,1024,-248,-24.21875
90,88,11,2174,2048,126,6.15234375
90,88,12,4455,4096,359,8.7646484375
90,88,13,5477,8192,-2715,-33.14208984375
90,88,14,24146,16384,7762,47.37548828125
90,88,15,5408,32768,-27360,-83.49609375
90,89,1,0,2,-2,-100.0
90,89,2,2,4,-2,-50.0
90,89,3,5,8,-3,-37.5
90,89,4,6,16,-10,-62.5
90,89,5,14,32,-18,-56.25
90,89,6,319,64,255,398.4375
90,89,7,125,128,-3,-2.34375
90,89,8,154,256,-102,-39.84375
90,89,9,629,512,117,22.8515625
90,89,10,401,1024,-623,-60.83984375
90,89,11,5592,2048,3544,173.046875
90,89,12,1934,4096,-2162,-52.783203125
90,89,13,5627,8192,-2565,-31.31103515625
90,89,14,12183,16384,-4201,-25.640869140625
90,89,15,56981,32768,24213,73.8922119140625
90,90,1,0,2,-2,-100.0
90,90,2,1,4,-3,-75.0
90,90,3,6,8,-2,-25.0
90,90,4,7,16,-9,-56.25
90,90,5,11,32,-21,-65.625
90,90,6,29,64,-35,-54.6875
90,90,7,6,128,-122,-95.3125
90,90,8,165,256,-91,-35.546875
90,90,9,1011,512,499,97.4609375
90,90,10,1628,1024,604,58.984375
90,90,11,5489,2048,3441,168.017578125
90,90,12,3887,4096,-209,-5.1025390625
90,90,13,3680,8192,-4512,-55.078125
90,90,14,1848,16384,-14536,-88.720703125
90,90,15,37146,32768,4378,13.360595703125
91,1,1,0,2,-2,-100.0
91,1,2,2,4,-2,-50.0
91,1,3,6,8,-2,-25.0
91,1,4,67,16,51,318.75
91,1,5,44,32,12,37.5
91,1,6,15,64,-49,-76.5625
91,1,7,34,128,-94,-73.4375
91,1,8,176,256,-80,-31.25
91,1,9,332,512,-180,-35.15625
91,1,10,5714,1024,4690,458.0078125
91,1,11,6121,2048,4073,198.876953125
91,1,12,7443,4096,3347,81.7138671875
91,1,13,3131,8192,-5061,-61.77978515625
91,1,14,454,16384,-15930,-97.22900390625
91,1,15,5511,32768,-27257,-83.1817626953125
91,2,1,0,2,-2,-100.0
91,2,2,1,4,-3,-75.0
91,2,3,3,8,-5,-62.5
91,2,4,19,16,3,18.75
91,2,5,8,32,-24,-75.0
91,2,6,54,64,-10,-15.625
91,2,7,25,128,-103,-80.46875
91,2,8,59,256,-197,-76.953125
91,2,9,265,512,-247,-48.2421875
91,2,10,43,1024,-981,-95.80078125
91,2,11,517,2048,-1531,-74.755859375
91,2,12,6597,4096,2501,61.0595703125
91,2,13,13731,8192,5539,67.61474609375
91,2,14,24098,16384,7714,47.08251953125
91,2,15,1106,32768,-31662,-96.624755859375
91,3,1,0,2,-2,-100.0
91,3,2,3,4,-1,-25.0
91,3,3,7,8,-1,-12.5
91,3,4,21,16,5,31.25
91,3,5,6,32,-26,-81.25
91,3,6,37,64,-27,-42.1875
91,3,7,153,128,25,19.53125
91,3,8,9,256,-247,-96.484375
91,3,9,525,512,13,2.5390625
91,3,10,512,1024,-512,-50.0
91,3,11,772,2048,-1276,-62.3046875
91,3,12,2458,4096,-1638,-39.990234375
91,3,13,15229,8192,7037,85.90087890625
91,3,14,87,16384,-16297,-99.468994140625
91,3,15,30393,32768,-2375,-7.2479248046875
91,4,1,0,2,-2,-100.0
91,4,2,3,4,-1,-25.0
91,4,3,2,8,-6,-75.0
91,4,4,19,16,3,18.75
91,4,5,19,32,-13,-40.625
91,4,6,50,64,-14,-21.875
91,4,7,52,128,-76,-59.375
91,4,8,102,256,-154,-60.15625
91,4,9,341,512,-171,-33.3984375
91,4,10,1682,1024,658,64.2578125
91,4,11,597,2048,-1451,-70.849609375
91,4,12,7861,4096,3765,91.9189453125
91,4,13,8128,8192,-64,-0.78125
91,4,14,15455,16384,-929,-5.670166015625
91,4,15,626,32768,-32142,-98.089599609375
91,5,1,0,2,-2,-100.0
91,5,2,4,4,0,0.0
91,5,3,5,8,-3,-37.5
91,5,4,7,16,-9,-56.25
91,5,5,16,32,-16,-50.0
91,5,6,70,64,6,9.375
91,5,7,60,128,-68,-53.125
91,5,8,44,256,-212,-82.8125
91,5,9,348,512,-164,-32.03125
91,5,10,1604,1024,580,56.640625
91,5,11,2593,2048,545,26.611328125
91,5,12,794,4096,-3302,-80.615234375
91,5,13,8490,8192,298,3.6376953125
91,5,14,29901,16384,13517,82.501220703125
91,5,15,38528,32768,5760,17.578125
91,6,1,0,2,-2,-100.0
91,6,2,4,4,0,0.0
91,6,3,7,8,-1,-12.5
91,6,4,11,16,-5,-31.25
91,6,5,9,32,-23,-71.875
91,6,6,61,64,-3,-4.6875
91,6,7,45,128,-83,-64.84375
91,6,8,437,256,181,70.703125
91,6,9,372,512,-140,-27.34375
91,6,10,1322,1024,298,29.1015625
91,6,11,558,2048,-1490,-72.75390625
91,6,12,3588,4096,-508,-12.40234375
91,6,13,5920,8192,-2272,-27.734375
91,6,14,14044,16384,-2340,-14.2822265625
91,6,15,711,32768,-32057,-97.8302001953125
91,7,1,0,2,-2,-100.0
91,7,2,1,4,-3,-75.0
91,7,3,10,8,2,25.0
91,7,4,19,16,3,18.75
91,7,5,10,32,-22,-68.75
91,7,6,53,64,-11,-17.1875
91,7,7,152,128,24,18.75
91,7,8,399,256,143,55.859375
91,7,9,1076,512,564,110.15625
91,7,10,456,1024,-568,-55.46875
91,7,11,147,2048,-1901,-92.822265625
91,7,12,1646,4096,-2450,-59.814453125
91,7,13,6227,8192,-1965,-23.98681640625
91,7,14,698,16384,-15686,-95.73974609375
91,7,15,33375,32768,607,1.8524169921875
91,8,1,0,2,-2,-100.0
91,8,2,1,4,-3,-75.0
91,8,3,12,8,4,50.0
91,8,4,6,16,-10,-62.5
91,8,5,11,32,-21,-65.625
91,8,6,192,64,128,200.0
91,8,7,7,128,-121,-94.53125
91,8,8,412,256,156,60.9375
91,8,9,1972,512,1460,285.15625
91,8,10,979,1024,-45,-4.39453125
91,8,11,843,2048,-1205,-58.837890625
91,8,12,6525,4096,2429,59.3017578125
91,8,13,10114,8192,1922,23.4619140625
91,8,14,4949,16384,-11435,-69.793701171875
91,8,15,6700,32768,-26068,-79.55322265625
91,9,1,0,2,-2,-100.0
91,9,2,2,4,-2,-50.0
91,9,3,5,8,-3,-37.5
91,9,4,12,16,-4,-25.0
91,9,5,4,32,-28,-87.5
91,9,6,38,64,-26,-40.625
91,9,7,162,128,34,26.5625
91,9,8,133,256,-123,-48.046875
91,9,9,167,512,-345,-67.3828125
91,9,10,628,1024,-396,-38.671875
91,9,11,343,2048,-1705,-83.251953125
91,9,12,5281,4096,1185,28.9306640625
91,9,13,1766,8192,-6426,-78.4423828125
91,9,14,758,16384,-15626,-95.37353515625
91,9,15,27010,32768,-5758,-17.572021484375
91,10,1,0,2,-2,-100.0
91,10,2,1,4,-3,-75.0
91,10,3,5,8,-3,-37.5
91,10,4,15,16,-1,-6.25
91,10,5,23,32,-9,-28.125
91,10,6,73,64,9,14.0625
91,10,7,98,128,-30,-23.4375
91,10,8,222,256,-34,-13.28125
91,10,9,481,512,-31,-6.0546875
91,10,10,364,1024,-660,-64.453125
91,10,11,2220,2048,172,8.3984375
91,10,12,3944,4096,-152,-3.7109375
91,10,13,16411,8192,8219,100.32958984375
91,10,14,1115,16384,-15269,-93.194580078125
91,10,15,54959,32768,22191,67.7215576171875
91,11,1,0,2,-2,-100.0
91,11,2,7,4,3,75.0
91,11,3,2,8,-6,-75.0
91,11,4,18,16,2,12.5
91,11,5,5,32,-27,-84.375
91,11,6,305,64,241,376.5625
91,11,7,93,128,-35,-27.34375
91,11,8,347,256,91,35.546875
91,11,9,154,512,-358,-69.921875
91,11,10,698,1024,-326,-31.8359375
91,11,11,1557,2048,-491,-23.974609375
91,11,12,851,4096,-3245,-79.2236328125
91,11,13,1100,8192,-7092,-86.572265625
91,11,14,15166,16384,-1218,-7.43408203125
91,11,15,105909,32768,73141,223.2086181640625
91,12,1,0,2,-2,-100.0
91,12,2,1,4,-3,-75.0
91,12,3,16,8,8,100.0
91,12,4,3,16,-13,-81.25
91,12,5,41,32,9,28.125
91,12,6,160,64,96,150.0
91,12,7,215,128,87,67.96875
91,12,8,126,256,-130,-50.78125
91,12,9,1228,512,716,139.84375
91,12,10,375,1024,-649,-63.37890625
91,12,11,3341,2048,1293,63.134765625
91,12,12,278,4096,-3818,-93.212890625
91,12,13,7213,8192,-979,-11.95068359375
91,12,14,27735,16384,11351,69.281005859375
91,12,15,22396,32768,-10372,-31.65283203125
91,13,1,0,2,-2,-100.0
91,13,2,1,4,-3,-75.0
91,13,3,10,8,2,25.0
91,13,4,5,16,-11,-68.75
91,13,5,8,32,-24,-75.0
91,13,6,112,64,48,75.0
91,13,7,63,128,-65,-50.78125
91,13,8,25,256,-231,-90.234375
91,13,9,2176,512,1664,325.0
91,13,10,1095,1024,71,6.93359375
91,13,11,6012,2048,3964,193.5546875
91,13,12,1813,4096,-2283,-55.7373046875
91,13,13,4293,8192,-3899,-47.59521484375
91,13,14,6901,16384,-9483,-57.879638671875
91,13,15,63547,32768,30779,93.9300537109375
91,14,1,0,2,-2,-100.0
91,14,2,8,4,4,100.0
91,14,3,3,8,-5,-62.5
91,14,4,3,16,-13,-81.25
91,14,5,52,32,20,62.5
91,14,6,17,64,-47,-73.4375
91,14,7,59,128,-69,-53.90625
91,14,8,193,256,-63,-24.609375
91,14,9,1277,512,765,149.4140625
91,14,10,1802,1024,778,75.9765625
91,14,11,377,2048,-1671,-81.591796875
91,14,12,985,4096,-3111,-75.9521484375
91,14,13,671,8192,-7521,-91.80908203125
91,14,14,26644,16384,10260,62.6220703125
91,14,15,14972,32768,-17796,-54.30908203125
91,15,1,0,2,-2,-100.0
91,15,2,1,4,-3,-75.0
91,15,3,3,8,-5,-62.5
91,15,4,3,16,-13,-81.25
91,15,5,57,32,25,78.125
91,15,6,33,64,-31,-48.4375
91,15,7,52,128,-76,-59.375
91,15,8,191,256,-65,-25.390625
91,15,9,421,512,-91,-17.7734375
91,15,10,5192,1024,4168,407.03125
91,15,11,131,2048,-1917,-93.603515625
91,15,12,1909,4096,-2187,-53.3935546875
91,15,13,2115,8192,-6077,-74.18212890625
91,15,14,8148,16384,-8236,-50.2685546875
91,15,15,2997,32768,-29771,-90.8538818359375
91,16,1,0,2,-2,-100.0
91,16,2,7,4,3,75.0
91,16,3,3,8,-5,-62.5
91,16,4,9,16,-7,-43.75
91,16,5,34,32,2,6.25
91,16,6,8,64,-56,-87.5
91,16,7,134,128,6,4.6875
91,16,8,179,256,-77,-30.078125
91,16,9,406,512,-106,-20.703125
91,16,10,726,1024,-298,-29.1015625
91,16,11,4593,2048,2545,124.267578125
91,16,12,4652,4096,556,13.57421875
91,16,13,6434,8192,-1758,-21.4599609375
91,16,14,16710,16384,326,1.98974609375
91,16,15,5019,32768,-27749,-84.6832275390625
91,17,1,0,2,-2,-100.0
91,17,2,1,4,-3,-75.0
91,17,3,3,8,-5,-62.5
91,17,4,4,16,-12,-75.0
91,17,5,26,32,-6,-18.75
91,17,6,35,64,-29,-45.3125
91,17,7,10,128,-118,-92.1875
91,17,8,260,256,4,1.5625
91,17,9,141,512,-371,-72.4609375
91,17,10,388,1024,-636,-62.109375
91,17,11,6547,2048,4499,219.677734375
91,17,12,4541,4096,445,10.8642578125
91,17,13,26134,8192,17942,219.0185546875
91,17,14,19225,16384,2841,17.340087890625
91,17,15,40970,32768,8202,25.030517578125
91,18,1,0,2,-2,-100.0
91,18,2,1,4,-3,-75.0
91,18,3,10,8,2,25.0
91,18,4,5,16,-11,-68.75
91,18,5,5,32,-27,-84.375
91,18,6,66,64,2,3.125
91,18,7,52,128,-76,-59.375
91,18,8,169,256,-87,-33.984375
91,18,9,1313,512,801,156.4453125
91,18,10,477,1024,-547,-53.41796875
91,18,11,789,2048,-1259,-61.474609375
91,18,12,6314,4096,2218,54.150390625
91,18,13,607,8192,-7585,-92.59033203125
91,18,14,9460,16384,-6924,-42.2607421875
91,18,15,5215,32768,-27553,-84.0850830078125
91,19,1,0,2,-2,-100.0
91,19,2,1,4,-3,-75.0
91,19,3,5,8,-3,-37.5
91,19,4,29,16,13,81.25
91,19,5,18,32,-14,-43.75
91,19,6,37,64,-27,-42.1875
91,19,7,33,128,-95,-74.21875
91,19,8,87,256,-169,-66.015625
91,19,9,214,512,-298,-58.203125
91,19,10,637,1024,-387,-37.79296875
91,19,11,843,2048,-1205,-58.837890625
91,19,12,447,4096,-3649,-89.0869140625
91,19,13,4156,8192,-4036,-49.267578125
91,19,14,10106,16384,-6278,-38.31787109375
91,19,15,27833,32768,-4935,-15.0604248046875
91,20,1,0,2,-2,-100.0
91,20,2,2,4,-2,-50.0
91,20,3,13,8,5,62.5
91,20,4,25,16,9,56.25
91,20,5,4,32,-28,-87.5
91,20,6,259,64,195,304.6875
91,20,7,111,128,-17,-13.28125
91,20,8,272,256,16,6.25
91,20,9,1505,512,993,193.9453125
91,20,10,305,1024,-719,-70.21484375
91,20,11,3119,2048,1071,52.294921875
91,20,12,2118,4096,-1978,-48.291015625
91,20,13,2402,8192,-5790,-70.6787109375
91,20,14,3747,16384,-12637,-77.130126953125
91,20,15,39895,32768,7127,21.7498779296875
91,21,1,0,2,-2,-100.0
91,21,2,1,4,-3,-75.0
91,21,3,3,8,-5,-62.5
91,21,4,4,16,-12,-75.0
91,21,5,26,32,-6,-18.75
91,21,6,69,64,5,7.8125
91,21,7,94,128,-34,-26.5625
91,21,8,1225,256,969,378.515625
91,21,9,1076,512,564,110.15625
91,21,10,405,1024,-619,-60.44921875
91,21,11,562,2048,-1486,-72.55859375
91,21,12,4611,4096,515,12.5732421875
91,21,13,3362,8192,-4830,-58.9599609375
91,21,14,12967,16384,-3417,-20.855712890625
91,21,15,25739,32768,-7029,-21.4508056640625
91,22,1,0,2,-2,-100.0
91,22,2,8,4,4,100.0
91,22,3,6,8,-2,-25.0
91,22,4,22,16,6,37.5
91,22,5,48,32,16,50.0
91,22,6,16,64,-48,-75.0
91,22,7,53,128,-75,-58.59375
91,22,8,182,256,-74,-28.90625
91,22,9,107,512,-405,-79.1015625
91,22,10,170,1024,-854,-83.3984375
91,22,11,1194,2048,-854,-41.69921875
91,22,12,15201,4096,11105,271.1181640625
91,22,13,2714,8192,-5478,-66.8701171875
91,22,14,4293,16384,-12091,-73.797607421875
91,22,15,78929,32768,46161,140.8721923828125
91,23,1,0,2,-2,-100.0
91,23,2,2,4,-2,-50.0
91,23,3,2,8,-6,-75.0
91,23,4,7,16,-9,-56.25
91,23,5,19,32,-13,-40.625
91,23,6,40,64,-24,-37.5
91,23,7,104,128,-24,-18.75
91,23,8,514,256,258,100.78125
91,23,9,62,512,-450,-87.890625
91,23,10,1372,1024,348,33.984375
91,23,11,2605,2048,557,27.197265625
91,23,12,3836,4096,-260,-6.34765625
91,23,13,848,8192,-7344,-89.6484375
91,23,14,12301,16384,-4083,-24.920654296875
91,23,15,66830,32768,34062,103.948974609375
91,24,1,0,2,-2,-100.0
91,24,2,6,4,2,50.0
91,24,3,11,8,3,37.5
91,24,4,44,16,28,175.0
91,24,5,19,32,-13,-40.625
91,24,6,46,64,-18,-28.125
91,24,7,153,128,25,19.53125
91,24,8,103,256,-153,-59.765625
91,24,9,660,512,148,28.90625
91,24,10,741,1024,-283,-27.63671875
91,24,11,61,2048,-1987,-97.021484375
91,24,12,4447,4096,351,8.5693359375
91,24,13,33578,8192,25386,309.8876953125
91,24,14,9848,16384,-6536,-39.892578125
91,24,15,12013,32768,-20755,-63.3392333984375
91,25,1,0,2,-2,-100.0
91,25,2,2,4,-2,-50.0
91,25,3,5,8,-3,-37.5
91,25,4,42,16,26,162.5
91,25,5,19,32,-13,-40.625
91,25,6,51,64,-13,-20.3125
91,25,7,10,128,-118,-92.1875
91,25,8,413,256,157,61.328125
91,25,9,943,512,431,84.1796875
91,25,10,1875,1024,851,83.10546875
91,25,11,4914,2048,2866,139.94140625
91,25,12,896,4096,-3200,-78.125
91,25,13,4345,8192,-3847,-46.96044921875
91,25,14,52050,16384,35666,217.68798828125
91,25,15,24145,32768,-8623,-26.3153076171875
91,26,1,0,2,-2,-100.0
91,26,2,1,4,-3,-75.0
91,26,3,4,8,-4,-50.0
91,26,4,27,16,11,68.75
91,26,5,28,32,-4,-12.5
91,26,6,39,64,-25,-39.0625
91,26,7,49,128,-79,-61.71875
91,26,8,76,256,-180,-70.3125
91,26,9,101,512,-411,-80.2734375
91,26,10,59,1024,-965,-94.23828125
91,26,11,1522,2048,-526,-25.68359375
91,26,12,761,4096,-3335,-81.4208984375
91,26,13,7321,8192,-871,-10.63232421875
91,26,14,23806,16384,7422,45.30029296875
91,26,15,32530,32768,-238,-0.726318359375
91,27,1,0,2,-2,-100.0
91,27,2,1,4,-3,-75.0
91,27,3,3,8,-5,-62.5
91,27,4,39,16,23,143.75
91,27,5,4,32,-28,-87.5
91,27,6,10,64,-54,-84.375
91,27,7,131,128,3,2.34375
91,27,8,117,256,-139,-54.296875
91,27,9,460,512,-52,-10.15625
91,27,10,2736,1024,1712,167.1875
91,27,11,175,2048,-1873,-91.455078125
91,27,12,2877,4096,-1219,-29.7607421875
91,27,13,719,8192,-7473,-91.22314453125
91,27,14,23719,16384,7335,44.769287109375
91,27,15,7653,32768,-25115,-76.6448974609375
91,28,1,0,2,-2,-100.0
91,28,2,2,4,-2,-50.0
91,28,3,4,8,-4,-50.0
91,28,4,10,16,-6,-37.5
91,28,5,45,32,13,40.625
91,28,6,57,64,-7,-10.9375
91,28,7,23,128,-105,-82.03125
91,28,8,1279,256,1023,399.609375
91,28,9,481,512,-31,-6.0546875
91,28,10,211,1024,-813,-79.39453125
91,28,11,6045,2048,3997,195.166015625
91,28,12,14688,4096,10592,258.59375
91,28,13,2219,8192,-5973,-72.91259765625
91,28,14,75502,16384,59118,360.82763671875
91,28,15,60510,32768,27742,84.661865234375
91,29,1,0,2,-2,-100.0
91,29,2,1,4,-3,-75.0
91,29,3,8,8,0,0.0
91,29,4,4,16,-12,-75.0
91,29,5,31,32,-1,-3.125
91,29,6,5,64,-59,-92.1875
91,29,7,49,128,-79,-61.71875
91,29,8,281,256,25,9.765625
91,29,9,1208,512,696,135.9375
91,29,10,1149,1024,125,12.20703125
91,29,11,6500,2048,4452,217.3828125
91,29,12,1935,4096,-2161,-52.7587890625
91,29,13,1985,8192,-6207,-75.76904296875
91,29,14,20309,16384,3925,23.956298828125
91,29,15,18928,32768,-13840,-42.236328125
91,30,1,0,2,-2,-100.0
91,30,2,1,4,-3,-75.0
91,30,3,9,8,1,12.5
91,30,4,15,16,-1,-6.25
91,30,5,58,32,26,81.25
91,30,6,24,64,-40,-62.5
91,30,7,302,128,174,135.9375
91,30,8,96,256,-160,-62.5
91,30,9,327,512,-185,-36.1328125
91,30,10,1346,1024,322,31.4453125
91,30,11,777,2048,-1271,-62.060546875
91,30,12,85,4096,-4011,-97.9248046875
91,30,13,2731,8192,-5461,-66.66259765625
91,30,14,35762,16384,19378,118.27392578125
91,30,15,30667,32768,-2101,-6.4117431640625
91,31,1,0,2,-2,-100.0
91,31,2,1,4,-3,-75.0
91,31,3,4,8,-4,-50.0
91,31,4,40,16,24,150.0
91,31,5,31,32,-1,-3.125
91,31,6,151,64,87,135.9375
91,31,7,175,128,47,36.71875
91,31,8,962,256,706,275.78125
91,31,9,728,512,216,42.1875
91,31,10,1129,1024,105,10.25390625
91,31,11,291,2048,-1757,-85.791015625
91,31,12,7507,4096,3411,83.2763671875
91,31,13,6191,8192,-2001,-24.42626953125
91,31,14,12932,16384,-3452,-21.0693359375
91,31,15,50290,32768,17522,53.472900390625
91,32,1,0,2,-2,-100.0
91,32,2,1,4,-3,-75.0
91,32,3,2,8,-6,-75.0
91,32,4,10,16,-6,-37.5
91,32,5,23,32,-9,-28.125
91,32,6,17,64,-47,-73.4375
91,32,7,254,128,126,98.4375
91,32,8,277,256,21,8.203125
91,32,9,1230,512,718,140.234375
91,32,10,444,1024,-580,-56.640625
91,32,11,1259,2048,-789,-38.525390625
91,32,12,929,4096,-3167,-77.3193359375
91,32,13,8234,8192,42,0.5126953125
91,32,14,28783,16384,12399,75.677490234375
91,32,15,102116,32768,69348,211.63330078125
91,33,1,0,2,-2,-100.0
91,33,2,2,4,-2,-50.0
91,33,3,6,8,-2,-25.0
91,33,4,6,16,-10,-62.5
91,33,5,13,32,-19,-59.375
91,33,6,9,64,-55,-85.9375
91,33,7,84,128,-44,-34.375
91,33,8,12,256,-244,-95.3125
91,33,9,276,512,-236,-46.09375
91,33,10,840,1024,-184,-17.96875
91,33,11,811,2048,-1237,-60.400390625
91,33,12,2741,4096,-1355,-33.0810546875
91,33,13,12086,8192,3894,47.5341796875
91,33,14,17967,16384,1583,9.661865234375
91,33,15,91035,32768,58267,177.8167724609375
91,34,1,0,2,-2,-100.0
91,34,2,4,4,0,0.0
91,34,3,5,8,-3,-37.5
91,34,4,9,16,-7,-43.75
91,34,5,49,32,17,53.125
91,34,6,31,64,-33,-51.5625
91,34,7,188,128,60,46.875
91,34,8,351,256,95,37.109375
91,34,9,287,512,-225,-43.9453125
91,34,10,3267,1024,2243,219.04296875
91,34,11,769,2048,-1279,-62.451171875
91,34,12,14250,4096,10154,247.900390625
91,34,13,5173,8192,-3019,-36.85302734375
91,34,14,22972,16384,6588,40.2099609375
91,34,15,240945,32768,208177,635.3057861328125
91,35,1,0,2,-2,-100.0
91,35,2,1,4,-3,-75.0
91,35,3,7,8,-1,-12.5
91,35,4,12,16,-4,-25.0
91,35,5,41,32,9,28.125
91,35,6,11,64,-53,-82.8125
91,35,7,24,128,-104,-81.25
91,35,8,714,256,458,178.90625
91,35,9,116,512,-396,-77.34375
91,35,10,811,1024,-213,-20.80078125
91,35,11,1212,2048,-836,-40.8203125
91,35,12,326,4096,-3770,-92.041015625
91,35,13,21766,8192,13574,165.6982421875
91,35,14,2845,16384,-13539,-82.635498046875
91,35,15,24741,32768,-8027,-24.4964599609375
91,36,1,0,2,-2,-100.0
91,36,2,1,4,-3,-75.0
91,36,3,8,8,0,0.0
91,36,4,30,16,14,87.5
91,36,5,21,32,-11,-34.375
91,36,6,65,64,1,1.5625
91,36,7,152,128,24,18.75
91,36,8,103,256,-153,-59.765625
91,36,9,217,512,-295,-57.6171875
91,36,10,647,1024,-377,-36.81640625
91,36,11,3289,2048,1241,60.595703125
91,36,12,4075,4096,-21,-0.5126953125
91,36,13,13737,8192,5545,67.68798828125
91,36,14,3126,16384,-13258,-80.92041015625
91,36,15,5155,32768,-27613,-84.2681884765625
91,37,1,0,2,-2,-100.0
91,37,2,4,4,0,0.0
91,37,3,4,8,-4,-50.0
91,37,4,5,16,-11,-68.75
91,37,5,20,32,-12,-37.5
91,37,6,32,64,-32,-50.0
91,37,7,6,128,-122,-95.3125
91,37,8,68,256,-188,-73.4375
91,37,9,491,512,-21,-4.1015625
91,37,10,328,1024,-696,-67.96875
91,37,11,1845,2048,-203,-9.912109375
91,37,12,4365,4096,269,6.5673828125
91,37,13,12246,8192,4054,49.4873046875
91,37,14,42577,16384,26193,159.869384765625
91,37,15,5994,32768,-26774,-81.707763671875
91,38,1,0,2,-2,-100.0
91,38,2,3,4,-1,-25.0
91,38,3,15,8,7,87.5
91,38,4,3,16,-13,-81.25
91,38,5,10,32,-22,-68.75
91,38,6,52,64,-12,-18.75
91,38,7,24,128,-104,-81.25
91,38,8,285,256,29,11.328125
91,38,9,320,512,-192,-37.5
91,38,10,2719,1024,1695,165.52734375
91,38,11,5185,2048,3137,153.173828125
91,38,12,4407,4096,311,7.5927734375
91,38,13,20064,8192,11872,144.921875
91,38,14,47251,16384,30867,188.397216796875
91,38,15,95131,32768,62363,190.3167724609375
91,39,1,0,2,-2,-100.0
91,39,2,3,4,-1,-25.0
91,39,3,2,8,-6,-75.0
91,39,4,51,16,35,218.75
91,39,5,37,32,5,15.625
91,39,6,49,64,-15,-23.4375
91,39,7,445,128,317,247.65625
91,39,8,632,256,376,146.875
91,39,9,473,512,-39,-7.6171875
91,39,10,512,1024,-512,-50.0
91,39,11,3791,2048,1743,85.107421875
91,39,12,7137,4096,3041,74.2431640625
91,39,13,3869,8192,-4323,-52.77099609375
91,39,14,14387,16384,-1997,-12.188720703125
91,39,15,6260,32768,-26508,-80.89599609375
91,40,1,0,2,-2,-100.0
91,40,2,1,4,-3,-75.0
91,40,3,8,8,0,0.0
91,40,4,13,16,-3,-18.75
91,40,5,15,32,-17,-53.125
91,40,6,35,64,-29,-45.3125
91,40,7,47,128,-81,-63.28125
91,40,8,320,256,64,25.0
91,40,9,1271,512,759,148.2421875
91,40,10,679,1024,-345,-33.69140625
91,40,11,202,2048,-1846,-90.13671875
91,40,12,9629,4096,5533,135.0830078125
91,40,13,12677,8192,4485,54.74853515625
91,40,14,19861,16384,3477,21.221923828125
91,40,15,9157,32768,-23611,-72.0550537109375
91,41,1,0,2,-2,-100.0
91,41,2,3,4,-1,-25.0
91,41,3,9,8,1,12.5
91,41,4,4,16,-12,-75.0
91,41,5,4,32,-28,-87.5
91,41,6,71,64,7,10.9375
91,41,7,193,128,65,50.78125
91,41,8,172,256,-84,-32.8125
91,41,9,110,512,-402,-78.515625
91,41,10,269,1024,-755,-73.73046875
91,41,11,1820,2048,-228,-11.1328125
91,41,12,6302,4096,2206,53.857421875
91,41,13,3650,8192,-4542,-55.4443359375
91,41,14,13811,16384,-2573,-15.704345703125
91,41,15,10839,32768,-21929,-66.9219970703125
91,42,1,0,2,-2,-100.0
91,42,2,1,4,-3,-75.0
91,42,3,4,8,-4,-50.0
91,42,4,12,16,-4,-25.0
91,42,5,34,32,2,6.25
91,42,6,109,64,45,70.3125
91,42,7,98,128,-30,-23.4375
91,42,8,137,256,-119,-46.484375
91,42,9,2315,512,1803,352.1484375
91,42,10,518,1024,-506,-49.4140625
91,42,11,525,2048,-1523,-74.365234375
91,42,12,1277,4096,-2819,-68.8232421875
91,42,13,15206,8192,7014,85.6201171875
91,42,14,8175,16384,-8209,-50.103759765625
91,42,15,21079,32768,-11689,-35.6719970703125
91,43,1,0,2,-2,-100.0
91,43,2,1,4,-3,-75.0
91,43,3,5,8,-3,-37.5
91,43,4,8,16,-8,-50.0
91,43,5,27,32,-5,-15.625
91,43,6,12,64,-52,-81.25
91,43,7,506,128,378,295.3125
91,43,8,169,256,-87,-33.984375
91,43,9,60,512,-452,-88.28125
91,43,10,372,1024,-652,-63.671875
91,43,11,325,2048,-1723,-84.130859375
91,43,12,8098,4096,4002,97.705078125
91,43,13,8672,8192,480,5.859375
91,43,14,10100,16384,-6284,-38.3544921875
91,43,15,142,32768,-32626,-99.566650390625
91,44,1,0,2,-2,-100.0
91,44,2,2,4,-2,-50.0
91,44,3,6,8,-2,-25.0
91,44,4,13,16,-3,-18.75
91,44,5,28,32,-4,-12.5
91,44,6,39,64,-25,-39.0625
91,44,7,187,128,59,46.09375
91,44,8,367,256,111,43.359375
91,44,9,331,512,-181,-35.3515625
91,44,10,1103,1024,79,7.71484375
91,44,11,728,2048,-1320,-64.453125
91,44,12,5245,4096,1149,28.0517578125
91,44,13,8277,8192,85,1.03759765625
91,44,14,36029,16384,19645,119.903564453125
91,44,15,2040,32768,-30728,-93.7744140625
91,45,1,0,2,-2,-100.0
91,45,2,3,4,-1,-25.0
91,45,3,4,8,-4,-50.0
91,45,4,8,16,-8,-50.0
91,45,5,9,32,-23,-71.875
91,45,6,89,64,25,39.0625
91,45,7,88,128,-40,-31.25
91,45,8,292,256,36,14.0625
91,45,9,41,512,-471,-91.9921875
91,45,10,289,1024,-735,-71.77734375
91,45,11,7518,2048,5470,267.08984375
91,45,12,524,4096,-3572,-87.20703125
91,45,13,1824,8192,-6368,-77.734375
91,45,14,72034,16384,55650,339.66064453125
91,45,15,10256,32768,-22512,-68.701171875
91,46,1,0,2,-2,-100.0
91,46,2,3,4,-1,-25.0
91,46,3,7,8,-1,-12.5
91,46,4,3,16,-13,-81.25
91,46,5,4,32,-28,-87.5
91,46,6,19,64,-45,-70.3125
91,46,7,90,128,-38,-29.6875
91,46,8,175,256,-81,-31.640625
91,46,9,1866,512,1354,264.453125
91,46,10,1474,1024,450,43.9453125
91,46,11,13,2048,-2035,-99.365234375
91,46,12,2036,4096,-2060,-50.29296875
91,46,13,7624,8192,-568,-6.93359375
91,46,14,9332,16384,-7052,-43.0419921875
91,46,15,56230,32768,23462,71.600341796875
91,47,1,0,2,-2,-100.0
91,47,2,3,4,-1,-25.0
91,47,3,2,8,-6,-75.0
91,47,4,33,16,17,106.25
91,47,5,27,32,-5,-15.625
91,47,6,50,64,-14,-21.875
91,47,7,112,128,-16,-12.5
91,47,8,63,256,-193,-75.390625
91,47,9,126,512,-386,-75.390625
91,47,10,594,1024,-430,-41.9921875
91,47,11,2339,2048,291,14.208984375
91,47,12,150,4096,-3946,-96.337890625
91,47,13,6799,8192,-1393,-17.00439453125
91,47,14,3862,16384,-12522,-76.42822265625
91,47,15,37835,32768,5067,15.4632568359375
91,48,1,0,2,-2,-100.0
91,48,2,1,4,-3,-75.0
91,48,3,17,8,9,112.5
91,48,4,6,16,-10,-62.5
91,48,5,5,32,-27,-84.375
91,48,6,5,64,-59,-92.1875
91,48,7,45,128,-83,-64.84375
91,48,8,542,256,286,111.71875
91,48,9,947,512,435,84.9609375
91,48,10,278,1024,-746,-72.8515625
91,48,11,328,2048,-1720,-83.984375
91,48,12,2182,4096,-1914,-46.728515625
91,48,13,6574,8192,-1618,-19.7509765625
91,48,14,410,16384,-15974,-97.49755859375
91,48,15,7178,32768,-25590,-78.094482421875
91,49,1,0,2,-2,-100.0
91,49,2,3,4,-1,-25.0
91,49,3,5,8,-3,-37.5
91,49,4,4,16,-12,-75.0
91,49,5,8,32,-24,-75.0
91,49,6,5,64,-59,-92.1875
91,49,7,155,128,27,21.09375
91,49,8,99,256,-157,-61.328125
91,49,9,9,512,-503,-98.2421875
91,49,10,279,1024,-745,-72.75390625
91,49,11,1039,2048,-1009,-49.267578125
91,49,12,4513,4096,417,10.1806640625
91,49,13,1796,8192,-6396,-78.076171875
91,49,14,28934,16384,12550,76.59912109375
91,49,15,32914,32768,146,0.445556640625
91,50,1,0,2,-2,-100.0
91,50,2,1,4,-3,-75.0
91,50,3,10,8,2,25.0
91,50,4,18,16,2,12.5
91,50,5,4,32,-28,-87.5
91,50,6,16,64,-48,-75.0
91,50,7,73,128,-55,-42.96875
91,50,8,62,256,-194,-75.78125
91,50,9,342,512,-170,-33.203125
91,50,10,499,1024,-525,-51.26953125
91,50,11,1975,2048,-73,-3.564453125
91,50,12,7538,4096,3442,84.033203125
91,50,13,1215,8192,-6977,-85.16845703125
91,50,14,6521,16384,-9863,-60.198974609375
91,50,15,18299,32768,-14469,-44.1558837890625
91,51,1,0,2,-2,-100.0
91,51,2,1,4,-3,-75.0
91,51,3,4,8,-4,-50.0
91,51,4,13,16,-3,-18.75
91,51,5,45,32,13,40.625
91,51,6,70,64,6,9.375
91,51,7,39,128,-89,-69.53125
91,51,8,45,256,-211,-82.421875
91,51,9,416,512,-96,-18.75
91,51,10,2082,1024,1058,103.3203125
91,51,11,2090,2048,42,2.05078125
91,51,12,2036,4096,-2060,-50.29296875
91,51,13,193,8192,-7999,-97.64404296875
91,51,14,4773,16384,-11611,-70.867919921875
91,51,15,92484,32768,59716,182.23876953125
91,52,1,0,2,-2,-100.0
91,52,2,2,4,-2,-50.0
91,52,3,3,8,-5,-62.5
91,52,4,7,16,-9,-56.25
91,52,5,13,32,-19,-59.375
91,52,6,24,64,-40,-62.5
91,52,7,47,128,-81,-63.28125
91,52,8,382,256,126,49.21875
91,52,9,834,512,322,62.890625
91,52,10,337,1024,-687,-67.08984375
91,52,11,228,2048,-1820,-88.8671875
91,52,12,972,4096,-3124,-76.26953125
91,52,13,12364,8192,4172,50.927734375
91,52,14,18900,16384,2516,15.3564453125
91,52,15,39783,32768,7015,21.4080810546875
91,53,1,0,2,-2,-100.0
91,53,2,2,4,-2,-50.0
91,53,3,7,8,-1,-12.5
91,53,4,21,16,5,31.25
91,53,5,5,32,-27,-84.375
91,53,6,57,64,-7,-10.9375
91,53,7,103,128,-25,-19.53125
91,53,8,120,256,-136,-53.125
91,53,9,33,512,-479,-93.5546875
91,53,10,642,1024,-382,-37.3046875
91,53,11,1328,2048,-720,-35.15625
91,53,12,35,4096,-4061,-99.1455078125
91,53,13,3116,8192,-5076,-61.962890625
91,53,14,2692,16384,-13692,-83.5693359375
91,53,15,64669,32768,31901,97.3541259765625
91,54,1,0,2,-2,-100.0
91,54,2,1,4,-3,-75.0
91,54,3,3,8,-5,-62.5
91,54,4,3,16,-13,-81.25
91,54,5,4,32,-28,-87.5
91,54,6,26,64,-38,-59.375
91,54,7,38,128,-90,-70.3125
91,54,8,735,256,479,187.109375
91,54,9,489,512,-23,-4.4921875
91,54,10,1368,1024,344,33.59375
91,54,11,272,2048,-1776,-86.71875
91,54,12,4704,4096,608,14.84375
91,54,13,3811,8192,-4381,-53.47900390625
91,54,14,2419,16384,-13965,-85.235595703125
91,54,15,18451,32768,-14317,-43.6920166015625
91,55,1,0,2,-2,-100.0
91,55,2,3,4,-1,-25.0
91,55,3,2,8,-6,-75.0
91,55,4,8,16,-8,-50.0
91,55,5,7,32,-25,-78.125
91,55,6,13,64,-51,-79.6875
91,55,7,105,128,-23,-17.96875
91,55,8,170,256,-86,-33.59375
91,55,9,711,512,199,38.8671875
91,55,10,1352,1024,328,32.03125
91,55,11,1321,2048,-727,-35.498046875
91,55,12,506,4096,-3590,-87.646484375
91,55,13,4755,8192,-3437,-41.95556640625
91,55,14,4161,16384,-12223,-74.603271484375
91,55,15,20349,32768,-12419,-37.8997802734375
91,56,1,0,2,-2,-100.0
91,56,2,2,4,-2,-50.0
91,56,3,7,8,-1,-12.5
91,56,4,6,16,-10,-62.5
91,56,5,12,32,-20,-62.5
91,56,6,46,64,-18,-28.125
91,56,7,7,128,-121,-94.53125
91,56,8,214,256,-42,-16.40625
91,56,9,434,512,-78,-15.234375
91,56,10,70,1024,-954,-93.1640625
91,56,11,1390,2048,-658,-32.12890625
91,56,12,2281,4096,-1815,-44.3115234375
91,56,13,15934,8192,7742,94.5068359375
91,56,14,13601,16384,-2783,-16.986083984375
91,56,15,61340,32768,28572,87.19482421875
91,57,1,0,2,-2,-100.0
91,57,2,2,4,-2,-50.0
91,57,3,3,8,-5,-62.5
91,57,4,6,16,-10,-62.5
91,57,5,13,32,-19,-59.375
91,57,6,35,64,-29,-45.3125
91,57,7,154,128,26,20.3125
91,57,8,200,256,-56,-21.875
91,57,9,24,512,-488,-95.3125
91,57,10,3527,1024,2503,244.43359375
91,57,11,2669,2048,621,30.322265625
91,57,12,1834,4096,-2262,-55.224609375
91,57,13,7876,8192,-316,-3.857421875
91,57,14,13417,16384,-2967,-18.109130859375
91,57,15,4604,32768,-28164,-85.94970703125
91,58,1,0,2,-2,-100.0
91,58,2,2,4,-2,-50.0
91,58,3,2,8,-6,-75.0
91,58,4,6,16,-10,-62.5
91,58,5,9,32,-23,-71.875
91,58,6,65,64,1,1.5625
91,58,7,525,128,397,310.15625
91,58,8,89,256,-167,-65.234375
91,58,9,1084,512,572,111.71875
91,58,10,322,1024,-702,-68.5546875
91,58,11,3533,2048,1485,72.509765625
91,58,12,10227,4096,6131,149.6826171875
91,58,13,3324,8192,-4868,-59.423828125
91,58,14,18902,16384,2518,15.36865234375
91,58,15,52940,32768,20172,61.56005859375
91,59,1,0,2,-2,-100.0
91,59,2,8,4,4,100.0
91,59,3,9,8,1,12.5
91,59,4,28,16,12,75.0
91,59,5,4,32,-28,-87.5
91,59,6,96,64,32,50.0
91,59,7,6,128,-122,-95.3125
91,59,8,222,256,-34,-13.28125
91,59,9,113,512,-399,-77.9296875
91,59,10,727,1024,-297,-29.00390625
91,59,11,3339,2048,1291,63.037109375
91,59,12,6335,4096,2239,54.6630859375
91,59,13,3907,8192,-4285,-52.30712890625
91,59,14,921,16384,-15463,-94.378662109375
91,59,15,21125,32768,-11643,-35.5316162109375
91,60,1,0,2,-2,-100.0
91,60,2,2,4,-2,-50.0
91,60,3,7,8,-1,-12.5
91,60,4,6,16,-10,-62.5
91,60,5,11,32,-21,-65.625
91,60,6,8,64,-56,-87.5
91,60,7,88,128,-40,-31.25
91,60,8,74,256,-182,-71.09375
91,60,9,406,512,-106,-20.703125
91,60,10,1881,1024,857,83.69140625
91,60,11,5214,2048,3166,154.58984375
91,60,12,4586,4096,490,11.962890625
91,60,13,886,8192,-7306,-89.1845703125
91,60,14,13548,16384,-2836,-17.3095703125
91,60,15,855,32768,-31913,-97.3907470703125
91,61,1,0,2,-2,-100.0
91,61,2,3,4,-1,-25.0
91,61,3,4,8,-4,-50.0
91,61,4,5,16,-11,-68.75
91,61,5,4,32,-28,-87.5
91,61,6,5,64,-59,-92.1875
91,61,7,143,128,15,11.71875
91,61,8,230,256,-26,-10.15625
91,61,9,283,512,-229,-44.7265625
91,61,10,1294,1024,270,26.3671875
91,61,11,83,2048,-1965,-95.947265625
91,61,12,10595,4096,6499,158.6669921875
91,61,13,54,8192,-8138,-99.3408203125
91,61,14,12638,16384,-3746,-22.86376953125
91,61,15,105032,32768,72264,220.5322265625
91,62,1,0,2,-2,-100.0
91,62,2,5,4,1,25.0
91,62,3,17,8,9,112.5
91,62,4,6,16,-10,-62.5
91,62,5,55,32,23,71.875
91,62,6,28,64,-36,-56.25
91,62,7,44,128,-84,-65.625
91,62,8,57,256,-199,-77.734375
91,62,9,89,512,-423,-82.6171875
91,62,10,236,1024,-788,-76.953125
91,62,11,4438,2048,2390,116.69921875
91,62,12,1215,4096,-2881,-70.3369140625
91,62,13,10822,8192,2630,32.1044921875
91,62,14,11566,16384,-4818,-29.40673828125
91,62,15,12040,32768,-20728,-63.2568359375
91,63,1,0,2,-2,-100.0
91,63,2,1,4,-3,-75.0
91,63,3,7,8,-1,-12.5
91,63,4,6,16,-10,-62.5
91,63,5,46,32,14,43.75
91,63,6,16,64,-48,-75.0
91,63,7,48,128,-80,-62.5
91,63,8,503,256,247,96.484375
91,63,9,358,512,-154,-30.078125
91,63,10,772,1024,-252,-24.609375
91,63,11,270,2048,-1778,-86.81640625
91,63,12,1781,4096,-2315,-56.5185546875
91,63,13,14762,8192,6570,80.2001953125
91,63,14,6060,16384,-10324,-63.0126953125
91,63,15,23796,32768,-8972,-27.38037109375
91,64,1,0,2,-2,-100.0
91,64,2,1,4,-3,-75.0
91,64,3,5,8,-3,-37.5
91,64,4,25,16,9,56.25
91,64,5,6,32,-26,-81.25
91,64,6,32,64,-32,-50.0
91,64,7,119,128,-9,-7.03125
91,64,8,549,256,293,114.453125
91,64,9,945,512,433,84.5703125
91,64,10,445,1024,-579,-56.54296875
91,64,11,3654,2048,1606,78.41796875
91,64,12,7445,4096,3349,81.7626953125
91,64,13,7524,8192,-668,-8.154296875
91,64,14,7346,16384,-9038,-55.16357421875
91,64,15,2936,32768,-29832,-91.0400390625
91,65,1,0,2,-2,-100.0
91,65,2,4,4,0,0.0
91,65,3,9,8,1,12.5
91,65,4,16,16,0,0.0
91,65,5,7,32,-25,-78.125
91,65,6,73,64,9,14.0625
91,65,7,373,128,245,191.40625
91,65,8,308,256,52,20.3125
91,65,9,87,512,-425,-83.0078125
91,65,10,1342,1024,318,31.0546875
91,65,11,3370,2048,1322,64.55078125
91,65,12,4294,4096,198,4.833984375
91,65,13,4934,8192,-3258,-39.7705078125
91,65,14,1446,16384,-14938,-91.17431640625
91,65,15,78521,32768,45753,139.6270751953125
91,66,1,0,2,-2,-100.0
91,66,2,1,4,-3,-75.0
91,66,3,5,8,-3,-37.5
91,66,4,29,16,13,81.25
91,66,5,24,32,-8,-25.0
91,66,6,203,64,139,217.1875
91,66,7,43,128,-85,-66.40625
91,66,8,324,256,68,26.5625
91,66,9,929,512,417,81.4453125
91,66,10,458,1024,-566,-55.2734375
91,66,11,2782,2048,734,35.83984375
91,66,12,32,4096,-4064,-99.21875
91,66,13,33431,8192,25239,308.09326171875
91,66,14,1414,16384,-14970,-91.36962890625
91,66,15,75246,32768,42478,129.632568359375
91,67,1,0,2,-2,-100.0
91,67,2,1,4,-3,-75.0
91,67,3,8,8,0,0.0
91,67,4,4,16,-12,-75.0
91,67,5,5,32,-27,-84.375
91,67,6,37,64,-27,-42.1875
91,67,7,138,128,10,7.8125
91,67,8,648,256,392,153.125
91,67,9,215,512,-297,-58.0078125
91,67,10,1036,1024,12,1.171875
91,67,11,2169,2048,121,5.908203125
91,67,12,1644,4096,-2452,-59.86328125
91,67,13,7503,8192,-689,-8.41064453125
91,67,14,12752,16384,-3632,-22.16796875
91,67,15,66308,32768,33540,102.35595703125
91,68,1,0,2,-2,-100.0
91,68,2,1,4,-3,-75.0
91,68,3,10,8,2,25.0
91,68,4,10,16,-6,-37.5
91,68,5,10,32,-22,-68.75
91,68,6,76,64,12,18.75
91,68,7,96,128,-32,-25.0
91,68,8,158,256,-98,-38.28125
91,68,9,118,512,-394,-76.953125
91,68,10,1034,1024,10,0.9765625
91,68,11,572,2048,-1476,-72.0703125
91,68,12,1681,4096,-2415,-58.9599609375
91,68,13,7153,8192,-1039,-12.68310546875
91,68,14,3205,16384,-13179,-80.438232421875
91,68,15,41619,32768,8851,27.0111083984375
91,69,1,0,2,-2,-100.0
91,69,2,3,4,-1,-25.0
91,69,3,5,8,-3,-37.5
91,69,4,8,16,-8,-50.0
91,69,5,5,32,-27,-84.375
91,69,6,102,64,38,59.375
91,69,7,79,128,-49,-38.28125
91,69,8,32,256,-224,-87.5
91,69,9,297,512,-215,-41.9921875
91,69,10,497,1024,-527,-51.46484375
91,69,11,851,2048,-1197,-58.447265625
91,69,12,10124,4096,6028,147.16796875
91,69,13,14226,8192,6034,73.6572265625
91,69,14,29584,16384,13200,80.56640625
91,69,15,111527,32768,78759,240.3533935546875
91,70,1,0,2,-2,-100.0
91,70,2,1,4,-3,-75.0
91,70,3,10,8,2,25.0
91,70,4,37,16,21,131.25
91,70,5,18,32,-14,-43.75
91,70,6,22,64,-42,-65.625
91,70,7,35,128,-93,-72.65625
91,70,8,375,256,119,46.484375
91,70,9,190,512,-322,-62.890625
91,70,10,120,1024,-904,-88.28125
91,70,11,211,2048,-1837,-89.697265625
91,70,12,8030,4096,3934,96.044921875
91,70,13,2291,8192,-5901,-72.03369140625
91,70,14,43568,16384,27184,165.91796875
91,70,15,51941,32768,19173,58.5113525390625
91,71,1,0,2,-2,-100.0
91,71,2,2,4,-2,-50.0
91,71,3,10,8,2,25.0
91,71,4,3,16,-13,-81.25
91,71,5,12,32,-20,-62.5
91,71,6,23,64,-41,-64.0625
91,71,7,18,128,-110,-85.9375
91,71,8,154,256,-102,-39.84375
91,71,9,633,512,121,23.6328125
91,71,10,874,1024,-150,-14.6484375
91,71,11,515,2048,-1533,-74.853515625
91,71,12,3177,4096,-919,-22.4365234375
91,71,13,4959,8192,-3233,-39.46533203125
91,71,14,848,16384,-15536,-94.82421875
91,71,15,26556,32768,-6212,-18.95751953125
91,72,1,0,2,-2,-100.0
91,72,2,2,4,-2,-50.0
91,72,3,6,8,-2,-25.0
91,72,4,19,16,3,18.75
91,72,5,13,32,-19,-59.375
91,72,6,182,64,118,184.375
91,72,7,11,128,-117,-91.40625
91,72,8,176,256,-80,-31.25
91,72,9,585,512,73,14.2578125
91,72,10,1126,1024,102,9.9609375
91,72,11,6788,2048,4740,231.4453125
91,72,12,3049,4096,-1047,-25.5615234375
91,72,13,5086,8192,-3106,-37.9150390625
91,72,14,10731,16384,-5653,-34.503173828125
91,72,15,58607,32768,25839,78.8543701171875
91,73,1,0,2,-2,-100.0
91,73,2,2,4,-2,-50.0
91,73,3,2,8,-6,-75.0
91,73,4,7,16,-9,-56.25
91,73,5,56,32,24,75.0
91,73,6,241,64,177,276.5625
91,73,7,64,128,-64,-50.0
91,73,8,583,256,327,127.734375
91,73,9,196,512,-316,-61.71875
91,73,10,708,1024,-316,-30.859375
91,73,11,1259,2048,-789,-38.525390625
91,73,12,1792,4096,-2304,-56.25
91,73,13,5966,8192,-2226,-27.1728515625
91,73,14,17052,16384,668,4.0771484375
91,73,15,81799,32768,49031,149.6307373046875
91,74,1,0,2,-2,-100.0
91,74,2,1,4,-3,-75.0
91,74,3,2,8,-6,-75.0
91,74,4,47,16,31,193.75
91,74,5,13,32,-19,-59.375
91,74,6,6,64,-58,-90.625
91,74,7,10,128,-118,-92.1875
91,74,8,299,256,43,16.796875
91,74,9,430,512,-82,-16.015625
91,74,10,804,1024,-220,-21.484375
91,74,11,6052,2048,4004,195.5078125
91,74,12,80,4096,-4016,-98.046875
91,74,13,1308,8192,-6884,-84.033203125
91,74,14,4138,16384,-12246,-74.74365234375
91,74,15,6121,32768,-26647,-81.3201904296875
91,75,1,0,2,-2,-100.0
91,75,2,2,4,-2,-50.0
91,75,3,6,8,-2,-25.0
91,75,4,17,16,1,6.25
91,75,5,35,32,3,9.375
91,75,6,29,64,-35,-54.6875
91,75,7,419,128,291,227.34375
91,75,8,444,256,188,73.4375
91,75,9,532,512,20,3.90625
91,75,10,864,1024,-160,-15.625
91,75,11,1252,2048,-796,-38.8671875
91,75,12,12700,4096,8604,210.05859375
91,75,13,2457,8192,-5735,-70.00732421875
91,75,14,23362,16384,6978,42.59033203125
91,75,15,15203,32768,-17565,-53.6041259765625
91,76,1,0,2,-2,-100.0
91,76,2,4,4,0,0.0
91,76,3,4,8,-4,-50.0
91,76,4,4,16,-12,-75.0
91,76,5,10,32,-22,-68.75
91,76,6,162,64,98,153.125
91,76,7,80,128,-48,-37.5
91,76,8,127,256,-129,-50.390625
91,76,9,2133,512,1621,316.6015625
91,76,10,1368,1024,344,33.59375
91,76,11,278,2048,-1770,-86.42578125
91,76,12,781,4096,-3315,-80.9326171875
91,76,13,1340,8192,-6852,-83.642578125
91,76,14,14236,16384,-2148,-13.1103515625
91,76,15,70002,32768,37234,113.629150390625
91,77,1,0,2,-2,-100.0
91,77,2,1,4,-3,-75.0
91,77,3,7,8,-1,-12.5
91,77,4,17,16,1,6.25
91,77,5,17,32,-15,-46.875
91,77,6,164,64,100,156.25
91,77,7,116,128,-12,-9.375
91,77,8,359,256,103,40.234375
91,77,9,543,512,31,6.0546875
91,77,10,325,1024,-699,-68.26171875
91,77,11,1069,2048,-979,-47.802734375
91,77,12,10194,4096,6098,148.876953125
91,77,13,201,8192,-7991,-97.54638671875
91,77,14,15199,16384,-1185,-7.232666015625
91,77,15,127942,32768,95174,290.447998046875
91,78,1,0,2,-2,-100.0
91,78,2,4,4,0,0.0
91,78,3,4,8,-4,-50.0
91,78,4,6,16,-10,-62.5
91,78,5,26,32,-6,-18.75
91,78,6,19,64,-45,-70.3125
91,78,7,42,128,-86,-67.1875
91,78,8,213,256,-43,-16.796875
91,78,9,179,512,-333,-65.0390625
91,78,10,133,1024,-891,-87.01171875
91,78,11,1612,2048,-436,-21.2890625
91,78,12,4656,4096,560,13.671875
91,78,13,15214,8192,7022,85.7177734375
91,78,14,10247,16384,-6137,-37.457275390625
91,78,15,9496,32768,-23272,-71.0205078125
91,79,1,0,2,-2,-100.0
91,79,2,2,4,-2,-50.0
91,79,3,2,8,-6,-75.0
91,79,4,3,16,-13,-81.25
91,79,5,4,32,-28,-87.5
91,79,6,53,64,-11,-17.1875
91,79,7,203,128,75,58.59375
91,79,8,879,256,623,243.359375
91,79,9,560,512,48,9.375
91,79,10,2178,1024,1154,112.6953125
91,79,11,972,2048,-1076,-52.5390625
91,79,12,17503,4096,13407,327.3193359375
91,79,13,22773,8192,14581,177.99072265625
91,79,14,136,16384,-16248,-99.169921875
91,79,15,46731,32768,13963,42.6116943359375
91,80,1,0,2,-2,-100.0
91,80,2,2,4,-2,-50.0
91,80,3,10,8,2,25.0
91,80,4,18,16,2,12.5
91,80,5,57,32,25,78.125
91,80,6,54,64,-10,-15.625
91,80,7,6,128,-122,-95.3125
91,80,8,594,256,338,132.03125
91,80,9,785,512,273,53.3203125
91,80,10,514,1024,-510,-49.8046875
91,80,11,3311,2048,1263,61.669921875
91,80,12,3305,4096,-791,-19.3115234375
91,80,13,2715,8192,-5477,-66.85791015625
91,80,14,5179,16384,-11205,-68.389892578125
91,80,15,4798,32768,-27970,-85.357666015625
91,81,1,0,2,-2,-100.0
91,81,2,1,4,-3,-75.0
91,81,3,3,8,-5,-62.5
91,81,4,10,16,-6,-37.5
91,81,5,7,32,-25,-78.125
91,81,6,192,64,128,200.0
91,81,7,78,128,-50,-39.0625
91,81,8,127,256,-129,-50.390625
91,81,9,1109,512,597,116.6015625
91,81,10,273,1024,-751,-73.33984375
91,81,11,897,2048,-1151,-56.201171875
91,81,12,4731,4096,635,15.5029296875
91,81,13,5403,8192,-2789,-34.04541015625
91,81,14,6598,16384,-9786,-59.72900390625
91,81,15,135354,32768,102586,313.067626953125
91,82,1,0,2,-2,-100.0
91,82,2,2,4,-2,-50.0
91,82,3,4,8,-4,-50.0
91,82,4,5,16,-11,-68.75
91,82,5,9,32,-23,-71.875
91,82,6,20,64,-44,-68.75
91,82,7,196,128,68,53.125
91,82,8,548,256,292,114.0625
91,82,9,1241,512,729,142.3828125
91,82,10,1585,1024,561,54.78515625
91,82,11,574,2048,-1474,-71.97265625
91,82,12,6411,4096,2315,56.5185546875
91,82,13,6205,8192,-1987,-24.25537109375
91,82,14,4887,16384,-11497,-70.172119140625
91,82,15,45361,32768,12593,38.4307861328125
91,83,1,0,2,-2,-100.0
91,83,2,1,4,-3,-75.0
91,83,3,11,8,3,37.5
91,83,4,5,16,-11,-68.75
91,83,5,22,32,-10,-31.25
91,83,6,77,64,13,20.3125
91,83,7,99,128,-29,-22.65625
91,83,8,44,256,-212,-82.8125
91,83,9,191,512,-321,-62.6953125
91,83,10,2082,1024,1058,103.3203125
91,83,11,630,2048,-1418,-69.23828125
91,83,12,559,4096,-3537,-86.3525390625
91,83,13,33997,8192,25805,315.00244140625
91,83,14,30655,16384,14271,87.103271484375
91,83,15,42663,32768,9895,30.1971435546875
91,84,1,0,2,-2,-100.0
91,84,2,4,4,0,0.0
91,84,3,11,8,3,37.5
91,84,4,20,16,4,25.0
91,84,5,4,32,-28,-87.5
91,84,6,32,64,-32,-50.0
91,84,7,147,128,19,14.84375
91,84,8,216,256,-40,-15.625
91,84,9,165,512,-347,-67.7734375
91,84,10,87,1024,-937,-91.50390625
91,84,11,283,2048,-1765,-86.181640625
91,84,12,3883,4096,-213,-5.2001953125
91,84,13,5598,8192,-2594,-31.6650390625
91,84,14,13083,16384,-3301,-20.147705078125
91,84,15,51323,32768,18555,56.6253662109375
91,85,1,0,2,-2,-100.0
91,85,2,2,4,-2,-50.0
91,85,3,7,8,-1,-12.5
91,85,4,9,16,-7,-43.75
91,85,5,4,32,-28,-87.5
91,85,6,19,64,-45,-70.3125
91,85,7,6,128,-122,-95.3125
91,85,8,97,256,-159,-62.109375
91,85,9,113,512,-399,-77.9296875
91,85,10,213,1024,-811,-79.19921875
91,85,11,1661,2048,-387,-18.896484375
91,85,12,2665,4096,-1431,-34.9365234375
91,85,13,1760,8192,-6432,-78.515625
91,85,14,47160,16384,30776,187.841796875
91,85,15,37569,32768,4801,14.6514892578125
91,86,1,0,2,-2,-100.0
91,86,2,3,4,-1,-25.0
91,86,3,5,8,-3,-37.5
91,86,4,18,16,2,12.5
91,86,5,13,32,-19,-59.375
91,86,6,130,64,66,103.125
91,86,7,56,128,-72,-56.25
91,86,8,372,256,116,45.3125
91,86,9,722,512,210,41.015625
91,86,10,337,1024,-687,-67.08984375
91,86,11,1921,2048,-127,-6.201171875
91,86,12,3819,4096,-277,-6.7626953125
91,86,13,12613,8192,4421,53.96728515625
91,86,14,17342,16384,958,5.84716796875
91,86,15,22452,32768,-10316,-31.48193359375
91,87,1,0,2,-2,-100.0
91,87,2,2,4,-2,-50.0
91,87,3,6,8,-2,-25.0
91,87,4,12,16,-4,-25.0
91,87,5,15,32,-17,-53.125
91,87,6,5,64,-59,-92.1875
91,87,7,50,128,-78,-60.9375
91,87,8,444,256,188,73.4375
91,87,9,201,512,-311,-60.7421875
91,87,10,823,1024,-201,-19.62890625
91,87,11,215,2048,-1833,-89.501953125
91,87,12,2522,4096,-1574,-38.427734375
91,87,13,17052,8192,8860,108.154296875
91,87,14,32018,16384,15634,95.42236328125
91,87,15,27475,32768,-5293,-16.1529541015625
91,88,1,0,2,-2,-100.0
91,88,2,1,4,-3,-75.0
91,88,3,4,8,-4,-50.0
91,88,4,3,16,-13,-81.25
91,88,5,66,32,34,106.25
91,88,6,51,64,-13,-20.3125
91,88,7,72,128,-56,-43.75
91,88,8,158,256,-98,-38.28125
91,88,9,48,512,-464,-90.625
91,88,10,1866,1024,842,82.2265625
91,88,11,3395,2048,1347,65.771484375
91,88,12,3200,4096,-896,-21.875
91,88,13,5493,8192,-2699,-32.94677734375
91,88,14,14682,16384,-1702,-10.38818359375
91,88,15,2059,32768,-30709,-93.7164306640625
91,89,1,0,2,-2,-100.0
91,89,2,1,4,-3,-75.0
91,89,3,2,8,-6,-75.0
91,89,4,26,16,10,62.5
91,89,5,18,32,-14,-43.75
91,89,6,30,64,-34,-53.125
91,89,7,111,128,-17,-13.28125
91,89,8,86,256,-170,-66.40625
91,89,9,513,512,1,0.1953125
91,89,10,1448,1024,424,41.40625
91,89,11,10844,2048,8796,429.4921875
91,89,12,4793,4096,697,17.0166015625
91,89,13,2071,8192,-6121,-74.71923828125
91,89,14,53543,16384,37159,226.800537109375
91,89,15,53855,32768,21087,64.3524169921875
91,90,1,0,2,-2,-100.0
91,90,2,4,4,0,0.0
91,90,3,3,8,-5,-62.5
91,90,4,18,16,2,12.5
91,90,5,4,32,-28,-87.5
91,90,6,24,64,-40,-62.5
91,90,7,136,128,8,6.25
91,90,8,203,256,-53,-20.703125
91,90,9,487,512,-25,-4.8828125
91,90,10,201,1024,-823,-80.37109375
91,90,11,265,2048,-1783,-87.060546875
91,90,12,6610,4096,2514,61.376953125
91,90,13,6629,8192,-1563,-19.07958984375
91,90,14,2614,16384,-13770,-84.04541015625
91,90,15,42143,32768,9375,28.6102294921875
91,91,1,0,2,-2,-100.0
91,91,2,2,4,-2,-50.0
91,91,3,5,8,-3,-37.5
91,91,4,12,16,-4,-25.0
91,91,5,32,32,0,0.0
91,91,6,108,64,44,68.75
91,91,7,13,128,-115,-89.84375
91,91,8,374,256,118,46.09375
91,91,9,63,512,-449,-87.6953125
91,91,10,163,1024,-861,-84.08203125
91,91,11,664,2048,-1384,-67.578125
91,91,12,1933,4096,-2163,-52.8076171875
91,91,13,4299,8192,-3893,-47.52197265625
91,91,14,48999,16384,32615,199.066162109375
91,91,15,68782,32768,36014,109.906005859375
92,1,1,0,2,-2,-100.0
92,1,2,3,4,-1,-25.0
92,1,3,6,8,-2,-25.0
92,1,4,6,16,-10,-62.5
92,1,5,22,32,-10,-31.25
92,1,6,32,64,-32,-50.0
92,1,7,16,128,-112,-87.5
92,1,8,201,256,-55,-21.484375
92,1,9,226,512,-286,-55.859375
92,1,10,1787,1024,763,74.51171875
92,1,11,946,2048,-1102,-53.80859375
92,1,12,2175,4096,-1921,-46.8994140625
92,1,13,4822,8192,-3370,-41.1376953125
92,1,14,15106,16384,-1278,-7.80029296875
92,1,15,44659,32768,11891,36.2884521484375
92,2,1,0,2,-2,-100.0
92,2,2,2,4,-2,-50.0
92,2,3,10,8,2,25.0
92,2,4,3,16,-13,-81.25
92,2,5,19,32,-13,-40.625
92,2,6,72,64,8,12.5
92,2,7,295,128,167,130.46875
92,2,8,354,256,98,38.28125
92,2,9,35,512,-477,-93.1640625
92,2,10,951,1024,-73,-7.12890625
92,2,11,358,2048,-1690,-82.51953125
92,2,12,253,4096,-3843,-93.8232421875
92,2,13,6493,8192,-1699,-20.73974609375
92,2,14,9379,16384,-7005,-42.755126953125
92,2,15,21603,32768,-11165,-34.0728759765625
92,3,1,0,2,-2,-100.0
92,3,2,1,4,-3,-75.0
92,3,3,10,8,2,25.0
92,3,4,6,16,-10,-62.5
92,3,5,4,32,-28,-87.5
92,3,6,19,64,-45,-70.3125
92,3,7,15,128,-113,-88.28125
92,3,8,135,256,-121,-47.265625
92,3,9,841,512,329,64.2578125
92,3,10,501,1024,-523,-51.07421875
92,3,11,3096,2048,1048,51.171875
92,3,12,5871,4096,1775,43.3349609375
92,3,13,4564,8192,-3628,-44.287109375
92,3,14,18998,16384,2614,15.95458984375
92,3,15,11099,32768,-21669,-66.1285400390625
92,4,1,0,2,-2,-100.0
92,4,2,1,4,-3,-75.0
92,4,3,3,8,-5,-62.5
92,4,4,16,16,0,0.0
92,4,5,20,32,-12,-37.5
92,4,6,16,64,-48,-75.0
92,4,7,19,128,-109,-85.15625
92,4,8,44,256,-212,-82.8125
92,4,9,96,512,-416,-81.25
92,4,10,601,1024,-423,-41.30859375
92,4,11,2561,2048,513,25.048828125
92,4,12,2389,4096,-1707,-41.6748046875
92,4,13,5451,8192,-2741,-33.45947265625
92,4,14,484,16384,-15900,-97.0458984375
92,4,15,10497,32768,-22271,-67.9656982421875
92,5,1,0,2,-2,-100.0
92,5,2,1,4,-3,-75.0
92,5,3,3,8,-5,-62.5
92,5,4,17,16,1,6.25
92,5,5,19,32,-13,-40.625
92,5,6,88,64,24,37.5
92,5,7,206,128,78,60.9375
92,5,8,448,256,192,75.0
92,5,9,1553,512,1041,203.3203125
92,5,10,111,1024,-913,-89.16015625
92,5,11,747,2048,-1301,-63.525390625
92,5,12,868,4096,-3228,-78.80859375
92,5,13,927,8192,-7265,-88.68408203125
92,5,14,4035,16384,-12349,-75.372314453125
92,5,15,22402,32768,-10366,-31.634521484375
92,6,1,0,2,-2,-100.0
92,6,2,1,4,-3,-75.0
92,6,3,2,8,-6,-75.0
92,6,4,24,16,8,50.0
92,6,5,28,32,-4,-12.5
92,6,6,5,64,-59,-92.1875
92,6,7,10,128,-118,-92.1875
92,6,8,27,256,-229,-89.453125
92,6,9,125,512,-387,-75.5859375
92,6,10,683,1024,-341,-33.30078125
92,6,11,3391,2048,1343,65.576171875
92,6,12,2586,4096,-1510,-36.865234375
92,6,13,11898,8192,3706,45.2392578125
92,6,14,20258,16384,3874,23.64501953125
92,6,15,101835,32768,69067,210.7757568359375
92,7,1,0,2,-2,-100.0
92,7,2,2,4,-2,-50.0
92,7,3,14,8,6,75.0
92,7,4,12,16,-4,-25.0
92,7,5,48,32,16,50.0
92,7,6,19,64,-45,-70.3125
92,7,7,88,128,-40,-31.25
92,7,8,241,256,-15,-5.859375
92,7,9,252,512,-260,-50.78125
92,7,10,1173,1024,149,14.55078125
92,7,11,1176,2048,-872,-42.578125
92,7,12,9680,4096,5584,136.328125
92,7,13,2842,8192,-5350,-65.3076171875
92,7,14,14981,16384,-1403,-8.563232421875
92,7,15,21764,32768,-11004,-33.58154296875
92,8,1,0,2,-2,-100.0
92,8,2,2,4,-2,-50.0
92,8,3,2,8,-6,-75.0
92,8,4,24,16,8,50.0
92,8,5,8,32,-24,-75.0
92,8,6,33,64,-31,-48.4375
92,8,7,152,128,24,18.75
92,8,8,94,256,-162,-63.28125
92,8,9,598,512,86,16.796875
92,8,10,2719,1024,1695,165.52734375
92,8,11,723,2048,-1325,-64.697265625
92,8,12,7469,4096,3373,82.3486328125
92,8,13,1281,8192,-6911,-84.36279296875
92,8,14,10072,16384,-6312,-38.525390625
92,8,15,35921,32768,3153,9.6221923828125
92,9,1,0,2,-2,-100.0
92,9,2,1,4,-3,-75.0
92,9,3,9,8,1,12.5
92,9,4,3,16,-13,-81.25
92,9,5,29,32,-3,-9.375
92,9,6,28,64,-36,-56.25
92,9,7,164,128,36,28.125
92,9,8,71,256,-185,-72.265625
92,9,9,269,512,-243,-47.4609375
92,9,10,240,1024,-784,-76.5625
92,9,11,371,2048,-1677,-81.884765625
92,9,12,1129,4096,-2967,-72.4365234375
92,9,13,3201,8192,-4991,-60.92529296875
92,9,14,37105,16384,20721,126.470947265625
92,9,15,24406,32768,-8362,-25.518798828125
92,10,1,0,2,-2,-100.0
92,10,2,1,4,-3,-75.0
92,10,3,5,8,-3,-37.5
92,10,4,4,16,-12,-75.0
92,10,5,88,32,56,175.0
92,10,6,42,64,-22,-34.375
92,10,7,12,128,-116,-90.625
92,10,8,236,256,-20,-7.8125
92,10,9,133,512,-379,-74.0234375
92,10,10,1540,1024,516,50.390625
92,10,11,38,2048,-2010,-98.14453125
92,10,12,1690,4096,-2406,-58.740234375
92,10,13,3201,8192,-4991,-60.92529296875
92,10,14,78153,16384,61769,377.008056640625
92,10,15,91055,32768,58287,177.8778076171875
92,11,1,0,2,-2,-100.0
92,11,2,7,4,3,75.0
92,11,3,10,8,2,25.0
92,11,4,3,16,-13,-81.25
92,11,5,15,32,-17,-53.125
92,11,6,23,64,-41,-64.0625
92,11,7,61,128,-67,-52.34375
92,11,8,73,256,-183,-71.484375
92,11,9,343,512,-169,-33.0078125
92,11,10,896,1024,-128,-12.5
92,11,11,692,2048,-1356,-66.2109375
92,11,12,7678,4096,3582,87.451171875
92,11,13,1424,8192,-6768,-82.6171875
92,11,14,36802,16384,20418,124.62158203125
92,11,15,10215,32768,-22553,-68.8262939453125
92,12,1,0,2,-2,-100.0
92,12,2,1,4,-3,-75.0
92,12,3,12,8,4,50.0
92,12,4,17,16,1,6.25
92,12,5,27,32,-5,-15.625
92,12,6,126,64,62,96.875
92,12,7,76,128,-52,-40.625
92,12,8,181,256,-75,-29.296875
92,12,9,877,512,365,71.2890625
92,12,10,184,1024,-840,-82.03125
92,12,11,1003,2048,-1045,-51.025390625
92,12,12,442,4096,-3654,-89.208984375
92,12,13,10007,8192,1815,22.15576171875
92,12,14,24612,16384,8228,50.2197265625
92,12,15,17084,32768,-15684,-47.86376953125
92,13,1,0,2,-2,-100.0
92,13,2,8,4,4,100.0
92,13,3,3,8,-5,-62.5
92,13,4,11,16,-5,-31.25
92,13,5,6,32,-26,-81.25
92,13,6,80,64,16,25.0
92,13,7,108,128,-20,-15.625
92,13,8,821,256,565,220.703125
92,13,9,414,512,-98,-19.140625
92,13,10,1202,1024,178,17.3828125
92,13,11,687,2048,-1361,-66.455078125
92,13,12,4750,4096,654,15.966796875
92,13,13,2546,8192,-5646,-68.9208984375
92,13,14,2955,16384,-13429,-81.964111328125
92,13,15,4440,32768,-28328,-86.4501953125
92,14,1,0,2,-2,-100.0
92,14,2,2,4,-2,-50.0
92,14,3,5,8,-3,-37.5
92,14,4,17,16,1,6.25
92,14,5,91,32,59,184.375
92,14,6,102,64,38,59.375
92,14,7,151,128,23,17.96875
92,14,8,131,256,-125,-48.828125
92,14,9,57,512,-455,-88.8671875
92,14,10,1329,1024,305,29.78515625
92,14,11,119,2048,-1929,-94.189453125
92,14,12,1204,4096,-2892,-70.60546875
92,14,13,9523,8192,1331,16.24755859375
92,14,14,2713,16384,-13671,-83.441162109375
92,14,15,1738,32768,-31030,-94.696044921875
92,15,1,0,2,-2,-100.0
92,15,2,1,4,-3,-75.0
92,15,3,19,8,11,137.5
92,15,4,5,16,-11,-68.75
92,15,5,90,32,58,181.25
92,15,6,30,64,-34,-53.125
92,15,7,81,128,-47,-36.71875
92,15,8,40,256,-216,-84.375
92,15,9,1060,512,548,107.03125
92,15,10,717,1024,-307,-29.98046875
92,15,11,1083,2048,-965,-47.119140625
92,15,12,3079,4096,-1017,-24.8291015625
92,15,13,2924,8192,-5268,-64.306640625
92,15,14,2150,16384,-14234,-86.87744140625
92,15,15,93463,32768,60695,185.2264404296875
92,16,1,0,2,-2,-100.0
92,16,2,3,4,-1,-25.0
92,16,3,2,8,-6,-75.0
92,16,4,18,16,2,12.5
92,16,5,97,32,65,203.125
92,16,6,130,64,66,103.125
92,16,7,183,128,55,42.96875
92,16,8,187,256,-69,-26.953125
92,16,9,246,512,-266,-51.953125
92,16,10,2329,1024,1305,127.44140625
92,16,11,1490,2048,-558,-27.24609375
92,16,12,13600,4096,9504,232.03125
92,16,13,10431,8192,2239,27.33154296875
92,16,14,18910,16384,2526,15.41748046875
92,16,15,72253,32768,39485,120.4986572265625
92,17,1,0,2,-2,-100.0
92,17,2,1,4,-3,-75.0
92,17,3,4,8,-4,-50.0
92,17,4,30,16,14,87.5
92,17,5,14,32,-18,-56.25
92,17,6,35,64,-29,-45.3125
92,17,7,35,128,-93,-72.65625
92,17,8,355,256,99,38.671875
92,17,9,110,512,-402,-78.515625
92,17,10,389,1024,-635,-62.01171875
92,17,11,960,2048,-1088,-53.125
92,17,12,9048,4096,4952,120.8984375
92,17,13,4855,8192,-3337,-40.73486328125
92,17,14,56306,16384,39922,243.66455078125
92,17,15,46640,32768,13872,42.333984375
92,18,1,0,2,-2,-100.0
92,18,2,1,4,-3,-75.0
92,18,3,12,8,4,50.0
92,18,4,3,16,-13,-81.25
92,18,5,4,32,-28,-87.5
92,18,6,114,64,50,78.125
92,18,7,202,128,74,57.8125
92,18,8,285,256,29,11.328125
92,18,9,932,512,420,82.03125
92,18,10,2071,1024,1047,102.24609375
92,18,11,328,2048,-1720,-83.984375
92,18,12,3737,4096,-359,-8.7646484375
92,18,13,930,8192,-7262,-88.6474609375
92,18,14,2265,16384,-14119,-86.175537109375
92,18,15,24826,32768,-7942,-24.237060546875
92,19,1,0,2,-2,-100.0
92,19,2,3,4,-1,-25.0
92,19,3,2,8,-6,-75.0
92,19,4,9,16,-7,-43.75
92,19,5,9,32,-23,-71.875
92,19,6,44,64,-20,-31.25
92,19,7,74,128,-54,-42.1875
92,19,8,53,256,-203,-79.296875
92,19,9,2420,512,1908,372.65625
92,19,10,275,1024,-749,-73.14453125
92,19,11,2048,2048,0,0.0
92,19,12,758,4096,-3338,-81.494140625
92,19,13,2775,8192,-5417,-66.12548828125
92,19,14,7218,16384,-9166,-55.94482421875
92,19,15,56542,32768,23774,72.552490234375
92,20,1,0,2,-2,-100.0
92,20,2,1,4,-3,-75.0
92,20,3,2,8,-6,-75.0
92,20,4,3,16,-13,-81.25
92,20,5,25,32,-7,-21.875
92,20,6,257,64,193,301.5625
92,20,7,53,128,-75,-58.59375
92,20,8,1001,256,745,291.015625
92,20,9,248,512,-264,-51.5625
92,20,10,1012,1024,-12,-1.171875
92,20,11,1219,2048,-829,-40.478515625
92,20,12,125,4096,-3971,-96.9482421875
92,20,13,4533,8192,-3659,-44.66552734375
92,20,14,17782,16384,1398,8.53271484375
92,20,15,5940,32768,-26828,-81.87255859375
92,21,1,0,2,-2,-100.0
92,21,2,1,4,-3,-75.0
92,21,3,13,8,5,62.5
92,21,4,60,16,44,275.0
92,21,5,8,32,-24,-75.0
92,21,6,30,64,-34,-53.125
92,21,7,38,128,-90,-70.3125
92,21,8,54,256,-202,-78.90625
92,21,9,659,512,147,28.7109375
92,21,10,2631,1024,1607,156.93359375
92,21,11,527,2048,-1521,-74.267578125
92,21,12,3182,4096,-914,-22.314453125
92,21,13,12846,8192,4654,56.8115234375
92,21,14,24919,16384,8535,52.093505859375
92,21,15,1237,32768,-31531,-96.2249755859375
92,22,1,0,2,-2,-100.0
92,22,2,4,4,0,0.0
92,22,3,3,8,-5,-62.5
92,22,4,24,16,8,50.0
92,22,5,18,32,-14,-43.75
92,22,6,8,64,-56,-87.5
92,22,7,48,128,-80,-62.5
92,22,8,855,256,599,233.984375
92,22,9,988,512,476,92.96875
92,22,10,128,1024,-896,-87.5
92,22,11,1250,2048,-798,-38.96484375
92,22,12,7053,4096,2957,72.1923828125
92,22,13,8025,8192,-167,-2.03857421875
92,22,14,9417,16384,-6967,-42.523193359375
92,22,15,23524,32768,-9244,-28.21044921875
92,23,1,0,2,-2,-100.0
92,23,2,3,4,-1,-25.0
92,23,3,4,8,-4,-50.0
92,23,4,34,16,18,112.5
92,23,5,54,32,22,68.75
92,23,6,48,64,-16,-25.0
92,23,7,848,128,720,562.5
92,23,8,264,256,8,3.125
92,23,9,173,512,-339,-66.2109375
92,23,10,1211,1024,187,18.26171875
92,23,11,2679,2048,631,30.810546875
92,23,12,2005,4096,-2091,-51.0498046875
92,23,13,2008,8192,-6184,-75.48828125
92,23,14,7985,16384,-8399,-51.263427734375
92,23,15,23631,32768,-9137,-27.8839111328125
92,24,1,0,2,-2,-100.0
92,24,2,3,4,-1,-25.0
92,24,3,2,8,-6,-75.0
92,24,4,15,16,-1,-6.25
92,24,5,38,32,6,18.75
92,24,6,10,64,-54,-84.375
92,24,7,19,128,-109,-85.15625
92,24,8,316,256,60,23.4375
92,24,9,270,512,-242,-47.265625
92,24,10,603,1024,-421,-41.11328125
92,24,11,3512,2048,1464,71.484375
92,24,12,1879,4096,-2217,-54.1259765625
92,24,13,48972,8192,40780,497.802734375
92,24,14,11997,16384,-4387,-26.776123046875
92,24,15,54399,32768,21631,66.0125732421875
92,25,1,0,2,-2,-100.0
92,25,2,2,4,-2,-50.0
92,25,3,3,8,-5,-62.5
92,25,4,7,16,-9,-56.25
92,25,5,33,32,1,3.125
92,25,6,5,64,-59,-92.1875
92,25,7,40,128,-88,-68.75
92,25,8,240,256,-16,-6.25
92,25,9,89,512,-423,-82.6171875
92,25,10,3441,1024,2417,236.03515625
92,25,11,3651,2048,1603,78.271484375
92,25,12,48,4096,-4048,-98.828125
92,25,13,21177,8192,12985,158.50830078125
92,25,14,210,16384,-16174,-98.71826171875
92,25,15,30821,32768,-1947,-5.9417724609375
92,26,1,0,2,-2,-100.0
92,26,2,1,4,-3,-75.0
92,26,3,9,8,1,12.5
92,26,4,15,16,-1,-6.25
92,26,5,137,32,105,328.125
92,26,6,45,64,-19,-29.6875
92,26,7,155,128,27,21.09375
92,26,8,170,256,-86,-33.59375
92,26,9,148,512,-364,-71.09375
92,26,10,250,1024,-774,-75.5859375
92,26,11,601,2048,-1447,-70.654296875
92,26,12,1634,4096,-2462,-60.107421875
92,26,13,91,8192,-8101,-98.88916015625
92,26,14,4440,16384,-11944,-72.900390625
92,26,15,2380,32768,-30388,-92.73681640625
92,27,1,0,2,-2,-100.0
92,27,2,6,4,2,50.0
92,27,3,6,8,-2,-25.0
92,27,4,9,16,-7,-43.75
92,27,5,13,32,-19,-59.375
92,27,6,14,64,-50,-78.125
92,27,7,10,128,-118,-92.1875
92,27,8,124,256,-132,-51.5625
92,27,9,706,512,194,37.890625
92,27,10,2474,1024,1450,141.6015625
92,27,11,447,2048,-1601,-78.173828125
92,27,12,1413,4096,-2683,-65.5029296875
92,27,13,860,8192,-7332,-89.501953125
92,27,14,10911,16384,-5473,-33.404541015625
92,27,15,14634,32768,-18134,-55.340576171875
92,28,1,0,2,-2,-100.0
92,28,2,2,4,-2,-50.0
92,28,3,2,8,-6,-75.0
92,28,4,11,16,-5,-31.25
92,28,5,11,32,-21,-65.625
92,28,6,91,64,27,42.1875
92,28,7,81,128,-47,-36.71875
92,28,8,180,256,-76,-29.6875
92,28,9,125,512,-387,-75.5859375
92,28,10,206,1024,-818,-79.8828125
92,28,11,1482,2048,-566,-27.63671875
92,28,12,13104,4096,9008,219.921875
92,28,13,6983,8192,-1209,-14.75830078125
92,28,14,40729,16384,24345,148.590087890625
92,28,15,7066,32768,-25702,-78.436279296875
92,29,1,0,2,-2,-100.0
92,29,2,1,4,-3,-75.0
92,29,3,2,8,-6,-75.0
92,29,4,16,16,0,0.0
92,29,5,55,32,23,71.875
92,29,6,105,64,41,64.0625
92,29,7,129,128,1,0.78125
92,29,8,341,256,85,33.203125
92,29,9,130,512,-382,-74.609375
92,29,10,199,1024,-825,-80.56640625
92,29,11,569,2048,-1479,-72.216796875
92,29,12,126,4096,-3970,-96.923828125
92,29,13,16769,8192,8577,104.69970703125
92,29,14,14861,16384,-1523,-9.295654296875
92,29,15,71566,32768,38798,118.402099609375
92,30,1,0,2,-2,-100.0
92,30,2,2,4,-2,-50.0
92,30,3,3,8,-5,-62.5
92,30,4,29,16,13,81.25
92,30,5,27,32,-5,-15.625
92,30,6,27,64,-37,-57.8125
92,30,7,125,128,-3,-2.34375
92,30,8,127,256,-129,-50.390625
92,30,9,735,512,223,43.5546875
92,30,10,53,1024,-971,-94.82421875
92,30,11,813,2048,-1235,-60.302734375
92,30,12,4361,4096,265,6.4697265625
92,30,13,13394,8192,5202,63.5009765625
92,30,14,6292,16384,-10092,-61.5966796875
92,30,15,58713,32768,25945,79.1778564453125
92,31,1,0,2,-2,-100.0
92,31,2,2,4,-2,-50.0
92,31,3,2,8,-6,-75.0
92,31,4,37,16,21,131.25
92,31,5,8,32,-24,-75.0
92,31,6,39,64,-25,-39.0625
92,31,7,133,128,5,3.90625
92,31,8,440,256,184,71.875
92,31,9,277,512,-235,-45.8984375
92,31,10,239,1024,-785,-76.66015625
92,31,11,1763,2048,-285,-13.916015625
92,31,12,447,4096,-3649,-89.0869140625
92,31,13,2633,8192,-5559,-67.85888671875
92,31,14,2259,16384,-14125,-86.212158203125
92,31,15,11425,32768,-21343,-65.1336669921875
92,32,1,0,2,-2,-100.0
92,32,2,1,4,-3,-75.0
92,32,3,9,8,1,12.5
92,32,4,53,16,37,231.25
92,32,5,32,32,0,0.0
92,32,6,30,64,-34,-53.125
92,32,7,100,128,-28,-21.875
92,32,8,330,256,74,28.90625
92,32,9,1086,512,574,112.109375
92,32,10,3176,1024,2152,210.15625
92,32,11,132,2048,-1916,-93.5546875
92,32,12,2182,4096,-1914,-46.728515625
92,32,13,2008,8192,-6184,-75.48828125
92,32,14,4078,16384,-12306,-75.10986328125
92,32,15,6300,32768,-26468,-80.77392578125
92,33,1,0,2,-2,-100.0
92,33,2,3,4,-1,-25.0
92,33,3,4,8,-4,-50.0
92,33,4,17,16,1,6.25
92,33,5,21,32,-11,-34.375
92,33,6,12,64,-52,-81.25
92,33,7,69,128,-59,-46.09375
92,33,8,551,256,295,115.234375
92,33,9,186,512,-326,-63.671875
92,33,10,1605,1024,581,56.73828125
92,33,11,1048,2048,-1000,-48.828125
92,33,12,9970,4096,5874,143.408203125
92,33,13,3892,8192,-4300,-52.490234375
92,33,14,219,16384,-16165,-98.663330078125
92,33,15,2214,32768,-30554,-93.243408203125
92,34,1,0,2,-2,-100.0
92,34,2,3,4,-1,-25.0
92,34,3,15,8,7,87.5
92,34,4,4,16,-12,-75.0
92,34,5,16,32,-16,-50.0
92,34,6,14,64,-50,-78.125
92,34,7,255,128,127,99.21875
92,34,8,256,256,0,0.0
92,34,9,615,512,103,20.1171875
92,34,10,3174,1024,2150,209.9609375
92,34,11,1084,2048,-964,-47.0703125
92,34,12,15315,4096,11219,273.9013671875
92,34,13,21508,8192,13316,162.548828125
92,34,14,5730,16384,-10654,-65.02685546875
92,34,15,174965,32768,142197,433.9508056640625
92,35,1,0,2,-2,-100.0
92,35,2,2,4,-2,-50.0
92,35,3,7,8,-1,-12.5
92,35,4,8,16,-8,-50.0
92,35,5,9,32,-23,-71.875
92,35,6,13,64,-51,-79.6875
92,35,7,84,128,-44,-34.375
92,35,8,109,256,-147,-57.421875
92,35,9,1099,512,587,114.6484375
92,35,10,850,1024,-174,-16.9921875
92,35,11,4847,2048,2799,136.669921875
92,35,12,865,4096,-3231,-78.8818359375
92,35,13,7921,8192,-271,-3.30810546875
92,35,14,3177,16384,-13207,-80.609130859375
92,35,15,70285,32768,37517,114.4927978515625
92,36,1,0,2,-2,-100.0
92,36,2,3,4,-1,-25.0
92,36,3,2,8,-6,-75.0
92,36,4,24,16,8,50.0
92,36,5,33,32,1,3.125
92,36,6,10,64,-54,-84.375
92,36,7,163,128,35,27.34375
92,36,8,1733,256,1477,576.953125
92,36,9,1182,512,670,130.859375
92,36,10,1203,1024,179,17.48046875
92,36,11,3863,2048,1815,88.623046875
92,36,12,2819,4096,-1277,-31.1767578125
92,36,13,4762,8192,-3430,-41.8701171875
92,36,14,2596,16384,-13788,-84.1552734375
92,36,15,296,32768,-32472,-99.0966796875
92,37,1,0,2,-2,-100.0
92,37,2,1,4,-3,-75.0
92,37,3,2,8,-6,-75.0
92,37,4,9,16,-7,-43.75
92,37,5,25,32,-7,-21.875
92,37,6,9,64,-55,-85.9375
92,37,7,243,128,115,89.84375
92,37,8,29,256,-227,-88.671875
92,37,9,347,512,-165,-32.2265625
92,37,10,1747,1024,723,70.60546875
92,37,11,1243,2048,-805,-39.306640625
92,37,12,2448,4096,-1648,-40.234375
92,37,13,38868,8192,30676,374.462890625
92,37,14,4059,16384,-12325,-75.225830078125
92,37,15,29951,32768,-2817,-8.5968017578125
92,38,1,0,2,-2,-100.0
92,38,2,3,4,-1,-25.0
92,38,3,6,8,-2,-25.0
92,38,4,24,16,8,50.0
92,38,5,32,32,0,0.0
92,38,6,14,64,-50,-78.125
92,38,7,134,128,6,4.6875
92,38,8,252,256,-4,-1.5625
92,38,9,1000,512,488,95.3125
92,38,10,60,1024,-964,-94.140625
92,38,11,159,2048,-1889,-92.236328125
92,38,12,4270,4096,174,4.248046875
92,38,13,8115,8192,-77,-0.93994140625
92,38,14,376,16384,-16008,-97.705078125
92,38,15,21141,32768,-11627,-35.4827880859375
92,39,1,0,2,-2,-100.0
92,39,2,7,4,3,75.0
92,39,3,15,8,7,87.5
92,39,4,4,16,-12,-75.0
92,39,5,36,32,4,12.5
92,39,6,11,64,-53,-82.8125
92,39,7,205,128,77,60.15625
92,39,8,190,256,-66,-25.78125
92,39,9,1190,512,678,132.421875
92,39,10,594,1024,-430,-41.9921875
92,39,11,7128,2048,5080,248.046875
92,39,12,5646,4096,1550,37.841796875
92,39,13,15293,8192,7101,86.68212890625
92,39,14,4138,16384,-12246,-74.74365234375
92,39,15,10403,32768,-22365,-68.2525634765625
92,40,1,0,2,-2,-100.0
92,40,2,3,4,-1,-25.0
92,40,3,2,8,-6,-75.0
92,40,4,21,16,5,31.25
92,40,5,152,32,120,375.0
92,40,6,140,64,76,118.75
92,40,7,21,128,-107,-83.59375
92,40,8,801,256,545,212.890625
92,40,9,2195,512,1683,328.7109375
92,40,10,136,1024,-888,-86.71875
92,40,11,716,2048,-1332,-65.0390625
92,40,12,5268,4096,1172,28.61328125
92,40,13,2579,8192,-5613,-68.51806640625
92,40,14,5062,16384,-11322,-69.10400390625
92,40,15,25168,32768,-7600,-23.193359375
92,41,1,0,2,-2,-100.0
92,41,2,1,4,-3,-75.0
92,41,3,2,8,-6,-75.0
92,41,4,4,16,-12,-75.0
92,41,5,20,32,-12,-37.5
92,41,6,70,64,6,9.375
92,41,7,119,128,-9,-7.03125
92,41,8,544,256,288,112.5
92,41,9,688,512,176,34.375
92,41,10,672,1024,-352,-34.375
92,41,11,937,2048,-1111,-54.248046875
92,41,12,4695,4096,599,14.6240234375
92,41,13,594,8192,-7598,-92.7490234375
92,41,14,8591,16384,-7793,-47.564697265625
92,41,15,1246,32768,-31522,-96.197509765625
92,42,1,0,2,-2,-100.0
92,42,2,1,4,-3,-75.0
92,42,3,3,8,-5,-62.5
92,42,4,3,16,-13,-81.25
92,42,5,23,32,-9,-28.125
92,42,6,40,64,-24,-37.5
92,42,7,132,128,4,3.125
92,42,8,77,256,-179,-69.921875
92,42,9,122,512,-390,-76.171875
92,42,10,250,1024,-774,-75.5859375
92,42,11,1564,2048,-484,-23.6328125
92,42,12,2020,4096,-2076,-50.68359375
92,42,13,2651,8192,-5541,-67.63916015625
92,42,14,28222,16384,11838,72.25341796875
92,42,15,2921,32768,-29847,-91.0858154296875
92,43,1,0,2,-2,-100.0
92,43,2,3,4,-1,-25.0
92,43,3,2,8,-6,-75.0
92,43,4,4,16,-12,-75.0
92,43,5,100,32,68,212.5
92,43,6,19,64,-45,-70.3125
92,43,7,37,128,-91,-71.09375
92,43,8,194,256,-62,-24.21875
92,43,9,525,512,13,2.5390625
92,43,10,924,1024,-100,-9.765625
92,43,11,4718,2048,2670,130.37109375
92,43,12,5105,4096,1009,24.6337890625
92,43,13,6089,8192,-2103,-25.67138671875
92,43,14,1607,16384,-14777,-90.191650390625
92,43,15,10285,32768,-22483,-68.6126708984375
92,44,1,0,2,-2,-100.0
92,44,2,4,4,0,0.0
92,44,3,2,8,-6,-75.0
92,44,4,3,16,-13,-81.25
92,44,5,34,32,2,6.25
92,44,6,14,64,-50,-78.125
92,44,7,18,128,-110,-85.9375
92,44,8,429,256,173,67.578125
92,44,9,21,512,-491,-95.8984375
92,44,10,1027,1024,3,0.29296875
92,44,11,2324,2048,276,13.4765625
92,44,12,17,4096,-4079,-99.5849609375
92,44,13,11826,8192,3634,44.3603515625
92,44,14,24455,16384,8071,49.261474609375
92,44,15,18671,32768,-14097,-43.0206298828125
92,45,1,0,2,-2,-100.0
92,45,2,1,4,-3,-75.0
92,45,3,4,8,-4,-50.0
92,45,4,3,16,-13,-81.25
92,45,5,112,32,80,250.0
92,45,6,74,64,10,15.625
92,45,7,171,128,43,33.59375
92,45,8,70,256,-186,-72.65625
92,45,9,83,512,-429,-83.7890625
92,45,10,315,1024,-709,-69.23828125
92,45,11,2240,2048,192,9.375
92,45,12,3406,4096,-690,-16.845703125
92,45,13,1191,8192,-7001,-85.46142578125
92,45,14,15485,16384,-899,-5.487060546875
92,45,15,98169,32768,65401,199.5880126953125
92,46,1,0,2,-2,-100.0
92,46,2,1,4,-3,-75.0
92,46,3,7,8,-1,-12.5
92,46,4,3,16,-13,-81.25
92,46,5,25,32,-7,-21.875
92,46,6,91,64,27,42.1875
92,46,7,19,128,-109,-85.15625
92,46,8,596,256,340,132.8125
92,46,9,376,512,-136,-26.5625
92,46,10,275,1024,-749,-73.14453125
92,46,11,252,2048,-1796,-87.6953125
92,46,12,9691,4096,5595,136.5966796875
92,46,13,6424,8192,-1768,-21.58203125
92,46,14,6628,16384,-9756,-59.5458984375
92,46,15,41293,32768,8525,26.0162353515625
92,47,1,0,2,-2,-100.0
92,47,2,1,4,-3,-75.0
92,47,3,4,8,-4,-50.0
92,47,4,3,16,-13,-81.25
92,47,5,32,32,0,0.0
92,47,6,28,64,-36,-56.25
92,47,7,100,128,-28,-21.875
92,47,8,212,256,-44,-17.1875
92,47,9,172,512,-340,-66.40625
92,47,10,139,1024,-885,-86.42578125
92,47,11,1815,2048,-233,-11.376953125
92,47,12,19660,4096,15564,379.98046875
92,47,13,23651,8192,15459,188.70849609375
92,47,14,30959,16384,14575,88.958740234375
92,47,15,39643,32768,6875,20.9808349609375
92,48,1,0,2,-2,-100.0
92,48,2,4,4,0,0.0
92,48,3,4,8,-4,-50.0
92,48,4,3,16,-13,-81.25
92,48,5,31,32,-1,-3.125
92,48,6,105,64,41,64.0625
92,48,7,171,128,43,33.59375
92,48,8,1291,256,1035,404.296875
92,48,9,140,512,-372,-72.65625
92,48,10,297,1024,-727,-70.99609375
92,48,11,1793,2048,-255,-12.451171875
92,48,12,1048,4096,-3048,-74.4140625
92,48,13,5121,8192,-3071,-37.48779296875
92,48,14,42392,16384,26008,158.740234375
92,48,15,65647,32768,32879,100.3387451171875
92,49,1,0,2,-2,-100.0
92,49,2,2,4,-2,-50.0
92,49,3,2,8,-6,-75.0
92,49,4,7,16,-9,-56.25
92,49,5,4,32,-28,-87.5
92,49,6,79,64,15,23.4375
92,49,7,112,128,-16,-12.5
92,49,8,219,256,-37,-14.453125
92,49,9,1541,512,1029,200.9765625
92,49,10,635,1024,-389,-37.98828125
92,49,11,36,2048,-2012,-98.2421875
92,49,12,2263,4096,-1833,-44.7509765625
92,49,13,13575,8192,5383,65.71044921875
92,49,14,18759,16384,2375,14.495849609375
92,49,15,77869,32768,45101,137.6373291015625
92,50,1,0,2,-2,-100.0
92,50,2,1,4,-3,-75.0
92,50,3,4,8,-4,-50.0
92,50,4,3,16,-13,-81.25
92,50,5,25,32,-7,-21.875
92,50,6,21,64,-43,-67.1875
92,50,7,31,128,-97,-75.78125
92,50,8,206,256,-50,-19.53125
92,50,9,1627,512,1115,217.7734375
92,50,10,1514,1024,490,47.8515625
92,50,11,1767,2048,-281,-13.720703125
92,50,12,12811,4096,8715,212.7685546875
92,50,13,3639,8192,-4553,-55.57861328125
92,50,14,21582,16384,5198,31.72607421875
92,50,15,27116,32768,-5652,-17.24853515625
92,51,1,0,2,-2,-100.0
92,51,2,4,4,0,0.0
92,51,3,4,8,-4,-50.0
92,51,4,20,16,4,25.0
92,51,5,16,32,-16,-50.0
92,51,6,194,64,130,203.125
92,51,7,127,128,-1,-0.78125
92,51,8,241,256,-15,-5.859375
92,51,9,827,512,315,61.5234375
92,51,10,1557,1024,533,52.05078125
92,51,11,628,2048,-1420,-69.3359375
92,51,12,998,4096,-3098,-75.634765625
92,51,13,595,8192,-7597,-92.73681640625
92,51,14,18423,16384,2039,12.445068359375
92,51,15,5605,32768,-27163,-82.8948974609375
92,52,1,0,2,-2,-100.0
92,52,2,4,4,0,0.0
92,52,3,22,8,14,175.0
92,52,4,20,16,4,25.0
92,52,5,4,32,-28,-87.5
92,52,6,5,64,-59,-92.1875
92,52,7,149,128,21,16.40625
92,52,8,186,256,-70,-27.34375
92,52,9,135,512,-377,-73.6328125
92,52,10,1032,1024,8,0.78125
92,52,11,1605,2048,-443,-21.630859375
92,52,12,3821,4096,-275,-6.7138671875
92,52,13,9532,8192,1340,16.357421875
92,52,14,4328,16384,-12056,-73.583984375
92,52,15,46252,32768,13484,41.14990234375
92,53,1,0,2,-2,-100.0
92,53,2,2,4,-2,-50.0
92,53,3,7,8,-1,-12.5
92,53,4,16,16,0,0.0
92,53,5,7,32,-25,-78.125
92,53,6,15,64,-49,-76.5625
92,53,7,78,128,-50,-39.0625
92,53,8,101,256,-155,-60.546875
92,53,9,1321,512,809,158.0078125
92,53,10,170,1024,-854,-83.3984375
92,53,11,392,2048,-1656,-80.859375
92,53,12,411,4096,-3685,-89.9658203125
92,53,13,8104,8192,-88,-1.07421875
92,53,14,2185,16384,-14199,-86.663818359375
92,53,15,19038,32768,-13730,-41.900634765625
92,54,1,0,2,-2,-100.0
92,54,2,2,4,-2,-50.0
92,54,3,7,8,-1,-12.5
92,54,4,21,16,5,31.25
92,54,5,18,32,-14,-43.75
92,54,6,14,64,-50,-78.125
92,54,7,88,128,-40,-31.25
92,54,8,649,256,393,153.515625
92,54,9,58,512,-454,-88.671875
92,54,10,730,1024,-294,-28.7109375
92,54,11,2820,2048,772,37.6953125
92,54,12,1147,4096,-2949,-71.9970703125
92,54,13,549,8192,-7643,-93.29833984375
92,54,14,11072,16384,-5312,-32.421875
92,54,15,82921,32768,50153,153.0548095703125
92,55,1,0,2,-2,-100.0
92,55,2,2,4,-2,-50.0
92,55,3,3,8,-5,-62.5
92,55,4,18,16,2,12.5
92,55,5,52,32,20,62.5
92,55,6,5,64,-59,-92.1875
92,55,7,38,128,-90,-70.3125
92,55,8,78,256,-178,-69.53125
92,55,9,2905,512,2393,467.3828125
92,55,10,240,1024,-784,-76.5625
92,55,11,1253,2048,-795,-38.818359375
92,55,12,3885,4096,-211,-5.1513671875
92,55,13,6842,8192,-1350,-16.4794921875
92,55,14,47363,16384,30979,189.080810546875
92,55,15,6649,32768,-26119,-79.7088623046875
92,56,1,0,2,-2,-100.0
92,56,2,3,4,-1,-25.0
92,56,3,10,8,2,25.0
92,56,4,15,16,-1,-6.25
92,56,5,8,32,-24,-75.0
92,56,6,104,64,40,62.5
92,56,7,97,128,-31,-24.21875
92,56,8,171,256,-85,-33.203125
92,56,9,138,512,-374,-73.046875
92,56,10,685,1024,-339,-33.10546875
92,56,11,4674,2048,2626,128.22265625
92,56,12,3764,4096,-332,-8.10546875
92,56,13,3531,8192,-4661,-56.89697265625
92,56,14,6333,16384,-10051,-61.346435546875
92,56,15,49050,32768,16282,49.688720703125
92,57,1,0,2,-2,-100.0
92,57,2,1,4,-3,-75.0
92,57,3,7,8,-1,-12.5
92,57,4,15,16,-1,-6.25
92,57,5,4,32,-28,-87.5
92,57,6,15,64,-49,-76.5625
92,57,7,59,128,-69,-53.90625
92,57,8,40,256,-216,-84.375
92,57,9,1197,512,685,133.7890625
92,57,10,1106,1024,82,8.0078125
92,57,11,2450,2048,402,19.62890625
92,57,12,4640,4096,544,13.28125
92,57,13,7736,8192,-456,-5.56640625
92,57,14,150,16384,-16234,-99.08447265625
92,57,15,11575,32768,-21193,-64.6759033203125
92,58,1,0,2,-2,-100.0
92,58,2,1,4,-3,-75.0
92,58,3,2,8,-6,-75.0
92,58,4,18,16,2,12.5
92,58,5,10,32,-22,-68.75
92,58,6,13,64,-51,-79.6875
92,58,7,44,128,-84,-65.625
92,58,8,906,256,650,253.90625
92,58,9,1106,512,594,116.015625
92,58,10,519,1024,-505,-49.31640625
92,58,11,633,2048,-1415,-69.091796875
92,58,12,1508,4096,-2588,-63.18359375
92,58,13,618,8192,-7574,-92.4560546875
92,58,14,3686,16384,-12698,-77.50244140625
92,58,15,11699,32768,-21069,-64.2974853515625
92,59,1,0,2,-2,-100.0
92,59,2,2,4,-2,-50.0
92,59,3,6,8,-2,-25.0
92,59,4,15,16,-1,-6.25
92,59,5,58,32,26,81.25
92,59,6,29,64,-35,-54.6875
92,59,7,14,128,-114,-89.0625
92,59,8,87,256,-169,-66.015625
92,59,9,530,512,18,3.515625
92,59,10,61,1024,-963,-94.04296875
92,59,11,1240,2048,-808,-39.453125
92,59,12,8133,4096,4037,98.5595703125
92,59,13,11930,8192,3738,45.6298828125
92,59,14,77221,16384,60837,371.319580078125
92,59,15,71118,32768,38350,117.034912109375
92,60,1,0,2,-2,-100.0
92,60,2,2,4,-2,-50.0
92,60,3,2,8,-6,-75.0
92,60,4,11,16,-5,-31.25
92,60,5,9,32,-23,-71.875
92,60,6,6,64,-58,-90.625
92,60,7,297,128,169,132.03125
92,60,8,279,256,23,8.984375
92,60,9,211,512,-301,-58.7890625
92,60,10,496,1024,-528,-51.5625
92,60,11,443,2048,-1605,-78.369140625
92,60,12,6156,4096,2060,50.29296875
92,60,13,6621,8192,-1571,-19.17724609375
92,60,14,506,16384,-15878,-96.91162109375
92,60,15,81444,32768,48676,148.54736328125
92,61,1,0,2,-2,-100.0
92,61,2,3,4,-1,-25.0
92,61,3,4,8,-4,-50.0
92,61,4,8,16,-8,-50.0
92,61,5,15,32,-17,-53.125
92,61,6,68,64,4,6.25
92,61,7,52,128,-76,-59.375
92,61,8,36,256,-220,-85.9375
92,61,9,1174,512,662,129.296875
92,61,10,1923,1024,899,87.79296875
92,61,11,3909,2048,1861,90.869140625
92,61,12,195,4096,-3901,-95.2392578125
92,61,13,1783,8192,-6409,-78.23486328125
92,61,14,745,16384,-15639,-95.452880859375
92,61,15,17967,32768,-14801,-45.1690673828125
92,62,1,0,2,-2,-100.0
92,62,2,1,4,-3,-75.0
92,62,3,9,8,1,12.5
92,62,4,3,16,-13,-81.25
92,62,5,4,32,-28,-87.5
92,62,6,12,64,-52,-81.25
92,62,7,293,128,165,128.90625
92,62,8,119,256,-137,-53.515625
92,62,9,84,512,-428,-83.59375
92,62,10,563,1024,-461,-45.01953125
92,62,11,2464,2048,416,20.3125
92,62,12,12977,4096,8881,216.8212890625
92,62,13,7901,8192,-291,-3.55224609375
92,62,14,31627,16384,15243,93.035888671875
92,62,15,28501,32768,-4267,-13.0218505859375
92,63,1,0,2,-2,-100.0
92,63,2,1,4,-3,-75.0
92,63,3,5,8,-3,-37.5
92,63,4,26,16,10,62.5
92,63,5,74,32,42,131.25
92,63,6,11,64,-53,-82.8125
92,63,7,24,128,-104,-81.25
92,63,8,141,256,-115,-44.921875
92,63,9,248,512,-264,-51.5625
92,63,10,2018,1024,994,97.0703125
92,63,11,1036,2048,-1012,-49.4140625
92,63,12,3953,4096,-143,-3.4912109375
92,63,13,3062,8192,-5130,-62.6220703125
92,63,14,18059,16384,1675,10.223388671875
92,63,15,86399,32768,53631,163.6688232421875
92,64,1,0,2,-2,-100.0
92,64,2,1,4,-3,-75.0
92,64,3,19,8,11,137.5
92,64,4,3,16,-13,-81.25
92,64,5,4,32,-28,-87.5
92,64,6,42,64,-22,-34.375
92,64,7,55,128,-73,-57.03125
92,64,8,178,256,-78,-30.46875
92,64,9,434,512,-78,-15.234375
92,64,10,2695,1024,1671,163.18359375
92,64,11,2518,2048,470,22.94921875
92,64,12,3394,4096,-702,-17.138671875
92,64,13,8694,8192,502,6.1279296875
92,64,14,9521,16384,-6863,-41.888427734375
92,64,15,15174,32768,-17594,-53.692626953125
92,65,1,0,2,-2,-100.0
92,65,2,2,4,-2,-50.0
92,65,3,5,8,-3,-37.5
92,65,4,7,16,-9,-56.25
92,65,5,9,32,-23,-71.875
92,65,6,62,64,-2,-3.125
92,65,7,52,128,-76,-59.375
92,65,8,74,256,-182,-71.09375
92,65,9,769,512,257,50.1953125
92,65,10,2421,1024,1397,136.42578125
92,65,11,1083,2048,-965,-47.119140625
92,65,12,620,4096,-3476,-84.86328125
92,65,13,447,8192,-7745,-94.54345703125
92,65,14,7182,16384,-9202,-56.16455078125
92,65,15,10398,32768,-22370,-68.267822265625
92,66,1,0,2,-2,-100.0
92,66,2,1,4,-3,-75.0
92,66,3,2,8,-6,-75.0
92,66,4,17,16,1,6.25
92,66,5,35,32,3,9.375
92,66,6,11,64,-53,-82.8125
92,66,7,45,128,-83,-64.84375
92,66,8,141,256,-115,-44.921875
92,66,9,1423,512,911,177.9296875
92,66,10,1203,1024,179,17.48046875
92,66,11,6059,2048,4011,195.849609375
92,66,12,7879,4096,3783,92.3583984375
92,66,13,6907,8192,-1285,-15.68603515625
92,66,14,6275,16384,-10109,-61.700439453125
92,66,15,2456,32768,-30312,-92.5048828125
92,67,1,0,2,-2,-100.0
92,67,2,1,4,-3,-75.0
92,67,3,3,8,-5,-62.5
92,67,4,11,16,-5,-31.25
92,67,5,28,32,-4,-12.5
92,67,6,15,64,-49,-76.5625
92,67,7,13,128,-115,-89.84375
92,67,8,349,256,93,36.328125
92,67,9,894,512,382,74.609375
92,67,10,2113,1024,1089,106.34765625
92,67,11,1752,2048,-296,-14.453125
92,67,12,2652,4096,-1444,-35.25390625
92,67,13,4112,8192,-4080,-49.8046875
92,67,14,20347,16384,3963,24.188232421875
92,67,15,66529,32768,33761,103.0303955078125
92,68,1,0,2,-2,-100.0
92,68,2,2,4,-2,-50.0
92,68,3,2,8,-6,-75.0
92,68,4,6,16,-10,-62.5
92,68,5,8,32,-24,-75.0
92,68,6,50,64,-14,-21.875
92,68,7,66,128,-62,-48.4375
92,68,8,41,256,-215,-83.984375
92,68,9,1708,512,1196,233.59375
92,68,10,499,1024,-525,-51.26953125
92,68,11,1397,2048,-651,-31.787109375
92,68,12,18714,4096,14618,356.884765625
92,68,13,7042,8192,-1150,-14.0380859375
92,68,14,22737,16384,6353,38.775634765625
92,68,15,59024,32768,26256,80.126953125
92,69,1,0,2,-2,-100.0
92,69,2,4,4,0,0.0
92,69,3,5,8,-3,-37.5
92,69,4,6,16,-10,-62.5
92,69,5,57,32,25,78.125
92,69,6,53,64,-11,-17.1875
92,69,7,171,128,43,33.59375
92,69,8,131,256,-125,-48.828125
92,69,9,408,512,-104,-20.3125
92,69,10,2509,1024,1485,145.01953125
92,69,11,2283,2048,235,11.474609375
92,69,12,3086,4096,-1010,-24.658203125
92,69,13,11173,8192,2981,36.38916015625
92,69,14,14808,16384,-1576,-9.619140625
92,69,15,21948,32768,-10820,-33.02001953125
92,70,1,0,2,-2,-100.0
92,70,2,1,4,-3,-75.0
92,70,3,15,8,7,87.5
92,70,4,6,16,-10,-62.5
92,70,5,65,32,33,103.125
92,70,6,26,64,-38,-59.375
92,70,7,161,128,33,25.78125
92,70,8,2090,256,1834,716.40625
92,70,9,1190,512,678,132.421875
92,70,10,2478,1024,1454,141.9921875
92,70,11,5023,2048,2975,145.263671875
92,70,12,2947,4096,-1149,-28.0517578125
92,70,13,3843,8192,-4349,-53.08837890625
92,70,14,1538,16384,-14846,-90.61279296875
92,70,15,6771,32768,-25997,-79.3365478515625
92,71,1,0,2,-2,-100.0
92,71,2,7,4,3,75.0
92,71,3,6,8,-2,-25.0
92,71,4,62,16,46,287.5
92,71,5,31,32,-1,-3.125
92,71,6,67,64,3,4.6875
92,71,7,40,128,-88,-68.75
92,71,8,65,256,-191,-74.609375
92,71,9,217,512,-295,-57.6171875
92,71,10,935,1024,-89,-8.69140625
92,71,11,3345,2048,1297,63.330078125
92,71,12,5784,4096,1688,41.2109375
92,71,13,894,8192,-7298,-89.0869140625
92,71,14,16425,16384,41,0.250244140625
92,71,15,3940,32768,-28828,-87.97607421875
92,72,1,0,2,-2,-100.0
92,72,2,2,4,-2,-50.0
92,72,3,8,8,0,0.0
92,72,4,3,16,-13,-81.25
92,72,5,12,32,-20,-62.5
92,72,6,59,64,-5,-7.8125
92,72,7,48,128,-80,-62.5
92,72,8,142,256,-114,-44.53125
92,72,9,348,512,-164,-32.03125
92,72,10,568,1024,-456,-44.53125
92,72,11,6871,2048,4823,235.498046875
92,72,12,14753,4096,10657,260.1806640625
92,72,13,5623,8192,-2569,-31.35986328125
92,72,14,12870,16384,-3514,-21.44775390625
92,72,15,30530,32768,-2238,-6.829833984375
92,73,1,0,2,-2,-100.0
92,73,2,2,4,-2,-50.0
92,73,3,13,8,5,62.5
92,73,4,3,16,-13,-81.25
92,73,5,6,32,-26,-81.25
92,73,6,82,64,18,28.125
92,73,7,455,128,327,255.46875
92,73,8,218,256,-38,-14.84375
92,73,9,235,512,-277,-54.1015625
92,73,10,286,1024,-738,-72.0703125
92,73,11,2779,2048,731,35.693359375
92,73,12,9935,4096,5839,142.5537109375
92,73,13,11505,8192,3313,40.44189453125
92,73,14,19739,16384,3355,20.477294921875
92,73,15,9578,32768,-23190,-70.770263671875
92,74,1,0,2,-2,-100.0
92,74,2,1,4,-3,-75.0
92,74,3,12,8,4,50.0
92,74,4,70,16,54,337.5
92,74,5,4,32,-28,-87.5
92,74,6,63,64,-1,-1.5625
92,74,7,377,128,249,194.53125
92,74,8,141,256,-115,-44.921875
92,74,9,165,512,-347,-67.7734375
92,74,10,315,1024,-709,-69.23828125
92,74,11,2118,2048,70,3.41796875
92,74,12,5567,4096,1471,35.9130859375
92,74,13,9070,8192,878,10.7177734375
92,74,14,27633,16384,11249,68.658447265625
92,74,15,94676,32768,61908,188.92822265625
92,75,1,0,2,-2,-100.0
92,75,2,3,4,-1,-25.0
92,75,3,4,8,-4,-50.0
92,75,4,4,16,-12,-75.0
92,75,5,11,32,-21,-65.625
92,75,6,122,64,58,90.625
92,75,7,227,128,99,77.34375
92,75,8,371,256,115,44.921875
92,75,9,32,512,-480,-93.75
92,75,10,688,1024,-336,-32.8125
92,75,11,2859,2048,811,39.599609375
92,75,12,8507,4096,4411,107.6904296875
92,75,13,4470,8192,-3722,-45.4345703125
92,75,14,2936,16384,-13448,-82.080078125
92,75,15,23511,32768,-9257,-28.2501220703125
92,76,1,0,2,-2,-100.0
92,76,2,1,4,-3,-75.0
92,76,3,4,8,-4,-50.0
92,76,4,4,16,-12,-75.0
92,76,5,20,32,-12,-37.5
92,76,6,10,64,-54,-84.375
92,76,7,288,128,160,125.0
92,76,8,78,256,-178,-69.53125
92,76,9,1733,512,1221,238.4765625
92,76,10,128,1024,-896,-87.5
92,76,11,4936,2048,2888,141.015625
92,76,12,1265,4096,-2831,-69.1162109375
92,76,13,13682,8192,5490,67.0166015625
92,76,14,10478,16384,-5906,-36.04736328125
92,76,15,21456,32768,-11312,-34.521484375
92,77,1,0,2,-2,-100.0
92,77,2,1,4,-3,-75.0
92,77,3,7,8,-1,-12.5
92,77,4,4,16,-12,-75.0
92,77,5,24,32,-8,-25.0
92,77,6,72,64,8,12.5
92,77,7,52,128,-76,-59.375
92,77,8,227,256,-29,-11.328125
92,77,9,49,512,-463,-90.4296875
92,77,10,647,1024,-377,-36.81640625
92,77,11,2959,2048,911,44.482421875
92,77,12,162,4096,-3934,-96.044921875
92,77,13,122,8192,-8070,-98.5107421875
92,77,14,26003,16384,9619,58.709716796875
92,77,15,33177,32768,409,1.2481689453125
92,78,1,0,2,-2,-100.0
92,78,2,1,4,-3,-75.0
92,78,3,3,8,-5,-62.5
92,78,4,9,16,-7,-43.75
92,78,5,33,32,1,3.125
92,78,6,176,64,112,175.0
92,78,7,215,128,87,67.96875
92,78,8,292,256,36,14.0625
92,78,9,186,512,-326,-63.671875
92,78,10,462,1024,-562,-54.8828125
92,78,11,2907,2048,859,41.943359375
92,78,12,4185,4096,89,2.1728515625
92,78,13,17782,8192,9590,117.0654296875
92,78,14,9320,16384,-7064,-43.115234375
92,78,15,13692,32768,-19076,-58.21533203125
92,79,1,0,2,-2,-100.0
92,79,2,1,4,-3,-75.0
92,79,3,5,8,-3,-37.5
92,79,4,7,16,-9,-56.25
92,79,5,23,32,-9,-28.125
92,79,6,9,64,-55,-85.9375
92,79,7,9,128,-119,-92.96875
92,79,8,619,256,363,141.796875
92,79,9,107,512,-405,-79.1015625
92,79,10,121,1024,-903,-88.18359375
92,79,11,3592,2048,1544,75.390625
92,79,12,3456,4096,-640,-15.625
92,79,13,13564,8192,5372,65.576171875
92,79,14,6879,16384,-9505,-58.013916015625
92,79,15,31335,32768,-1433,-4.3731689453125
92,80,1,0,2,-2,-100.0
92,80,2,2,4,-2,-50.0
92,80,3,5,8,-3,-37.5
92,80,4,40,16,24,150.0
92,80,5,31,32,-1,-3.125
92,80,6,82,64,18,28.125
92,80,7,178,128,50,39.0625
92,80,8,159,256,-97,-37.890625
92,80,9,262,512,-250,-48.828125
92,80,10,146,1024,-878,-85.7421875
92,80,11,1210,2048,-838,-40.91796875
92,80,12,23281,4096,19185,468.3837890625
92,80,13,10880,8192,2688,32.8125
92,80,14,6377,16384,-10007,-61.077880859375
92,80,15,25853,32768,-6915,-21.1029052734375
92,81,1,0,2,-2,-100.0
92,81,2,2,4,-2,-50.0
92,81,3,5,8,-3,-37.5
92,81,4,16,16,0,0.0
92,81,5,43,32,11,34.375
92,81,6,24,64,-40,-62.5
92,81,7,21,128,-107,-83.59375
92,81,8,474,256,218,85.15625
92,81,9,634,512,122,23.828125
92,81,10,739,1024,-285,-27.83203125
92,81,11,1447,2048,-601,-29.345703125
92,81,12,3199,4096,-897,-21.8994140625
92,81,13,5376,8192,-2816,-34.375
92,81,14,221,16384,-16163,-98.651123046875
92,81,15,53531,32768,20763,63.3636474609375
92,82,1,0,2,-2,-100.0
92,82,2,1,4,-3,-75.0
92,82,3,3,8,-5,-62.5
92,82,4,21,16,5,31.25
92,82,5,5,32,-27,-84.375
92,82,6,102,64,38,59.375
92,82,7,57,128,-71,-55.46875
92,82,8,152,256,-104,-40.625
92,82,9,1851,512,1339,261.5234375
92,82,10,489,1024,-535,-52.24609375
92,82,11,73,2048,-1975,-96.435546875
92,82,12,6298,4096,2202,53.759765625
92,82,13,5512,8192,-2680,-32.71484375
92,82,14,7508,16384,-8876,-54.1748046875
92,82,15,15539,32768,-17229,-52.5787353515625
92,83,1,0,2,-2,-100.0
92,83,2,1,4,-3,-75.0
92,83,3,12,8,4,50.0
92,83,4,29,16,13,81.25
92,83,5,118,32,86,268.75
92,83,6,39,64,-25,-39.0625
92,83,7,119,128,-9,-7.03125
92,83,8,119,256,-137,-53.515625
92,83,9,658,512,146,28.515625
92,83,10,999,1024,-25,-2.44140625
92,83,11,3397,2048,1349,65.869140625
92,83,12,5047,4096,951,23.2177734375
92,83,13,1048,8192,-7144,-87.20703125
92,83,14,299,16384,-16085,-98.175048828125
92,83,15,60778,32768,28010,85.479736328125
92,84,1,0,2,-2,-100.0
92,84,2,5,4,1,25.0
92,84,3,2,8,-6,-75.0
92,84,4,3,16,-13,-81.25
92,84,5,63,32,31,96.875
92,84,6,28,64,-36,-56.25
92,84,7,166,128,38,29.6875
92,84,8,63,256,-193,-75.390625
92,84,9,359,512,-153,-29.8828125
92,84,10,1655,1024,631,61.62109375
92,84,11,66,2048,-1982,-96.77734375
92,84,12,9978,4096,5882,143.603515625
92,84,13,838,8192,-7354,-89.7705078125
92,84,14,13109,16384,-3275,-19.989013671875
92,84,15,38654,32768,5886,17.962646484375
92,85,1,0,2,-2,-100.0
92,85,2,4,4,0,0.0
92,85,3,5,8,-3,-37.5
92,85,4,23,16,7,43.75
92,85,5,13,32,-19,-59.375
92,85,6,59,64,-5,-7.8125
92,85,7,409,128,281,219.53125
92,85,8,127,256,-129,-50.390625
92,85,9,814,512,302,58.984375
92,85,10,55,1024,-969,-94.62890625
92,85,11,1811,2048,-237,-11.572265625
92,85,12,27059,4096,22963,560.6201171875
92,85,13,10840,8192,2648,32.32421875
92,85,14,25495,16384,9111,55.609130859375
92,85,15,88255,32768,55487,169.3328857421875
92,86,1,0,2,-2,-100.0
92,86,2,5,4,1,25.0
92,86,3,6,8,-2,-25.0
92,86,4,4,16,-12,-75.0
92,86,5,6,32,-26,-81.25
92,86,6,31,64,-33,-51.5625
92,86,7,87,128,-41,-32.03125
92,86,8,293,256,37,14.453125
92,86,9,580,512,68,13.28125
92,86,10,602,1024,-422,-41.2109375
92,86,11,2343,2048,295,14.404296875
92,86,12,3579,4096,-517,-12.6220703125
92,86,13,17180,8192,8988,109.716796875
92,86,14,11824,16384,-4560,-27.83203125
92,86,15,32885,32768,117,0.3570556640625
92,87,1,0,2,-2,-100.0
92,87,2,3,4,-1,-25.0
92,87,3,5,8,-3,-37.5
92,87,4,15,16,-1,-6.25
92,87,5,23,32,-9,-28.125
92,87,6,6,64,-58,-90.625
92,87,7,85,128,-43,-33.59375
92,87,8,698,256,442,172.65625
92,87,9,567,512,55,10.7421875
92,87,10,285,1024,-739,-72.16796875
92,87,11,3857,2048,1809,88.330078125
92,87,12,7725,4096,3629,88.5986328125
92,87,13,1615,8192,-6577,-80.28564453125
92,87,14,19636,16384,3252,19.8486328125
92,87,15,35661,32768,2893,8.8287353515625
92,88,1,0,2,-2,-100.0
92,88,2,2,4,-2,-50.0
92,88,3,6,8,-2,-25.0
92,88,4,3,16,-13,-81.25
92,88,5,15,32,-17,-53.125
92,88,6,64,64,0,0.0
92,88,7,52,128,-76,-59.375
92,88,8,382,256,126,49.21875
92,88,9,219,512,-293,-57.2265625
92,88,10,729,1024,-295,-28.80859375
92,88,11,6049,2048,4001,195.361328125
92,88,12,13509,4096,9413,229.8095703125
92,88,13,10018,8192,1826,22.2900390625
92,88,14,36481,16384,20097,122.662353515625
92,88,15,8231,32768,-24537,-74.8809814453125
92,89,1,0,2,-2,-100.0
92,89,2,1,4,-3,-75.0
92,89,3,13,8,5,62.5
92,89,4,5,16,-11,-68.75
92,89,5,53,32,21,65.625
92,89,6,63,64,-1,-1.5625
92,89,7,85,128,-43,-33.59375
92,89,8,814,256,558,217.96875
92,89,9,132,512,-380,-74.21875
92,89,10,559,1024,-465,-45.41015625
92,89,11,6722,2048,4674,228.22265625
92,89,12,1559,4096,-2537,-61.9384765625
92,89,13,8258,8192,66,0.8056640625
92,89,14,2312,16384,-14072,-85.888671875
92,89,15,15254,32768,-17514,-53.448486328125
92,90,1,0,2,-2,-100.0
92,90,2,2,4,-2,-50.0
92,90,3,7,8,-1,-12.5
92,90,4,11,16,-5,-31.25
92,90,5,9,32,-23,-71.875
92,90,6,144,64,80,125.0
92,90,7,107,128,-21,-16.40625
92,90,8,22,256,-234,-91.40625
92,90,9,3648,512,3136,612.5
92,90,10,1178,1024,154,15.0390625
92,90,11,244,2048,-1804,-88.0859375
92,90,12,5806,4096,1710,41.748046875
92,90,13,9196,8192,1004,12.255859375
92,90,14,11608,16384,-4776,-29.150390625
92,90,15,11545,32768,-21223,-64.7674560546875
92,91,1,0,2,-2,-100.0
92,91,2,1,4,-3,-75.0
92,91,3,3,8,-5,-62.5
92,91,4,4,16,-12,-75.0
92,91,5,69,32,37,115.625
92,91,6,58,64,-6,-9.375
92,91,7,228,128,100,78.125
92,91,8,36,256,-220,-85.9375
92,91,9,134,512,-378,-73.828125
92,91,10,964,1024,-60,-5.859375
92,91,11,3611,2048,1563,76.318359375
92,91,12,1030,4096,-3066,-74.853515625
92,91,13,1510,8192,-6682,-81.5673828125
92,91,14,4679,16384,-11705,-71.441650390625
92,91,15,10148,32768,-22620,-69.03076171875
92,92,1,0,2,-2,-100.0
92,92,2,3,4,-1,-25.0
92,92,3,8,8,0,0.0
92,92,4,10,16,-6,-37.5
92,92,5,9,32,-23,-71.875
92,92,6,45,64,-19,-29.6875
92,92,7,15,128,-113,-88.28125
92,92,8,9,256,-247,-96.484375
92,92,9,117,512,-395,-77.1484375
92,92,10,716,1024,-308,-30.078125
92,92,11,2660,2048,612,29.8828125
92,92,12,29194,4096,25098,612.744140625
92,92,13,3377,8192,-4815,-58.77685546875
92,92,14,2628,16384,-13756,-83.9599609375
92,92,15,2376,32768,-30392,-92.7490234375
93,1,1,0,2,-2,-100.0
93,1,2,2,4,-2,-50.0
93,1,3,3,8,-5,-62.5
93,1,4,3,16,-13,-81.25
93,1,5,17,32,-15,-46.875
93,1,6,35,64,-29,-45.3125
93,1,7,95,128,-33,-25.78125
93,1,8,71,256,-185,-72.265625
93,1,9,57,512,-455,-88.8671875
93,1,10,89,1024,-935,-91.30859375
93,1,11,6642,2048,4594,224.31640625
93,1,12,39,4096,-4057,-99.0478515625
93,1,13,22868,8192,14676,179.150390625
93,1,14,23310,16384,6926,42.27294921875
93,1,15,62893,32768,30125,91.9342041015625
93,2,1,0,2,-2,-100.0
93,2,2,1,4,-3,-75.0
93,2,3,17,8,9,112.5
93,2,4,8,16,-8,-50.0
93,2,5,14,32,-18,-56.25
93,2,6,77,64,13,20.3125
93,2,7,148,128,20,15.625
93,2,8,59,256,-197,-76.953125
93,2,9,900,512,388,75.78125
93,2,10,1527,1024,503,49.12109375
93,2,11,5826,2048,3778,184.47265625
93,2,12,1319,4096,-2777,-67.7978515625
93,2,13,289,8192,-7903,-96.47216796875
93,2,14,3197,16384,-13187,-80.487060546875
93,2,15,21580,32768,-11188,-34.14306640625
93,3,1,0,2,-2,-100.0
93,3,2,1,4,-3,-75.0
93,3,3,14,8,6,75.0
93,3,4,7,16,-9,-56.25
93,3,5,27,32,-5,-15.625
93,3,6,44,64,-20,-31.25
93,3,7,9,128,-119,-92.96875
93,3,8,1082,256,826,322.65625
93,3,9,697,512,185,36.1328125
93,3,10,1048,1024,24,2.34375
93,3,11,2926,2048,878,42.87109375
93,3,12,1102,4096,-2994,-73.095703125
93,3,13,44073,8192,35881,438.00048828125
93,3,14,6220,16384,-10164,-62.0361328125
93,3,15,38297,32768,5529,16.8731689453125
93,4,1,0,2,-2,-100.0
93,4,2,1,4,-3,-75.0
93,4,3,5,8,-3,-37.5
93,4,4,26,16,10,62.5
93,4,5,28,32,-4,-12.5
93,4,6,16,64,-48,-75.0
93,4,7,139,128,11,8.59375
93,4,8,182,256,-74,-28.90625
93,4,9,384,512,-128,-25.0
93,4,10,616,1024,-408,-39.84375
93,4,11,335,2048,-1713,-83.642578125
93,4,12,11798,4096,7702,188.037109375
93,4,13,4080,8192,-4112,-50.1953125
93,4,14,9882,16384,-6502,-39.68505859375
93,4,15,21745,32768,-11023,-33.6395263671875
93,5,1,0,2,-2,-100.0
93,5,2,6,4,2,50.0
93,5,3,4,8,-4,-50.0
93,5,4,3,16,-13,-81.25
93,5,5,6,32,-26,-81.25
93,5,6,22,64,-42,-65.625
93,5,7,7,128,-121,-94.53125
93,5,8,11,256,-245,-95.703125
93,5,9,92,512,-420,-82.03125
93,5,10,1174,1024,150,14.6484375
93,5,11,65,2048,-1983,-96.826171875
93,5,12,1118,4096,-2978,-72.705078125
93,5,13,4442,8192,-3750,-45.7763671875
93,5,14,6307,16384,-10077,-61.505126953125
93,5,15,60116,32768,27348,83.45947265625
93,6,1,0,2,-2,-100.0
93,6,2,2,4,-2,-50.0
93,6,3,16,8,8,100.0
93,6,4,26,16,10,62.5
93,6,5,17,32,-15,-46.875
93,6,6,13,64,-51,-79.6875
93,6,7,64,128,-64,-50.0
93,6,8,78,256,-178,-69.53125
93,6,9,463,512,-49,-9.5703125
93,6,10,414,1024,-610,-59.5703125
93,6,11,715,2048,-1333,-65.087890625
93,6,12,3963,4096,-133,-3.2470703125
93,6,13,26986,8192,18794,229.4189453125
93,6,14,1153,16384,-15231,-92.962646484375
93,6,15,11004,32768,-21764,-66.41845703125
93,7,1,0,2,-2,-100.0
93,7,2,2,4,-2,-50.0
93,7,3,7,8,-1,-12.5
93,7,4,6,16,-10,-62.5
93,7,5,9,32,-23,-71.875
93,7,6,27,64,-37,-57.8125
93,7,7,353,128,225,175.78125
93,7,8,87,256,-169,-66.015625
93,7,9,386,512,-126,-24.609375
93,7,10,266,1024,-758,-74.0234375
93,7,11,2727,2048,679,33.154296875
93,7,12,445,4096,-3651,-89.1357421875
93,7,13,35285,8192,27093,330.72509765625
93,7,14,594,16384,-15790,-96.37451171875
93,7,15,6879,32768,-25889,-79.0069580078125
93,8,1,0,2,-2,-100.0
93,8,2,1,4,-3,-75.0
93,8,3,2,8,-6,-75.0
93,8,4,24,16,8,50.0
93,8,5,45,32,13,40.625
93,8,6,62,64,-2,-3.125
93,8,7,144,128,16,12.5
93,8,8,48,256,-208,-81.25
93,8,9,797,512,285,55.6640625
93,8,10,72,1024,-952,-92.96875
93,8,11,1887,2048,-161,-7.861328125
93,8,12,3803,4096,-293,-7.1533203125
93,8,13,533,8192,-7659,-93.49365234375
93,8,14,5374,16384,-11010,-67.19970703125
93,8,15,53341,32768,20573,62.7838134765625
93,9,1,0,2,-2,-100.0
93,9,2,4,4,0,0.0
93,9,3,8,8,0,0.0
93,9,4,18,16,2,12.5
93,9,5,50,32,18,56.25
93,9,6,61,64,-3,-4.6875
93,9,7,85,128,-43,-33.59375
93,9,8,226,256,-30,-11.71875
93,9,9,440,512,-72,-14.0625
93,9,10,784,1024,-240,-23.4375
93,9,11,1374,2048,-674,-32.91015625
93,9,12,228,4096,-3868,-94.43359375
93,9,13,683,8192,-7509,-91.66259765625
93,9,14,933,16384,-15451,-94.305419921875
93,9,15,3993,32768,-28775,-87.8143310546875
93,10,1,0,2,-2,-100.0
93,10,2,6,4,2,50.0
93,10,3,2,8,-6,-75.0
93,10,4,3,16,-13,-81.25
93,10,5,101,32,69,215.625
93,10,6,40,64,-24,-37.5
93,10,7,17,128,-111,-86.71875
93,10,8,11,256,-245,-95.703125
93,10,9,143,512,-369,-72.0703125
93,10,10,686,1024,-338,-33.0078125
93,10,11,2688,2048,640,31.25
93,10,12,5170,4096,1074,26.220703125
93,10,13,2012,8192,-6180,-75.439453125
93,10,14,10335,16384,-6049,-36.920166015625
93,10,15,10813,32768,-21955,-67.0013427734375
93,11,1,0,2,-2,-100.0
93,11,2,1,4,-3,-75.0
93,11,3,18,8,10,125.0
93,11,4,3,16,-13,-81.25
93,11,5,42,32,10,31.25
93,11,6,99,64,35,54.6875
93,11,7,42,128,-86,-67.1875
93,11,8,545,256,289,112.890625
93,11,9,28,512,-484,-94.53125
93,11,10,587,1024,-437,-42.67578125
93,11,11,1111,2048,-937,-45.751953125
93,11,12,13842,4096,9746,237.939453125
93,11,13,913,8192,-7279,-88.85498046875
93,11,14,45897,16384,29513,180.133056640625
93,11,15,88799,32768,56031,170.9930419921875
93,12,1,0,2,-2,-100.0
93,12,2,1,4,-3,-75.0
93,12,3,4,8,-4,-50.0
93,12,4,7,16,-9,-56.25
93,12,5,12,32,-20,-62.5
93,12,6,58,64,-6,-9.375
93,12,7,225,128,97,75.78125
93,12,8,174,256,-82,-32.03125
93,12,9,543,512,31,6.0546875
93,12,10,2588,1024,1564,152.734375
93,12,11,605,2048,-1443,-70.458984375
93,12,12,566,4096,-3530,-86.181640625
93,12,13,19208,8192,11016,134.47265625
93,12,14,27018,16384,10634,64.90478515625
93,12,15,3945,32768,-28823,-87.9608154296875
93,13,1,0,2,-2,-100.0
93,13,2,2,4,-2,-50.0
93,13,3,5,8,-3,-37.5
93,13,4,15,16,-1,-6.25
93,13,5,55,32,23,71.875
93,13,6,24,64,-40,-62.5
93,13,7,30,128,-98,-76.5625
93,13,8,234,256,-22,-8.59375
93,13,9,134,512,-378,-73.828125
93,13,10,1099,1024,75,7.32421875
93,13,11,1038,2048,-1010,-49.31640625
93,13,12,1659,4096,-2437,-59.4970703125
93,13,13,1106,8192,-7086,-86.4990234375
93,13,14,24657,16384,8273,50.494384765625
93,13,15,42924,32768,10156,30.99365234375
93,14,1,0,2,-2,-100.0
93,14,2,2,4,-2,-50.0
93,14,3,10,8,2,25.0
93,14,4,3,16,-13,-81.25
93,14,5,39,32,7,21.875
93,14,6,24,64,-40,-62.5
93,14,7,128,128,0,0.0
93,14,8,737,256,481,187.890625
93,14,9,98,512,-414,-80.859375
93,14,10,893,1024,-131,-12.79296875
93,14,11,1872,2048,-176,-8.59375
93,14,12,2017,4096,-2079,-50.7568359375
93,14,13,1972,8192,-6220,-75.927734375
93,14,14,210,16384,-16174,-98.71826171875
93,14,15,26271,32768,-6497,-19.8272705078125
93,15,1,0,2,-2,-100.0
93,15,2,2,4,-2,-50.0
93,15,3,11,8,3,37.5
93,15,4,4,16,-12,-75.0
93,15,5,7,32,-25,-78.125
93,15,6,33,64,-31,-48.4375
93,15,7,56,128,-72,-56.25
93,15,8,514,256,258,100.78125
93,15,9,176,512,-336,-65.625
93,15,10,22,1024,-1002,-97.8515625
93,15,11,13,2048,-2035,-99.365234375
93,15,12,2336,4096,-1760,-42.96875
93,15,13,283,8192,-7909,-96.54541015625
93,15,14,9652,16384,-6732,-41.0888671875
93,15,15,2605,32768,-30163,-92.0501708984375
93,16,1,0,2,-2,-100.0
93,16,2,2,4,-2,-50.0
93,16,3,7,8,-1,-12.5
93,16,4,26,16,10,62.5
93,16,5,32,32,0,0.0
93,16,6,33,64,-31,-48.4375
93,16,7,142,128,14,10.9375
93,16,8,183,256,-73,-28.515625
93,16,9,70,512,-442,-86.328125
93,16,10,152,1024,-872,-85.15625
93,16,11,300,2048,-1748,-85.3515625
93,16,12,6980,4096,2884,70.41015625
93,16,13,7416,8192,-776,-9.47265625
93,16,14,20571,16384,4187,25.555419921875
93,16,15,134652,32768,101884,310.92529296875
93,17,1,0,2,-2,-100.0
93,17,2,1,4,-3,-75.0
93,17,3,4,8,-4,-50.0
93,17,4,6,16,-10,-62.5
93,17,5,26,32,-6,-18.75
93,17,6,68,64,4,6.25
93,17,7,158,128,30,23.4375
93,17,8,43,256,-213,-83.203125
93,17,9,310,512,-202,-39.453125
93,17,10,1934,1024,910,88.8671875
93,17,11,786,2048,-1262,-61.62109375
93,17,12,3062,4096,-1034,-25.244140625
93,17,13,12942,8192,4750,57.9833984375
93,17,14,14816,16384,-1568,-9.5703125
93,17,15,45676,32768,12908,39.39208984375
93,18,1,0,2,-2,-100.0
93,18,2,5,4,1,25.0
93,18,3,2,8,-6,-75.0
93,18,4,17,16,1,6.25
93,18,5,17,32,-15,-46.875
93,18,6,53,64,-11,-17.1875
93,18,7,11,128,-117,-91.40625
93,18,8,130,256,-126,-49.21875
93,18,9,318,512,-194,-37.890625
93,18,10,785,1024,-239,-23.33984375
93,18,11,950,2048,-1098,-53.61328125
93,18,12,2336,4096,-1760,-42.96875
93,18,13,7287,8192,-905,-11.04736328125
93,18,14,53129,16384,36745,224.273681640625
93,18,15,1348,32768,-31420,-95.88623046875
93,19,1,0,2,-2,-100.0
93,19,2,4,4,0,0.0
93,19,3,14,8,6,75.0
93,19,4,20,16,4,25.0
93,19,5,78,32,46,143.75
93,19,6,15,64,-49,-76.5625
93,19,7,32,128,-96,-75.0
93,19,8,37,256,-219,-85.546875
93,19,9,398,512,-114,-22.265625
93,19,10,219,1024,-805,-78.61328125
93,19,11,7451,2048,5403,263.818359375
93,19,12,4241,4096,145,3.5400390625
93,19,13,2327,8192,-5865,-71.59423828125
93,19,14,3888,16384,-12496,-76.26953125
93,19,15,14650,32768,-18118,-55.291748046875
93,20,1,0,2,-2,-100.0
93,20,2,1,4,-3,-75.0
93,20,3,5,8,-3,-37.5
93,20,4,8,16,-8,-50.0
93,20,5,63,32,31,96.875
93,20,6,72,64,8,12.5
93,20,7,562,128,434,339.0625
93,20,8,174,256,-82,-32.03125
93,20,9,25,512,-487,-95.1171875
93,20,10,213,1024,-811,-79.19921875
93,20,11,3248,2048,1200,58.59375
93,20,12,1092,4096,-3004,-73.33984375
93,20,13,8548,8192,356,4.345703125
93,20,14,3554,16384,-12830,-78.30810546875
93,20,15,6818,32768,-25950,-79.193115234375
93,21,1,0,2,-2,-100.0
93,21,2,2,4,-2,-50.0
93,21,3,2,8,-6,-75.0
93,21,4,10,16,-6,-37.5
93,21,5,4,32,-28,-87.5
93,21,6,100,64,36,56.25
93,21,7,206,128,78,60.9375
93,21,8,192,256,-64,-25.0
93,21,9,1464,512,952,185.9375
93,21,10,325,1024,-699,-68.26171875
93,21,11,39,2048,-2009,-98.095703125
93,21,12,6615,4096,2519,61.4990234375
93,21,13,43121,8192,34929,426.37939453125
93,21,14,18250,16384,1866,11.38916015625
93,21,15,53228,32768,20460,62.43896484375
93,22,1,0,2,-2,-100.0
93,22,2,2,4,-2,-50.0
93,22,3,24,8,16,200.0
93,22,4,9,16,-7,-43.75
93,22,5,17,32,-15,-46.875
93,22,6,20,64,-44,-68.75
93,22,7,18,128,-110,-85.9375
93,22,8,287,256,31,12.109375
93,22,9,296,512,-216,-42.1875
93,22,10,675,1024,-349,-34.08203125
93,22,11,742,2048,-1306,-63.76953125
93,22,12,92,4096,-4004,-97.75390625
93,22,13,6874,8192,-1318,-16.0888671875
93,22,14,34162,16384,17778,108.50830078125
93,22,15,22464,32768,-10304,-31.4453125
93,23,1,0,2,-2,-100.0
93,23,2,1,4,-3,-75.0
93,23,3,4,8,-4,-50.0
93,23,4,3,16,-13,-81.25
93,23,5,63,32,31,96.875
93,23,6,8,64,-56,-87.5
93,23,7,31,128,-97,-75.78125
93,23,8,313,256,57,22.265625
93,23,9,539,512,27,5.2734375
93,23,10,2299,1024,1275,124.51171875
93,23,11,3777,2048,1729,84.423828125
93,23,12,8454,4096,4358,106.396484375
93,23,13,20580,8192,12388,151.220703125
93,23,14,821,16384,-15563,-94.989013671875
93,23,15,19300,32768,-13468,-41.10107421875
93,24,1,0,2,-2,-100.0
93,24,2,1,4,-3,-75.0
93,24,3,2,8,-6,-75.0
93,24,4,20,16,4,25.0
93,24,5,35,32,3,9.375
93,24,6,33,64,-31,-48.4375
93,24,7,47,128,-81,-63.28125
93,24,8,273,256,17,6.640625
93,24,9,378,512,-134,-26.171875
93,24,10,186,1024,-838,-81.8359375
93,24,11,1841,2048,-207,-10.107421875
93,24,12,6821,4096,2725,66.5283203125
93,24,13,5966,8192,-2226,-27.1728515625
93,24,14,1684,16384,-14700,-89.7216796875
93,24,15,73184,32768,40416,123.33984375
93,25,1,0,2,-2,-100.0
93,25,2,2,4,-2,-50.0
93,25,3,5,8,-3,-37.5
93,25,4,18,16,2,12.5
93,25,5,30,32,-2,-6.25
93,25,6,205,64,141,220.3125
93,25,7,228,128,100,78.125
93,25,8,184,256,-72,-28.125
93,25,9,564,512,52,10.15625
93,25,10,1317,1024,293,28.61328125
93,25,11,1594,2048,-454,-22.16796875
93,25,12,2697,4096,-1399,-34.1552734375
93,25,13,18394,8192,10202,124.5361328125
93,25,14,17577,16384,1193,7.281494140625
93,25,15,3758,32768,-29010,-88.531494140625
93,26,1,0,2,-2,-100.0
93,26,2,1,4,-3,-75.0
93,26,3,9,8,1,12.5
93,26,4,13,16,-3,-18.75
93,26,5,22,32,-10,-31.25
93,26,6,120,64,56,87.5
93,26,7,82,128,-46,-35.9375
93,26,8,416,256,160,62.5
93,26,9,1780,512,1268,247.65625
93,26,10,240,1024,-784,-76.5625
93,26,11,3943,2048,1895,92.529296875
93,26,12,11117,4096,7021,171.4111328125
93,26,13,1423,8192,-6769,-82.62939453125
93,26,14,3508,16384,-12876,-78.5888671875
93,26,15,27805,32768,-4963,-15.1458740234375
93,27,1,0,2,-2,-100.0
93,27,2,3,4,-1,-25.0
93,27,3,8,8,0,0.0
93,27,4,12,16,-4,-25.0
93,27,5,24,32,-8,-25.0
93,27,6,74,64,10,15.625
93,27,7,16,128,-112,-87.5
93,27,8,49,256,-207,-80.859375
93,27,9,123,512,-389,-75.9765625
93,27,10,1295,1024,271,26.46484375
93,27,11,1143,2048,-905,-44.189453125
93,27,12,10325,4096,6229,152.0751953125
93,27,13,148,8192,-8044,-98.193359375
93,27,14,1144,16384,-15240,-93.017578125
93,27,15,14067,32768,-18701,-57.0709228515625
93,28,1,0,2,-2,-100.0
93,28,2,1,4,-3,-75.0
93,28,3,13,8,5,62.5
93,28,4,11,16,-5,-31.25
93,28,5,17,32,-15,-46.875
93,28,6,8,64,-56,-87.5
93,28,7,89,128,-39,-30.46875
93,28,8,826,256,570,222.65625
93,28,9,1539,512,1027,200.5859375
93,28,10,122,1024,-902,-88.0859375
93,28,11,797,2048,-1251,-61.083984375
93,28,12,1500,4096,-2596,-63.37890625
93,28,13,10540,8192,2348,28.662109375
93,28,14,1704,16384,-14680,-89.599609375
93,28,15,18474,32768,-14294,-43.621826171875
93,29,1,0,2,-2,-100.0
93,29,2,3,4,-1,-25.0
93,29,3,3,8,-5,-62.5
93,29,4,36,16,20,125.0
93,29,5,20,32,-12,-37.5
93,29,6,10,64,-54,-84.375
93,29,7,120,128,-8,-6.25
93,29,8,558,256,302,117.96875
93,29,9,1049,512,537,104.8828125
93,29,10,60,1024,-964,-94.140625
93,29,11,890,2048,-1158,-56.54296875
93,29,12,4603,4096,507,12.3779296875
93,29,13,12966,8192,4774,58.2763671875
93,29,14,4137,16384,-12247,-74.749755859375
93,29,15,19041,32768,-13727,-41.8914794921875
93,30,1,0,2,-2,-100.0
93,30,2,3,4,-1,-25.0
93,30,3,2,8,-6,-75.0
93,30,4,10,16,-6,-37.5
93,30,5,20,32,-12,-37.5
93,30,6,32,64,-32,-50.0
93,30,7,61,128,-67,-52.34375
93,30,8,94,256,-162,-63.28125
93,30,9,953,512,441,86.1328125
93,30,10,120,1024,-904,-88.28125
93,30,11,1374,2048,-674,-32.91015625
93,30,12,1108,4096,-2988,-72.94921875
93,30,13,7522,8192,-670,-8.1787109375
93,30,14,37315,16384,20931,127.752685546875
93,30,15,464,32768,-32304,-98.583984375
93,31,1,0,2,-2,-100.0
93,31,2,1,4,-3,-75.0
93,31,3,7,8,-1,-12.5
93,31,4,10,16,-6,-37.5
93,31,5,7,32,-25,-78.125
93,31,6,82,64,18,28.125
93,31,7,256,128,128,100.0
93,31,8,170,256,-86,-33.59375
93,31,9,2758,512,2246,438.671875
93,31,10,406,1024,-618,-60.3515625
93,31,11,1300,2048,-748,-36.5234375
93,31,12,12216,4096,8120,198.2421875
93,31,13,7323,8192,-869,-10.60791015625
93,31,14,7720,16384,-8664,-52.880859375
93,31,15,4511,32768,-28257,-86.2335205078125
93,32,1,0,2,-2,-100.0
93,32,2,4,4,0,0.0
93,32,3,3,8,-5,-62.5
93,32,4,19,16,3,18.75
93,32,5,29,32,-3,-9.375
93,32,6,38,64,-26,-40.625
93,32,7,25,128,-103,-80.46875
93,32,8,834,256,578,225.78125
93,32,9,26,512,-486,-94.921875
93,32,10,462,1024,-562,-54.8828125
93,32,11,65,2048,-1983,-96.826171875
93,32,12,1756,4096,-2340,-57.12890625
93,32,13,200,8192,-7992,-97.55859375
93,32,14,26240,16384,9856,60.15625
93,32,15,32864,32768,96,0.29296875
93,33,1,0,2,-2,-100.0
93,33,2,2,4,-2,-50.0
93,33,3,3,8,-5,-62.5
93,33,4,4,16,-12,-75.0
93,33,5,15,32,-17,-53.125
93,33,6,303,64,239,373.4375
93,33,7,207,128,79,61.71875
93,33,8,220,256,-36,-14.0625
93,33,9,581,512,69,13.4765625
93,33,10,482,1024,-542,-52.9296875
93,33,11,8741,2048,6693,326.806640625
93,33,12,9096,4096,5000,122.0703125
93,33,13,4368,8192,-3824,-46.6796875
93,33,14,6922,16384,-9462,-57.75146484375
93,33,15,36409,32768,3641,11.1114501953125
93,34,1,0,2,-2,-100.0
93,34,2,1,4,-3,-75.0
93,34,3,10,8,2,25.0
93,34,4,3,16,-13,-81.25
93,34,5,13,32,-19,-59.375
93,34,6,34,64,-30,-46.875
93,34,7,222,128,94,73.4375
93,34,8,100,256,-156,-60.9375
93,34,9,687,512,175,34.1796875
93,34,10,277,1024,-747,-72.94921875
93,34,11,5620,2048,3572,174.4140625
93,34,12,19,4096,-4077,-99.5361328125
93,34,13,394,8192,-7798,-95.1904296875
93,34,14,43858,16384,27474,167.68798828125
93,34,15,11362,32768,-21406,-65.325927734375
93,35,1,0,2,-2,-100.0
93,35,2,2,4,-2,-50.0
93,35,3,4,8,-4,-50.0
93,35,4,22,16,6,37.5
93,35,5,13,32,-19,-59.375
93,35,6,39,64,-25,-39.0625
93,35,7,177,128,49,38.28125
93,35,8,246,256,-10,-3.90625
93,35,9,1375,512,863,168.5546875
93,35,10,313,1024,-711,-69.43359375
93,35,11,878,2048,-1170,-57.12890625
93,35,12,4928,4096,832,20.3125
93,35,13,19391,8192,11199,136.70654296875
93,35,14,1981,16384,-14403,-87.908935546875
93,35,15,20728,32768,-12040,-36.7431640625
93,36,1,0,2,-2,-100.0
93,36,2,1,4,-3,-75.0
93,36,3,8,8,0,0.0
93,36,4,39,16,23,143.75
93,36,5,40,32,8,25.0
93,36,6,28,64,-36,-56.25
93,36,7,110,128,-18,-14.0625
93,36,8,127,256,-129,-50.390625
93,36,9,133,512,-379,-74.0234375
93,36,10,893,1024,-131,-12.79296875
93,36,11,1359,2048,-689,-33.642578125
93,36,12,1076,4096,-3020,-73.73046875
93,36,13,810,8192,-7382,-90.1123046875
93,36,14,31476,16384,15092,92.1142578125
93,36,15,29813,32768,-2955,-9.0179443359375
93,37,1,0,2,-2,-100.0
93,37,2,1,4,-3,-75.0
93,37,3,12,8,4,50.0
93,37,4,3,16,-13,-81.25
93,37,5,49,32,17,53.125
93,37,6,14,64,-50,-78.125
93,37,7,161,128,33,25.78125
93,37,8,14,256,-242,-94.53125
93,37,9,77,512,-435,-84.9609375
93,37,10,864,1024,-160,-15.625
93,37,11,286,2048,-1762,-86.03515625
93,37,12,2678,4096,-1418,-34.619140625
93,37,13,15493,8192,7301,89.12353515625
93,37,14,4508,16384,-11876,-72.4853515625
93,37,15,9264,32768,-23504,-71.728515625
93,38,1,0,2,-2,-100.0
93,38,2,1,4,-3,-75.0
93,38,3,5,8,-3,-37.5
93,38,4,21,16,5,31.25
93,38,5,22,32,-10,-31.25
93,38,6,9,64,-55,-85.9375
93,38,7,174,128,46,35.9375
93,38,8,391,256,135,52.734375
93,38,9,357,512,-155,-30.2734375
93,38,10,1086,1024,62,6.0546875
93,38,11,1067,2048,-981,-47.900390625
93,38,12,4199,4096,103,2.5146484375
93,38,13,3961,8192,-4231,-51.64794921875
93,38,14,29164,16384,12780,78.0029296875
93,38,15,60839,32768,28071,85.6658935546875
93,39,1,0,2,-2,-100.0
93,39,2,1,4,-3,-75.0
93,39,3,19,8,11,137.5
93,39,4,3,16,-13,-81.25
93,39,5,40,32,8,25.0
93,39,6,70,64,6,9.375
93,39,7,14,128,-114,-89.0625
93,39,8,72,256,-184,-71.875
93,39,9,264,512,-248,-48.4375
93,39,10,2130,1024,1106,108.0078125
93,39,11,127,2048,-1921,-93.798828125
93,39,12,1256,4096,-2840,-69.3359375
93,39,13,5446,8192,-2746,-33.5205078125
93,39,14,10033,16384,-6351,-38.763427734375
93,39,15,4487,32768,-28281,-86.3067626953125
93,40,1,0,2,-2,-100.0
93,40,2,1,4,-3,-75.0
93,40,3,11,8,3,37.5
93,40,4,3,16,-13,-81.25
93,40,5,4,32,-28,-87.5
93,40,6,5,64,-59,-92.1875
93,40,7,64,128,-64,-50.0
93,40,8,192,256,-64,-25.0
93,40,9,1359,512,847,165.4296875
93,40,10,678,1024,-346,-33.7890625
93,40,11,2942,2048,894,43.65234375
93,40,12,1960,4096,-2136,-52.1484375
93,40,13,4399,8192,-3793,-46.30126953125
93,40,14,26259,16384,9875,60.272216796875
93,40,15,5703,32768,-27065,-82.5958251953125
93,41,1,0,2,-2,-100.0
93,41,2,1,4,-3,-75.0
93,41,3,7,8,-1,-12.5
93,41,4,14,16,-2,-12.5
93,41,5,47,32,15,46.875
93,41,6,75,64,11,17.1875
93,41,7,167,128,39,30.46875
93,41,8,302,256,46,17.96875
93,41,9,313,512,-199,-38.8671875
93,41,10,293,1024,-731,-71.38671875
93,41,11,1145,2048,-903,-44.091796875
93,41,12,2821,4096,-1275,-31.1279296875
93,41,13,16869,8192,8677,105.92041015625
93,41,14,15806,16384,-578,-3.52783203125
93,41,15,18582,32768,-14186,-43.292236328125
93,42,1,0,2,-2,-100.0
93,42,2,2,4,-2,-50.0
93,42,3,15,8,7,87.5
93,42,4,3,16,-13,-81.25
93,42,5,15,32,-17,-53.125
93,42,6,45,64,-19,-29.6875
93,42,7,205,128,77,60.15625
93,42,8,32,256,-224,-87.5
93,42,9,332,512,-180,-35.15625
93,42,10,1369,1024,345,33.69140625
93,42,11,309,2048,-1739,-84.912109375
93,42,12,1910,4096,-2186,-53.369140625
93,42,13,8661,8192,469,5.72509765625
93,42,14,1598,16384,-14786,-90.24658203125
93,42,15,6670,32768,-26098,-79.644775390625
93,43,1,0,2,-2,-100.0
93,43,2,1,4,-3,-75.0
93,43,3,6,8,-2,-25.0
93,43,4,3,16,-13,-81.25
93,43,5,8,32,-24,-75.0
93,43,6,44,64,-20,-31.25
93,43,7,35,128,-93,-72.65625
93,43,8,42,256,-214,-83.59375
93,43,9,184,512,-328,-64.0625
93,43,10,107,1024,-917,-89.55078125
93,43,11,820,2048,-1228,-59.9609375
93,43,12,5824,4096,1728,42.1875
93,43,13,13549,8192,5357,65.39306640625
93,43,14,80042,16384,63658,388.53759765625
93,43,15,66640,32768,33872,103.369140625
93,44,1,0,2,-2,-100.0
93,44,2,1,4,-3,-75.0
93,44,3,2,8,-6,-75.0
93,44,4,19,16,3,18.75
93,44,5,51,32,19,59.375
93,44,6,14,64,-50,-78.125
93,44,7,528,128,400,312.5
93,44,8,48,256,-208,-81.25
93,44,9,804,512,292,57.03125
93,44,10,421,1024,-603,-58.88671875
93,44,11,12,2048,-2036,-99.4140625
93,44,12,4530,4096,434,10.595703125
93,44,13,29652,8192,21460,261.962890625
93,44,14,26099,16384,9715,59.295654296875
93,44,15,6784,32768,-25984,-79.296875
93,45,1,0,2,-2,-100.0
93,45,2,5,4,1,25.0
93,45,3,2,8,-6,-75.0
93,45,4,13,16,-3,-18.75
93,45,5,53,32,21,65.625
93,45,6,30,64,-34,-53.125
93,45,7,132,128,4,3.125
93,45,8,121,256,-135,-52.734375
93,45,9,746,512,234,45.703125
93,45,10,1598,1024,574,56.0546875
93,45,11,2186,2048,138,6.73828125
93,45,12,8943,4096,4847,118.3349609375
93,45,13,2192,8192,-6000,-73.2421875
93,45,14,4566,16384,-11818,-72.13134765625
93,45,15,50013,32768,17245,52.6275634765625
93,46,1,0,2,-2,-100.0
93,46,2,1,4,-3,-75.0
93,46,3,5,8,-3,-37.5
93,46,4,3,16,-13,-81.25
93,46,5,35,32,3,9.375
93,46,6,121,64,57,89.0625
93,46,7,91,128,-37,-28.90625
93,46,8,448,256,192,75.0
93,46,9,180,512,-332,-64.84375
93,46,10,1590,1024,566,55.2734375
93,46,11,404,2048,-1644,-80.2734375
93,46,12,6702,4096,2606,63.623046875
93,46,13,14722,8192,6530,79.7119140625
93,46,14,14458,16384,-1926,-11.75537109375
93,46,15,20356,32768,-12412,-37.87841796875
93,47,1,0,2,-2,-100.0
93,47,2,2,4,-2,-50.0
93,47,3,5,8,-3,-37.5
93,47,4,11,16,-5,-31.25
93,47,5,15,32,-17,-53.125
93,47,6,5,64,-59,-92.1875
93,47,7,212,128,84,65.625
93,47,8,191,256,-65,-25.390625
93,47,9,379,512,-133,-25.9765625
93,47,10,1166,1024,142,13.8671875
93,47,11,1273,2048,-775,-37.841796875
93,47,12,9103,4096,5007,122.2412109375
93,47,13,2896,8192,-5296,-64.6484375
93,47,14,9063,16384,-7321,-44.683837890625
93,47,15,28544,32768,-4224,-12.890625
93,48,1,0,2,-2,-100.0
93,48,2,1,4,-3,-75.0
93,48,3,11,8,3,37.5
93,48,4,6,16,-10,-62.5
93,48,5,4,32,-28,-87.5
93,48,6,19,64,-45,-70.3125
93,48,7,55,128,-73,-57.03125
93,48,8,473,256,217,84.765625
93,48,9,828,512,316,61.71875
93,48,10,1326,1024,302,29.4921875
93,48,11,1669,2048,-379,-18.505859375
93,48,12,3677,4096,-419,-10.2294921875
93,48,13,9246,8192,1054,12.8662109375
93,48,14,3210,16384,-13174,-80.40771484375
93,48,15,48466,32768,15698,47.906494140625
93,49,1,0,2,-2,-100.0
93,49,2,1,4,-3,-75.0
93,49,3,2,8,-6,-75.0
93,49,4,4,16,-12,-75.0
93,49,5,50,32,18,56.25
93,49,6,43,64,-21,-32.8125
93,49,7,73,128,-55,-42.96875
93,49,8,192,256,-64,-25.0
93,49,9,214,512,-298,-58.203125
93,49,10,1440,1024,416,40.625
93,49,11,807,2048,-1241,-60.595703125
93,49,12,1043,4096,-3053,-74.5361328125
93,49,13,17676,8192,9484,115.771484375
93,49,14,35024,16384,18640,113.76953125
93,49,15,60276,32768,27508,83.94775390625
93,50,1,0,2,-2,-100.0
93,50,2,1,4,-3,-75.0
93,50,3,2,8,-6,-75.0
93,50,4,3,16,-13,-81.25
93,50,5,34,32,2,6.25
93,50,6,12,64,-52,-81.25
93,50,7,33,128,-95,-74.21875
93,50,8,174,256,-82,-32.03125
93,50,9,465,512,-47,-9.1796875
93,50,10,1116,1024,92,8.984375
93,50,11,659,2048,-1389,-67.822265625
93,50,12,12954,4096,8858,216.259765625
93,50,13,218,8192,-7974,-97.3388671875
93,50,14,7455,16384,-8929,-54.498291015625
93,50,15,24036,32768,-8732,-26.64794921875
93,51,1,0,2,-2,-100.0
93,51,2,1,4,-3,-75.0
93,51,3,3,8,-5,-62.5
93,51,4,3,16,-13,-81.25
93,51,5,42,32,10,31.25
93,51,6,20,64,-44,-68.75
93,51,7,42,128,-86,-67.1875
93,51,8,302,256,46,17.96875
93,51,9,377,512,-135,-26.3671875
93,51,10,1256,1024,232,22.65625
93,51,11,635,2048,-1413,-68.994140625
93,51,12,4498,4096,402,9.814453125
93,51,13,7382,8192,-810,-9.8876953125
93,51,14,14556,16384,-1828,-11.1572265625
93,51,15,21902,32768,-10866,-33.160400390625
93,52,1,0,2,-2,-100.0
93,52,2,1,4,-3,-75.0
93,52,3,3,8,-5,-62.5
93,52,4,26,16,10,62.5
93,52,5,149,32,117,365.625
93,52,6,31,64,-33,-51.5625
93,52,7,142,128,14,10.9375
93,52,8,86,256,-170,-66.40625
93,52,9,1040,512,528,103.125
93,52,10,1254,1024,230,22.4609375
93,52,11,1772,2048,-276,-13.4765625
93,52,12,2450,4096,-1646,-40.185546875
93,52,13,6774,8192,-1418,-17.3095703125
93,52,14,13137,16384,-3247,-19.818115234375
93,52,15,19754,32768,-13014,-39.715576171875
93,53,1,0,2,-2,-100.0
93,53,2,2,4,-2,-50.0
93,53,3,9,8,1,12.5
93,53,4,13,16,-3,-18.75
93,53,5,9,32,-23,-71.875
93,53,6,17,64,-47,-73.4375
93,53,7,121,128,-7,-5.46875
93,53,8,448,256,192,75.0
93,53,9,147,512,-365,-71.2890625
93,53,10,280,1024,-744,-72.65625
93,53,11,8290,2048,6242,304.78515625
93,53,12,12731,4096,8635,210.8154296875
93,53,13,14891,8192,6699,81.77490234375
93,53,14,54262,16384,37878,231.18896484375
93,53,15,11470,32768,-21298,-64.996337890625
93,54,1,0,2,-2,-100.0
93,54,2,1,4,-3,-75.0
93,54,3,3,8,-5,-62.5
93,54,4,14,16,-2,-12.5
93,54,5,5,32,-27,-84.375
93,54,6,18,64,-46,-71.875
93,54,7,59,128,-69,-53.90625
93,54,8,201,256,-55,-21.484375
93,54,9,669,512,157,30.6640625
93,54,10,1432,1024,408,39.84375
93,54,11,4151,2048,2103,102.685546875
93,54,12,1711,4096,-2385,-58.2275390625
93,54,13,11544,8192,3352,40.91796875
93,54,14,655,16384,-15729,-96.002197265625
93,54,15,430,32768,-32338,-98.687744140625
93,55,1,0,2,-2,-100.0
93,55,2,1,4,-3,-75.0
93,55,3,2,8,-6,-75.0
93,55,4,12,16,-4,-25.0
93,55,5,31,32,-1,-3.125
93,55,6,125,64,61,95.3125
93,55,7,167,128,39,30.46875
93,55,8,81,256,-175,-68.359375
93,55,9,594,512,82,16.015625
93,55,10,1014,1024,-10,-0.9765625
93,55,11,2387,2048,339,16.552734375
93,55,12,2891,4096,-1205,-29.4189453125
93,55,13,1112,8192,-7080,-86.42578125
93,55,14,56837,16384,40453,246.905517578125
93,55,15,21348,32768,-11420,-34.85107421875
93,56,1,0,2,-2,-100.0
93,56,2,5,4,1,25.0
93,56,3,2,8,-6,-75.0
93,56,4,11,16,-5,-31.25
93,56,5,12,32,-20,-62.5
93,56,6,48,64,-16,-25.0
93,56,7,218,128,90,70.3125
93,56,8,81,256,-175,-68.359375
93,56,9,216,512,-296,-57.8125
93,56,10,585,1024,-439,-42.87109375
93,56,11,450,2048,-1598,-78.02734375
93,56,12,6717,4096,2621,63.9892578125
93,56,13,121,8192,-8071,-98.52294921875
93,56,14,2038,16384,-14346,-87.56103515625
93,56,15,9672,32768,-23096,-70.4833984375
93,57,1,0,2,-2,-100.0
93,57,2,1,4,-3,-75.0
93,57,3,7,8,-1,-12.5
93,57,4,7,16,-9,-56.25
93,57,5,15,32,-17,-53.125
93,57,6,35,64,-29,-45.3125
93,57,7,161,128,33,25.78125
93,57,8,565,256,309,120.703125
93,57,9,704,512,192,37.5
93,57,10,43,1024,-981,-95.80078125
93,57,11,3193,2048,1145,55.908203125
93,57,12,2624,4096,-1472,-35.9375
93,57,13,5649,8192,-2543,-31.04248046875
93,57,14,36661,16384,20277,123.760986328125
93,57,15,25555,32768,-7213,-22.0123291015625
93,58,1,0,2,-2,-100.0
93,58,2,1,4,-3,-75.0
93,58,3,2,8,-6,-75.0
93,58,4,3,16,-13,-81.25
93,58,5,9,32,-23,-71.875
93,58,6,57,64,-7,-10.9375
93,58,7,55,128,-73,-57.03125
93,58,8,207,256,-49,-19.140625
93,58,9,416,512,-96,-18.75
93,58,10,2568,1024,1544,150.78125
93,58,11,2120,2048,72,3.515625
93,58,12,97,4096,-3999,-97.6318359375
93,58,13,14996,8192,6804,83.056640625
93,58,14,5640,16384,-10744,-65.576171875
93,58,15,105921,32768,73153,223.2452392578125
93,59,1,0,2,-2,-100.0
93,59,2,1,4,-3,-75.0
93,59,3,3,8,-5,-62.5
93,59,4,19,16,3,18.75
93,59,5,63,32,31,96.875
93,59,6,150,64,86,134.375
93,59,7,18,128,-110,-85.9375
93,59,8,147,256,-109,-42.578125
93,59,9,512,512,0,0.0
93,59,10,365,1024,-659,-64.35546875
93,59,11,294,2048,-1754,-85.64453125
93,59,12,6379,4096,2283,55.7373046875
93,59,13,5145,8192,-3047,-37.19482421875
93,59,14,36665,16384,20281,123.785400390625
93,59,15,3358,32768,-29410,-89.752197265625
93,60,1,0,2,-2,-100.0
93,60,2,2,4,-2,-50.0
93,60,3,2,8,-6,-75.0
93,60,4,5,16,-11,-68.75
93,60,5,13,32,-19,-59.375
93,60,6,45,64,-19,-29.6875
93,60,7,31,128,-97,-75.78125
93,60,8,40,256,-216,-84.375
93,60,9,161,512,-351,-68.5546875
93,60,10,207,1024,-817,-79.78515625
93,60,11,152,2048,-1896,-92.578125
93,60,12,3138,4096,-958,-23.388671875
93,60,13,11283,8192,3091,37.73193359375
93,60,14,28171,16384,11787,71.942138671875
93,60,15,24288,32768,-8480,-25.87890625
93,61,1,0,2,-2,-100.0
93,61,2,2,4,-2,-50.0
93,61,3,14,8,6,75.0
93,61,4,18,16,2,12.5
93,61,5,10,32,-22,-68.75
93,61,6,75,64,11,17.1875
93,61,7,168,128,40,31.25
93,61,8,75,256,-181,-70.703125
93,61,9,327,512,-185,-36.1328125
93,61,10,93,1024,-931,-90.91796875
93,61,11,9695,2048,7647,373.388671875
93,61,12,6770,4096,2674,65.283203125
93,61,13,22110,8192,13918,169.8974609375
93,61,14,29019,16384,12635,77.117919921875
93,61,15,57786,32768,25018,76.348876953125
93,62,1,0,2,-2,-100.0
93,62,2,4,4,0,0.0
93,62,3,7,8,-1,-12.5
93,62,4,3,16,-13,-81.25
93,62,5,13,32,-19,-59.375
93,62,6,55,64,-9,-14.0625
93,62,7,16,128,-112,-87.5
93,62,8,17,256,-239,-93.359375
93,62,9,213,512,-299,-58.3984375
93,62,10,600,1024,-424,-41.40625
93,62,11,221,2048,-1827,-89.208984375
93,62,12,1647,4096,-2449,-59.7900390625
93,62,13,9885,8192,1693,20.66650390625
93,62,14,3941,16384,-12443,-75.946044921875
93,62,15,59745,32768,26977,82.3272705078125
93,63,1,0,2,-2,-100.0
93,63,2,2,4,-2,-50.0
93,63,3,7,8,-1,-12.5
93,63,4,18,16,2,12.5
93,63,5,15,32,-17,-53.125
93,63,6,84,64,20,31.25
93,63,7,83,128,-45,-35.15625
93,63,8,20,256,-236,-92.1875
93,63,9,290,512,-222,-43.359375
93,63,10,2973,1024,1949,190.33203125
93,63,11,580,2048,-1468,-71.6796875
93,63,12,9205,4096,5109,124.7314453125
93,63,13,14633,8192,6441,78.62548828125
93,63,14,17062,16384,678,4.13818359375
93,63,15,17357,32768,-15411,-47.0306396484375
93,64,1,0,2,-2,-100.0
93,64,2,4,4,0,0.0
93,64,3,2,8,-6,-75.0
93,64,4,3,16,-13,-81.25
93,64,5,29,32,-3,-9.375
93,64,6,18,64,-46,-71.875
93,64,7,95,128,-33,-25.78125
93,64,8,320,256,64,25.0
93,64,9,56,512,-456,-89.0625
93,64,10,5564,1024,4540,443.359375
93,64,11,4709,2048,2661,129.931640625
93,64,12,2012,4096,-2084,-50.87890625
93,64,13,6378,8192,-1814,-22.1435546875
93,64,14,18507,16384,2123,12.957763671875
93,64,15,84975,32768,52207,159.3231201171875
93,65,1,0,2,-2,-100.0
93,65,2,1,4,-3,-75.0
93,65,3,2,8,-6,-75.0
93,65,4,8,16,-8,-50.0
93,65,5,9,32,-23,-71.875
93,65,6,213,64,149,232.8125
93,65,7,259,128,131,102.34375
93,65,8,28,256,-228,-89.0625
93,65,9,117,512,-395,-77.1484375
93,65,10,201,1024,-823,-80.37109375
93,65,11,678,2048,-1370,-66.89453125
93,65,12,1139,4096,-2957,-72.1923828125
93,65,13,231,8192,-7961,-97.18017578125
93,65,14,14704,16384,-1680,-10.25390625
93,65,15,1239,32768,-31529,-96.2188720703125
93,66,1,0,2,-2,-100.0
93,66,2,2,4,-2,-50.0
93,66,3,2,8,-6,-75.0
93,66,4,15,16,-1,-6.25
93,66,5,12,32,-20,-62.5
93,66,6,34,64,-30,-46.875
93,66,7,113,128,-15,-11.71875
93,66,8,492,256,236,92.1875
93,66,9,816,512,304,59.375
93,66,10,931,1024,-93,-9.08203125
93,66,11,9835,2048,7787,380.224609375
93,66,12,1907,4096,-2189,-53.4423828125
93,66,13,2076,8192,-6116,-74.658203125
93,66,14,38536,16384,22152,135.205078125
93,66,15,214475,32768,181707,554.5257568359375
93,67,1,0,2,-2,-100.0
93,67,2,1,4,-3,-75.0
93,67,3,7,8,-1,-12.5
93,67,4,72,16,56,350.0
93,67,5,55,32,23,71.875
93,67,6,42,64,-22,-34.375
93,67,7,69,128,-59,-46.09375
93,67,8,41,256,-215,-83.984375
93,67,9,84,512,-428,-83.59375
93,67,10,1222,1024,198,19.3359375
93,67,11,1362,2048,-686,-33.49609375
93,67,12,1950,4096,-2146,-52.392578125
93,67,13,3071,8192,-5121,-62.51220703125
93,67,14,799,16384,-15585,-95.123291015625
93,67,15,407,32768,-32361,-98.7579345703125
93,68,1,0,2,-2,-100.0
93,68,2,2,4,-2,-50.0
93,68,3,21,8,13,162.5
93,68,4,16,16,0,0.0
93,68,5,26,32,-6,-18.75
93,68,6,100,64,36,56.25
93,68,7,49,128,-79,-61.71875
93,68,8,444,256,188,73.4375
93,68,9,1033,512,521,101.7578125
93,68,10,2639,1024,1615,157.71484375
93,68,11,205,2048,-1843,-89.990234375
93,68,12,3690,4096,-406,-9.912109375
93,68,13,5261,8192,-2931,-35.77880859375
93,68,14,7292,16384,-9092,-55.4931640625
93,68,15,2063,32768,-30705,-93.7042236328125
93,69,1,0,2,-2,-100.0
93,69,2,3,4,-1,-25.0
93,69,3,4,8,-4,-50.0
93,69,4,6,16,-10,-62.5
93,69,5,32,32,0,0.0
93,69,6,43,64,-21,-32.8125
93,69,7,76,128,-52,-40.625
93,69,8,201,256,-55,-21.484375
93,69,9,924,512,412,80.46875
93,69,10,702,1024,-322,-31.4453125
93,69,11,3223,2048,1175,57.373046875
93,69,12,12170,4096,8074,197.119140625
93,69,13,4323,8192,-3869,-47.22900390625
93,69,14,24250,16384,7866,48.01025390625
93,69,15,79204,32768,46436,141.71142578125
93,70,1,0,2,-2,-100.0
93,70,2,1,4,-3,-75.0
93,70,3,8,8,0,0.0
93,70,4,8,16,-8,-50.0
93,70,5,30,32,-2,-6.25
93,70,6,19,64,-45,-70.3125
93,70,7,108,128,-20,-15.625
93,70,8,135,256,-121,-47.265625
93,70,9,1534,512,1022,199.609375
93,70,10,62,1024,-962,-93.9453125
93,70,11,900,2048,-1148,-56.0546875
93,70,12,3833,4096,-263,-6.4208984375
93,70,13,14049,8192,5857,71.49658203125
93,70,14,23578,16384,7194,43.90869140625
93,70,15,25220,32768,-7548,-23.03466796875
93,71,1,0,2,-2,-100.0
93,71,2,1,4,-3,-75.0
93,71,3,3,8,-5,-62.5
93,71,4,3,16,-13,-81.25
93,71,5,56,32,24,75.0
93,71,6,18,64,-46,-71.875
93,71,7,112,128,-16,-12.5
93,71,8,69,256,-187,-73.046875
93,71,9,672,512,160,31.25
93,71,10,2444,1024,1420,138.671875
93,71,11,1366,2048,-682,-33.30078125
93,71,12,8445,4096,4349,106.1767578125
93,71,13,5569,8192,-2623,-32.01904296875
93,71,14,25810,16384,9426,57.53173828125
93,71,15,7468,32768,-25300,-77.20947265625
93,72,1,0,2,-2,-100.0
93,72,2,5,4,1,25.0
93,72,3,6,8,-2,-25.0
93,72,4,13,16,-3,-18.75
93,72,5,5,32,-27,-84.375
93,72,6,51,64,-13,-20.3125
93,72,7,175,128,47,36.71875
93,72,8,318,256,62,24.21875
93,72,9,145,512,-367,-71.6796875
93,72,10,1603,1024,579,56.54296875
93,72,11,2031,2048,-17,-0.830078125
93,72,12,1675,4096,-2421,-59.1064453125
93,72,13,9908,8192,1716,20.947265625
93,72,14,4470,16384,-11914,-72.71728515625
93,72,15,42728,32768,9960,30.3955078125
93,73,1,0,2,-2,-100.0
93,73,2,3,4,-1,-25.0
93,73,3,7,8,-1,-12.5
93,73,4,11,16,-5,-31.25
93,73,5,4,32,-28,-87.5
93,73,6,92,64,28,43.75
93,73,7,25,128,-103,-80.46875
93,73,8,68,256,-188,-73.4375
93,73,9,338,512,-174,-33.984375
93,73,10,858,1024,-166,-16.2109375
93,73,11,1866,2048,-182,-8.88671875
93,73,12,5179,4096,1083,26.4404296875
93,73,13,578,8192,-7614,-92.9443359375
93,73,14,3022,16384,-13362,-81.55517578125
93,73,15,31835,32768,-933,-2.8472900390625
93,74,1,0,2,-2,-100.0
93,74,2,1,4,-3,-75.0
93,74,3,19,8,11,137.5
93,74,4,5,16,-11,-68.75
93,74,5,30,32,-2,-6.25
93,74,6,242,64,178,278.125
93,74,7,12,128,-116,-90.625
93,74,8,143,256,-113,-44.140625
93,74,9,723,512,211,41.2109375
93,74,10,1092,1024,68,6.640625
93,74,11,2605,2048,557,27.197265625
93,74,12,4356,4096,260,6.34765625
93,74,13,2377,8192,-5815,-70.98388671875
93,74,14,948,16384,-15436,-94.2138671875
93,74,15,41676,32768,8908,27.18505859375
93,75,1,0,2,-2,-100.0
93,75,2,3,4,-1,-25.0
93,75,3,2,8,-6,-75.0
93,75,4,4,16,-12,-75.0
93,75,5,20,32,-12,-37.5
93,75,6,240,64,176,275.0
93,75,7,12,128,-116,-90.625
93,75,8,86,256,-170,-66.40625
93,75,9,735,512,223,43.5546875
93,75,10,206,1024,-818,-79.8828125
93,75,11,394,2048,-1654,-80.76171875
93,75,12,11448,4096,7352,179.4921875
93,75,13,707,8192,-7485,-91.36962890625
93,75,14,885,16384,-15499,-94.598388671875
93,75,15,109393,32768,76625,233.8409423828125
93,76,1,0,2,-2,-100.0
93,76,2,1,4,-3,-75.0
93,76,3,16,8,8,100.0
93,76,4,4,16,-12,-75.0
93,76,5,41,32,9,28.125
93,76,6,23,64,-41,-64.0625
93,76,7,333,128,205,160.15625
93,76,8,43,256,-213,-83.203125
93,76,9,1160,512,648,126.5625
93,76,10,466,1024,-558,-54.4921875
93,76,11,3233,2048,1185,57.861328125
93,76,12,2386,4096,-1710,-41.748046875
93,76,13,6315,8192,-1877,-22.91259765625
93,76,14,29088,16384,12704,77.5390625
93,76,15,42136,32768,9368,28.5888671875
93,77,1,0,2,-2,-100.0
93,77,2,5,4,1,25.0
93,77,3,5,8,-3,-37.5
93,77,4,25,16,9,56.25
93,77,5,14,32,-18,-56.25
93,77,6,7,64,-57,-89.0625
93,77,7,16,128,-112,-87.5
93,77,8,171,256,-85,-33.203125
93,77,9,356,512,-156,-30.46875
93,77,10,1092,1024,68,6.640625
93,77,11,1359,2048,-689,-33.642578125
93,77,12,1946,4096,-2150,-52.490234375
93,77,13,14864,8192,6672,81.4453125
93,77,14,12525,16384,-3859,-23.553466796875
93,77,15,2807,32768,-29961,-91.4337158203125
93,78,1,0,2,-2,-100.0
93,78,2,1,4,-3,-75.0
93,78,3,3,8,-5,-62.5
93,78,4,3,16,-13,-81.25
93,78,5,46,32,14,43.75
93,78,6,98,64,34,53.125
93,78,7,69,128,-59,-46.09375
93,78,8,842,256,586,228.90625
93,78,9,595,512,83,16.2109375
93,78,10,1380,1024,356,34.765625
93,78,11,4783,2048,2735,133.544921875
93,78,12,10309,4096,6213,151.6845703125
93,78,13,8385,8192,193,2.35595703125
93,78,14,4357,16384,-12027,-73.406982421875
93,78,15,20010,32768,-12758,-38.934326171875
93,79,1,0,2,-2,-100.0
93,79,2,1,4,-3,-75.0
93,79,3,2,8,-6,-75.0
93,79,4,15,16,-1,-6.25
93,79,5,15,32,-17,-53.125
93,79,6,151,64,87,135.9375
93,79,7,75,128,-53,-41.40625
93,79,8,88,256,-168,-65.625
93,79,9,1357,512,845,165.0390625
93,79,10,145,1024,-879,-85.83984375
93,79,11,1166,2048,-882,-43.06640625
93,79,12,3161,4096,-935,-22.8271484375
93,79,13,1966,8192,-6226,-76.0009765625
93,79,14,23616,16384,7232,44.140625
93,79,15,29732,32768,-3036,-9.26513671875
93,80,1,0,2,-2,-100.0
93,80,2,3,4,-1,-25.0
93,80,3,3,8,-5,-62.5
93,80,4,3,16,-13,-81.25
93,80,5,64,32,32,100.0
93,80,6,7,64,-57,-89.0625
93,80,7,245,128,117,91.40625
93,80,8,455,256,199,77.734375
93,80,9,333,512,-179,-34.9609375
93,80,10,279,1024,-745,-72.75390625
93,80,11,440,2048,-1608,-78.515625
93,80,12,1757,4096,-2339,-57.1044921875
93,80,13,8469,8192,277,3.38134765625
93,80,14,27503,16384,11119,67.864990234375
93,80,15,33883,32768,1115,3.4027099609375
93,81,1,0,2,-2,-100.0
93,81,2,1,4,-3,-75.0
93,81,3,3,8,-5,-62.5
93,81,4,26,16,10,62.5
93,81,5,6,32,-26,-81.25
93,81,6,21,64,-43,-67.1875
93,81,7,157,128,29,22.65625
93,81,8,20,256,-236,-92.1875
93,81,9,159,512,-353,-68.9453125
93,81,10,61,1024,-963,-94.04296875
93,81,11,270,2048,-1778,-86.81640625
93,81,12,605,4096,-3491,-85.2294921875
93,81,13,24,8192,-8168,-99.70703125
93,81,14,6974,16384,-9410,-57.43408203125
93,81,15,123303,32768,90535,276.2908935546875
93,82,1,0,2,-2,-100.0
93,82,2,4,4,0,0.0
93,82,3,17,8,9,112.5
93,82,4,13,16,-3,-18.75
93,82,5,10,32,-22,-68.75
93,82,6,235,64,171,267.1875
93,82,7,100,128,-28,-21.875
93,82,8,120,256,-136,-53.125
93,82,9,627,512,115,22.4609375
93,82,10,16,1024,-1008,-98.4375
93,82,11,3422,2048,1374,67.08984375
93,82,12,798,4096,-3298,-80.517578125
93,82,13,3602,8192,-4590,-56.0302734375
93,82,14,18648,16384,2264,13.818359375
93,82,15,13906,32768,-18862,-57.562255859375
93,83,1,0,2,-2,-100.0
93,83,2,2,4,-2,-50.0
93,83,3,3,8,-5,-62.5
93,83,4,10,16,-6,-37.5
93,83,5,19,32,-13,-40.625
93,83,6,70,64,6,9.375
93,83,7,83,128,-45,-35.15625
93,83,8,127,256,-129,-50.390625
93,83,9,406,512,-106,-20.703125
93,83,10,236,1024,-788,-76.953125
93,83,11,2318,2048,270,13.18359375
93,83,12,5925,4096,1829,44.6533203125
93,83,13,2046,8192,-6146,-75.0244140625
93,83,14,16511,16384,127,0.775146484375
93,83,15,11616,32768,-21152,-64.55078125
93,84,1,0,2,-2,-100.0
93,84,2,3,4,-1,-25.0
93,84,3,11,8,3,37.5
93,84,4,16,16,0,0.0
93,84,5,100,32,68,212.5
93,84,6,166,64,102,159.375
93,84,7,47,128,-81,-63.28125
93,84,8,109,256,-147,-57.421875
93,84,9,18,512,-494,-96.484375
93,84,10,2861,1024,1837,179.39453125
93,84,11,26,2048,-2022,-98.73046875
93,84,12,8754,4096,4658,113.720703125
93,84,13,4234,8192,-3958,-48.3154296875
93,84,14,2604,16384,-13780,-84.1064453125
93,84,15,13645,32768,-19123,-58.3587646484375
93,85,1,0,2,-2,-100.0
93,85,2,1,4,-3,-75.0
93,85,3,16,8,8,100.0
93,85,4,20,16,4,25.0
93,85,5,8,32,-24,-75.0
93,85,6,51,64,-13,-20.3125
93,85,7,22,128,-106,-82.8125
93,85,8,292,256,36,14.0625
93,85,9,174,512,-338,-66.015625
93,85,10,183,1024,-841,-82.12890625
93,85,11,870,2048,-1178,-57.51953125
93,85,12,2759,4096,-1337,-32.6416015625
93,85,13,2850,8192,-5342,-65.2099609375
93,85,14,826,16384,-15558,-94.95849609375
93,85,15,90636,32768,57868,176.59912109375
93,86,1,0,2,-2,-100.0
93,86,2,2,4,-2,-50.0
93,86,3,7,8,-1,-12.5
93,86,4,10,16,-6,-37.5
93,86,5,15,32,-17,-53.125
93,86,6,36,64,-28,-43.75
93,86,7,45,128,-83,-64.84375
93,86,8,260,256,4,1.5625
93,86,9,361,512,-151,-29.4921875
93,86,10,549,1024,-475,-46.38671875
93,86,11,954,2048,-1094,-53.41796875
93,86,12,10794,4096,6698,163.525390625
93,86,13,1657,8192,-6535,-79.77294921875
93,86,14,11104,16384,-5280,-32.2265625
93,86,15,25446,32768,-7322,-22.344970703125
93,87,1,0,2,-2,-100.0
93,87,2,1,4,-3,-75.0
93,87,3,4,8,-4,-50.0
93,87,4,20,16,4,25.0
93,87,5,50,32,18,56.25
93,87,6,32,64,-32,-50.0
93,87,7,14,128,-114,-89.0625
93,87,8,321,256,65,25.390625
93,87,9,514,512,2,0.390625
93,87,10,561,1024,-463,-45.21484375
93,87,11,699,2048,-1349,-65.869140625
93,87,12,419,4096,-3677,-89.7705078125
93,87,13,3932,8192,-4260,-52.001953125
93,87,14,15160,16384,-1224,-7.470703125
93,87,15,3727,32768,-29041,-88.6260986328125
93,88,1,0,2,-2,-100.0
93,88,2,3,4,-1,-25.0
93,88,3,2,8,-6,-75.0
93,88,4,13,16,-3,-18.75
93,88,5,40,32,8,25.0
93,88,6,47,64,-17,-26.5625
93,88,7,107,128,-21,-16.40625
93,88,8,73,256,-183,-71.484375
93,88,9,1068,512,556,108.59375
93,88,10,540,1024,-484,-47.265625
93,88,11,5365,2048,3317,161.962890625
93,88,12,4902,4096,806,19.677734375
93,88,13,33216,8192,25024,305.46875
93,88,14,5961,16384,-10423,-63.616943359375
93,88,15,46858,32768,14090,42.999267578125
93,89,1,0,2,-2,-100.0
93,89,2,1,4,-3,-75.0
93,89,3,11,8,3,37.5
93,89,4,10,16,-6,-37.5
93,89,5,42,32,10,31.25
93,89,6,115,64,51,79.6875
93,89,7,35,128,-93,-72.65625
93,89,8,67,256,-189,-73.828125
93,89,9,555,512,43,8.3984375
93,89,10,272,1024,-752,-73.4375
93,89,11,689,2048,-1359,-66.357421875
93,89,12,11329,4096,7233,176.5869140625
93,89,13,889,8192,-7303,-89.14794921875
93,89,14,8116,16384,-8268,-50.4638671875
93,89,15,435,32768,-32333,-98.6724853515625
93,90,1,0,2,-2,-100.0
93,90,2,2,4,-2,-50.0
93,90,3,2,8,-6,-75.0
93,90,4,10,16,-6,-37.5
93,90,5,60,32,28,87.5
93,90,6,71,64,7,10.9375
93,90,7,35,128,-93,-72.65625
93,90,8,121,256,-135,-52.734375
93,90,9,84,512,-428,-83.59375
93,90,10,942,1024,-82,-8.0078125
93,90,11,1293,2048,-755,-36.865234375
93,90,12,280,4096,-3816,-93.1640625
93,90,13,7548,8192,-644,-7.861328125
93,90,14,3618,16384,-12766,-77.91748046875
93,90,15,28794,32768,-3974,-12.127685546875
93,91,1,0,2,-2,-100.0
93,91,2,1,4,-3,-75.0
93,91,3,3,8,-5,-62.5
93,91,4,23,16,7,43.75
93,91,5,8,32,-24,-75.0
93,91,6,76,64,12,18.75
93,91,7,296,128,168,131.25
93,91,8,112,256,-144,-56.25
93,91,9,64,512,-448,-87.5
93,91,10,681,1024,-343,-33.49609375
93,91,11,249,2048,-1799,-87.841796875
93,91,12,5971,4096,1875,45.7763671875
93,91,13,969,8192,-7223,-88.17138671875
93,91,14,33817,16384,17433,106.402587890625
93,91,15,49986,32768,17218,52.545166015625
93,92,1,0,2,-2,-100.0
93,92,2,1,4,-3,-75.0
93,92,3,12,8,4,50.0
93,92,4,18,16,2,12.5
93,92,5,8,32,-24,-75.0
93,92,6,10,64,-54,-84.375
93,92,7,155,128,27,21.09375
93,92,8,80,256,-176,-68.75
93,92,9,361,512,-151,-29.4921875
93,92,10,32,1024,-992,-96.875
93,92,11,748,2048,-1300,-63.4765625
93,92,12,586,4096,-3510,-85.693359375
93,92,13,19407,8192,11215,136.90185546875
93,92,14,11815,16384,-4569,-27.886962890625
93,92,15,1085,32768,-31683,-96.6888427734375
93,93,1,0,2,-2,-100.0
93,93,2,2,4,-2,-50.0
93,93,3,3,8,-5,-62.5
93,93,4,3,16,-13,-81.25
93,93,5,28,32,-4,-12.5
93,93,6,11,64,-53,-82.8125
93,93,7,106,128,-22,-17.1875
93,93,8,243,256,-13,-5.078125
93,93,9,84,512,-428,-83.59375
93,93,10,3433,1024,2409,235.25390625
93,93,11,1606,2048,-442,-21.58203125
93,93,12,1445,4096,-2651,-64.7216796875
93,93,13,4203,8192,-3989,-48.69384765625
93,93,14,5809,16384,-10575,-64.544677734375
93,93,15,63663,32768,30895,94.2840576171875
94,1,1,0,2,-2,-100.0
94,1,2,1,4,-3,-75.0
94,1,3,8,8,0,0.0
94,1,4,7,16,-9,-56.25
94,1,5,32,32,0,0.0
94,1,6,63,64,-1,-1.5625
94,1,7,7,128,-121,-94.53125
94,1,8,480,256,224,87.5
94,1,9,1231,512,719,140.4296875
94,1,10,583,1024,-441,-43.06640625
94,1,11,4997,2048,2949,143.994140625
94,1,12,670,4096,-3426,-83.642578125
94,1,13,17211,8192,9019,110.09521484375
94,1,14,1804,16384,-14580,-88.9892578125
94,1,15,6532,32768,-26236,-80.06591796875
94,2,1,0,2,-2,-100.0
94,2,2,1,4,-3,-75.0
94,2,3,16,8,8,100.0
94,2,4,15,16,-1,-6.25
94,2,5,40,32,8,25.0
94,2,6,10,64,-54,-84.375
94,2,7,41,128,-87,-67.96875
94,2,8,22,256,-234,-91.40625
94,2,9,642,512,130,25.390625
94,2,10,2648,1024,1624,158.59375
94,2,11,6399,2048,4351,212.451171875
94,2,12,5936,4096,1840,44.921875
94,2,13,2420,8192,-5772,-70.458984375
94,2,14,18776,16384,2392,14.599609375
94,2,15,26516,32768,-6252,-19.07958984375
94,3,1,0,2,-2,-100.0
94,3,2,2,4,-2,-50.0
94,3,3,4,8,-4,-50.0
94,3,4,12,16,-4,-25.0
94,3,5,4,32,-28,-87.5
94,3,6,115,64,51,79.6875
94,3,7,105,128,-23,-17.96875
94,3,8,205,256,-51,-19.921875
94,3,9,275,512,-237,-46.2890625
94,3,10,1529,1024,505,49.31640625
94,3,11,1426,2048,-622,-30.37109375
94,3,12,6925,4096,2829,69.0673828125
94,3,13,14817,8192,6625,80.87158203125
94,3,14,608,16384,-15776,-96.2890625
94,3,15,678,32768,-32090,-97.930908203125
94,4,1,0,2,-2,-100.0
94,4,2,1,4,-3,-75.0
94,4,3,4,8,-4,-50.0
94,4,4,9,16,-7,-43.75
94,4,5,52,32,20,62.5
94,4,6,228,64,164,256.25
94,4,7,93,128,-35,-27.34375
94,4,8,7,256,-249,-97.265625
94,4,9,229,512,-283,-55.2734375
94,4,10,494,1024,-530,-51.7578125
94,4,11,229,2048,-1819,-88.818359375
94,4,12,2094,4096,-2002,-48.876953125
94,4,13,9656,8192,1464,17.87109375
94,4,14,2244,16384,-14140,-86.3037109375
94,4,15,57834,32768,25066,76.495361328125
94,5,1,0,2,-2,-100.0
94,5,2,2,4,-2,-50.0
94,5,3,2,8,-6,-75.0
94,5,4,6,16,-10,-62.5
94,5,5,5,32,-27,-84.375
94,5,6,16,64,-48,-75.0
94,5,7,235,128,107,83.59375
94,5,8,39,256,-217,-84.765625
94,5,9,50,512,-462,-90.234375
94,5,10,689,1024,-335,-32.71484375
94,5,11,678,2048,-1370,-66.89453125
94,5,12,2441,4096,-1655,-40.4052734375
94,5,13,10439,8192,2247,27.42919921875
94,5,14,34556,16384,18172,110.9130859375
94,5,15,34886,32768,2118,6.463623046875
94,6,1,0,2,-2,-100.0
94,6,2,4,4,0,0.0
94,6,3,29,8,21,262.5
94,6,4,6,16,-10,-62.5
94,6,5,22,32,-10,-31.25
94,6,6,52,64,-12,-18.75
94,6,7,181,128,53,41.40625
94,6,8,314,256,58,22.65625
94,6,9,280,512,-232,-45.3125
94,6,10,367,1024,-657,-64.16015625
94,6,11,4400,2048,2352,114.84375
94,6,12,8199,4096,4103,100.1708984375
94,6,13,926,8192,-7266,-88.6962890625
94,6,14,2449,16384,-13935,-85.052490234375
94,6,15,87909,32768,55141,168.2769775390625
94,7,1,0,2,-2,-100.0
94,7,2,2,4,-2,-50.0
94,7,3,11,8,3,37.5
94,7,4,3,16,-13,-81.25
94,7,5,65,32,33,103.125
94,7,6,14,64,-50,-78.125
94,7,7,203,128,75,58.59375
94,7,8,353,256,97,37.890625
94,7,9,51,512,-461,-90.0390625
94,7,10,1283,1024,259,25.29296875
94,7,11,5857,2048,3809,185.986328125
94,7,12,2262,4096,-1834,-44.775390625
94,7,13,1049,8192,-7143,-87.19482421875
94,7,14,7912,16384,-8472,-51.708984375
94,7,15,15452,32768,-17316,-52.84423828125
94,8,1,0,2,-2,-100.0
94,8,2,4,4,0,0.0
94,8,3,6,8,-2,-25.0
94,8,4,5,16,-11,-68.75
94,8,5,21,32,-11,-34.375
94,8,6,29,64,-35,-54.6875
94,8,7,75,128,-53,-41.40625
94,8,8,320,256,64,25.0
94,8,9,91,512,-421,-82.2265625
94,8,10,366,1024,-658,-64.2578125
94,8,11,402,2048,-1646,-80.37109375
94,8,12,716,4096,-3380,-82.51953125
94,8,13,3250,8192,-4942,-60.3271484375
94,8,14,12921,16384,-3463,-21.136474609375
94,8,15,39525,32768,6757,20.6207275390625
94,9,1,0,2,-2,-100.0
94,9,2,1,4,-3,-75.0
94,9,3,11,8,3,37.5
94,9,4,30,16,14,87.5
94,9,5,9,32,-23,-71.875
94,9,6,25,64,-39,-60.9375
94,9,7,137,128,9,7.03125
94,9,8,106,256,-150,-58.59375
94,9,9,245,512,-267,-52.1484375
94,9,10,728,1024,-296,-28.90625
94,9,11,2437,2048,389,18.994140625
94,9,12,2704,4096,-1392,-33.984375
94,9,13,1244,8192,-6948,-84.814453125
94,9,14,119939,16384,103555,632.049560546875
94,9,15,1035,32768,-31733,-96.8414306640625
94,10,1,0,2,-2,-100.0
94,10,2,4,4,0,0.0
94,10,3,4,8,-4,-50.0
94,10,4,14,16,-2,-12.5
94,10,5,4,32,-28,-87.5
94,10,6,165,64,101,157.8125
94,10,7,161,128,33,25.78125
94,10,8,372,256,116,45.3125
94,10,9,206,512,-306,-59.765625
94,10,10,1939,1024,915,89.35546875
94,10,11,1126,2048,-922,-45.01953125
94,10,12,633,4096,-3463,-84.5458984375
94,10,13,544,8192,-7648,-93.359375
94,10,14,21200,16384,4816,29.39453125
94,10,15,14543,32768,-18225,-55.6182861328125
94,11,1,0,2,-2,-100.0
94,11,2,1,4,-3,-75.0
94,11,3,10,8,2,25.0
94,11,4,20,16,4,25.0
94,11,5,23,32,-9,-28.125
94,11,6,146,64,82,128.125
94,11,7,397,128,269,210.15625
94,11,8,44,256,-212,-82.8125
94,11,9,1291,512,779,152.1484375
94,11,10,47,1024,-977,-95.41015625
94,11,11,1874,2048,-174,-8.49609375
94,11,12,148,4096,-3948,-96.38671875
94,11,13,16644,8192,8452,103.173828125
94,11,14,8584,16384,-7800,-47.607421875
94,11,15,2683,32768,-30085,-91.8121337890625
94,12,1,0,2,-2,-100.0
94,12,2,1,4,-3,-75.0
94,12,3,5,8,-3,-37.5
94,12,4,8,16,-8,-50.0
94,12,5,8,32,-24,-75.0
94,12,6,98,64,34,53.125
94,12,7,62,128,-66,-51.5625
94,12,8,284,256,28,10.9375
94,12,9,459,512,-53,-10.3515625
94,12,10,1209,1024,185,18.06640625
94,12,11,2095,2048,47,2.294921875
94,12,12,7681,4096,3585,87.5244140625
94,12,13,5122,8192,-3070,-37.4755859375
94,12,14,12669,16384,-3715,-22.674560546875
94,12,15,2967,32768,-29801,-90.9454345703125
94,13,1,0,2,-2,-100.0
94,13,2,3,4,-1,-25.0
94,13,3,4,8,-4,-50.0
94,13,4,26,16,10,62.5
94,13,5,35,32,3,9.375
94,13,6,103,64,39,60.9375
94,13,7,143,128,15,11.71875
94,13,8,228,256,-28,-10.9375
94,13,9,251,512,-261,-50.9765625
94,13,10,925,1024,-99,-9.66796875
94,13,11,425,2048,-1623,-79.248046875
94,13,12,526,4096,-3570,-87.158203125
94,13,13,1641,8192,-6551,-79.96826171875
94,13,14,1347,16384,-15037,-91.778564453125
94,13,15,10511,32768,-22257,-67.9229736328125
94,14,1,0,2,-2,-100.0
94,14,2,1,4,-3,-75.0
94,14,3,4,8,-4,-50.0
94,14,4,4,16,-12,-75.0
94,14,5,27,32,-5,-15.625
94,14,6,36,64,-28,-43.75
94,14,7,265,128,137,107.03125
94,14,8,101,256,-155,-60.546875
94,14,9,374,512,-138,-26.953125
94,14,10,350,1024,-674,-65.8203125
94,14,11,2081,2048,33,1.611328125
94,14,12,4796,4096,700,17.08984375
94,14,13,3175,8192,-5017,-61.24267578125
94,14,14,1407,16384,-14977,-91.412353515625
94,14,15,71537,32768,38769,118.3135986328125
94,15,1,0,2,-2,-100.0
94,15,2,1,4,-3,-75.0
94,15,3,15,8,7,87.5
94,15,4,4,16,-12,-75.0
94,15,5,26,32,-6,-18.75
94,15,6,52,64,-12,-18.75
94,15,7,6,128,-122,-95.3125
94,15,8,141,256,-115,-44.921875
94,15,9,113,512,-399,-77.9296875
94,15,10,746,1024,-278,-27.1484375
94,15,11,1838,2048,-210,-10.25390625
94,15,12,7078,4096,2982,72.802734375
94,15,13,860,8192,-7332,-89.501953125
94,15,14,3054,16384,-13330,-81.35986328125
94,15,15,76978,32768,44210,134.918212890625
94,16,1,0,2,-2,-100.0
94,16,2,3,4,-1,-25.0
94,16,3,9,8,1,12.5
94,16,4,10,16,-6,-37.5
94,16,5,16,32,-16,-50.0
94,16,6,86,64,22,34.375
94,16,7,72,128,-56,-43.75
94,16,8,57,256,-199,-77.734375
94,16,9,902,512,390,76.171875
94,16,10,493,1024,-531,-51.85546875
94,16,11,819,2048,-1229,-60.009765625
94,16,12,5996,4096,1900,46.38671875
94,16,13,1165,8192,-7027,-85.77880859375
94,16,14,35231,16384,18847,115.032958984375
94,16,15,40040,32768,7272,22.1923828125
94,17,1,0,2,-2,-100.0
94,17,2,1,4,-3,-75.0
94,17,3,17,8,9,112.5
94,17,4,4,16,-12,-75.0
94,17,5,16,32,-16,-50.0
94,17,6,154,64,90,140.625
94,17,7,72,128,-56,-43.75
94,17,8,809,256,553,216.015625
94,17,9,18,512,-494,-96.484375
94,17,10,151,1024,-873,-85.25390625
94,17,11,480,2048,-1568,-76.5625
94,17,12,1746,4096,-2350,-57.373046875
94,17,13,465,8192,-7727,-94.32373046875
94,17,14,16579,16384,195,1.190185546875
94,17,15,16081,32768,-16687,-50.9246826171875
94,18,1,0,2,-2,-100.0
94,18,2,2,4,-2,-50.0
94,18,3,10,8,2,25.0
94,18,4,9,16,-7,-43.75
94,18,5,157,32,125,390.625
94,18,6,59,64,-5,-7.8125
94,18,7,404,128,276,215.625
94,18,8,78,256,-178,-69.53125
94,18,9,1073,512,561,109.5703125
94,18,10,468,1024,-556,-54.296875
94,18,11,1352,2048,-696,-33.984375
94,18,12,678,4096,-3418,-83.447265625
94,18,13,6272,8192,-1920,-23.4375
94,18,14,12756,16384,-3628,-22.1435546875
94,18,15,39694,32768,6926,21.136474609375
94,19,1,0,2,-2,-100.0
94,19,2,1,4,-3,-75.0
94,19,3,10,8,2,25.0
94,19,4,3,16,-13,-81.25
94,19,5,13,32,-19,-59.375
94,19,6,17,64,-47,-73.4375
94,19,7,206,128,78,60.9375
94,19,8,377,256,121,47.265625
94,19,9,1079,512,567,110.7421875
94,19,10,480,1024,-544,-53.125
94,19,11,6028,2048,3980,194.3359375
94,19,12,2249,4096,-1847,-45.0927734375
94,19,13,16068,8192,7876,96.142578125
94,19,14,34325,16384,17941,109.503173828125
94,19,15,11730,32768,-21038,-64.202880859375
94,20,1,0,2,-2,-100.0
94,20,2,1,4,-3,-75.0
94,20,3,14,8,6,75.0
94,20,4,20,16,4,25.0
94,20,5,4,32,-28,-87.5
94,20,6,15,64,-49,-76.5625
94,20,7,85,128,-43,-33.59375
94,20,8,19,256,-237,-92.578125
94,20,9,1419,512,907,177.1484375
94,20,10,110,1024,-914,-89.2578125
94,20,11,3527,2048,1479,72.216796875
94,20,12,5452,4096,1356,33.10546875
94,20,13,20239,8192,12047,147.05810546875
94,20,14,775,16384,-15609,-95.269775390625
94,20,15,38506,32768,5738,17.510986328125
94,21,1,0,2,-2,-100.0
94,21,2,2,4,-2,-50.0
94,21,3,8,8,0,0.0
94,21,4,3,16,-13,-81.25
94,21,5,22,32,-10,-31.25
94,21,6,203,64,139,217.1875
94,21,7,39,128,-89,-69.53125
94,21,8,226,256,-30,-11.71875
94,21,9,538,512,26,5.078125
94,21,10,4141,1024,3117,304.39453125
94,21,11,668,2048,-1380,-67.3828125
94,21,12,1372,4096,-2724,-66.50390625
94,21,13,331,8192,-7861,-95.95947265625
94,21,14,34057,16384,17673,107.867431640625
94,21,15,4794,32768,-27974,-85.369873046875
94,22,1,0,2,-2,-100.0
94,22,2,4,4,0,0.0
94,22,3,7,8,-1,-12.5
94,22,4,5,16,-11,-68.75
94,22,5,25,32,-7,-21.875
94,22,6,37,64,-27,-42.1875
94,22,7,6,128,-122,-95.3125
94,22,8,57,256,-199,-77.734375
94,22,9,193,512,-319,-62.3046875
94,22,10,137,1024,-887,-86.62109375
94,22,11,146,2048,-1902,-92.87109375
94,22,12,2892,4096,-1204,-29.39453125
94,22,13,11379,8192,3187,38.90380859375
94,22,14,9025,16384,-7359,-44.915771484375
94,22,15,13894,32768,-18874,-57.598876953125
94,23,1,0,2,-2,-100.0
94,23,2,1,4,-3,-75.0
94,23,3,8,8,0,0.0
94,23,4,8,16,-8,-50.0
94,23,5,16,32,-16,-50.0
94,23,6,98,64,34,53.125
94,23,7,172,128,44,34.375
94,23,8,123,256,-133,-51.953125
94,23,9,57,512,-455,-88.8671875
94,23,10,637,1024,-387,-37.79296875
94,23,11,106,2048,-1942,-94.82421875
94,23,12,4069,4096,-27,-0.6591796875
94,23,13,4435,8192,-3757,-45.86181640625
94,23,14,1848,16384,-14536,-88.720703125
94,23,15,50624,32768,17856,54.4921875
94,24,1,0,2,-2,-100.0
94,24,2,1,4,-3,-75.0
94,24,3,2,8,-6,-75.0
94,24,4,59,16,43,268.75
94,24,5,53,32,21,65.625
94,24,6,34,64,-30,-46.875
94,24,7,6,128,-122,-95.3125
94,24,8,471,256,215,83.984375
94,24,9,137,512,-375,-73.2421875
94,24,10,2893,1024,1869,182.51953125
94,24,11,2129,2048,81,3.955078125
94,24,12,3500,4096,-596,-14.55078125
94,24,13,7699,8192,-493,-6.01806640625
94,24,14,18994,16384,2610,15.93017578125
94,24,15,27363,32768,-5405,-16.4947509765625
94,25,1,0,2,-2,-100.0
94,25,2,1,4,-3,-75.0
94,25,3,14,8,6,75.0
94,25,4,4,16,-12,-75.0
94,25,5,95,32,63,196.875
94,25,6,150,64,86,134.375
94,25,7,24,128,-104,-81.25
94,25,8,394,256,138,53.90625
94,25,9,384,512,-128,-25.0
94,25,10,354,1024,-670,-65.4296875
94,25,11,6183,2048,4135,201.904296875
94,25,12,1731,4096,-2365,-57.7392578125
94,25,13,4003,8192,-4189,-51.13525390625
94,25,14,25810,16384,9426,57.53173828125
94,25,15,20242,32768,-12526,-38.226318359375
94,26,1,0,2,-2,-100.0
94,26,2,1,4,-3,-75.0
94,26,3,12,8,4,50.0
94,26,4,12,16,-4,-25.0
94,26,5,37,32,5,15.625
94,26,6,34,64,-30,-46.875
94,26,7,407,128,279,217.96875
94,26,8,320,256,64,25.0
94,26,9,172,512,-340,-66.40625
94,26,10,1491,1024,467,45.60546875
94,26,11,4657,2048,2609,127.392578125
94,26,12,7352,4096,3256,79.4921875
94,26,13,2592,8192,-5600,-68.359375
94,26,14,44871,16384,28487,173.870849609375
94,26,15,1197,32768,-31571,-96.3470458984375
94,27,1,0,2,-2,-100.0
94,27,2,1,4,-3,-75.0
94,27,3,4,8,-4,-50.0
94,27,4,6,16,-10,-62.5
94,27,5,19,32,-13,-40.625
94,27,6,11,64,-53,-82.8125
94,27,7,80,128,-48,-37.5
94,27,8,552,256,296,115.625
94,27,9,87,512,-425,-83.0078125
94,27,10,81,1024,-943,-92.08984375
94,27,11,165,2048,-1883,-91.943359375
94,27,12,2257,4096,-1839,-44.8974609375
94,27,13,39210,8192,31018,378.6376953125
94,27,14,17816,16384,1432,8.740234375
94,27,15,1304,32768,-31464,-96.0205078125
94,28,1,0,2,-2,-100.0
94,28,2,1,4,-3,-75.0
94,28,3,7,8,-1,-12.5
94,28,4,12,16,-4,-25.0
94,28,5,23,32,-9,-28.125
94,28,6,120,64,56,87.5
94,28,7,17,128,-111,-86.71875
94,28,8,330,256,74,28.90625
94,28,9,220,512,-292,-57.03125
94,28,10,456,1024,-568,-55.46875
94,28,11,1140,2048,-908,-44.3359375
94,28,12,2377,4096,-1719,-41.9677734375
94,28,13,10298,8192,2106,25.7080078125
94,28,14,5172,16384,-11212,-68.4326171875
94,28,15,13887,32768,-18881,-57.6202392578125
94,29,1,0,2,-2,-100.0
94,29,2,1,4,-3,-75.0
94,29,3,4,8,-4,-50.0
94,29,4,11,16,-5,-31.25
94,29,5,15,32,-17,-53.125
94,29,6,9,64,-55,-85.9375
94,29,7,162,128,34,26.5625
94,29,8,616,256,360,140.625
94,29,9,727,512,215,41.9921875
94,29,10,1120,1024,96,9.375
94,29,11,2424,2048,376,18.359375
94,29,12,4032,4096,-64,-1.5625
94,29,13,82,8192,-8110,-98.9990234375
94,29,14,687,16384,-15697,-95.806884765625
94,29,15,5149,32768,-27619,-84.2864990234375
94,30,1,0,2,-2,-100.0
94,30,2,3,4,-1,-25.0
94,30,3,5,8,-3,-37.5
94,30,4,11,16,-5,-31.25
94,30,5,36,32,4,12.5
94,30,6,111,64,47,73.4375
94,30,7,55,128,-73,-57.03125
94,30,8,466,256,210,82.03125
94,30,9,207,512,-305,-59.5703125
94,30,10,39,1024,-985,-96.19140625
94,30,11,669,2048,-1379,-67.333984375
94,30,12,5123,4096,1027,25.0732421875
94,30,13,1524,8192,-6668,-81.396484375
94,30,14,13996,16384,-2388,-14.5751953125
94,30,15,11535,32768,-21233,-64.7979736328125
94,31,1,0,2,-2,-100.0
94,31,2,1,4,-3,-75.0
94,31,3,4,8,-4,-50.0
94,31,4,8,16,-8,-50.0
94,31,5,22,32,-10,-31.25
94,31,6,29,64,-35,-54.6875
94,31,7,51,128,-77,-60.15625
94,31,8,440,256,184,71.875
94,31,9,469,512,-43,-8.3984375
94,31,10,108,1024,-916,-89.453125
94,31,11,490,2048,-1558,-76.07421875
94,31,12,554,4096,-3542,-86.474609375
94,31,13,5308,8192,-2884,-35.205078125
94,31,14,3158,16384,-13226,-80.72509765625
94,31,15,112125,32768,79357,242.1783447265625
94,32,1,0,2,-2,-100.0
94,32,2,1,4,-3,-75.0
94,32,3,3,8,-5,-62.5
94,32,4,26,16,10,62.5
94,32,5,69,32,37,115.625
94,32,6,42,64,-22,-34.375
94,32,7,48,128,-80,-62.5
94,32,8,426,256,170,66.40625
94,32,9,758,512,246,48.046875
94,32,10,328,1024,-696,-67.96875
94,32,11,126,2048,-1922,-93.84765625
94,32,12,12255,4096,8159,199.1943359375
94,32,13,10482,8192,2290,27.9541015625
94,32,14,8601,16384,-7783,-47.503662109375
94,32,15,16599,32768,-16169,-49.3438720703125
94,33,1,0,2,-2,-100.0
94,33,2,6,4,2,50.0
94,33,3,2,8,-6,-75.0
94,33,4,3,16,-13,-81.25
94,33,5,11,32,-21,-65.625
94,33,6,28,64,-36,-56.25
94,33,7,32,128,-96,-75.0
94,33,8,458,256,202,78.90625
94,33,9,823,512,311,60.7421875
94,33,10,1508,1024,484,47.265625
94,33,11,428,2048,-1620,-79.1015625
94,33,12,6098,4096,2002,48.876953125
94,33,13,2995,8192,-5197,-63.43994140625
94,33,14,45085,16384,28701,175.177001953125
94,33,15,28731,32768,-4037,-12.3199462890625
94,34,1,0,2,-2,-100.0
94,34,2,2,4,-2,-50.0
94,34,3,12,8,4,50.0
94,34,4,11,16,-5,-31.25
94,34,5,41,32,9,28.125
94,34,6,203,64,139,217.1875
94,34,7,272,128,144,112.5
94,34,8,172,256,-84,-32.8125
94,34,9,472,512,-40,-7.8125
94,34,10,66,1024,-958,-93.5546875
94,34,11,2819,2048,771,37.646484375
94,34,12,3513,4096,-583,-14.2333984375
94,34,13,653,8192,-7539,-92.02880859375
94,34,14,8579,16384,-7805,-47.637939453125
94,34,15,840,32768,-31928,-97.4365234375
94,35,1,0,2,-2,-100.0
94,35,2,1,4,-3,-75.0
94,35,3,10,8,2,25.0
94,35,4,3,16,-13,-81.25
94,35,5,9,32,-23,-71.875
94,35,6,31,64,-33,-51.5625
94,35,7,28,128,-100,-78.125
94,35,8,477,256,221,86.328125
94,35,9,295,512,-217,-42.3828125
94,35,10,1691,1024,667,65.13671875
94,35,11,4866,2048,2818,137.59765625
94,35,12,1692,4096,-2404,-58.69140625
94,35,13,15834,8192,7642,93.2861328125
94,35,14,2102,16384,-14282,-87.17041015625
94,35,15,7855,32768,-24913,-76.0284423828125
94,36,1,0,2,-2,-100.0
94,36,2,1,4,-3,-75.0
94,36,3,6,8,-2,-25.0
94,36,4,76,16,60,375.0
94,36,5,23,32,-9,-28.125
94,36,6,5,64,-59,-92.1875
94,36,7,69,128,-59,-46.09375
94,36,8,7,256,-249,-97.265625
94,36,9,855,512,343,66.9921875
94,36,10,571,1024,-453,-44.23828125
94,36,11,5751,2048,3703,180.810546875
94,36,12,2670,4096,-1426,-34.814453125
94,36,13,5481,8192,-2711,-33.09326171875
94,36,14,1917,16384,-14467,-88.299560546875
94,36,15,8031,32768,-24737,-75.4913330078125
94,37,1,0,2,-2,-100.0
94,37,2,1,4,-3,-75.0
94,37,3,5,8,-3,-37.5
94,37,4,7,16,-9,-56.25
94,37,5,48,32,16,50.0
94,37,6,71,64,7,10.9375
94,37,7,310,128,182,142.1875
94,37,8,157,256,-99,-38.671875
94,37,9,187,512,-325,-63.4765625
94,37,10,633,1024,-391,-38.18359375
94,37,11,511,2048,-1537,-75.048828125
94,37,12,4272,4096,176,4.296875
94,37,13,16628,8192,8436,102.978515625
94,37,14,5406,16384,-10978,-67.00439453125
94,37,15,48309,32768,15541,47.4273681640625
94,38,1,0,2,-2,-100.0
94,38,2,5,4,1,25.0
94,38,3,8,8,0,0.0
94,38,4,39,16,23,143.75
94,38,5,47,32,15,46.875
94,38,6,143,64,79,123.4375
94,38,7,70,128,-58,-45.3125
94,38,8,65,256,-191,-74.609375
94,38,9,23,512,-489,-95.5078125
94,38,10,2231,1024,1207,117.87109375
94,38,11,1341,2048,-707,-34.521484375
94,38,12,4576,4096,480,11.71875
94,38,13,3381,8192,-4811,-58.72802734375
94,38,14,9465,16384,-6919,-42.230224609375
94,38,15,50556,32768,17788,54.28466796875
94,39,1,0,2,-2,-100.0
94,39,2,1,4,-3,-75.0
94,39,3,4,8,-4,-50.0
94,39,4,12,16,-4,-25.0
94,39,5,54,32,22,68.75
94,39,6,41,64,-23,-35.9375
94,39,7,173,128,45,35.15625
94,39,8,142,256,-114,-44.53125
94,39,9,513,512,1,0.1953125
94,39,10,2885,1024,1861,181.73828125
94,39,11,2800,2048,752,36.71875
94,39,12,981,4096,-3115,-76.0498046875
94,39,13,6305,8192,-1887,-23.03466796875
94,39,14,8781,16384,-7603,-46.405029296875
94,39,15,7663,32768,-25105,-76.6143798828125
94,40,1,0,2,-2,-100.0
94,40,2,1,4,-3,-75.0
94,40,3,3,8,-5,-62.5
94,40,4,7,16,-9,-56.25
94,40,5,10,32,-22,-68.75
94,40,6,55,64,-9,-14.0625
94,40,7,107,128,-21,-16.40625
94,40,8,84,256,-172,-67.1875
94,40,9,1254,512,742,144.921875
94,40,10,617,1024,-407,-39.74609375
94,40,11,551,2048,-1497,-73.095703125
94,40,12,3406,4096,-690,-16.845703125
94,40,13,11344,8192,3152,38.4765625
94,40,14,1878,16384,-14506,-88.53759765625
94,40,15,33838,32768,1070,3.265380859375
94,41,1,0,2,-2,-100.0
94,41,2,1,4,-3,-75.0
94,41,3,4,8,-4,-50.0
94,41,4,6,16,-10,-62.5
94,41,5,8,32,-24,-75.0
94,41,6,56,64,-8,-12.5
94,41,7,7,128,-121,-94.53125
94,41,8,211,256,-45,-17.578125
94,41,9,684,512,172,33.59375
94,41,10,1181,1024,157,15.33203125
94,41,11,468,2048,-1580,-77.1484375
94,41,12,1269,4096,-2827,-69.0185546875
94,41,13,8837,8192,645,7.87353515625
94,41,14,58118,16384,41734,254.72412109375
94,41,15,49893,32768,17125,52.2613525390625
94,42,1,0,2,-2,-100.0
94,42,2,2,4,-2,-50.0
94,42,3,5,8,-3,-37.5
94,42,4,3,16,-13,-81.25
94,42,5,6,32,-26,-81.25
94,42,6,118,64,54,84.375
94,42,7,60,128,-68,-53.125
94,42,8,289,256,33,12.890625
94,42,9,1526,512,1014,198.046875
94,42,10,3156,1024,2132,208.203125
94,42,11,137,2048,-1911,-93.310546875
94,42,12,3910,4096,-186,-4.541015625
94,42,13,27111,8192,18919,230.94482421875
94,42,14,880,16384,-15504,-94.62890625
94,42,15,12411,32768,-20357,-62.1246337890625
94,43,1,0,2,-2,-100.0
94,43,2,1,4,-3,-75.0
94,43,3,5,8,-3,-37.5
94,43,4,16,16,0,0.0
94,43,5,35,32,3,9.375
94,43,6,59,64,-5,-7.8125
94,43,7,144,128,16,12.5
94,43,8,147,256,-109,-42.578125
94,43,9,311,512,-201,-39.2578125
94,43,10,16,1024,-1008,-98.4375
94,43,11,694,2048,-1354,-66.11328125
94,43,12,673,4096,-3423,-83.5693359375
94,43,13,6566,8192,-1626,-19.8486328125
94,43,14,25748,16384,9364,57.1533203125
94,43,15,34071,32768,1303,3.9764404296875
94,44,1,0,2,-2,-100.0
94,44,2,1,4,-3,-75.0
94,44,3,2,8,-6,-75.0
94,44,4,9,16,-7,-43.75
94,44,5,21,32,-11,-34.375
94,44,6,22,64,-42,-65.625
94,44,7,17,128,-111,-86.71875
94,44,8,245,256,-11,-4.296875
94,44,9,192,512,-320,-62.5
94,44,10,1157,1024,133,12.98828125
94,44,11,3440,2048,1392,67.96875
94,44,12,1312,4096,-2784,-67.96875
94,44,13,3782,8192,-4410,-53.8330078125
94,44,14,4085,16384,-12299,-75.067138671875
94,44,15,20315,32768,-12453,-38.0035400390625
94,45,1,0,2,-2,-100.0
94,45,2,1,4,-3,-75.0
94,45,3,7,8,-1,-12.5
94,45,4,14,16,-2,-12.5
94,45,5,17,32,-15,-46.875
94,45,6,19,64,-45,-70.3125
94,45,7,142,128,14,10.9375
94,45,8,582,256,326,127.34375
94,45,9,60,512,-452,-88.28125
94,45,10,794,1024,-230,-22.4609375
94,45,11,4282,2048,2234,109.08203125
94,45,12,2115,4096,-1981,-48.3642578125
94,45,13,4003,8192,-4189,-51.13525390625
94,45,14,3614,16384,-12770,-77.94189453125
94,45,15,1568,32768,-31200,-95.21484375
94,46,1,0,2,-2,-100.0
94,46,2,1,4,-3,-75.0
94,46,3,5,8,-3,-37.5
94,46,4,50,16,34,212.5
94,46,5,8,32,-24,-75.0
94,46,6,61,64,-3,-4.6875
94,46,7,62,128,-66,-51.5625
94,46,8,63,256,-193,-75.390625
94,46,9,8,512,-504,-98.4375
94,46,10,1964,1024,940,91.796875
94,46,11,1836,2048,-212,-10.3515625
94,46,12,3539,4096,-557,-13.5986328125
94,46,13,13860,8192,5668,69.189453125
94,46,14,4548,16384,-11836,-72.2412109375
94,46,15,1726,32768,-31042,-94.732666015625
94,47,1,0,2,-2,-100.0
94,47,2,2,4,-2,-50.0
94,47,3,2,8,-6,-75.0
94,47,4,17,16,1,6.25
94,47,5,15,32,-17,-53.125
94,47,6,34,64,-30,-46.875
94,47,7,40,128,-88,-68.75
94,47,8,102,256,-154,-60.15625
94,47,9,850,512,338,66.015625
94,47,10,258,1024,-766,-74.8046875
94,47,11,50,2048,-1998,-97.55859375
94,47,12,8214,4096,4118,100.537109375
94,47,13,5996,8192,-2196,-26.806640625
94,47,14,13960,16384,-2424,-14.794921875
94,47,15,7591,32768,-25177,-76.8341064453125
94,48,1,0,2,-2,-100.0
94,48,2,3,4,-1,-25.0
94,48,3,3,8,-5,-62.5
94,48,4,11,16,-5,-31.25
94,48,5,23,32,-9,-28.125
94,48,6,43,64,-21,-32.8125
94,48,7,157,128,29,22.65625
94,48,8,14,256,-242,-94.53125
94,48,9,457,512,-55,-10.7421875
94,48,10,251,1024,-773,-75.48828125
94,48,11,5977,2048,3929,191.845703125
94,48,12,2785,4096,-1311,-32.0068359375
94,48,13,10678,8192,2486,30.3466796875
94,48,14,32649,16384,16265,99.273681640625
94,48,15,27374,32768,-5394,-16.461181640625
94,49,1,0,2,-2,-100.0
94,49,2,1,4,-3,-75.0
94,49,3,7,8,-1,-12.5
94,49,4,36,16,20,125.0
94,49,5,19,32,-13,-40.625
94,49,6,53,64,-11,-17.1875
94,49,7,49,128,-79,-61.71875
94,49,8,194,256,-62,-24.21875
94,49,9,366,512,-146,-28.515625
94,49,10,15,1024,-1009,-98.53515625
94,49,11,124,2048,-1924,-93.9453125
94,49,12,897,4096,-3199,-78.1005859375
94,49,13,18761,8192,10569,129.01611328125
94,49,14,5492,16384,-10892,-66.4794921875
94,49,15,8856,32768,-23912,-72.9736328125
94,50,1,0,2,-2,-100.0
94,50,2,2,4,-2,-50.0
94,50,3,25,8,17,212.5
94,50,4,8,16,-8,-50.0
94,50,5,70,32,38,118.75
94,50,6,27,64,-37,-57.8125
94,50,7,102,128,-26,-20.3125
94,50,8,47,256,-209,-81.640625
94,50,9,510,512,-2,-0.390625
94,50,10,2002,1024,978,95.5078125
94,50,11,9345,2048,7297,356.298828125
94,50,12,1915,4096,-2181,-53.2470703125
94,50,13,1238,8192,-6954,-84.8876953125
94,50,14,18635,16384,2251,13.739013671875
94,50,15,41456,32768,8688,26.513671875
94,51,1,0,2,-2,-100.0
94,51,2,1,4,-3,-75.0
94,51,3,4,8,-4,-50.0
94,51,4,32,16,16,100.0
94,51,5,33,32,1,3.125
94,51,6,15,64,-49,-76.5625
94,51,7,28,128,-100,-78.125
94,51,8,154,256,-102,-39.84375
94,51,9,1227,512,715,139.6484375
94,51,10,1332,1024,308,30.078125
94,51,11,1522,2048,-526,-25.68359375
94,51,12,10299,4096,6203,151.4404296875
94,51,13,3024,8192,-5168,-63.0859375
94,51,14,11257,16384,-5127,-31.292724609375
94,51,15,25631,32768,-7137,-21.7803955078125
94,52,1,0,2,-2,-100.0
94,52,2,1,4,-3,-75.0
94,52,3,2,8,-6,-75.0
94,52,4,6,16,-10,-62.5
94,52,5,10,32,-22,-68.75
94,52,6,60,64,-4,-6.25
94,52,7,40,128,-88,-68.75
94,52,8,148,256,-108,-42.1875
94,52,9,41,512,-471,-91.9921875
94,52,10,5151,1024,4127,403.02734375
94,52,11,679,2048,-1369,-66.845703125
94,52,12,13,4096,-4083,-99.6826171875
94,52,13,3390,8192,-4802,-58.6181640625
94,52,14,5189,16384,-11195,-68.328857421875
94,52,15,36845,32768,4077,12.4420166015625
94,53,1,0,2,-2,-100.0
94,53,2,1,4,-3,-75.0
94,53,3,8,8,0,0.0
94,53,4,26,16,10,62.5
94,53,5,72,32,40,125.0
94,53,6,12,64,-52,-81.25
94,53,7,139,128,11,8.59375
94,53,8,33,256,-223,-87.109375
94,53,9,1013,512,501,97.8515625
94,53,10,2155,1024,1131,110.44921875
94,53,11,1314,2048,-734,-35.83984375
94,53,12,9074,4096,4978,121.533203125
94,53,13,861,8192,-7331,-89.48974609375
94,53,14,5154,16384,-11230,-68.54248046875
94,53,15,5272,32768,-27496,-83.9111328125
94,54,1,0,2,-2,-100.0
94,54,2,1,4,-3,-75.0
94,54,3,7,8,-1,-12.5
94,54,4,3,16,-13,-81.25
94,54,5,13,32,-19,-59.375
94,54,6,84,64,20,31.25
94,54,7,92,128,-36,-28.125
94,54,8,86,256,-170,-66.40625
94,54,9,64,512,-448,-87.5
94,54,10,2294,1024,1270,124.0234375
94,54,11,1649,2048,-399,-19.482421875
94,54,12,1229,4096,-2867,-69.9951171875
94,54,13,2428,8192,-5764,-70.361328125
94,54,14,15444,16384,-940,-5.7373046875
94,54,15,24301,32768,-8467,-25.8392333984375
94,55,1,0,2,-2,-100.0
94,55,2,3,4,-1,-25.0
94,55,3,7,8,-1,-12.5
94,55,4,22,16,6,37.5
94,55,5,4,32,-28,-87.5
94,55,6,5,64,-59,-92.1875
94,55,7,65,128,-63,-49.21875
94,55,8,454,256,198,77.34375
94,55,9,535,512,23,4.4921875
94,55,10,147,1024,-877,-85.64453125
94,55,11,987,2048,-1061,-51.806640625
94,55,12,3055,4096,-1041,-25.4150390625
94,55,13,2439,8192,-5753,-70.22705078125
94,55,14,33110,16384,16726,102.08740234375
94,55,15,67225,32768,34457,105.1544189453125
94,56,1,0,2,-2,-100.0
94,56,2,1,4,-3,-75.0
94,56,3,2,8,-6,-75.0
94,56,4,27,16,11,68.75
94,56,5,135,32,103,321.875
94,56,6,86,64,22,34.375
94,56,7,13,128,-115,-89.84375
94,56,8,14,256,-242,-94.53125
94,56,9,841,512,329,64.2578125
94,56,10,2406,1024,1382,134.9609375
94,56,11,408,2048,-1640,-80.078125
94,56,12,3990,4096,-106,-2.587890625
94,56,13,1055,8192,-7137,-87.12158203125
94,56,14,1551,16384,-14833,-90.533447265625
94,56,15,45910,32768,13142,40.106201171875
94,57,1,0,2,-2,-100.0
94,57,2,2,4,-2,-50.0
94,57,3,5,8,-3,-37.5
94,57,4,6,16,-10,-62.5
94,57,5,50,32,18,56.25
94,57,6,16,64,-48,-75.0
94,57,7,153,128,25,19.53125
94,57,8,49,256,-207,-80.859375
94,57,9,151,512,-361,-70.5078125
94,57,10,100,1024,-924,-90.234375
94,57,11,42,2048,-2006,-97.94921875
94,57,12,9287,4096,5191,126.7333984375
94,57,13,1147,8192,-7045,-85.99853515625
94,57,14,32229,16384,15845,96.710205078125
94,57,15,15637,32768,-17131,-52.2796630859375
94,58,1,0,2,-2,-100.0
94,58,2,2,4,-2,-50.0
94,58,3,2,8,-6,-75.0
94,58,4,3,16,-13,-81.25
94,58,5,43,32,11,34.375
94,58,6,50,64,-14,-21.875
94,58,7,6,128,-122,-95.3125
94,58,8,23,256,-233,-91.015625
94,58,9,406,512,-106,-20.703125
94,58,10,758,1024,-266,-25.9765625
94,58,11,3253,2048,1205,58.837890625
94,58,12,678,4096,-3418,-83.447265625
94,58,13,2807,8192,-5385,-65.73486328125
94,58,14,23617,16384,7233,44.146728515625
94,58,15,24712,32768,-8056,-24.5849609375
94,59,1,0,2,-2,-100.0
94,59,2,5,4,1,25.0
94,59,3,2,8,-6,-75.0
94,59,4,24,16,8,50.0
94,59,5,41,32,9,28.125
94,59,6,41,64,-23,-35.9375
94,59,7,139,128,11,8.59375
94,59,8,348,256,92,35.9375
94,59,9,1255,512,743,145.1171875
94,59,10,576,1024,-448,-43.75
94,59,11,589,2048,-1459,-71.240234375
94,59,12,487,4096,-3609,-88.1103515625
94,59,13,12792,8192,4600,56.15234375
94,59,14,13936,16384,-2448,-14.94140625
94,59,15,4526,32768,-28242,-86.187744140625
94,60,1,0,2,-2,-100.0
94,60,2,3,4,-1,-25.0
94,60,3,20,8,12,150.0
94,60,4,9,16,-7,-43.75
94,60,5,4,32,-28,-87.5
94,60,6,24,64,-40,-62.5
94,60,7,29,128,-99,-77.34375
94,60,8,138,256,-118,-46.09375
94,60,9,327,512,-185,-36.1328125
94,60,10,2576,1024,1552,151.5625
94,60,11,2641,2048,593,28.955078125
94,60,12,13483,4096,9387,229.1748046875
94,60,13,14505,8192,6313,77.06298828125
94,60,14,4503,16384,-11881,-72.515869140625
94,60,15,9640,32768,-23128,-70.5810546875
94,61,1,0,2,-2,-100.0
94,61,2,5,4,1,25.0
94,61,3,3,8,-5,-62.5
94,61,4,12,16,-4,-25.0
94,61,5,10,32,-22,-68.75
94,61,6,5,64,-59,-92.1875
94,61,7,13,128,-115,-89.84375
94,61,8,235,256,-21,-8.203125
94,61,9,776,512,264,51.5625
94,61,10,902,1024,-122,-11.9140625
94,61,11,2511,2048,463,22.607421875
94,61,12,1794,4096,-2302,-56.201171875
94,61,13,603,8192,-7589,-92.63916015625
94,61,14,2295,16384,-14089,-85.992431640625
94,61,15,9689,32768,-23079,-70.4315185546875
94,62,1,0,2,-2,-100.0
94,62,2,1,4,-3,-75.0
94,62,3,4,8,-4,-50.0
94,62,4,9,16,-7,-43.75
94,62,5,20,32,-12,-37.5
94,62,6,36,64,-28,-43.75
94,62,7,50,128,-78,-60.9375
94,62,8,32,256,-224,-87.5
94,62,9,198,512,-314,-61.328125
94,62,10,449,1024,-575,-56.15234375
94,62,11,282,2048,-1766,-86.23046875
94,62,12,3065,4096,-1031,-25.1708984375
94,62,13,12371,8192,4179,51.01318359375
94,62,14,4172,16384,-12212,-74.5361328125
94,62,15,3677,32768,-29091,-88.7786865234375
94,63,1,0,2,-2,-100.0
94,63,2,3,4,-1,-25.0
94,63,3,8,8,0,0.0
94,63,4,39,16,23,143.75
94,63,5,5,32,-27,-84.375
94,63,6,58,64,-6,-9.375
94,63,7,9,128,-119,-92.96875
94,63,8,159,256,-97,-37.890625
94,63,9,162,512,-350,-68.359375
94,63,10,757,1024,-267,-26.07421875
94,63,11,666,2048,-1382,-67.48046875
94,63,12,5492,4096,1396,34.08203125
94,63,13,23350,8192,15158,185.0341796875
94,63,14,26060,16384,9676,59.0576171875
94,63,15,888,32768,-31880,-97.2900390625
94,64,1,0,2,-2,-100.0
94,64,2,3,4,-1,-25.0
94,64,3,3,8,-5,-62.5
94,64,4,3,16,-13,-81.25
94,64,5,14,32,-18,-56.25
94,64,6,250,64,186,290.625
94,64,7,351,128,223,174.21875
94,64,8,684,256,428,167.1875
94,64,9,902,512,390,76.171875
94,64,10,573,1024,-451,-44.04296875
94,64,11,567,2048,-1481,-72.314453125
94,64,12,281,4096,-3815,-93.1396484375
94,64,13,459,8192,-7733,-94.39697265625
94,64,14,947,16384,-15437,-94.219970703125
94,64,15,96297,32768,63529,193.8751220703125
94,65,1,0,2,-2,-100.0
94,65,2,3,4,-1,-25.0
94,65,3,8,8,0,0.0
94,65,4,46,16,30,187.5
94,65,5,10,32,-22,-68.75
94,65,6,23,64,-41,-64.0625
94,65,7,168,128,40,31.25
94,65,8,62,256,-194,-75.78125
94,65,9,128,512,-384,-75.0
94,65,10,913,1024,-111,-10.83984375
94,65,11,702,2048,-1346,-65.72265625
94,65,12,5459,4096,1363,33.2763671875
94,65,13,8513,8192,321,3.91845703125
94,65,14,6502,16384,-9882,-60.31494140625
94,65,15,20076,32768,-12692,-38.73291015625
94,66,1,0,2,-2,-100.0
94,66,2,1,4,-3,-75.0
94,66,3,6,8,-2,-25.0
94,66,4,3,16,-13,-81.25
94,66,5,39,32,7,21.875
94,66,6,21,64,-43,-67.1875
94,66,7,230,128,102,79.6875
94,66,8,238,256,-18,-7.03125
94,66,9,80,512,-432,-84.375
94,66,10,511,1024,-513,-50.09765625
94,66,11,991,2048,-1057,-51.611328125
94,66,12,382,4096,-3714,-90.673828125
94,66,13,9854,8192,1662,20.2880859375
94,66,14,4222,16384,-12162,-74.23095703125
94,66,15,21503,32768,-11265,-34.3780517578125
94,67,1,0,2,-2,-100.0
94,67,2,5,4,1,25.0
94,67,3,19,8,11,137.5
94,67,4,19,16,3,18.75
94,67,5,9,32,-23,-71.875
94,67,6,59,64,-5,-7.8125
94,67,7,183,128,55,42.96875
94,67,8,96,256,-160,-62.5
94,67,9,243,512,-269,-52.5390625
94,67,10,1412,1024,388,37.890625
94,67,11,2009,2048,-39,-1.904296875
94,67,12,3197,4096,-899,-21.9482421875
94,67,13,765,8192,-7427,-90.66162109375
94,67,14,11814,16384,-4570,-27.89306640625
94,67,15,32210,32768,-558,-1.702880859375
94,68,1,0,2,-2,-100.0
94,68,2,4,4,0,0.0
94,68,3,3,8,-5,-62.5
94,68,4,10,16,-6,-37.5
94,68,5,20,32,-12,-37.5
94,68,6,241,64,177,276.5625
94,68,7,114,128,-14,-10.9375
94,68,8,188,256,-68,-26.5625
94,68,9,784,512,272,53.125
94,68,10,572,1024,-452,-44.140625
94,68,11,1795,2048,-253,-12.353515625
94,68,12,7152,4096,3056,74.609375
94,68,13,2858,8192,-5334,-65.1123046875
94,68,14,40099,16384,23715,144.744873046875
94,68,15,6208,32768,-26560,-81.0546875
94,69,1,0,2,-2,-100.0
94,69,2,4,4,0,0.0
94,69,3,2,8,-6,-75.0
94,69,4,6,16,-10,-62.5
94,69,5,26,32,-6,-18.75
94,69,6,11,64,-53,-82.8125
94,69,7,396,128,268,209.375
94,69,8,11,256,-245,-95.703125
94,69,9,368,512,-144,-28.125
94,69,10,145,1024,-879,-85.83984375
94,69,11,1469,2048,-579,-28.271484375
94,69,12,10961,4096,6865,167.6025390625
94,69,13,2067,8192,-6125,-74.76806640625
94,69,14,28031,16384,11647,71.087646484375
94,69,15,32795,32768,27,0.0823974609375
94,70,1,0,2,-2,-100.0
94,70,2,1,4,-3,-75.0
94,70,3,3,8,-5,-62.5
94,70,4,20,16,4,25.0
94,70,5,4,32,-28,-87.5
94,70,6,15,64,-49,-76.5625
94,70,7,29,128,-99,-77.34375
94,70,8,321,256,65,25.390625
94,70,9,6490,512,5978,1167.578125
94,70,10,1123,1024,99,9.66796875
94,70,11,502,2048,-1546,-75.48828125
94,70,12,5148,4096,1052,25.68359375
94,70,13,1400,8192,-6792,-82.91015625
94,70,14,34442,16384,18058,110.21728515625
94,70,15,76637,32768,43869,133.8775634765625
94,71,1,0,2,-2,-100.0
94,71,2,1,4,-3,-75.0
94,71,3,8,8,0,0.0
94,71,4,8,16,-8,-50.0
94,71,5,23,32,-9,-28.125
94,71,6,14,64,-50,-78.125
94,71,7,93,128,-35,-27.34375
94,71,8,306,256,50,19.53125
94,71,9,234,512,-278,-54.296875
94,71,10,1638,1024,614,59.9609375
94,71,11,1988,2048,-60,-2.9296875
94,71,12,5798,4096,1702,41.552734375
94,71,13,1061,8192,-7131,-87.04833984375
94,71,14,4704,16384,-11680,-71.2890625
94,71,15,18651,32768,-14117,-43.0816650390625
94,72,1,0,2,-2,-100.0
94,72,2,2,4,-2,-50.0
94,72,3,3,8,-5,-62.5
94,72,4,9,16,-7,-43.75
94,72,5,11,32,-21,-65.625
94,72,6,23,64,-41,-64.0625
94,72,7,6,128,-122,-95.3125
94,72,8,28,256,-228,-89.0625
94,72,9,86,512,-426,-83.203125
94,72,10,6333,1024,5309,518.45703125
94,72,11,32,2048,-2016,-98.4375
94,72,12,2590,4096,-1506,-36.767578125
94,72,13,11463,8192,3271,39.92919921875
94,72,14,8426,16384,-7958,-48.57177734375
94,72,15,3615,32768,-29153,-88.9678955078125
94,73,1,0,2,-2,-100.0
94,73,2,2,4,-2,-50.0
94,73,3,6,8,-2,-25.0
94,73,4,12,16,-4,-25.0
94,73,5,25,32,-7,-21.875
94,73,6,7,64,-57,-89.0625
94,73,7,161,128,33,25.78125
94,73,8,318,256,62,24.21875
94,73,9,1608,512,1096,214.0625
94,73,10,1587,1024,563,54.98046875
94,73,11,218,2048,-1830,-89.35546875
94,73,12,1313,4096,-2783,-67.9443359375
94,73,13,308,8192,-7884,-96.240234375
94,73,14,3638,16384,-12746,-77.79541015625
94,73,15,8940,32768,-23828,-72.71728515625
94,74,1,0,2,-2,-100.0
94,74,2,1,4,-3,-75.0
94,74,3,2,8,-6,-75.0
94,74,4,5,16,-11,-68.75
94,74,5,72,32,40,125.0
94,74,6,40,64,-24,-37.5
94,74,7,7,128,-121,-94.53125
94,74,8,577,256,321,125.390625
94,74,9,114,512,-398,-77.734375
94,74,10,295,1024,-729,-71.19140625
94,74,11,2125,2048,77,3.759765625
94,74,12,5543,4096,1447,35.3271484375
94,74,13,7064,8192,-1128,-13.76953125
94,74,14,92,16384,-16292,-99.4384765625
94,74,15,47112,32768,14344,43.7744140625
94,75,1,0,2,-2,-100.0
94,75,2,2,4,-2,-50.0
94,75,3,13,8,5,62.5
94,75,4,26,16,10,62.5
94,75,5,105,32,73,228.125
94,75,6,12,64,-52,-81.25
94,75,7,252,128,124,96.875
94,75,8,15,256,-241,-94.140625
94,75,9,255,512,-257,-50.1953125
94,75,10,1548,1024,524,51.171875
94,75,11,88,2048,-1960,-95.703125
94,75,12,6975,4096,2879,70.2880859375
94,75,13,538,8192,-7654,-93.4326171875
94,75,14,10500,16384,-5884,-35.9130859375
94,75,15,45680,32768,12912,39.404296875
94,76,1,0,2,-2,-100.0
94,76,2,1,4,-3,-75.0
94,76,3,9,8,1,12.5
94,76,4,3,16,-13,-81.25
94,76,5,26,32,-6,-18.75
94,76,6,11,64,-53,-82.8125
94,76,7,112,128,-16,-12.5
94,76,8,72,256,-184,-71.875
94,76,9,249,512,-263,-51.3671875
94,76,10,504,1024,-520,-50.78125
94,76,11,4001,2048,1953,95.361328125
94,76,12,1515,4096,-2581,-63.0126953125
94,76,13,23645,8192,15453,188.63525390625
94,76,14,73810,16384,57426,350.50048828125
94,76,15,36464,32768,3696,11.279296875
94,77,1,0,2,-2,-100.0
94,77,2,4,4,0,0.0
94,77,3,3,8,-5,-62.5
94,77,4,16,16,0,0.0
94,77,5,55,32,23,71.875
94,77,6,78,64,14,21.875
94,77,7,19,128,-109,-85.15625
94,77,8,7,256,-249,-97.265625
94,77,9,864,512,352,68.75
94,77,10,627,1024,-397,-38.76953125
94,77,11,2342,2048,294,14.35546875
94,77,12,4195,4096,99,2.4169921875
94,77,13,2421,8192,-5771,-70.44677734375
94,77,14,11423,16384,-4961,-30.279541015625
94,77,15,60250,32768,27482,83.868408203125
94,78,1,0,2,-2,-100.0
94,78,2,1,4,-3,-75.0
94,78,3,8,8,0,0.0
94,78,4,18,16,2,12.5
94,78,5,13,32,-19,-59.375
94,78,6,18,64,-46,-71.875
94,78,7,189,128,61,47.65625
94,78,8,39,256,-217,-84.765625
94,78,9,854,512,342,66.796875
94,78,10,1621,1024,597,58.30078125
94,78,11,301,2048,-1747,-85.302734375
94,78,12,224,4096,-3872,-94.53125
94,78,13,8569,8192,377,4.60205078125
94,78,14,7356,16384,-9028,-55.1025390625
94,78,15,36509,32768,3741,11.4166259765625
94,79,1,0,2,-2,-100.0
94,79,2,1,4,-3,-75.0
94,79,3,6,8,-2,-25.0
94,79,4,17,16,1,6.25
94,79,5,5,32,-27,-84.375
94,79,6,28,64,-36,-56.25
94,79,7,60,128,-68,-53.125
94,79,8,228,256,-28,-10.9375
94,79,9,577,512,65,12.6953125
94,79,10,483,1024,-541,-52.83203125
94,79,11,4396,2048,2348,114.6484375
94,79,12,4540,4096,444,10.83984375
94,79,13,15615,8192,7423,90.61279296875
94,79,14,6270,16384,-10114,-61.73095703125
94,79,15,8835,32768,-23933,-73.0377197265625
94,80,1,0,2,-2,-100.0
94,80,2,1,4,-3,-75.0
94,80,3,11,8,3,37.5
94,80,4,5,16,-11,-68.75
94,80,5,9,32,-23,-71.875
94,80,6,18,64,-46,-71.875
94,80,7,69,128,-59,-46.09375
94,80,8,117,256,-139,-54.296875
94,80,9,1677,512,1165,227.5390625
94,80,10,2061,1024,1037,101.26953125
94,80,11,3993,2048,1945,94.970703125
94,80,12,5508,4096,1412,34.47265625
94,80,13,7220,8192,-972,-11.865234375
94,80,14,28050,16384,11666,71.20361328125
94,80,15,102611,32768,69843,213.1439208984375
94,81,1,0,2,-2,-100.0
94,81,2,1,4,-3,-75.0
94,81,3,2,8,-6,-75.0
94,81,4,23,16,7,43.75
94,81,5,15,32,-17,-53.125
94,81,6,217,64,153,239.0625
94,81,7,243,128,115,89.84375
94,81,8,202,256,-54,-21.09375
94,81,9,206,512,-306,-59.765625
94,81,10,1359,1024,335,32.71484375
94,81,11,1608,2048,-440,-21.484375
94,81,12,1260,4096,-2836,-69.23828125
94,81,13,23385,8192,15193,185.46142578125
94,81,14,20440,16384,4056,24.755859375
94,81,15,47795,32768,15027,45.8587646484375
94,82,1,0,2,-2,-100.0
94,82,2,1,4,-3,-75.0
94,82,3,3,8,-5,-62.5
94,82,4,5,16,-11,-68.75
94,82,5,81,32,49,153.125
94,82,6,31,64,-33,-51.5625
94,82,7,254,128,126,98.4375
94,82,8,144,256,-112,-43.75
94,82,9,338,512,-174,-33.984375
94,82,10,225,1024,-799,-78.02734375
94,82,11,759,2048,-1289,-62.939453125
94,82,12,6692,4096,2596,63.37890625
94,82,13,9047,8192,855,10.43701171875
94,82,14,13445,16384,-2939,-17.938232421875
94,82,15,68239,32768,35471,108.2489013671875
94,83,1,0,2,-2,-100.0
94,83,2,1,4,-3,-75.0
94,83,3,8,8,0,0.0
94,83,4,3,16,-13,-81.25
94,83,5,14,32,-18,-56.25
94,83,6,138,64,74,115.625
94,83,7,64,128,-64,-50.0
94,83,8,229,256,-27,-10.546875
94,83,9,20,512,-492,-96.09375
94,83,10,1102,1024,78,7.6171875
94,83,11,591,2048,-1457,-71.142578125
94,83,12,441,4096,-3655,-89.2333984375
94,83,13,3602,8192,-4590,-56.0302734375
94,83,14,7020,16384,-9364,-57.1533203125
94,83,15,105036,32768,72268,220.54443359375
94,84,1,0,2,-2,-100.0
94,84,2,1,4,-3,-75.0
94,84,3,31,8,23,287.5
94,84,4,4,16,-12,-75.0
94,84,5,50,32,18,56.25
94,84,6,5,64,-59,-92.1875
94,84,7,23,128,-105,-82.03125
94,84,8,28,256,-228,-89.0625
94,84,9,345,512,-167,-32.6171875
94,84,10,23,1024,-1001,-97.75390625
94,84,11,3460,2048,1412,68.9453125
94,84,12,11369,4096,7273,177.5634765625
94,84,13,4874,8192,-3318,-40.5029296875
94,84,14,41087,16384,24703,150.775146484375
94,84,15,22679,32768,-10089,-30.7891845703125
94,85,1,0,2,-2,-100.0
94,85,2,1,4,-3,-75.0
94,85,3,3,8,-5,-62.5
94,85,4,65,16,49,306.25
94,85,5,17,32,-15,-46.875
94,85,6,34,64,-30,-46.875
94,85,7,32,128,-96,-75.0
94,85,8,76,256,-180,-70.3125
94,85,9,421,512,-91,-17.7734375
94,85,10,467,1024,-557,-54.39453125
94,85,11,369,2048,-1679,-81.982421875
94,85,12,19929,4096,15833,386.5478515625
94,85,13,2910,8192,-5282,-64.4775390625
94,85,14,7025,16384,-9359,-57.122802734375
94,85,15,4208,32768,-28560,-87.158203125
94,86,1,0,2,-2,-100.0
94,86,2,2,4,-2,-50.0
94,86,3,2,8,-6,-75.0
94,86,4,7,16,-9,-56.25
94,86,5,51,32,19,59.375
94,86,6,39,64,-25,-39.0625
94,86,7,21,128,-107,-83.59375
94,86,8,88,256,-168,-65.625
94,86,9,103,512,-409,-79.8828125
94,86,10,66,1024,-958,-93.5546875
94,86,11,936,2048,-1112,-54.296875
94,86,12,2128,4096,-1968,-48.046875
94,86,13,11198,8192,3006,36.6943359375
94,86,14,6938,16384,-9446,-57.65380859375
94,86,15,108916,32768,76148,232.38525390625
94,87,1,0,2,-2,-100.0
94,87,2,1,4,-3,-75.0
94,87,3,5,8,-3,-37.5
94,87,4,10,16,-6,-37.5
94,87,5,23,32,-9,-28.125
94,87,6,9,64,-55,-85.9375
94,87,7,66,128,-62,-48.4375
94,87,8,34,256,-222,-86.71875
94,87,9,491,512,-21,-4.1015625
94,87,10,169,1024,-855,-83.49609375
94,87,11,767,2048,-1281,-62.548828125
94,87,12,8950,4096,4854,118.505859375
94,87,13,10085,8192,1893,23.10791015625
94,87,14,1388,16384,-14996,-91.5283203125
94,87,15,41111,32768,8343,25.4608154296875
94,88,1,0,2,-2,-100.0
94,88,2,2,4,-2,-50.0
94,88,3,4,8,-4,-50.0
94,88,4,9,16,-7,-43.75
94,88,5,17,32,-15,-46.875
94,88,6,96,64,32,50.0
94,88,7,135,128,7,5.46875
94,88,8,1503,256,1247,487.109375
94,88,9,1067,512,555,108.3984375
94,88,10,133,1024,-891,-87.01171875
94,88,11,981,2048,-1067,-52.099609375
94,88,12,2711,4096,-1385,-33.8134765625
94,88,13,2784,8192,-5408,-66.015625
94,88,14,17272,16384,888,5.419921875
94,88,15,776,32768,-31992,-97.6318359375
94,89,1,0,2,-2,-100.0
94,89,2,1,4,-3,-75.0
94,89,3,10,8,2,25.0
94,89,4,18,16,2,12.5
94,89,5,14,32,-18,-56.25
94,89,6,11,64,-53,-82.8125
94,89,7,31,128,-97,-75.78125
94,89,8,55,256,-201,-78.515625
94,89,9,11,512,-501,-97.8515625
94,89,10,903,1024,-121,-11.81640625
94,89,11,7415,2048,5367,262.060546875
94,89,12,1142,4096,-2954,-72.119140625
94,89,13,984,8192,-7208,-87.98828125
94,89,14,9617,16384,-6767,-41.302490234375
94,89,15,13561,32768,-19207,-58.6151123046875
94,90,1,0,2,-2,-100.0
94,90,2,1,4,-3,-75.0
94,90,3,3,8,-5,-62.5
94,90,4,17,16,1,6.25
94,90,5,29,32,-3,-9.375
94,90,6,29,64,-35,-54.6875
94,90,7,22,128,-106,-82.8125
94,90,8,36,256,-220,-85.9375
94,90,9,1149,512,637,124.4140625
94,90,10,937,1024,-87,-8.49609375
94,90,11,2860,2048,812,39.6484375
94,90,12,4979,4096,883,21.5576171875
94,90,13,2703,8192,-5489,-67.00439453125
94,90,14,174,16384,-16210,-98.93798828125
94,90,15,123885,32768,91117,278.0670166015625
94,91,1,0,2,-2,-100.0
94,91,2,4,4,0,0.0
94,91,3,4,8,-4,-50.0
94,91,4,11,16,-5,-31.25
94,91,5,20,32,-12,-37.5
94,91,6,35,64,-29,-45.3125
94,91,7,195,128,67,52.34375
94,91,8,397,256,141,55.078125
94,91,9,823,512,311,60.7421875
94,91,10,1326,1024,302,29.4921875
94,91,11,271,2048,-1777,-86.767578125
94,91,12,7832,4096,3736,91.2109375
94,91,13,15362,8192,7170,87.5244140625
94,91,14,38101,16384,21717,132.550048828125
94,91,15,16715,32768,-16053,-48.9898681640625
94,92,1,0,2,-2,-100.0
94,92,2,3,4,-1,-25.0
94,92,3,4,8,-4,-50.0
94,92,4,15,16,-1,-6.25
94,92,5,4,32,-28,-87.5
94,92,6,223,64,159,248.4375
94,92,7,171,128,43,33.59375
94,92,8,9,256,-247,-96.484375
94,92,9,935,512,423,82.6171875
94,92,10,2273,1024,1249,121.97265625
94,92,11,595,2048,-1453,-70.947265625
94,92,12,1741,4096,-2355,-57.4951171875
94,92,13,1022,8192,-7170,-87.5244140625
94,92,14,21032,16384,4648,28.369140625
94,92,15,18944,32768,-13824,-42.1875
94,93,1,0,2,-2,-100.0
94,93,2,3,4,-1,-25.0
94,93,3,2,8,-6,-75.0
94,93,4,16,16,0,0.0
94,93,5,40,32,8,25.0
94,93,6,14,64,-50,-78.125
94,93,7,214,128,86,67.1875
94,93,8,339,256,83,32.421875
94,93,9,402,512,-110,-21.484375
94,93,10,3461,1024,2437,237.98828125
94,93,11,4890,2048,2842,138.76953125
94,93,12,1731,4096,-2365,-57.7392578125
94,93,13,1711,8192,-6481,-79.11376953125
94,93,14,21004,16384,4620,28.1982421875
94,93,15,39479,32768,6711,20.4803466796875
94,94,1,0,2,-2,-100.0
94,94,2,3,4,-1,-25.0
94,94,3,4,8,-4,-50.0
94,94,4,23,16,7,43.75
94,94,5,6,32,-26,-81.25
94,94,6,48,64,-16,-25.0
94,94,7,82,128,-46,-35.9375
94,94,8,35,256,-221,-86.328125
94,94,9,2068,512,1556,303.90625
94,94,10,421,1024,-603,-58.88671875
94,94,11,2463,2048,415,20.263671875
94,94,12,2187,4096,-1909,-46.6064453125
94,94,13,19721,8192,11529,140.73486328125
94,94,14,5948,16384,-10436,-63.6962890625
94,94,15,59783,32768,27015,82.4432373046875
95,1,1,0,2,-2,-100.0
95,1,2,1,4,-3,-75.0
95,1,3,9,8,1,12.5
95,1,4,3,16,-13,-81.25
95,1,5,63,32,31,96.875
95,1,6,22,64,-42,-65.625
95,1,7,146,128,18,14.0625
95,1,8,81,256,-175,-68.359375
95,1,9,17,512,-495,-96.6796875
95,1,10,315,1024,-709,-69.23828125
95,1,11,5102,2048,3054,149.12109375
95,1,12,1350,4096,-2746,-67.041015625
95,1,13,11952,8192,3760,45.8984375
95,1,14,5381,16384,-11003,-67.156982421875
95,1,15,126579,32768,93811,286.2884521484375
95,2,1,0,2,-2,-100.0
95,2,2,3,4,-1,-25.0
95,2,3,2,8,-6,-75.0
95,2,4,27,16,11,68.75
95,2,5,5,32,-27,-84.375
95,2,6,24,64,-40,-62.5
95,2,7,6,128,-122,-95.3125
95,2,8,116,256,-140,-54.6875
95,2,9,271,512,-241,-47.0703125
95,2,10,291,1024,-733,-71.58203125
95,2,11,1761,2048,-287,-14.013671875
95,2,12,7497,4096,3401,83.0322265625
95,2,13,13275,8192,5083,62.04833984375
95,2,14,20177,16384,3793,23.150634765625
95,2,15,6969,32768,-25799,-78.7322998046875
95,3,1,0,2,-2,-100.0
95,3,2,1,4,-3,-75.0
95,3,3,9,8,1,12.5
95,3,4,18,16,2,12.5
95,3,5,37,32,5,15.625
95,3,6,56,64,-8,-12.5
95,3,7,105,128,-23,-17.96875
95,3,8,151,256,-105,-41.015625
95,3,9,1208,512,696,135.9375
95,3,10,1592,1024,568,55.46875
95,3,11,115,2048,-1933,-94.384765625
95,3,12,1271,4096,-2825,-68.9697265625
95,3,13,3631,8192,-4561,-55.67626953125
95,3,14,2622,16384,-13762,-83.99658203125
95,3,15,34281,32768,1513,4.6173095703125
95,4,1,0,2,-2,-100.0
95,4,2,3,4,-1,-25.0
95,4,3,4,8,-4,-50.0
95,4,4,30,16,14,87.5
95,4,5,35,32,3,9.375
95,4,6,81,64,17,26.5625
95,4,7,28,128,-100,-78.125
95,4,8,127,256,-129,-50.390625
95,4,9,810,512,298,58.203125
95,4,10,1179,1024,155,15.13671875
95,4,11,562,2048,-1486,-72.55859375
95,4,12,226,4096,-3870,-94.482421875
95,4,13,7148,8192,-1044,-12.744140625
95,4,14,8299,16384,-8085,-49.346923828125
95,4,15,663,32768,-32105,-97.9766845703125
95,5,1,0,2,-2,-100.0
95,5,2,1,4,-3,-75.0
95,5,3,2,8,-6,-75.0
95,5,4,3,16,-13,-81.25
95,5,5,7,32,-25,-78.125
95,5,6,57,64,-7,-10.9375
95,5,7,128,128,0,0.0
95,5,8,164,256,-92,-35.9375
95,5,9,30,512,-482,-94.140625
95,5,10,1914,1024,890,86.9140625
95,5,11,1056,2048,-992,-48.4375
95,5,12,1799,4096,-2297,-56.0791015625
95,5,13,18849,8192,10657,130.09033203125
95,5,14,9156,16384,-7228,-44.1162109375
95,5,15,12021,32768,-20747,-63.3148193359375
95,6,1,0,2,-2,-100.0
95,6,2,2,4,-2,-50.0
95,6,3,7,8,-1,-12.5
95,6,4,7,16,-9,-56.25
95,6,5,18,32,-14,-43.75
95,6,6,175,64,111,173.4375
95,6,7,85,128,-43,-33.59375
95,6,8,350,256,94,36.71875
95,6,9,74,512,-438,-85.546875
95,6,10,358,1024,-666,-65.0390625
95,6,11,585,2048,-1463,-71.435546875
95,6,12,5786,4096,1690,41.259765625
95,6,13,5500,8192,-2692,-32.861328125
95,6,14,5653,16384,-10731,-65.496826171875
95,6,15,28808,32768,-3960,-12.0849609375
95,7,1,0,2,-2,-100.0
95,7,2,1,4,-3,-75.0
95,7,3,12,8,4,50.0
95,7,4,16,16,0,0.0
95,7,5,52,32,20,62.5
95,7,6,27,64,-37,-57.8125
95,7,7,6,128,-122,-95.3125
95,7,8,447,256,191,74.609375
95,7,9,17,512,-495,-96.6796875
95,7,10,2521,1024,1497,146.19140625
95,7,11,4327,2048,2279,111.279296875
95,7,12,4621,4096,525,12.8173828125
95,7,13,1626,8192,-6566,-80.1513671875
95,7,14,33606,16384,17222,105.11474609375
95,7,15,104956,32768,72188,220.30029296875
95,8,1,0,2,-2,-100.0
95,8,2,1,4,-3,-75.0
95,8,3,9,8,1,12.5
95,8,4,3,16,-13,-81.25
95,8,5,4,32,-28,-87.5
95,8,6,9,64,-55,-85.9375
95,8,7,155,128,27,21.09375
95,8,8,276,256,20,7.8125
95,8,9,516,512,4,0.78125
95,8,10,1183,1024,159,15.52734375
95,8,11,3809,2048,1761,85.986328125
95,8,12,5024,4096,928,22.65625
95,8,13,39,8192,-8153,-99.52392578125
95,8,14,99006,16384,82622,504.28466796875
95,8,15,25292,32768,-7476,-22.81494140625
95,9,1,0,2,-2,-100.0
95,9,2,1,4,-3,-75.0
95,9,3,5,8,-3,-37.5
95,9,4,3,16,-13,-81.25
95,9,5,140,32,108,337.5
95,9,6,38,64,-26,-40.625
95,9,7,31,128,-97,-75.78125
95,9,8,341,256,85,33.203125
95,9,9,322,512,-190,-37.109375
95,9,10,25,1024,-999,-97.55859375
95,9,11,4287,2048,2239,109.326171875
95,9,12,951,4096,-3145,-76.7822265625
95,9,13,21624,8192,13432,163.96484375
95,9,14,18577,16384,2193,13.385009765625
95,9,15,5868,32768,-26900,-82.09228515625
95,10,1,0,2,-2,-100.0
95,10,2,7,4,3,75.0
95,10,3,2,8,-6,-75.0
95,10,4,7,16,-9,-56.25
95,10,5,11,32,-21,-65.625
95,10,6,15,64,-49,-76.5625
95,10,7,279,128,151,117.96875
95,10,8,131,256,-125,-48.828125
95,10,9,19,512,-493,-96.2890625
95,10,10,584,1024,-440,-42.96875
95,10,11,988,2048,-1060,-51.7578125
95,10,12,15527,4096,11431,279.0771484375
95,10,13,12052,8192,3860,47.119140625
95,10,14,6863,16384,-9521,-58.111572265625
95,10,15,10961,32768,-21807,-66.5496826171875
95,11,1,0,2,-2,-100.0
95,11,2,4,4,0,0.0
95,11,3,9,8,1,12.5
95,11,4,8,16,-8,-50.0
95,11,5,7,32,-25,-78.125
95,11,6,6,64,-58,-90.625
95,11,7,25,128,-103,-80.46875
95,11,8,67,256,-189,-73.828125
95,11,9,427,512,-85,-16.6015625
95,11,10,1528,1024,504,49.21875
95,11,11,2990,2048,942,45.99609375
95,11,12,637,4096,-3459,-84.4482421875
95,11,13,14441,8192,6249,76.28173828125
95,11,14,1079,16384,-15305,-93.414306640625
95,11,15,36380,32768,3612,11.02294921875
95,12,1,0,2,-2,-100.0
95,12,2,1,4,-3,-75.0
95,12,3,7,8,-1,-12.5
95,12,4,11,16,-5,-31.25
95,12,5,5,32,-27,-84.375
95,12,6,88,64,24,37.5
95,12,7,109,128,-19,-14.84375
95,12,8,231,256,-25,-9.765625
95,12,9,129,512,-383,-74.8046875
95,12,10,77,1024,-947,-92.48046875
95,12,11,2916,2048,868,42.3828125
95,12,12,281,4096,-3815,-93.1396484375
95,12,13,2704,8192,-5488,-66.9921875
95,12,14,14996,16384,-1388,-8.4716796875
95,12,15,7041,32768,-25727,-78.5125732421875
95,13,1,0,2,-2,-100.0
95,13,2,1,4,-3,-75.0
95,13,3,8,8,0,0.0
95,13,4,3,16,-13,-81.25
95,13,5,49,32,17,53.125
95,13,6,20,64,-44,-68.75
95,13,7,107,128,-21,-16.40625
95,13,8,212,256,-44,-17.1875
95,13,9,567,512,55,10.7421875
95,13,10,785,1024,-239,-23.33984375
95,13,11,3831,2048,1783,87.060546875
95,13,12,603,4096,-3493,-85.2783203125
95,13,13,1170,8192,-7022,-85.7177734375
95,13,14,12452,16384,-3932,-23.9990234375
95,13,15,11178,32768,-21590,-65.887451171875
95,14,1,0,2,-2,-100.0
95,14,2,3,4,-1,-25.0
95,14,3,2,8,-6,-75.0
95,14,4,19,16,3,18.75
95,14,5,25,32,-7,-21.875
95,14,6,205,64,141,220.3125
95,14,7,128,128,0,0.0
95,14,8,38,256,-218,-85.15625
95,14,9,1132,512,620,121.09375
95,14,10,250,1024,-774,-75.5859375
95,14,11,3683,2048,1635,79.833984375
95,14,12,5017,4096,921,22.4853515625
95,14,13,1467,8192,-6725,-82.09228515625
95,14,14,29922,16384,13538,82.62939453125
95,14,15,2184,32768,-30584,-93.3349609375
95,15,1,0,2,-2,-100.0
95,15,2,6,4,2,50.0
95,15,3,7,8,-1,-12.5
95,15,4,5,16,-11,-68.75
95,15,5,87,32,55,171.875
95,15,6,5,64,-59,-92.1875
95,15,7,41,128,-87,-67.96875
95,15,8,7,256,-249,-97.265625
95,15,9,102,512,-410,-80.078125
95,15,10,388,1024,-636,-62.109375
95,15,11,1152,2048,-896,-43.75
95,15,12,1206,4096,-2890,-70.556640625
95,15,13,16876,8192,8684,106.005859375
95,15,14,30965,16384,14581,88.995361328125
95,15,15,67353,32768,34585,105.5450439453125
95,16,1,0,2,-2,-100.0
95,16,2,1,4,-3,-75.0
95,16,3,27,8,19,237.5
95,16,4,28,16,12,75.0
95,16,5,8,32,-24,-75.0
95,16,6,17,64,-47,-73.4375
95,16,7,227,128,99,77.34375
95,16,8,26,256,-230,-89.84375
95,16,9,435,512,-77,-15.0390625
95,16,10,1875,1024,851,83.10546875
95,16,11,888,2048,-1160,-56.640625
95,16,12,3469,4096,-627,-15.3076171875
95,16,13,5675,8192,-2517,-30.72509765625
95,16,14,3600,16384,-12784,-78.02734375
95,16,15,17133,32768,-15635,-47.7142333984375
95,17,1,0,2,-2,-100.0
95,17,2,6,4,2,50.0
95,17,3,3,8,-5,-62.5
95,17,4,11,16,-5,-31.25
95,17,5,31,32,-1,-3.125
95,17,6,13,64,-51,-79.6875
95,17,7,43,128,-85,-66.40625
95,17,8,487,256,231,90.234375
95,17,9,288,512,-224,-43.75
95,17,10,821,1024,-203,-19.82421875
95,17,11,2199,2048,151,7.373046875
95,17,12,6876,4096,2780,67.87109375
95,17,13,4639,8192,-3553,-43.37158203125
95,17,14,52788,16384,36404,222.1923828125
95,17,15,17928,32768,-14840,-45.2880859375
95,18,1,0,2,-2,-100.0
95,18,2,1,4,-3,-75.0
95,18,3,3,8,-5,-62.5
95,18,4,7,16,-9,-56.25
95,18,5,117,32,85,265.625
95,18,6,47,64,-17,-26.5625
95,18,7,56,128,-72,-56.25
95,18,8,51,256,-205,-80.078125
95,18,9,310,512,-202,-39.453125
95,18,10,995,1024,-29,-2.83203125
95,18,11,3208,2048,1160,56.640625
95,18,12,7758,4096,3662,89.404296875
95,18,13,8072,8192,-120,-1.46484375
95,18,14,31724,16384,15340,93.6279296875
95,18,15,1816,32768,-30952,-94.4580078125
95,19,1,0,2,-2,-100.0
95,19,2,1,4,-3,-75.0
95,19,3,7,8,-1,-12.5
95,19,4,23,16,7,43.75
95,19,5,29,32,-3,-9.375
95,19,6,12,64,-52,-81.25
95,19,7,37,128,-91,-71.09375
95,19,8,364,256,108,42.1875
95,19,9,562,512,50,9.765625
95,19,10,1088,1024,64,6.25
95,19,11,926,2048,-1122,-54.78515625
95,19,12,189,4096,-3907,-95.3857421875
95,19,13,4615,8192,-3577,-43.66455078125
95,19,14,2536,16384,-13848,-84.521484375
95,19,15,91611,32768,58843,179.5745849609375
95,20,1,0,2,-2,-100.0
95,20,2,3,4,-1,-25.0
95,20,3,2,8,-6,-75.0
95,20,4,40,16,24,150.0
95,20,5,46,32,14,43.75
95,20,6,50,64,-14,-21.875
95,20,7,36,128,-92,-71.875
95,20,8,16,256,-240,-93.75
95,20,9,785,512,273,53.3203125
95,20,10,1081,1024,57,5.56640625
95,20,11,7952,2048,5904,288.28125
95,20,12,13584,4096,9488,231.640625
95,20,13,15801,8192,7609,92.88330078125
95,20,14,299,16384,-16085,-98.175048828125
95,20,15,28418,32768,-4350,-13.275146484375
95,21,1,0,2,-2,-100.0
95,21,2,7,4,3,75.0
95,21,3,8,8,0,0.0
95,21,4,10,16,-6,-37.5
95,21,5,11,32,-21,-65.625
95,21,6,7,64,-57,-89.0625
95,21,7,425,128,297,232.03125
95,21,8,22,256,-234,-91.40625
95,21,9,583,512,71,13.8671875
95,21,10,918,1024,-106,-10.3515625
95,21,11,532,2048,-1516,-74.0234375
95,21,12,6576,4096,2480,60.546875
95,21,13,1626,8192,-6566,-80.1513671875
95,21,14,6323,16384,-10061,-61.407470703125
95,21,15,46603,32768,13835,42.2210693359375
95,22,1,0,2,-2,-100.0
95,22,2,3,4,-1,-25.0
95,22,3,6,8,-2,-25.0
95,22,4,8,16,-8,-50.0
95,22,5,48,32,16,50.0
95,22,6,74,64,10,15.625
95,22,7,39,128,-89,-69.53125
95,22,8,155,256,-101,-39.453125
95,22,9,914,512,402,78.515625
95,22,10,24,1024,-1000,-97.65625
95,22,11,1072,2048,-976,-47.65625
95,22,12,8267,4096,4171,101.8310546875
95,22,13,10896,8192,2704,33.0078125
95,22,14,4227,16384,-12157,-74.200439453125
95,22,15,22062,32768,-10706,-32.672119140625
95,23,1,0,2,-2,-100.0
95,23,2,1,4,-3,-75.0
95,23,3,8,8,0,0.0
95,23,4,5,16,-11,-68.75
95,23,5,16,32,-16,-50.0
95,23,6,17,64,-47,-73.4375
95,23,7,121,128,-7,-5.46875
95,23,8,36,256,-220,-85.9375
95,23,9,50,512,-462,-90.234375
95,23,10,802,1024,-222,-21.6796875
95,23,11,3771,2048,1723,84.130859375
95,23,12,3800,4096,-296,-7.2265625
95,23,13,3173,8192,-5019,-61.26708984375
95,23,14,3769,16384,-12615,-76.995849609375
95,23,15,9308,32768,-23460,-71.59423828125
95,24,1,0,2,-2,-100.0
95,24,2,3,4,-1,-25.0
95,24,3,4,8,-4,-50.0
95,24,4,12,16,-4,-25.0
95,24,5,12,32,-20,-62.5
95,24,6,83,64,19,29.6875
95,24,7,29,128,-99,-77.34375
95,24,8,492,256,236,92.1875
95,24,9,796,512,284,55.46875
95,24,10,47,1024,-977,-95.41015625
95,24,11,4711,2048,2663,130.029296875
95,24,12,11859,4096,7763,189.5263671875
95,24,13,1721,8192,-6471,-78.99169921875
95,24,14,2136,16384,-14248,-86.962890625
95,24,15,25594,32768,-7174,-21.893310546875
95,25,1,0,2,-2,-100.0
95,25,2,3,4,-1,-25.0
95,25,3,2,8,-6,-75.0
95,25,4,22,16,6,37.5
95,25,5,39,32,7,21.875
95,25,6,56,64,-8,-12.5
95,25,7,282,128,154,120.3125
95,25,8,82,256,-174,-67.96875
95,25,9,316,512,-196,-38.28125
95,25,10,431,1024,-593,-57.91015625
95,25,11,1707,2048,-341,-16.650390625
95,25,12,5477,4096,1381,33.7158203125
95,25,13,7041,8192,-1151,-14.05029296875
95,25,14,26402,16384,10018,61.14501953125
95,25,15,19851,32768,-12917,-39.4195556640625
95,26,1,0,2,-2,-100.0
95,26,2,1,4,-3,-75.0
95,26,3,3,8,-5,-62.5
95,26,4,21,16,5,31.25
95,26,5,25,32,-7,-21.875
95,26,6,31,64,-33,-51.5625
95,26,7,77,128,-51,-39.84375
95,26,8,306,256,50,19.53125
95,26,9,1395,512,883,172.4609375
95,26,10,926,1024,-98,-9.5703125
95,26,11,3306,2048,1258,61.42578125
95,26,12,1530,4096,-2566,-62.646484375
95,26,13,2917,8192,-5275,-64.39208984375
95,26,14,3911,16384,-12473,-76.129150390625
95,26,15,26072,32768,-6696,-20.4345703125
95,27,1,0,2,-2,-100.0
95,27,2,3,4,-1,-25.0
95,27,3,6,8,-2,-25.0
95,27,4,42,16,26,162.5
95,27,5,10,32,-22,-68.75
95,27,6,32,64,-32,-50.0
95,27,7,112,128,-16,-12.5
95,27,8,1060,256,804,314.0625
95,27,9,35,512,-477,-93.1640625
95,27,10,649,1024,-375,-36.62109375
95,27,11,455,2048,-1593,-77.783203125
95,27,12,1924,4096,-2172,-53.02734375
95,27,13,965,8192,-7227,-88.22021484375
95,27,14,5707,16384,-10677,-65.167236328125
95,27,15,21519,32768,-11249,-34.3292236328125
95,28,1,0,2,-2,-100.0
95,28,2,1,4,-3,-75.0
95,28,3,2,8,-6,-75.0
95,28,4,36,16,20,125.0
95,28,5,25,32,-7,-21.875
95,28,6,101,64,37,57.8125
95,28,7,196,128,68,53.125
95,28,8,446,256,190,74.21875
95,28,9,360,512,-152,-29.6875
95,28,10,1310,1024,286,27.9296875
95,28,11,2824,2048,776,37.890625
95,28,12,2857,4096,-1239,-30.2490234375
95,28,13,24628,8192,16436,200.634765625
95,28,14,4940,16384,-11444,-69.8486328125
95,28,15,91977,32768,59209,180.6915283203125
95,29,1,0,2,-2,-100.0
95,29,2,4,4,0,0.0
95,29,3,14,8,6,75.0
95,29,4,5,16,-11,-68.75
95,29,5,108,32,76,237.5
95,29,6,150,64,86,134.375
95,29,7,23,128,-105,-82.03125
95,29,8,182,256,-74,-28.90625
95,29,9,42,512,-470,-91.796875
95,29,10,99,1024,-925,-90.33203125
95,29,11,491,2048,-1557,-76.025390625
95,29,12,38,4096,-4058,-99.072265625
95,29,13,6172,8192,-2020,-24.658203125
95,29,14,42374,16384,25990,158.63037109375
95,29,15,70200,32768,37432,114.2333984375
95,30,1,0,2,-2,-100.0
95,30,2,1,4,-3,-75.0
95,30,3,6,8,-2,-25.0
95,30,4,46,16,30,187.5
95,30,5,4,32,-28,-87.5
95,30,6,17,64,-47,-73.4375
95,30,7,223,128,95,74.21875
95,30,8,159,256,-97,-37.890625
95,30,9,964,512,452,88.28125
95,30,10,407,1024,-617,-60.25390625
95,30,11,852,2048,-1196,-58.3984375
95,30,12,10153,4096,6057,147.8759765625
95,30,13,10366,8192,2174,26.5380859375
95,30,14,21407,16384,5023,30.657958984375
95,30,15,4404,32768,-28364,-86.56005859375
95,31,1,0,2,-2,-100.0
95,31,2,1,4,-3,-75.0
95,31,3,14,8,6,75.0
95,31,4,3,16,-13,-81.25
95,31,5,5,32,-27,-84.375
95,31,6,63,64,-1,-1.5625
95,31,7,101,128,-27,-21.09375
95,31,8,677,256,421,164.453125
95,31,9,69,512,-443,-86.5234375
95,31,10,675,1024,-349,-34.08203125
95,31,11,3131,2048,1083,52.880859375
95,31,12,195,4096,-3901,-95.2392578125
95,31,13,22328,8192,14136,172.55859375
95,31,14,19024,16384,2640,16.11328125
95,31,15,25884,32768,-6884,-21.00830078125
95,32,1,0,2,-2,-100.0
95,32,2,1,4,-3,-75.0
95,32,3,3,8,-5,-62.5
95,32,4,10,16,-6,-37.5
95,32,5,51,32,19,59.375
95,32,6,113,64,49,76.5625
95,32,7,30,128,-98,-76.5625
95,32,8,20,256,-236,-92.1875
95,32,9,728,512,216,42.1875
95,32,10,229,1024,-795,-77.63671875
95,32,11,1151,2048,-897,-43.798828125
95,32,12,1231,4096,-2865,-69.9462890625
95,32,13,5962,8192,-2230,-27.2216796875
95,32,14,53711,16384,37327,227.825927734375
95,32,15,63213,32768,30445,92.9107666015625
95,33,1,0,2,-2,-100.0
95,33,2,2,4,-2,-50.0
95,33,3,4,8,-4,-50.0
95,33,4,16,16,0,0.0
95,33,5,71,32,39,121.875
95,33,6,58,64,-6,-9.375
95,33,7,48,128,-80,-62.5
95,33,8,82,256,-174,-67.96875
95,33,9,113,512,-399,-77.9296875
95,33,10,2604,1024,1580,154.296875
95,33,11,780,2048,-1268,-61.9140625
95,33,12,5186,4096,1090,26.611328125
95,33,13,5430,8192,-2762,-33.7158203125
95,33,14,26775,16384,10391,63.421630859375
95,33,15,69460,32768,36692,111.97509765625
95,34,1,0,2,-2,-100.0
95,34,2,3,4,-1,-25.0
95,34,3,3,8,-5,-62.5
95,34,4,6,16,-10,-62.5
95,34,5,5,32,-27,-84.375
95,34,6,28,64,-36,-56.25
95,34,7,174,128,46,35.9375
95,34,8,137,256,-119,-46.484375
95,34,9,1070,512,558,108.984375
95,34,10,2163,1024,1139,111.23046875
95,34,11,2866,2048,818,39.94140625
95,34,12,4718,4096,622,15.185546875
95,34,13,6964,8192,-1228,-14.990234375
95,34,14,20627,16384,4243,25.897216796875
95,34,15,7451,32768,-25317,-77.2613525390625
95,35,1,0,2,-2,-100.0
95,35,2,1,4,-3,-75.0
95,35,3,3,8,-5,-62.5
95,35,4,4,16,-12,-75.0
95,35,5,115,32,83,259.375
95,35,6,36,64,-28,-43.75
95,35,7,74,128,-54,-42.1875
95,35,8,198,256,-58,-22.65625
95,35,9,691,512,179,34.9609375
95,35,10,3890,1024,2866,279.8828125
95,35,11,2261,2048,213,10.400390625
95,35,12,4611,4096,515,12.5732421875
95,35,13,28068,8192,19876,242.626953125
95,35,14,3027,16384,-13357,-81.524658203125
95,35,15,65973,32768,33205,101.3336181640625
95,36,1,0,2,-2,-100.0
95,36,2,3,4,-1,-25.0
95,36,3,15,8,7,87.5
95,36,4,6,16,-10,-62.5
95,36,5,12,32,-20,-62.5
95,36,6,186,64,122,190.625
95,36,7,106,128,-22,-17.1875
95,36,8,39,256,-217,-84.765625
95,36,9,59,512,-453,-88.4765625
95,36,10,2262,1024,1238,120.8984375
95,36,11,1080,2048,-968,-47.265625
95,36,12,666,4096,-3430,-83.740234375
95,36,13,1770,8192,-6422,-78.3935546875
95,36,14,2244,16384,-14140,-86.3037109375
95,36,15,14008,32768,-18760,-57.2509765625
95,37,1,0,2,-2,-100.0
95,37,2,1,4,-3,-75.0
95,37,3,2,8,-6,-75.0
95,37,4,20,16,4,25.0
95,37,5,18,32,-14,-43.75
95,37,6,52,64,-12,-18.75
95,37,7,7,128,-121,-94.53125
95,37,8,22,256,-234,-91.40625
95,37,9,809,512,297,58.0078125
95,37,10,462,1024,-562,-54.8828125
95,37,11,2900,2048,852,41.6015625
95,37,12,3935,4096,-161,-3.9306640625
95,37,13,2190,8192,-6002,-73.2666015625
95,37,14,12539,16384,-3845,-23.468017578125
95,37,15,23431,32768,-9337,-28.4942626953125
95,38,1,0,2,-2,-100.0
95,38,2,2,4,-2,-50.0
95,38,3,17,8,9,112.5
95,38,4,44,16,28,175.0
95,38,5,5,32,-27,-84.375
95,38,6,189,64,125,195.3125
95,38,7,237,128,109,85.15625
95,38,8,549,256,293,114.453125
95,38,9,530,512,18,3.515625
95,38,10,173,1024,-851,-83.10546875
95,38,11,1557,2048,-491,-23.974609375
95,38,12,4496,4096,400,9.765625
95,38,13,1694,8192,-6498,-79.3212890625
95,38,14,13607,16384,-2777,-16.949462890625
95,38,15,34990,32768,2222,6.781005859375
95,39,1,0,2,-2,-100.0
95,39,2,1,4,-3,-75.0
95,39,3,3,8,-5,-62.5
95,39,4,7,16,-9,-56.25
95,39,5,138,32,106,331.25
95,39,6,17,64,-47,-73.4375
95,39,7,144,128,16,12.5
95,39,8,359,256,103,40.234375
95,39,9,385,512,-127,-24.8046875
95,39,10,1399,1024,375,36.62109375
95,39,11,2561,2048,513,25.048828125
95,39,12,382,4096,-3714,-90.673828125
95,39,13,6066,8192,-2126,-25.9521484375
95,39,14,2137,16384,-14247,-86.956787109375
95,39,15,56766,32768,23998,73.236083984375
95,40,1,0,2,-2,-100.0
95,40,2,2,4,-2,-50.0
95,40,3,12,8,4,50.0
95,40,4,6,16,-10,-62.5
95,40,5,20,32,-12,-37.5
95,40,6,14,64,-50,-78.125
95,40,7,245,128,117,91.40625
95,40,8,158,256,-98,-38.28125
95,40,9,115,512,-397,-77.5390625
95,40,10,2199,1024,1175,114.74609375
95,40,11,1057,2048,-991,-48.388671875
95,40,12,3003,4096,-1093,-26.6845703125
95,40,13,6133,8192,-2059,-25.13427734375
95,40,14,2716,16384,-13668,-83.4228515625
95,40,15,2606,32768,-30162,-92.047119140625
95,41,1,0,2,-2,-100.0
95,41,2,1,4,-3,-75.0
95,41,3,5,8,-3,-37.5
95,41,4,11,16,-5,-31.25
95,41,5,20,32,-12,-37.5
95,41,6,53,64,-11,-17.1875
95,41,7,32,128,-96,-75.0
95,41,8,71,256,-185,-72.265625
95,41,9,2069,512,1557,304.1015625
95,41,10,1021,1024,-3,-0.29296875
95,41,11,555,2048,-1493,-72.900390625
95,41,12,11351,4096,7255,177.1240234375
95,41,13,10598,8192,2406,29.3701171875
95,41,14,4805,16384,-11579,-70.672607421875
95,41,15,45725,32768,12957,39.5416259765625
95,42,1,0,2,-2,-100.0
95,42,2,1,4,-3,-75.0
95,42,3,3,8,-5,-62.5
95,42,4,5,16,-11,-68.75
95,42,5,27,32,-5,-15.625
95,42,6,12,64,-52,-81.25
95,42,7,206,128,78,60.9375
95,42,8,179,256,-77,-30.078125
95,42,9,94,512,-418,-81.640625
95,42,10,614,1024,-410,-40.0390625
95,42,11,423,2048,-1625,-79.345703125
95,42,12,5136,4096,1040,25.390625
95,42,13,1168,8192,-7024,-85.7421875
95,42,14,4832,16384,-11552,-70.5078125
95,42,15,26255,32768,-6513,-19.8760986328125
95,43,1,0,2,-2,-100.0
95,43,2,1,4,-3,-75.0
95,43,3,12,8,4,50.0
95,43,4,24,16,8,50.0
95,43,5,7,32,-25,-78.125
95,43,6,28,64,-36,-56.25
95,43,7,221,128,93,72.65625
95,43,8,865,256,609,237.890625
95,43,9,147,512,-365,-71.2890625
95,43,10,86,1024,-938,-91.6015625
95,43,11,1006,2048,-1042,-50.87890625
95,43,12,2932,4096,-1164,-28.41796875
95,43,13,8327,8192,135,1.64794921875
95,43,14,11432,16384,-4952,-30.224609375
95,43,15,105141,32768,72373,220.8648681640625
95,44,1,0,2,-2,-100.0
95,44,2,2,4,-2,-50.0
95,44,3,5,8,-3,-37.5
95,44,4,31,16,15,93.75
95,44,5,16,32,-16,-50.0
95,44,6,36,64,-28,-43.75
95,44,7,182,128,54,42.1875
95,44,8,92,256,-164,-64.0625
95,44,9,170,512,-342,-66.796875
95,44,10,165,1024,-859,-83.88671875
95,44,11,298,2048,-1750,-85.44921875
95,44,12,2657,4096,-1439,-35.1318359375
95,44,13,1815,8192,-6377,-77.84423828125
95,44,14,5489,16384,-10895,-66.497802734375
95,44,15,203,32768,-32565,-99.3804931640625
95,45,1,0,2,-2,-100.0
95,45,2,2,4,-2,-50.0
95,45,3,3,8,-5,-62.5
95,45,4,16,16,0,0.0
95,45,5,13,32,-19,-59.375
95,45,6,15,64,-49,-76.5625
95,45,7,143,128,15,11.71875
95,45,8,137,256,-119,-46.484375
95,45,9,90,512,-422,-82.421875
95,45,10,93,1024,-931,-90.91796875
95,45,11,498,2048,-1550,-75.68359375
95,45,12,4584,4096,488,11.9140625
95,45,13,767,8192,-7425,-90.63720703125
95,45,14,5346,16384,-11038,-67.37060546875
95,45,15,35176,32768,2408,7.3486328125
95,46,1,0,2,-2,-100.0
95,46,2,1,4,-3,-75.0
95,46,3,7,8,-1,-12.5
95,46,4,28,16,12,75.0
95,46,5,21,32,-11,-34.375
95,46,6,6,64,-58,-90.625
95,46,7,66,128,-62,-48.4375
95,46,8,393,256,137,53.515625
95,46,9,162,512,-350,-68.359375
95,46,10,4288,1024,3264,318.75
95,46,11,1852,2048,-196,-9.5703125
95,46,12,2939,4096,-1157,-28.2470703125
95,46,13,9330,8192,1138,13.8916015625
95,46,14,3979,16384,-12405,-75.714111328125
95,46,15,11296,32768,-21472,-65.52734375
95,47,1,0,2,-2,-100.0
95,47,2,1,4,-3,-75.0
95,47,3,4,8,-4,-50.0
95,47,4,6,16,-10,-62.5
95,47,5,24,32,-8,-25.0
95,47,6,68,64,4,6.25
95,47,7,19,128,-109,-85.15625
95,47,8,236,256,-20,-7.8125
95,47,9,772,512,260,50.78125
95,47,10,1851,1024,827,80.76171875
95,47,11,244,2048,-1804,-88.0859375
95,47,12,769,4096,-3327,-81.2255859375
95,47,13,5953,8192,-2239,-27.33154296875
95,47,14,33112,16384,16728,102.099609375
95,47,15,39529,32768,6761,20.6329345703125
95,48,1,0,2,-2,-100.0
95,48,2,1,4,-3,-75.0
95,48,3,10,8,2,25.0
95,48,4,6,16,-10,-62.5
95,48,5,103,32,71,221.875
95,48,6,7,64,-57,-89.0625
95,48,7,45,128,-83,-64.84375
95,48,8,83,256,-173,-67.578125
95,48,9,1408,512,896,175.0
95,48,10,1267,1024,243,23.73046875
95,48,11,492,2048,-1556,-75.9765625
95,48,12,5913,4096,1817,44.3603515625
95,48,13,764,8192,-7428,-90.673828125
95,48,14,13175,16384,-3209,-19.586181640625
95,48,15,68037,32768,35269,107.6324462890625
95,49,1,0,2,-2,-100.0
95,49,2,3,4,-1,-25.0
95,49,3,7,8,-1,-12.5
95,49,4,11,16,-5,-31.25
95,49,5,84,32,52,162.5
95,49,6,48,64,-16,-25.0
95,49,7,176,128,48,37.5
95,49,8,77,256,-179,-69.921875
95,49,9,241,512,-271,-52.9296875
95,49,10,2267,1024,1243,121.38671875
95,49,11,1548,2048,-500,-24.4140625
95,49,12,4762,4096,666,16.259765625
95,49,13,8901,8192,709,8.65478515625
95,49,14,29226,16384,12842,78.38134765625
95,49,15,8615,32768,-24153,-73.7091064453125
95,50,1,0,2,-2,-100.0
95,50,2,3,4,-1,-25.0
95,50,3,2,8,-6,-75.0
95,50,4,22,16,6,37.5
95,50,5,12,32,-20,-62.5
95,50,6,159,64,95,148.4375
95,50,7,448,128,320,250.0
95,50,8,210,256,-46,-17.96875
95,50,9,464,512,-48,-9.375
95,50,10,637,1024,-387,-37.79296875
95,50,11,2078,2048,30,1.46484375
95,50,12,14524,4096,10428,254.58984375
95,50,13,1902,8192,-6290,-76.7822265625
95,50,14,5180,16384,-11204,-68.3837890625
95,50,15,5429,32768,-27339,-83.4320068359375
95,51,1,0,2,-2,-100.0
95,51,2,3,4,-1,-25.0
95,51,3,11,8,3,37.5
95,51,4,27,16,11,68.75
95,51,5,39,32,7,21.875
95,51,6,26,64,-38,-59.375
95,51,7,68,128,-60,-46.875
95,51,8,27,256,-229,-89.453125
95,51,9,382,512,-130,-25.390625
95,51,10,404,1024,-620,-60.546875
95,51,11,1006,2048,-1042,-50.87890625
95,51,12,6758,4096,2662,64.990234375
95,51,13,4846,8192,-3346,-40.8447265625
95,51,14,3415,16384,-12969,-79.156494140625
95,51,15,129628,32768,96860,295.59326171875
95,52,1,0,2,-2,-100.0
95,52,2,2,4,-2,-50.0
95,52,3,2,8,-6,-75.0
95,52,4,17,16,1,6.25
95,52,5,38,32,6,18.75
95,52,6,34,64,-30,-46.875
95,52,7,19,128,-109,-85.15625
95,52,8,869,256,613,239.453125
95,52,9,832,512,320,62.5
95,52,10,2325,1024,1301,127.05078125
95,52,11,1269,2048,-779,-38.037109375
95,52,12,9780,4096,5684,138.76953125
95,52,13,5649,8192,-2543,-31.04248046875
95,52,14,5484,16384,-10900,-66.5283203125
95,52,15,47068,32768,14300,43.64013671875
95,53,1,0,2,-2,-100.0
95,53,2,1,4,-3,-75.0
95,53,3,2,8,-6,-75.0
95,53,4,17,16,1,6.25
95,53,5,7,32,-25,-78.125
95,53,6,24,64,-40,-62.5
95,53,7,144,128,16,12.5
95,53,8,52,256,-204,-79.6875
95,53,9,164,512,-348,-67.96875
95,53,10,455,1024,-569,-55.56640625
95,53,11,653,2048,-1395,-68.115234375
95,53,12,624,4096,-3472,-84.765625
95,53,13,31546,8192,23354,285.0830078125
95,53,14,4260,16384,-12124,-73.9990234375
95,53,15,79353,32768,46585,142.1661376953125
95,54,1,0,2,-2,-100.0
95,54,2,1,4,-3,-75.0
95,54,3,4,8,-4,-50.0
95,54,4,14,16,-2,-12.5
95,54,5,11,32,-21,-65.625
95,54,6,45,64,-19,-29.6875
95,54,7,213,128,85,66.40625
95,54,8,166,256,-90,-35.15625
95,54,9,463,512,-49,-9.5703125
95,54,10,2235,1024,1211,118.26171875
95,54,11,1180,2048,-868,-42.3828125
95,54,12,1590,4096,-2506,-61.181640625
95,54,13,777,8192,-7415,-90.51513671875
95,54,14,7901,16384,-8483,-51.776123046875
95,54,15,133066,32768,100298,306.085205078125
95,55,1,0,2,-2,-100.0
95,55,2,1,4,-3,-75.0
95,55,3,4,8,-4,-50.0
95,55,4,12,16,-4,-25.0
95,55,5,25,32,-7,-21.875
95,55,6,30,64,-34,-53.125
95,55,7,143,128,15,11.71875
95,55,8,238,256,-18,-7.03125
95,55,9,734,512,222,43.359375
95,55,10,1166,1024,142,13.8671875
95,55,11,1730,2048,-318,-15.52734375
95,55,12,11422,4096,7326,178.857421875
95,55,13,9764,8192,1572,19.189453125
95,55,14,32679,16384,16295,99.456787109375
95,55,15,41026,32768,8258,25.201416015625
95,56,1,0,2,-2,-100.0
95,56,2,1,4,-3,-75.0
95,56,3,2,8,-6,-75.0
95,56,4,8,16,-8,-50.0
95,56,5,53,32,21,65.625
95,56,6,125,64,61,95.3125
95,56,7,218,128,90,70.3125
95,56,8,326,256,70,27.34375
95,56,9,171,512,-341,-66.6015625
95,56,10,1485,1024,461,45.01953125
95,56,11,176,2048,-1872,-91.40625
95,56,12,6170,4096,2074,50.634765625
95,56,13,2890,8192,-5302,-64.7216796875
95,56,14,5097,16384,-11287,-68.890380859375
95,56,15,15005,32768,-17763,-54.2083740234375
95,57,1,0,2,-2,-100.0
95,57,2,1,4,-3,-75.0
95,57,3,6,8,-2,-25.0
95,57,4,5,16,-11,-68.75
95,57,5,26,32,-6,-18.75
95,57,6,39,64,-25,-39.0625
95,57,7,122,128,-6,-4.6875
95,57,8,245,256,-11,-4.296875
95,57,9,490,512,-22,-4.296875
95,57,10,556,1024,-468,-45.703125
95,57,11,2842,2048,794,38.76953125
95,57,12,2119,4096,-1977,-48.2666015625
95,57,13,2113,8192,-6079,-74.20654296875
95,57,14,15808,16384,-576,-3.515625
95,57,15,7596,32768,-25172,-76.81884765625
95,58,1,0,2,-2,-100.0
95,58,2,8,4,4,100.0
95,58,3,2,8,-6,-75.0
95,58,4,4,16,-12,-75.0
95,58,5,4,32,-28,-87.5
95,58,6,66,64,2,3.125
95,58,7,153,128,25,19.53125
95,58,8,62,256,-194,-75.78125
95,58,9,705,512,193,37.6953125
95,58,10,1624,1024,600,58.59375
95,58,11,1565,2048,-483,-23.583984375
95,58,12,3649,4096,-447,-10.9130859375
95,58,13,7579,8192,-613,-7.48291015625
95,58,14,1401,16384,-14983,-91.448974609375
95,58,15,30323,32768,-2445,-7.4615478515625
95,59,1,0,2,-2,-100.0
95,59,2,1,4,-3,-75.0
95,59,3,17,8,9,112.5
95,59,4,17,16,1,6.25
95,59,5,8,32,-24,-75.0
95,59,6,12,64,-52,-81.25
95,59,7,54,128,-74,-57.8125
95,59,8,81,256,-175,-68.359375
95,59,9,1030,512,518,101.171875
95,59,10,463,1024,-561,-54.78515625
95,59,11,2031,2048,-17,-0.830078125
95,59,12,2471,4096,-1625,-39.6728515625
95,59,13,5904,8192,-2288,-27.9296875
95,59,14,10517,16384,-5867,-35.809326171875
95,59,15,8065,32768,-24703,-75.3875732421875
95,60,1,0,2,-2,-100.0
95,60,2,1,4,-3,-75.0
95,60,3,2,8,-6,-75.0
95,60,4,3,16,-13,-81.25
95,60,5,19,32,-13,-40.625
95,60,6,26,64,-38,-59.375
95,60,7,144,128,16,12.5
95,60,8,361,256,105,41.015625
95,60,9,328,512,-184,-35.9375
95,60,10,534,1024,-490,-47.8515625
95,60,11,11290,2048,9242,451.26953125
95,60,12,1900,4096,-2196,-53.61328125
95,60,13,7467,8192,-725,-8.85009765625
95,60,14,1408,16384,-14976,-91.40625
95,60,15,11546,32768,-21222,-64.764404296875
95,61,1,0,2,-2,-100.0
95,61,2,1,4,-3,-75.0
95,61,3,7,8,-1,-12.5
95,61,4,9,16,-7,-43.75
95,61,5,8,32,-24,-75.0
95,61,6,152,64,88,137.5
95,61,7,250,128,122,95.3125
95,61,8,44,256,-212,-82.8125
95,61,9,506,512,-6,-1.171875
95,61,10,1002,1024,-22,-2.1484375
95,61,11,1113,2048,-935,-45.654296875
95,61,12,4798,4096,702,17.138671875
95,61,13,5942,8192,-2250,-27.4658203125
95,61,14,11247,16384,-5137,-31.353759765625
95,61,15,7007,32768,-25761,-78.6163330078125
95,62,1,0,2,-2,-100.0
95,62,2,1,4,-3,-75.0
95,62,3,5,8,-3,-37.5
95,62,4,3,16,-13,-81.25
95,62,5,30,32,-2,-6.25
95,62,6,300,64,236,368.75
95,62,7,27,128,-101,-78.90625
95,62,8,112,256,-144,-56.25
95,62,9,1562,512,1050,205.078125
95,62,10,2356,1024,1332,130.078125
95,62,11,747,2048,-1301,-63.525390625
95,62,12,5790,4096,1694,41.357421875
95,62,13,7545,8192,-647,-7.89794921875
95,62,14,16350,16384,-34,-0.20751953125
95,62,15,20283,32768,-12485,-38.1011962890625
95,63,1,0,2,-2,-100.0
95,63,2,3,4,-1,-25.0
95,63,3,4,8,-4,-50.0
95,63,4,8,16,-8,-50.0
95,63,5,41,32,9,28.125
95,63,6,196,64,132,206.25
95,63,7,45,128,-83,-64.84375
95,63,8,140,256,-116,-45.3125
95,63,9,627,512,115,22.4609375
95,63,10,501,1024,-523,-51.07421875
95,63,11,1487,2048,-561,-27.392578125
95,63,12,4249,4096,153,3.7353515625
95,63,13,17033,8192,8841,107.92236328125
95,63,14,7147,16384,-9237,-56.378173828125
95,63,15,73351,32768,40583,123.8494873046875
95,64,1,0,2,-2,-100.0
95,64,2,1,4,-3,-75.0
95,64,3,4,8,-4,-50.0
95,64,4,9,16,-7,-43.75
95,64,5,6,32,-26,-81.25
95,64,6,56,64,-8,-12.5
95,64,7,59,128,-69,-53.90625
95,64,8,163,256,-93,-36.328125
95,64,9,129,512,-383,-74.8046875
95,64,10,224,1024,-800,-78.125
95,64,11,1223,2048,-825,-40.283203125
95,64,12,4401,4096,305,7.4462890625
95,64,13,1240,8192,-6952,-84.86328125
95,64,14,906,16384,-15478,-94.47021484375
95,64,15,16865,32768,-15903,-48.5321044921875
95,65,1,0,2,-2,-100.0
95,65,2,3,4,-1,-25.0
95,65,3,10,8,2,25.0
95,65,4,15,16,-1,-6.25
95,65,5,16,32,-16,-50.0
95,65,6,223,64,159,248.4375
95,65,7,104,128,-24,-18.75
95,65,8,430,256,174,67.96875
95,65,9,1272,512,760,148.4375
95,65,10,1807,1024,783,76.46484375
95,65,11,133,2048,-1915,-93.505859375
95,65,12,2705,4096,-1391,-33.9599609375
95,65,13,8720,8192,528,6.4453125
95,65,14,3000,16384,-13384,-81.689453125
95,65,15,10303,32768,-22465,-68.5577392578125
95,66,1,0,2,-2,-100.0
95,66,2,1,4,-3,-75.0
95,66,3,9,8,1,12.5
95,66,4,24,16,8,50.0
95,66,5,103,32,71,221.875
95,66,6,29,64,-35,-54.6875
95,66,7,101,128,-27,-21.09375
95,66,8,64,256,-192,-75.0
95,66,9,1380,512,868,169.53125
95,66,10,720,1024,-304,-29.6875
95,66,11,2201,2048,153,7.470703125
95,66,12,2853,4096,-1243,-30.3466796875
95,66,13,438,8192,-7754,-94.6533203125
95,66,14,16016,16384,-368,-2.24609375
95,66,15,10108,32768,-22660,-69.15283203125
95,67,1,0,2,-2,-100.0
95,67,2,1,4,-3,-75.0
95,67,3,11,8,3,37.5
95,67,4,13,16,-3,-18.75
95,67,5,48,32,16,50.0
95,67,6,80,64,16,25.0
95,67,7,65,128,-63,-49.21875
95,67,8,285,256,29,11.328125
95,67,9,23,512,-489,-95.5078125
95,67,10,901,1024,-123,-12.01171875
95,67,11,4000,2048,1952,95.3125
95,67,12,2118,4096,-1978,-48.291015625
95,67,13,8219,8192,27,0.32958984375
95,67,14,7746,16384,-8638,-52.72216796875
95,67,15,2143,32768,-30625,-93.4600830078125
95,68,1,0,2,-2,-100.0
95,68,2,1,4,-3,-75.0
95,68,3,7,8,-1,-12.5
95,68,4,6,16,-10,-62.5
95,68,5,22,32,-10,-31.25
95,68,6,62,64,-2,-3.125
95,68,7,58,128,-70,-54.6875
95,68,8,68,256,-188,-73.4375
95,68,9,921,512,409,79.8828125
95,68,10,365,1024,-659,-64.35546875
95,68,11,226,2048,-1822,-88.96484375
95,68,12,5921,4096,1825,44.5556640625
95,68,13,20200,8192,12008,146.58203125
95,68,14,5373,16384,-11011,-67.205810546875
95,68,15,17853,32768,-14915,-45.5169677734375
95,69,1,0,2,-2,-100.0
95,69,2,1,4,-3,-75.0
95,69,3,2,8,-6,-75.0
95,69,4,5,16,-11,-68.75
95,69,5,26,32,-6,-18.75
95,69,6,12,64,-52,-81.25
95,69,7,185,128,57,44.53125
95,69,8,361,256,105,41.015625
95,69,9,103,512,-409,-79.8828125
95,69,10,626,1024,-398,-38.8671875
95,69,11,2228,2048,180,8.7890625
95,69,12,2019,4096,-2077,-50.7080078125
95,69,13,8643,8192,451,5.50537109375
95,69,14,4373,16384,-12011,-73.309326171875
95,69,15,55175,32768,22407,68.3807373046875
95,70,1,0,2,-2,-100.0
95,70,2,1,4,-3,-75.0
95,70,3,2,8,-6,-75.0
95,70,4,4,16,-12,-75.0
95,70,5,11,32,-21,-65.625
95,70,6,155,64,91,142.1875
95,70,7,50,128,-78,-60.9375
95,70,8,400,256,144,56.25
95,70,9,107,512,-405,-79.1015625
95,70,10,3141,1024,2117,206.73828125
95,70,11,9017,2048,6969,340.283203125
95,70,12,1889,4096,-2207,-53.8818359375
95,70,13,11303,8192,3111,37.97607421875
95,70,14,19719,16384,3335,20.355224609375
95,70,15,25467,32768,-7301,-22.2808837890625
95,71,1,0,2,-2,-100.0
95,71,2,2,4,-2,-50.0
95,71,3,9,8,1,12.5
95,71,4,4,16,-12,-75.0
95,71,5,4,32,-28,-87.5
95,71,6,12,64,-52,-81.25
95,71,7,35,128,-93,-72.65625
95,71,8,641,256,385,150.390625
95,71,9,726,512,214,41.796875
95,71,10,575,1024,-449,-43.84765625
95,71,11,2137,2048,89,4.345703125
95,71,12,5244,4096,1148,28.02734375
95,71,13,457,8192,-7735,-94.42138671875
95,71,14,35125,16384,18741,114.385986328125
95,71,15,35654,32768,2886,8.807373046875
95,72,1,0,2,-2,-100.0
95,72,2,1,4,-3,-75.0
95,72,3,17,8,9,112.5
95,72,4,10,16,-6,-37.5
95,72,5,21,32,-11,-34.375
95,72,6,62,64,-2,-3.125
95,72,7,6,128,-122,-95.3125
95,72,8,331,256,75,29.296875
95,72,9,908,512,396,77.34375
95,72,10,10,1024,-1014,-99.0234375
95,72,11,618,2048,-1430,-69.82421875
95,72,12,1141,4096,-2955,-72.1435546875
95,72,13,13677,8192,5485,66.95556640625
95,72,14,10136,16384,-6248,-38.134765625
95,72,15,42774,32768,10006,30.535888671875
95,73,1,0,2,-2,-100.0
95,73,2,1,4,-3,-75.0
95,73,3,7,8,-1,-12.5
95,73,4,9,16,-7,-43.75
95,73,5,61,32,29,90.625
95,73,6,115,64,51,79.6875
95,73,7,131,128,3,2.34375
95,73,8,158,256,-98,-38.28125
95,73,9,58,512,-454,-88.671875
95,73,10,670,1024,-354,-34.5703125
95,73,11,8537,2048,6489,316.845703125
95,73,12,4603,4096,507,12.3779296875
95,73,13,10401,8192,2209,26.96533203125
95,73,14,9271,16384,-7113,-43.414306640625
95,73,15,63400,32768,30632,93.4814453125
95,74,1,0,2,-2,-100.0
95,74,2,4,4,0,0.0
95,74,3,9,8,1,12.5
95,74,4,14,16,-2,-12.5
95,74,5,4,32,-28,-87.5
95,74,6,81,64,17,26.5625
95,74,7,305,128,177,138.28125
95,74,8,345,256,89,34.765625
95,74,9,36,512,-476,-92.96875
95,74,10,2062,1024,1038,101.3671875
95,74,11,219,2048,-1829,-89.306640625
95,74,12,11803,4096,7707,188.1591796875
95,74,13,2593,8192,-5599,-68.34716796875
95,74,14,28366,16384,11982,73.13232421875
95,74,15,2277,32768,-30491,-93.0511474609375
95,75,1,0,2,-2,-100.0
95,75,2,1,4,-3,-75.0
95,75,3,11,8,3,37.5
95,75,4,30,16,14,87.5
95,75,5,71,32,39,121.875
95,75,6,76,64,12,18.75
95,75,7,33,128,-95,-74.21875
95,75,8,569,256,313,122.265625
95,75,9,558,512,46,8.984375
95,75,10,1317,1024,293,28.61328125
95,75,11,1498,2048,-550,-26.85546875
95,75,12,5252,4096,1156,28.22265625
95,75,13,2532,8192,-5660,-69.091796875
95,75,14,9387,16384,-6997,-42.706298828125
95,75,15,162176,32768,129408,394.921875
95,76,1,0,2,-2,-100.0
95,76,2,2,4,-2,-50.0
95,76,3,3,8,-5,-62.5
95,76,4,16,16,0,0.0
95,76,5,30,32,-2,-6.25
95,76,6,17,64,-47,-73.4375
95,76,7,220,128,92,71.875
95,76,8,155,256,-101,-39.453125
95,76,9,100,512,-412,-80.46875
95,76,10,2600,1024,1576,153.90625
95,76,11,9795,2048,7747,378.271484375
95,76,12,1822,4096,-2274,-55.517578125
95,76,13,4333,8192,-3859,-47.10693359375
95,76,14,4321,16384,-12063,-73.626708984375
95,76,15,8705,32768,-24063,-73.4344482421875
95,77,1,0,2,-2,-100.0
95,77,2,1,4,-3,-75.0
95,77,3,8,8,0,0.0
95,77,4,32,16,16,100.0
95,77,5,19,32,-13,-40.625
95,77,6,14,64,-50,-78.125
95,77,7,328,128,200,156.25
95,77,8,85,256,-171,-66.796875
95,77,9,61,512,-451,-88.0859375
95,77,10,362,1024,-662,-64.6484375
95,77,11,2512,2048,464,22.65625
95,77,12,2479,4096,-1617,-39.4775390625
95,77,13,202,8192,-7990,-97.5341796875
95,77,14,53846,16384,37462,228.64990234375
95,77,15,83099,32768,50331,153.5980224609375
95,78,1,0,2,-2,-100.0
95,78,2,3,4,-1,-25.0
95,78,3,3,8,-5,-62.5
95,78,4,21,16,5,31.25
95,78,5,7,32,-25,-78.125
95,78,6,9,64,-55,-85.9375
95,78,7,75,128,-53,-41.40625
95,78,8,88,256,-168,-65.625
95,78,9,135,512,-377,-73.6328125
95,78,10,2441,1024,1417,138.37890625
95,78,11,133,2048,-1915,-93.505859375
95,78,12,4565,4096,469,11.4501953125
95,78,13,6791,8192,-1401,-17.10205078125
95,78,14,13051,16384,-3333,-20.343017578125
95,78,15,42418,32768,9650,29.449462890625
95,79,1,0,2,-2,-100.0
95,79,2,2,4,-2,-50.0
95,79,3,12,8,4,50.0
95,79,4,28,16,12,75.0
95,79,5,15,32,-17,-53.125
95,79,6,42,64,-22,-34.375
95,79,7,11,128,-117,-91.40625
95,79,8,16,256,-240,-93.75
95,79,9,1635,512,1123,219.3359375
95,79,10,261,1024,-763,-74.51171875
95,79,11,354,2048,-1694,-82.71484375
95,79,12,952,4096,-3144,-76.7578125
95,79,13,9961,8192,1769,21.59423828125
95,79,14,18977,16384,2593,15.826416015625
95,79,15,20283,32768,-12485,-38.1011962890625
95,80,1,0,2,-2,-100.0
95,80,2,1,4,-3,-75.0
95,80,3,4,8,-4,-50.0
95,80,4,5,16,-11,-68.75
95,80,5,14,32,-18,-56.25
95,80,6,120,64,56,87.5
95,80,7,30,128,-98,-76.5625
95,80,8,95,256,-161,-62.890625
95,80,9,918,512,406,79.296875
95,80,10,464,1024,-560,-54.6875
95,80,11,1184,2048,-864,-42.1875
95,80,12,1649,4096,-2447,-59.7412109375
95,80,13,4016,8192,-4176,-50.9765625
95,80,14,44315,16384,27931,170.477294921875
95,80,15,23576,32768,-9192,-28.0517578125
95,81,1,0,2,-2,-100.0
95,81,2,3,4,-1,-25.0
95,81,3,4,8,-4,-50.0
95,81,4,3,16,-13,-81.25
95,81,5,9,32,-23,-71.875
95,81,6,12,64,-52,-81.25
95,81,7,82,128,-46,-35.9375
95,81,8,598,256,342,133.59375
95,81,9,409,512,-103,-20.1171875
95,81,10,696,1024,-328,-32.03125
95,81,11,607,2048,-1441,-70.361328125
95,81,12,6624,4096,2528,61.71875
95,81,13,3416,8192,-4776,-58.30078125
95,81,14,13185,16384,-3199,-19.525146484375
95,81,15,4796,32768,-27972,-85.36376953125
95,82,1,0,2,-2,-100.0
95,82,2,1,4,-3,-75.0
95,82,3,3,8,-5,-62.5
95,82,4,36,16,20,125.0
95,82,5,81,32,49,153.125
95,82,6,65,64,1,1.5625
95,82,7,223,128,95,74.21875
95,82,8,203,256,-53,-20.703125
95,82,9,1485,512,973,190.0390625
95,82,10,625,1024,-399,-38.96484375
95,82,11,1539,2048,-509,-24.853515625
95,82,12,31,4096,-4065,-99.2431640625
95,82,13,7013,8192,-1179,-14.39208984375
95,82,14,37471,16384,21087,128.704833984375
95,82,15,42517,32768,9749,29.7515869140625
95,83,1,0,2,-2,-100.0
95,83,2,2,4,-2,-50.0
95,83,3,3,8,-5,-62.5
95,83,4,21,16,5,31.25
95,83,5,7,32,-25,-78.125
95,83,6,14,64,-50,-78.125
95,83,7,201,128,73,57.03125
95,83,8,69,256,-187,-73.046875
95,83,9,607,512,95,18.5546875
95,83,10,68,1024,-956,-93.359375
95,83,11,1534,2048,-514,-25.09765625
95,83,12,13530,4096,9434,230.322265625
95,83,13,20058,8192,11866,144.8486328125
95,83,14,9835,16384,-6549,-39.971923828125
95,83,15,68076,32768,35308,107.75146484375
95,84,1,0,2,-2,-100.0
95,84,2,1,4,-3,-75.0
95,84,3,4,8,-4,-50.0
95,84,4,13,16,-3,-18.75
95,84,5,36,32,4,12.5
95,84,6,17,64,-47,-73.4375
95,84,7,84,128,-44,-34.375
95,84,8,1171,256,915,357.421875
95,84,9,254,512,-258,-50.390625
95,84,10,149,1024,-875,-85.44921875
95,84,11,1329,2048,-719,-35.107421875
95,84,12,4991,4096,895,21.8505859375
95,84,13,1850,8192,-6342,-77.4169921875
95,84,14,35374,16384,18990,115.90576171875
95,84,15,20142,32768,-12626,-38.531494140625
95,85,1,0,2,-2,-100.0
95,85,2,2,4,-2,-50.0
95,85,3,12,8,4,50.0
95,85,4,6,16,-10,-62.5
95,85,5,11,32,-21,-65.625
95,85,6,130,64,66,103.125
95,85,7,532,128,404,315.625
95,85,8,297,256,41,16.015625
95,85,9,151,512,-361,-70.5078125
95,85,10,125,1024,-899,-87.79296875
95,85,11,1627,2048,-421,-20.556640625
95,85,12,1670,4096,-2426,-59.228515625
95,85,13,7439,8192,-753,-9.19189453125
95,85,14,2793,16384,-13591,-82.952880859375
95,85,15,20054,32768,-12714,-38.800048828125
95,86,1,0,2,-2,-100.0
95,86,2,2,4,-2,-50.0
95,86,3,2,8,-6,-75.0
95,86,4,10,16,-6,-37.5
95,86,5,36,32,4,12.5
95,86,6,249,64,185,289.0625
95,86,7,79,128,-49,-38.28125
95,86,8,112,256,-144,-56.25
95,86,9,430,512,-82,-16.015625
95,86,10,562,1024,-462,-45.1171875
95,86,11,3210,2048,1162,56.73828125
95,86,12,765,4096,-3331,-81.3232421875
95,86,13,2864,8192,-5328,-65.0390625
95,86,14,1497,16384,-14887,-90.863037109375
95,86,15,63498,32768,30730,93.780517578125
95,87,1,0,2,-2,-100.0
95,87,2,5,4,1,25.0
95,87,3,4,8,-4,-50.0
95,87,4,3,16,-13,-81.25
95,87,5,75,32,43,134.375
95,87,6,105,64,41,64.0625
95,87,7,30,128,-98,-76.5625
95,87,8,713,256,457,178.515625
95,87,9,1174,512,662,129.296875
95,87,10,1227,1024,203,19.82421875
95,87,11,1924,2048,-124,-6.0546875
95,87,12,9583,4096,5487,133.9599609375
95,87,13,824,8192,-7368,-89.94140625
95,87,14,21731,16384,5347,32.635498046875
95,87,15,24923,32768,-7845,-23.9410400390625
95,88,1,0,2,-2,-100.0
95,88,2,2,4,-2,-50.0
95,88,3,5,8,-3,-37.5
95,88,4,30,16,14,87.5
95,88,5,71,32,39,121.875
95,88,6,35,64,-29,-45.3125
95,88,7,6,128,-122,-95.3125
95,88,8,171,256,-85,-33.203125
95,88,9,1223,512,711,138.8671875
95,88,10,735,1024,-289,-28.22265625
95,88,11,1784,2048,-264,-12.890625
95,88,12,4375,4096,279,6.8115234375
95,88,13,5104,8192,-3088,-37.6953125
95,88,14,4072,16384,-12312,-75.146484375
95,88,15,83472,32768,50704,154.736328125
95,89,1,0,2,-2,-100.0
95,89,2,3,4,-1,-25.0
95,89,3,3,8,-5,-62.5
95,89,4,51,16,35,218.75
95,89,5,5,32,-27,-84.375
95,89,6,19,64,-45,-70.3125
95,89,7,98,128,-30,-23.4375
95,89,8,269,256,13,5.078125
95,89,9,53,512,-459,-89.6484375
95,89,10,2727,1024,1703,166.30859375
95,89,11,207,2048,-1841,-89.892578125
95,89,12,24,4096,-4072,-99.4140625
95,89,13,12882,8192,4690,57.2509765625
95,89,14,38705,16384,22321,136.236572265625
95,89,15,20269,32768,-12499,-38.1439208984375
95,90,1,0,2,-2,-100.0
95,90,2,4,4,0,0.0
95,90,3,2,8,-6,-75.0
95,90,4,6,16,-10,-62.5
95,90,5,17,32,-15,-46.875
95,90,6,17,64,-47,-73.4375
95,90,7,71,128,-57,-44.53125
95,90,8,862,256,606,236.71875
95,90,9,370,512,-142,-27.734375
95,90,10,1036,1024,12,1.171875
95,90,11,2330,2048,282,13.76953125
95,90,12,1298,4096,-2798,-68.310546875
95,90,13,36234,8192,28042,342.3095703125
95,90,14,1342,16384,-15042,-91.80908203125
95,90,15,65841,32768,33073,100.9307861328125
95,91,1,0,2,-2,-100.0
95,91,2,3,4,-1,-25.0
95,91,3,6,8,-2,-25.0
95,91,4,3,16,-13,-81.25
95,91,5,45,32,13,40.625
95,91,6,131,64,67,104.6875
95,91,7,291,128,163,127.34375
95,91,8,201,256,-55,-21.484375
95,91,9,50,512,-462,-90.234375
95,91,10,2086,1024,1062,103.7109375
95,91,11,2320,2048,272,13.28125
95,91,12,1001,4096,-3095,-75.5615234375
95,91,13,1166,8192,-7026,-85.7666015625
95,91,14,6603,16384,-9781,-59.698486328125
95,91,15,86069,32768,53301,162.6617431640625
95,92,1,0,2,-2,-100.0
95,92,2,1,4,-3,-75.0
95,92,3,4,8,-4,-50.0
95,92,4,4,16,-12,-75.0
95,92,5,10,32,-22,-68.75
95,92,6,209,64,145,226.5625
95,92,7,244,128,116,90.625
95,92,8,31,256,-225,-87.890625
95,92,9,538,512,26,5.078125
95,92,10,293,1024,-731,-71.38671875
95,92,11,1112,2048,-936,-45.703125
95,92,12,2566,4096,-1530,-37.353515625
95,92,13,3072,8192,-5120,-62.5
95,92,14,921,16384,-15463,-94.378662109375
95,92,15,15628,32768,-17140,-52.30712890625
95,93,1,0,2,-2,-100.0
95,93,2,1,4,-3,-75.0
95,93,3,8,8,0,0.0
95,93,4,36,16,20,125.0
95,93,5,13,32,-19,-59.375
95,93,6,69,64,5,7.8125
95,93,7,80,128,-48,-37.5
95,93,8,134,256,-122,-47.65625
95,93,9,1438,512,926,180.859375
95,93,10,690,1024,-334,-32.6171875
95,93,11,477,2048,-1571,-76.708984375
95,93,12,2439,4096,-1657,-40.4541015625
95,93,13,2500,8192,-5692,-69.482421875
95,93,14,18587,16384,2203,13.446044921875
95,93,15,7467,32768,-25301,-77.2125244140625
95,94,1,0,2,-2,-100.0
95,94,2,2,4,-2,-50.0
95,94,3,2,8,-6,-75.0
95,94,4,16,16,0,0.0
95,94,5,66,32,34,106.25
95,94,6,30,64,-34,-53.125
95,94,7,200,128,72,56.25
95,94,8,567,256,311,121.484375
95,94,9,622,512,110,21.484375
95,94,10,101,1024,-923,-90.13671875
95,94,11,334,2048,-1714,-83.69140625
95,94,12,4444,4096,348,8.49609375
95,94,13,12022,8192,3830,46.7529296875
95,94,14,17239,16384,855,5.218505859375
95,94,15,407,32768,-32361,-98.7579345703125
95,95,1,0,2,-2,-100.0
95,95,2,1,4,-3,-75.0
95,95,3,3,8,-5,-62.5
95,95,4,28,16,12,75.0
95,95,5,49,32,17,53.125
95,95,6,59,64,-5,-7.8125
95,95,7,95,128,-33,-25.78125
95,95,8,260,256,4,1.5625
95,95,9,46,512,-466,-91.015625
95,95,10,508,1024,-516,-50.390625
95,95,11,768,2048,-1280,-62.5
95,95,12,1620,4096,-2476,-60.44921875
95,95,13,5058,8192,-3134,-38.2568359375
95,95,14,2830,16384,-13554,-82.72705078125
95,95,15,42609,32768,9841,30.0323486328125
96,1,1,0,2,-2,-100.0
96,1,2,1,4,-3,-75.0
96,1,3,3,8,-5,-62.5
96,1,4,14,16,-2,-12.5
96,1,5,47,32,15,46.875
96,1,6,73,64,9,14.0625
96,1,7,471,128,343,267.96875
96,1,8,110,256,-146,-57.03125
96,1,9,309,512,-203,-39.6484375
96,1,10,1069,1024,45,4.39453125
96,1,11,1311,2048,-737,-35.986328125
96,1,12,19584,4096,15488,378.125
96,1,13,4060,8192,-4132,-50.439453125
96,1,14,3325,16384,-13059,-79.705810546875
96,1,15,30297,32768,-2471,-7.5408935546875
96,2,1,0,2,-2,-100.0
96,2,2,3,4,-1,-25.0
96,2,3,3,8,-5,-62.5
96,2,4,29,16,13,81.25
96,2,5,6,32,-26,-81.25
96,2,6,33,64,-31,-48.4375
96,2,7,52,128,-76,-59.375
96,2,8,320,256,64,25.0
96,2,9,311,512,-201,-39.2578125
96,2,10,272,1024,-752,-73.4375
96,2,11,1176,2048,-872,-42.578125
96,2,12,20112,4096,16016,391.015625
96,2,13,8084,8192,-108,-1.318359375
96,2,14,9976,16384,-6408,-39.111328125
96,2,15,6023,32768,-26745,-81.6192626953125
96,3,1,0,2,-2,-100.0
96,3,2,3,4,-1,-25.0
96,3,3,2,8,-6,-75.0
96,3,4,5,16,-11,-68.75
96,3,5,4,32,-28,-87.5
96,3,6,24,64,-40,-62.5
96,3,7,338,128,210,164.0625
96,3,8,62,256,-194,-75.78125
96,3,9,382,512,-130,-25.390625
96,3,10,1967,1024,943,92.08984375
96,3,11,5185,2048,3137,153.173828125
96,3,12,2287,4096,-1809,-44.1650390625
96,3,13,9465,8192,1273,15.53955078125
96,3,14,12199,16384,-4185,-25.543212890625
96,3,15,2740,32768,-30028,-91.63818359375
96,4,1,0,2,-2,-100.0
96,4,2,1,4,-3,-75.0
96,4,3,16,8,8,100.0
96,4,4,30,16,14,87.5
96,4,5,39,32,7,21.875
96,4,6,113,64,49,76.5625
96,4,7,873,128,745,582.03125
96,4,8,376,256,120,46.875
96,4,9,395,512,-117,-22.8515625
96,4,10,1920,1024,896,87.5
96,4,11,5281,2048,3233,157.861328125
96,4,12,2040,4096,-2056,-50.1953125
96,4,13,5031,8192,-3161,-38.58642578125
96,4,14,14751,16384,-1633,-9.967041015625
96,4,15,44818,32768,12050,36.773681640625
96,5,1,0,2,-2,-100.0
96,5,2,1,4,-3,-75.0
96,5,3,11,8,3,37.5
96,5,4,33,16,17,106.25
96,5,5,15,32,-17,-53.125
96,5,6,8,64,-56,-87.5
96,5,7,49,128,-79,-61.71875
96,5,8,458,256,202,78.90625
96,5,9,609,512,97,18.9453125
96,5,10,495,1024,-529,-51.66015625
96,5,11,491,2048,-1557,-76.025390625
96,5,12,5479,4096,1383,33.7646484375
96,5,13,8909,8192,717,8.75244140625
96,5,14,54733,16384,38349,234.063720703125
96,5,15,78999,32768,46231,141.0858154296875
96,6,1,0,2,-2,-100.0
96,6,2,3,4,-1,-25.0
96,6,3,2,8,-6,-75.0
96,6,4,8,16,-8,-50.0
96,6,5,48,32,16,50.0
96,6,6,26,64,-38,-59.375
96,6,7,150,128,22,17.1875
96,6,8,761,256,505,197.265625
96,6,9,1888,512,1376,268.75
96,6,10,26,1024,-998,-97.4609375
96,6,11,1355,2048,-693,-33.837890625
96,6,12,2370,4096,-1726,-42.138671875
96,6,13,12661,8192,4469,54.55322265625
96,6,14,24281,16384,7897,48.199462890625
96,6,15,49727,32768,16959,51.7547607421875
96,7,1,0,2,-2,-100.0
96,7,2,1,4,-3,-75.0
96,7,3,6,8,-2,-25.0
96,7,4,3,16,-13,-81.25
96,7,5,28,32,-4,-12.5
96,7,6,12,64,-52,-81.25
96,7,7,10,128,-118,-92.1875
96,7,8,209,256,-47,-18.359375
96,7,9,1135,512,623,121.6796875
96,7,10,340,1024,-684,-66.796875
96,7,11,161,2048,-1887,-92.138671875
96,7,12,4525,4096,429,10.4736328125
96,7,13,24505,8192,16313,199.13330078125
96,7,14,20200,16384,3816,23.291015625
96,7,15,18741,32768,-14027,-42.8070068359375
96,8,1,0,2,-2,-100.0
96,8,2,3,4,-1,-25.0
96,8,3,4,8,-4,-50.0
96,8,4,13,16,-3,-18.75
96,8,5,36,32,4,12.5
96,8,6,11,64,-53,-82.8125
96,8,7,26,128,-102,-79.6875
96,8,8,10,256,-246,-96.09375
96,8,9,223,512,-289,-56.4453125
96,8,10,419,1024,-605,-59.08203125
96,8,11,969,2048,-1079,-52.685546875
96,8,12,7421,4096,3325,81.1767578125
96,8,13,1856,8192,-6336,-77.34375
96,8,14,1379,16384,-15005,-91.583251953125
96,8,15,45092,32768,12324,37.60986328125
96,9,1,0,2,-2,-100.0
96,9,2,9,4,5,125.0
96,9,3,9,8,1,12.5
96,9,4,5,16,-11,-68.75
96,9,5,17,32,-15,-46.875
96,9,6,14,64,-50,-78.125
96,9,7,85,128,-43,-33.59375
96,9,8,25,256,-231,-90.234375
96,9,9,1917,512,1405,274.4140625
96,9,10,1331,1024,307,29.98046875
96,9,11,484,2048,-1564,-76.3671875
96,9,12,8487,4096,4391,107.2021484375
96,9,13,5070,8192,-3122,-38.1103515625
96,9,14,708,16384,-15676,-95.6787109375
96,9,15,14254,32768,-18514,-56.500244140625
96,10,1,0,2,-2,-100.0
96,10,2,1,4,-3,-75.0
96,10,3,2,8,-6,-75.0
96,10,4,7,16,-9,-56.25
96,10,5,35,32,3,9.375
96,10,6,39,64,-25,-39.0625
96,10,7,88,128,-40,-31.25
96,10,8,11,256,-245,-95.703125
96,10,9,27,512,-485,-94.7265625
96,10,10,230,1024,-794,-77.5390625
96,10,11,1713,2048,-335,-16.357421875
96,10,12,4137,4096,41,1.0009765625
96,10,13,1617,8192,-6575,-80.26123046875
96,10,14,5227,16384,-11157,-68.096923828125
96,10,15,20902,32768,-11866,-36.212158203125
96,11,1,0,2,-2,-100.0
96,11,2,2,4,-2,-50.0
96,11,3,4,8,-4,-50.0
96,11,4,8,16,-8,-50.0
96,11,5,7,32,-25,-78.125
96,11,6,57,64,-7,-10.9375
96,11,7,188,128,60,46.875
96,11,8,8,256,-248,-96.875
96,11,9,677,512,165,32.2265625
96,11,10,1473,1024,449,43.84765625
96,11,11,1372,2048,-676,-33.0078125
96,11,12,7210,4096,3114,76.025390625
96,11,13,13944,8192,5752,70.21484375
96,11,14,25990,16384,9606,58.63037109375
96,11,15,14589,32768,-18179,-55.4779052734375
96,12,1,0,2,-2,-100.0
96,12,2,2,4,-2,-50.0
96,12,3,3,8,-5,-62.5
96,12,4,21,16,5,31.25
96,12,5,14,32,-18,-56.25
96,12,6,145,64,81,126.5625
96,12,7,269,128,141,110.15625
96,12,8,337,256,81,31.640625
96,12,9,421,512,-91,-17.7734375
96,12,10,948,1024,-76,-7.421875
96,12,11,4108,2048,2060,100.5859375
96,12,12,1384,4096,-2712,-66.2109375
96,12,13,10584,8192,2392,29.19921875
96,12,14,5456,16384,-10928,-66.69921875
96,12,15,1187,32768,-31581,-96.3775634765625
96,13,1,0,2,-2,-100.0
96,13,2,1,4,-3,-75.0
96,13,3,9,8,1,12.5
96,13,4,34,16,18,112.5
96,13,5,65,32,33,103.125
96,13,6,17,64,-47,-73.4375
96,13,7,135,128,7,5.46875
96,13,8,101,256,-155,-60.546875
96,13,9,39,512,-473,-92.3828125
96,13,10,696,1024,-328,-32.03125
96,13,11,2327,2048,279,13.623046875
96,13,12,10102,4096,6006,146.630859375
96,13,13,853,8192,-7339,-89.58740234375
96,13,14,46477,16384,30093,183.673095703125
96,13,15,30787,32768,-1981,-6.0455322265625
96,14,1,0,2,-2,-100.0
96,14,2,1,4,-3,-75.0
96,14,3,2,8,-6,-75.0
96,14,4,27,16,11,68.75
96,14,5,88,32,56,175.0
96,14,6,174,64,110,171.875
96,14,7,9,128,-119,-92.96875
96,14,8,223,256,-33,-12.890625
96,14,9,244,512,-268,-52.34375
96,14,10,1001,1024,-23,-2.24609375
96,14,11,2543,2048,495,24.169921875
96,14,12,5885,4096,1789,43.6767578125
96,14,13,34953,8192,26761,326.67236328125
96,14,14,4105,16384,-12279,-74.945068359375
96,14,15,393,32768,-32375,-98.8006591796875
96,15,1,0,2,-2,-100.0
96,15,2,4,4,0,0.0
96,15,3,6,8,-2,-25.0
96,15,4,14,16,-2,-12.5
96,15,5,42,32,10,31.25
96,15,6,129,64,65,101.5625
96,15,7,59,128,-69,-53.90625
96,15,8,336,256,80,31.25
96,15,9,1164,512,652,127.34375
96,15,10,402,1024,-622,-60.7421875
96,15,11,1659,2048,-389,-18.994140625
96,15,12,847,4096,-3249,-79.3212890625
96,15,13,5038,8192,-3154,-38.5009765625
96,15,14,2599,16384,-13785,-84.136962890625
96,15,15,46275,32768,13507,41.2200927734375
96,16,1,0,2,-2,-100.0
96,16,2,3,4,-1,-25.0
96,16,3,10,8,2,25.0
96,16,4,12,16,-4,-25.0
96,16,5,17,32,-15,-46.875
96,16,6,96,64,32,50.0
96,16,7,73,128,-55,-42.96875
96,16,8,242,256,-14,-5.46875
96,16,9,1182,512,670,130.859375
96,16,10,185,1024,-839,-81.93359375
96,16,11,3109,2048,1061,51.806640625
96,16,12,1049,4096,-3047,-74.3896484375
96,16,13,3263,8192,-4929,-60.16845703125
96,16,14,59288,16384,42904,261.865234375
96,16,15,2801,32768,-29967,-91.4520263671875
96,17,1,0,2,-2,-100.0
96,17,2,1,4,-3,-75.0
96,17,3,2,8,-6,-75.0
96,17,4,23,16,7,43.75
96,17,5,15,32,-17,-53.125
96,17,6,78,64,14,21.875
96,17,7,286,128,158,123.4375
96,17,8,22,256,-234,-91.40625
96,17,9,32,512,-480,-93.75
96,17,10,1265,1024,241,23.53515625
96,17,11,1946,2048,-102,-4.98046875
96,17,12,5599,4096,1503,36.6943359375
96,17,13,14256,8192,6064,74.0234375
96,17,14,13169,16384,-3215,-19.622802734375
96,17,15,60243,32768,27475,83.8470458984375
96,18,1,0,2,-2,-100.0
96,18,2,2,4,-2,-50.0
96,18,3,2,8,-6,-75.0
96,18,4,3,16,-13,-81.25
96,18,5,19,32,-13,-40.625
96,18,6,36,64,-28,-43.75
96,18,7,172,128,44,34.375
96,18,8,244,256,-12,-4.6875
96,18,9,1789,512,1277,249.4140625
96,18,10,125,1024,-899,-87.79296875
96,18,11,3941,2048,1893,92.431640625
96,18,12,56,4096,-4040,-98.6328125
96,18,13,3355,8192,-4837,-59.04541015625
96,18,14,3943,16384,-12441,-75.933837890625
96,18,15,27392,32768,-5376,-16.40625
96,19,1,0,2,-2,-100.0
96,19,2,2,4,-2,-50.0
96,19,3,4,8,-4,-50.0
96,19,4,8,16,-8,-50.0
96,19,5,23,32,-9,-28.125
96,19,6,46,64,-18,-28.125
96,19,7,359,128,231,180.46875
96,19,8,155,256,-101,-39.453125
96,19,9,702,512,190,37.109375
96,19,10,1464,1024,440,42.96875
96,19,11,1640,2048,-408,-19.921875
96,19,12,4772,4096,676,16.50390625
96,19,13,44,8192,-8148,-99.462890625
96,19,14,3328,16384,-13056,-79.6875
96,19,15,45763,32768,12995,39.6575927734375
96,20,1,0,2,-2,-100.0
96,20,2,1,4,-3,-75.0
96,20,3,2,8,-6,-75.0
96,20,4,9,16,-7,-43.75
96,20,5,4,32,-28,-87.5
96,20,6,50,64,-14,-21.875
96,20,7,128,128,0,0.0
96,20,8,460,256,204,79.6875
96,20,9,408,512,-104,-20.3125
96,20,10,34,1024,-990,-96.6796875
96,20,11,177,2048,-1871,-91.357421875
96,20,12,579,4096,-3517,-85.8642578125
96,20,13,1986,8192,-6206,-75.7568359375
96,20,14,18620,16384,2236,13.6474609375
96,20,15,49252,32768,16484,50.30517578125
96,21,1,0,2,-2,-100.0
96,21,2,2,4,-2,-50.0
96,21,3,2,8,-6,-75.0
96,21,4,8,16,-8,-50.0
96,21,5,29,32,-3,-9.375
96,21,6,53,64,-11,-17.1875
96,21,7,302,128,174,135.9375
96,21,8,95,256,-161,-62.890625
96,21,9,802,512,290,56.640625
96,21,10,1823,1024,799,78.02734375
96,21,11,126,2048,-1922,-93.84765625
96,21,12,2634,4096,-1462,-35.693359375
96,21,13,4156,8192,-4036,-49.267578125
96,21,14,6952,16384,-9432,-57.568359375
96,21,15,26752,32768,-6016,-18.359375
96,22,1,0,2,-2,-100.0
96,22,2,1,4,-3,-75.0
96,22,3,5,8,-3,-37.5
96,22,4,8,16,-8,-50.0
96,22,5,9,32,-23,-71.875
96,22,6,35,64,-29,-45.3125
96,22,7,384,128,256,200.0
96,22,8,270,256,14,5.46875
96,22,9,260,512,-252,-49.21875
96,22,10,385,1024,-639,-62.40234375
96,22,11,4481,2048,2433,118.798828125
96,22,12,2814,4096,-1282,-31.298828125
96,22,13,2700,8192,-5492,-67.041015625
96,22,14,48649,16384,32265,196.929931640625
96,22,15,11075,32768,-21693,-66.2017822265625
96,23,1,0,2,-2,-100.0
96,23,2,2,4,-2,-50.0
96,23,3,9,8,1,12.5
96,23,4,69,16,53,331.25
96,23,5,40,32,8,25.0
96,23,6,43,64,-21,-32.8125
96,23,7,83,128,-45,-35.15625
96,23,8,427,256,171,66.796875
96,23,9,517,512,5,0.9765625
96,23,10,1021,1024,-3,-0.29296875
96,23,11,2215,2048,167,8.154296875
96,23,12,1987,4096,-2109,-51.4892578125
96,23,13,2116,8192,-6076,-74.169921875
96,23,14,2821,16384,-13563,-82.781982421875
96,23,15,9645,32768,-23123,-70.5657958984375
96,24,1,0,2,-2,-100.0
96,24,2,3,4,-1,-25.0
96,24,3,2,8,-6,-75.0
96,24,4,17,16,1,6.25
96,24,5,41,32,9,28.125
96,24,6,193,64,129,201.5625
96,24,7,140,128,12,9.375
96,24,8,267,256,11,4.296875
96,24,9,331,512,-181,-35.3515625
96,24,10,1556,1024,532,51.953125
96,24,11,966,2048,-1082,-52.83203125
96,24,12,1945,4096,-2151,-52.5146484375
96,24,13,2347,8192,-5845,-71.35009765625
96,24,14,1506,16384,-14878,-90.80810546875
96,24,15,25672,32768,-7096,-21.6552734375
96,25,1,0,2,-2,-100.0
96,25,2,2,4,-2,-50.0
96,25,3,4,8,-4,-50.0
96,25,4,6,16,-10,-62.5
96,25,5,19,32,-13,-40.625
96,25,6,108,64,44,68.75
96,25,7,143,128,15,11.71875
96,25,8,195,256,-61,-23.828125
96,25,9,233,512,-279,-54.4921875
96,25,10,1049,1024,25,2.44140625
96,25,11,881,2048,-1167,-56.982421875
96,25,12,2413,4096,-1683,-41.0888671875
96,25,13,5890,8192,-2302,-28.1005859375
96,25,14,8689,16384,-7695,-46.966552734375
96,25,15,25476,32768,-7292,-22.25341796875
96,26,1,0,2,-2,-100.0
96,26,2,1,4,-3,-75.0
96,26,3,11,8,3,37.5
96,26,4,3,16,-13,-81.25
96,26,5,35,32,3,9.375
96,26,6,11,64,-53,-82.8125
96,26,7,25,128,-103,-80.46875
96,26,8,249,256,-7,-2.734375
96,26,9,796,512,284,55.46875
96,26,10,194,1024,-830,-81.0546875
96,26,11,1063,2048,-985,-48.095703125
96,26,12,8157,4096,4061,99.1455078125
96,26,13,5377,8192,-2815,-34.36279296875
96,26,14,2267,16384,-14117,-86.163330078125
96,26,15,9928,32768,-22840,-69.7021484375
96,27,1,0,2,-2,-100.0
96,27,2,1,4,-3,-75.0
96,27,3,12,8,4,50.0
96,27,4,3,16,-13,-81.25
96,27,5,7,32,-25,-78.125
96,27,6,114,64,50,78.125
96,27,7,18,128,-110,-85.9375
96,27,8,340,256,84,32.8125
96,27,9,695,512,183,35.7421875
96,27,10,2325,1024,1301,127.05078125
96,27,11,799,2048,-1249,-60.986328125
96,27,12,7030,4096,2934,71.630859375
96,27,13,14100,8192,5908,72.119140625
96,27,14,5940,16384,-10444,-63.7451171875
96,27,15,3556,32768,-29212,-89.14794921875
96,28,1,0,2,-2,-100.0
96,28,2,3,4,-1,-25.0
96,28,3,4,8,-4,-50.0
96,28,4,17,16,1,6.25
96,28,5,22,32,-10,-31.25
96,28,6,20,64,-44,-68.75
96,28,7,28,128,-100,-78.125
96,28,8,224,256,-32,-12.5
96,28,9,202,512,-310,-60.546875
96,28,10,2610,1024,1586,154.8828125
96,28,11,2615,2048,567,27.685546875
96,28,12,3077,4096,-1019,-24.8779296875
96,28,13,18307,8192,10115,123.47412109375
96,28,14,30205,16384,13821,84.356689453125
96,28,15,98362,32768,65594,200.177001953125
96,29,1,0,2,-2,-100.0
96,29,2,5,4,1,25.0
96,29,3,10,8,2,25.0
96,29,4,10,16,-6,-37.5
96,29,5,12,32,-20,-62.5
96,29,6,106,64,42,65.625
96,29,7,333,128,205,160.15625
96,29,8,424,256,168,65.625
96,29,9,1473,512,961,187.6953125
96,29,10,1540,1024,516,50.390625
96,29,11,4222,2048,2174,106.15234375
96,29,12,4640,4096,544,13.28125
96,29,13,19794,8192,11602,141.6259765625
96,29,14,1037,16384,-15347,-93.670654296875
96,29,15,8795,32768,-23973,-73.1597900390625
96,30,1,0,2,-2,-100.0
96,30,2,1,4,-3,-75.0
96,30,3,4,8,-4,-50.0
96,30,4,16,16,0,0.0
96,30,5,21,32,-11,-34.375
96,30,6,38,64,-26,-40.625
96,30,7,70,128,-58,-45.3125
96,30,8,182,256,-74,-28.90625
96,30,9,504,512,-8,-1.5625
96,30,10,71,1024,-953,-93.06640625
96,30,11,1499,2048,-549,-26.806640625
96,30,12,1661,4096,-2435,-59.4482421875
96,30,13,5879,8192,-2313,-28.23486328125
96,30,14,1352,16384,-15032,-91.748046875
96,30,15,3154,32768,-29614,-90.374755859375
96,31,1,0,2,-2,-100.0
96,31,2,1,4,-3,-75.0
96,31,3,9,8,1,12.5
96,31,4,14,16,-2,-12.5
96,31,5,9,32,-23,-71.875
96,31,6,143,64,79,123.4375
96,31,7,55,128,-73,-57.03125
96,31,8,103,256,-153,-59.765625
96,31,9,310,512,-202,-39.453125
96,31,10,113,1024,-911,-88.96484375
96,31,11,456,2048,-1592,-77.734375
96,31,12,4261,4096,165,4.0283203125
96,31,13,9571,8192,1379,16.83349609375
96,31,14,10598,16384,-5786,-35.31494140625
96,31,15,13312,32768,-19456,-59.375
96,32,1,0,2,-2,-100.0
96,32,2,2,4,-2,-50.0
96,32,3,3,8,-5,-62.5
96,32,4,26,16,10,62.5
96,32,5,41,32,9,28.125
96,32,6,166,64,102,159.375
96,32,7,116,128,-12,-9.375
96,32,8,65,256,-191,-74.609375
96,32,9,28,512,-484,-94.53125
96,32,10,366,1024,-658,-64.2578125
96,32,11,3569,2048,1521,74.267578125
96,32,12,264,4096,-3832,-93.5546875
96,32,13,2271,8192,-5921,-72.27783203125
96,32,14,8913,16384,-7471,-45.599365234375
96,32,15,42327,32768,9559,29.1717529296875
96,33,1,0,2,-2,-100.0
96,33,2,1,4,-3,-75.0
96,33,3,13,8,5,62.5
96,33,4,13,16,-3,-18.75
96,33,5,21,32,-11,-34.375
96,33,6,10,64,-54,-84.375
96,33,7,70,128,-58,-45.3125
96,33,8,151,256,-105,-41.015625
96,33,9,197,512,-315,-61.5234375
96,33,10,995,1024,-29,-2.83203125
96,33,11,3326,2048,1278,62.40234375
96,33,12,2431,4096,-1665,-40.6494140625
96,33,13,25696,8192,17504,213.671875
96,33,14,31644,16384,15260,93.1396484375
96,33,15,13739,32768,-19029,-58.0718994140625
96,34,1,0,2,-2,-100.0
96,34,2,4,4,0,0.0
96,34,3,8,8,0,0.0
96,34,4,26,16,10,62.5
96,34,5,40,32,8,25.0
96,34,6,16,64,-48,-75.0
96,34,7,54,128,-74,-57.8125
96,34,8,100,256,-156,-60.9375
96,34,9,445,512,-67,-13.0859375
96,34,10,1785,1024,761,74.31640625
96,34,11,357,2048,-1691,-82.568359375
96,34,12,10114,4096,6018,146.923828125
96,34,13,2996,8192,-5196,-63.427734375
96,34,14,6399,16384,-9985,-60.943603515625
96,34,15,94574,32768,61806,188.616943359375
96,35,1,0,2,-2,-100.0
96,35,2,6,4,2,50.0
96,35,3,6,8,-2,-25.0
96,35,4,5,16,-11,-68.75
96,35,5,18,32,-14,-43.75
96,35,6,181,64,117,182.8125
96,35,7,45,128,-83,-64.84375
96,35,8,179,256,-77,-30.078125
96,35,9,25,512,-487,-95.1171875
96,35,10,1318,1024,294,28.7109375
96,35,11,1894,2048,-154,-7.51953125
96,35,12,1168,4096,-2928,-71.484375
96,35,13,5257,8192,-2935,-35.82763671875
96,35,14,1758,16384,-14626,-89.27001953125
96,35,15,60396,32768,27628,84.31396484375
96,36,1,0,2,-2,-100.0
96,36,2,1,4,-3,-75.0
96,36,3,21,8,13,162.5
96,36,4,3,16,-13,-81.25
96,36,5,90,32,58,181.25
96,36,6,163,64,99,154.6875
96,36,7,316,128,188,146.875
96,36,8,417,256,161,62.890625
96,36,9,59,512,-453,-88.4765625
96,36,10,412,1024,-612,-59.765625
96,36,11,653,2048,-1395,-68.115234375
96,36,12,3262,4096,-834,-20.361328125
96,36,13,117,8192,-8075,-98.57177734375
96,36,14,24723,16384,8339,50.897216796875
96,36,15,114815,32768,82047,250.3875732421875
96,37,1,0,2,-2,-100.0
96,37,2,1,4,-3,-75.0
96,37,3,2,8,-6,-75.0
96,37,4,46,16,30,187.5
96,37,5,8,32,-24,-75.0
96,37,6,26,64,-38,-59.375
96,37,7,144,128,16,12.5
96,37,8,444,256,188,73.4375
96,37,9,69,512,-443,-86.5234375
96,37,10,126,1024,-898,-87.6953125
96,37,11,2346,2048,298,14.55078125
96,37,12,3695,4096,-401,-9.7900390625
96,37,13,13611,8192,5419,66.14990234375
96,37,14,11024,16384,-5360,-32.71484375
96,37,15,32400,32768,-368,-1.123046875
96,38,1,0,2,-2,-100.0
96,38,2,1,4,-3,-75.0
96,38,3,8,8,0,0.0
96,38,4,14,16,-2,-12.5
96,38,5,28,32,-4,-12.5
96,38,6,65,64,1,1.5625
96,38,7,24,128,-104,-81.25
96,38,8,151,256,-105,-41.015625
96,38,9,1628,512,1116,217.96875
96,38,10,64,1024,-960,-93.75
96,38,11,181,2048,-1867,-91.162109375
96,38,12,395,4096,-3701,-90.3564453125
96,38,13,20511,8192,12319,150.37841796875
96,38,14,14895,16384,-1489,-9.088134765625
96,38,15,32488,32768,-280,-0.8544921875
96,39,1,0,2,-2,-100.0
96,39,2,1,4,-3,-75.0
96,39,3,3,8,-5,-62.5
96,39,4,8,16,-8,-50.0
96,39,5,28,32,-4,-12.5
96,39,6,132,64,68,106.25
96,39,7,593,128,465,363.28125
96,39,8,287,256,31,12.109375
96,39,9,389,512,-123,-24.0234375
96,39,10,294,1024,-730,-71.2890625
96,39,11,739,2048,-1309,-63.916015625
96,39,12,7890,4096,3794,92.626953125
96,39,13,842,8192,-7350,-89.7216796875
96,39,14,60081,16384,43697,266.705322265625
96,39,15,5470,32768,-27298,-83.306884765625
96,40,1,0,2,-2,-100.0
96,40,2,2,4,-2,-50.0
96,40,3,12,8,4,50.0
96,40,4,18,16,2,12.5
96,40,5,20,32,-12,-37.5
96,40,6,17,64,-47,-73.4375
96,40,7,67,128,-61,-47.65625
96,40,8,194,256,-62,-24.21875
96,40,9,34,512,-478,-93.359375
96,40,10,144,1024,-880,-85.9375
96,40,11,1077,2048,-971,-47.412109375
96,40,12,660,4096,-3436,-83.88671875
96,40,13,7477,8192,-715,-8.72802734375
96,40,14,7962,16384,-8422,-51.40380859375
96,40,15,15390,32768,-17378,-53.033447265625
96,41,1,0,2,-2,-100.0
96,41,2,2,4,-2,-50.0
96,41,3,2,8,-6,-75.0
96,41,4,29,16,13,81.25
96,41,5,8,32,-24,-75.0
96,41,6,105,64,41,64.0625
96,41,7,35,128,-93,-72.65625
96,41,8,368,256,112,43.75
96,41,9,381,512,-131,-25.5859375
96,41,10,1364,1024,340,33.203125
96,41,11,2932,2048,884,43.1640625
96,41,12,2276,4096,-1820,-44.43359375
96,41,13,2542,8192,-5650,-68.9697265625
96,41,14,15995,16384,-389,-2.374267578125
96,41,15,14411,32768,-18357,-56.0211181640625
96,42,1,0,2,-2,-100.0
96,42,2,3,4,-1,-25.0
96,42,3,2,8,-6,-75.0
96,42,4,6,16,-10,-62.5
96,42,5,13,32,-19,-59.375
96,42,6,27,64,-37,-57.8125
96,42,7,427,128,299,233.59375
96,42,8,269,256,13,5.078125
96,42,9,132,512,-380,-74.21875
96,42,10,761,1024,-263,-25.68359375
96,42,11,1134,2048,-914,-44.62890625
96,42,12,10998,4096,6902,168.505859375
96,42,13,595,8192,-7597,-92.73681640625
96,42,14,5241,16384,-11143,-68.011474609375
96,42,15,37356,32768,4588,14.00146484375
96,43,1,0,2,-2,-100.0
96,43,2,2,4,-2,-50.0
96,43,3,3,8,-5,-62.5
96,43,4,12,16,-4,-25.0
96,43,5,10,32,-22,-68.75
96,43,6,54,64,-10,-15.625
96,43,7,63,128,-65,-50.78125
96,43,8,133,256,-123,-48.046875
96,43,9,584,512,72,14.0625
96,43,10,1143,1024,119,11.62109375
96,43,11,1215,2048,-833,-40.673828125
96,43,12,3809,4096,-287,-7.0068359375
96,43,13,7104,8192,-1088,-13.28125
96,43,14,21623,16384,5239,31.976318359375
96,43,15,17068,32768,-15700,-47.91259765625
96,44,1,0,2,-2,-100.0
96,44,2,1,4,-3,-75.0
96,44,3,5,8,-3,-37.5
96,44,4,12,16,-4,-25.0
96,44,5,40,32,8,25.0
96,44,6,133,64,69,107.8125
96,44,7,132,128,4,3.125
96,44,8,232,256,-24,-9.375
96,44,9,649,512,137,26.7578125
96,44,10,679,1024,-345,-33.69140625
96,44,11,4524,2048,2476,120.8984375
96,44,12,3498,4096,-598,-14.599609375
96,44,13,16944,8192,8752,106.8359375
96,44,14,5544,16384,-10840,-66.162109375
96,44,15,15718,32768,-17050,-52.032470703125
96,45,1,0,2,-2,-100.0
96,45,2,2,4,-2,-50.0
96,45,3,11,8,3,37.5
96,45,4,23,16,7,43.75
96,45,5,34,32,2,6.25
96,45,6,22,64,-42,-65.625
96,45,7,17,128,-111,-86.71875
96,45,8,282,256,26,10.15625
96,45,9,60,512,-452,-88.28125
96,45,10,1121,1024,97,9.47265625
96,45,11,1584,2048,-464,-22.65625
96,45,12,3462,4096,-634,-15.478515625
96,45,13,12479,8192,4287,52.33154296875
96,45,14,2812,16384,-13572,-82.8369140625
96,45,15,5094,32768,-27674,-84.454345703125
96,46,1,0,2,-2,-100.0
96,46,2,1,4,-3,-75.0
96,46,3,5,8,-3,-37.5
96,46,4,11,16,-5,-31.25
96,46,5,57,32,25,78.125
96,46,6,64,64,0,0.0
96,46,7,96,128,-32,-25.0
96,46,8,336,256,80,31.25
96,46,9,279,512,-233,-45.5078125
96,46,10,208,1024,-816,-79.6875
96,46,11,2940,2048,892,43.5546875
96,46,12,428,4096,-3668,-89.55078125
96,46,13,6453,8192,-1739,-21.22802734375
96,46,14,6906,16384,-9478,-57.84912109375
96,46,15,1144,32768,-31624,-96.5087890625
96,47,1,0,2,-2,-100.0
96,47,2,2,4,-2,-50.0
96,47,3,6,8,-2,-25.0
96,47,4,26,16,10,62.5
96,47,5,58,32,26,81.25
96,47,6,33,64,-31,-48.4375
96,47,7,9,128,-119,-92.96875
96,47,8,216,256,-40,-15.625
96,47,9,495,512,-17,-3.3203125
96,47,10,1835,1024,811,79.19921875
96,47,11,757,2048,-1291,-63.037109375
96,47,12,4471,4096,375,9.1552734375
96,47,13,11669,8192,3477,42.44384765625
96,47,14,11502,16384,-4882,-29.79736328125
96,47,15,2753,32768,-30015,-91.5985107421875
96,48,1,0,2,-2,-100.0
96,48,2,2,4,-2,-50.0
96,48,3,9,8,1,12.5
96,48,4,7,16,-9,-56.25
96,48,5,65,32,33,103.125
96,48,6,19,64,-45,-70.3125
96,48,7,24,128,-104,-81.25
96,48,8,344,256,88,34.375
96,48,9,420,512,-92,-17.96875
96,48,10,3203,1024,2179,212.79296875
96,48,11,917,2048,-1131,-55.224609375
96,48,12,2119,4096,-1977,-48.2666015625
96,48,13,16456,8192,8264,100.87890625
96,48,14,20139,16384,3755,22.918701171875
96,48,15,30863,32768,-1905,-5.8135986328125
96,49,1,0,2,-2,-100.0
96,49,2,2,4,-2,-50.0
96,49,3,2,8,-6,-75.0
96,49,4,21,16,5,31.25
96,49,5,28,32,-4,-12.5
96,49,6,6,64,-58,-90.625
96,49,7,52,128,-76,-59.375
96,49,8,251,256,-5,-1.953125
96,49,9,829,512,317,61.9140625
96,49,10,613,1024,-411,-40.13671875
96,49,11,470,2048,-1578,-77.05078125
96,49,12,6065,4096,1969,48.0712890625
96,49,13,22682,8192,14490,176.8798828125
96,49,14,8228,16384,-8156,-49.7802734375
96,49,15,5077,32768,-27691,-84.5062255859375
96,50,1,0,2,-2,-100.0
96,50,2,1,4,-3,-75.0
96,50,3,2,8,-6,-75.0
96,50,4,3,16,-13,-81.25
96,50,5,4,32,-28,-87.5
96,50,6,141,64,77,120.3125
96,50,7,21,128,-107,-83.59375
96,50,8,88,256,-168,-65.625
96,50,9,166,512,-346,-67.578125
96,50,10,757,1024,-267,-26.07421875
96,50,11,7870,2048,5822,284.27734375
96,50,12,6296,4096,2200,53.7109375
96,50,13,1417,8192,-6775,-82.70263671875
96,50,14,64543,16384,48159,293.939208984375
96,50,15,57067,32768,24299,74.1546630859375
96,51,1,0,2,-2,-100.0
96,51,2,1,4,-3,-75.0
96,51,3,7,8,-1,-12.5
96,51,4,7,16,-9,-56.25
96,51,5,9,32,-23,-71.875
96,51,6,41,64,-23,-35.9375
96,51,7,86,128,-42,-32.8125
96,51,8,270,256,14,5.46875
96,51,9,715,512,203,39.6484375
96,51,10,2542,1024,1518,148.2421875
96,51,11,7749,2048,5701,278.369140625
96,51,12,2332,4096,-1764,-43.06640625
96,51,13,7206,8192,-986,-12.0361328125
96,51,14,5860,16384,-10524,-64.2333984375
96,51,15,14056,32768,-18712,-57.1044921875
96,52,1,0,2,-2,-100.0
96,52,2,1,4,-3,-75.0
96,52,3,15,8,7,87.5
96,52,4,5,16,-11,-68.75
96,52,5,27,32,-5,-15.625
96,52,6,64,64,0,0.0
96,52,7,111,128,-17,-13.28125
96,52,8,139,256,-117,-45.703125
96,52,9,199,512,-313,-61.1328125
96,52,10,1218,1024,194,18.9453125
96,52,11,893,2048,-1155,-56.396484375
96,52,12,5314,4096,1218,29.736328125
96,52,13,898,8192,-7294,-89.0380859375
96,52,14,21122,16384,4738,28.91845703125
96,52,15,55101,32768,22333,68.1549072265625
96,53,1,0,2,-2,-100.0
96,53,2,1,4,-3,-75.0
96,53,3,9,8,1,12.5
96,53,4,13,16,-3,-18.75
96,53,5,54,32,22,68.75
96,53,6,51,64,-13,-20.3125
96,53,7,212,128,84,65.625
96,53,8,53,256,-203,-79.296875
96,53,9,393,512,-119,-23.2421875
96,53,10,1777,1024,753,73.53515625
96,53,11,815,2048,-1233,-60.205078125
96,53,12,2853,4096,-1243,-30.3466796875
96,53,13,1460,8192,-6732,-82.177734375
96,53,14,17365,16384,981,5.987548828125
96,53,15,6735,32768,-26033,-79.4464111328125
96,54,1,0,2,-2,-100.0
96,54,2,2,4,-2,-50.0
96,54,3,2,8,-6,-75.0
96,54,4,6,16,-10,-62.5
96,54,5,11,32,-21,-65.625
96,54,6,28,64,-36,-56.25
96,54,7,71,128,-57,-44.53125
96,54,8,292,256,36,14.0625
96,54,9,404,512,-108,-21.09375
96,54,10,1086,1024,62,6.0546875
96,54,11,347,2048,-1701,-83.056640625
96,54,12,2966,4096,-1130,-27.587890625
96,54,13,2051,8192,-6141,-74.96337890625
96,54,14,53841,16384,37457,228.619384765625
96,54,15,18122,32768,-14646,-44.696044921875
96,55,1,0,2,-2,-100.0
96,55,2,1,4,-3,-75.0
96,55,3,5,8,-3,-37.5
96,55,4,4,16,-12,-75.0
96,55,5,17,32,-15,-46.875
96,55,6,70,64,6,9.375
96,55,7,103,128,-25,-19.53125
96,55,8,76,256,-180,-70.3125
96,55,9,519,512,7,1.3671875
96,55,10,386,1024,-638,-62.3046875
96,55,11,1583,2048,-465,-22.705078125
96,55,12,7727,4096,3631,88.6474609375
96,55,13,3759,8192,-4433,-54.11376953125
96,55,14,21340,16384,4956,30.2490234375
96,55,15,5772,32768,-26996,-82.38525390625
96,56,1,0,2,-2,-100.0
96,56,2,1,4,-3,-75.0
96,56,3,6,8,-2,-25.0
96,56,4,3,16,-13,-81.25
96,56,5,48,32,16,50.0
96,56,6,25,64,-39,-60.9375
96,56,7,383,128,255,199.21875
96,56,8,122,256,-134,-52.34375
96,56,9,303,512,-209,-40.8203125
96,56,10,549,1024,-475,-46.38671875
96,56,11,228,2048,-1820,-88.8671875
96,56,12,8100,4096,4004,97.75390625
96,56,13,12051,8192,3859,47.10693359375
96,56,14,25056,16384,8672,52.9296875
96,56,15,1854,32768,-30914,-94.342041015625
96,57,1,0,2,-2,-100.0
96,57,2,4,4,0,0.0
96,57,3,19,8,11,137.5
96,57,4,22,16,6,37.5
96,57,5,65,32,33,103.125
96,57,6,26,64,-38,-59.375
96,57,7,426,128,298,232.8125
96,57,8,17,256,-239,-93.359375
96,57,9,670,512,158,30.859375
96,57,10,2055,1024,1031,100.68359375
96,57,11,1923,2048,-125,-6.103515625
96,57,12,4827,4096,731,17.8466796875
96,57,13,581,8192,-7611,-92.90771484375
96,57,14,4016,16384,-12368,-75.48828125
96,57,15,33723,32768,955,2.9144287109375
96,58,1,0,2,-2,-100.0
96,58,2,1,4,-3,-75.0
96,58,3,6,8,-2,-25.0
96,58,4,4,16,-12,-75.0
96,58,5,8,32,-24,-75.0
96,58,6,36,64,-28,-43.75
96,58,7,83,128,-45,-35.15625
96,58,8,390,256,134,52.34375
96,58,9,66,512,-446,-87.109375
96,58,10,815,1024,-209,-20.41015625
96,58,11,607,2048,-1441,-70.361328125
96,58,12,628,4096,-3468,-84.66796875
96,58,13,4418,8192,-3774,-46.0693359375
96,58,14,13195,16384,-3189,-19.464111328125
96,58,15,68961,32768,36193,110.4522705078125
96,59,1,0,2,-2,-100.0
96,59,2,2,4,-2,-50.0
96,59,3,9,8,1,12.5
96,59,4,8,16,-8,-50.0
96,59,5,54,32,22,68.75
96,59,6,125,64,61,95.3125
96,59,7,184,128,56,43.75
96,59,8,149,256,-107,-41.796875
96,59,9,81,512,-431,-84.1796875
96,59,10,78,1024,-946,-92.3828125
96,59,11,2372,2048,324,15.8203125
96,59,12,3519,4096,-577,-14.0869140625
96,59,13,19853,8192,11661,142.34619140625
96,59,14,12476,16384,-3908,-23.8525390625
96,59,15,27026,32768,-5742,-17.523193359375
96,60,1,0,2,-2,-100.0
96,60,2,2,4,-2,-50.0
96,60,3,11,8,3,37.5
96,60,4,5,16,-11,-68.75
96,60,5,4,32,-28,-87.5
96,60,6,62,64,-2,-3.125
96,60,7,20,128,-108,-84.375
96,60,8,75,256,-181,-70.703125
96,60,9,825,512,313,61.1328125
96,60,10,63,1024,-961,-93.84765625
96,60,11,262,2048,-1786,-87.20703125
96,60,12,3787,4096,-309,-7.5439453125
96,60,13,7468,8192,-724,-8.837890625
96,60,14,2382,16384,-14002,-85.46142578125
96,60,15,16541,32768,-16227,-49.5208740234375
96,61,1,0,2,-2,-100.0
96,61,2,1,4,-3,-75.0
96,61,3,3,8,-5,-62.5
96,61,4,40,16,24,150.0
96,61,5,11,32,-21,-65.625
96,61,6,5,64,-59,-92.1875
96,61,7,36,128,-92,-71.875
96,61,8,132,256,-124,-48.4375
96,61,9,43,512,-469,-91.6015625
96,61,10,739,1024,-285,-27.83203125
96,61,11,888,2048,-1160,-56.640625
96,61,12,10605,4096,6509,158.9111328125
96,61,13,5451,8192,-2741,-33.45947265625
96,61,14,6919,16384,-9465,-57.769775390625
96,61,15,24328,32768,-8440,-25.7568359375
96,62,1,0,2,-2,-100.0
96,62,2,1,4,-3,-75.0
96,62,3,7,8,-1,-12.5
96,62,4,4,16,-12,-75.0
96,62,5,60,32,28,87.5
96,62,6,261,64,197,307.8125
96,62,7,57,128,-71,-55.46875
96,62,8,161,256,-95,-37.109375
96,62,9,739,512,227,44.3359375
96,62,10,60,1024,-964,-94.140625
96,62,11,42,2048,-2006,-97.94921875
96,62,12,950,4096,-3146,-76.806640625
96,62,13,4565,8192,-3627,-44.27490234375
96,62,14,7300,16384,-9084,-55.4443359375
96,62,15,46583,32768,13815,42.1600341796875
96,63,1,0,2,-2,-100.0
96,63,2,8,4,4,100.0
96,63,3,6,8,-2,-25.0
96,63,4,6,16,-10,-62.5
96,63,5,7,32,-25,-78.125
96,63,6,87,64,23,35.9375
96,63,7,67,128,-61,-47.65625
96,63,8,77,256,-179,-69.921875
96,63,9,8,512,-504,-98.4375
96,63,10,146,1024,-878,-85.7421875
96,63,11,1513,2048,-535,-26.123046875
96,63,12,1250,4096,-2846,-69.482421875
96,63,13,2709,8192,-5483,-66.93115234375
96,63,14,9477,16384,-6907,-42.156982421875
96,63,15,2441,32768,-30327,-92.5506591796875
96,64,1,0,2,-2,-100.0
96,64,2,1,4,-3,-75.0
96,64,3,5,8,-3,-37.5
96,64,4,9,16,-7,-43.75
96,64,5,10,32,-22,-68.75
96,64,6,44,64,-20,-31.25
96,64,7,271,128,143,111.71875
96,64,8,718,256,462,180.46875
96,64,9,944,512,432,84.375
96,64,10,117,1024,-907,-88.57421875
96,64,11,1968,2048,-80,-3.90625
96,64,12,2480,4096,-1616,-39.453125
96,64,13,6386,8192,-1806,-22.0458984375
96,64,14,28536,16384,12152,74.169921875
96,64,15,33664,32768,896,2.734375
96,65,1,0,2,-2,-100.0
96,65,2,1,4,-3,-75.0
96,65,3,9,8,1,12.5
96,65,4,16,16,0,0.0
96,65,5,13,32,-19,-59.375
96,65,6,24,64,-40,-62.5
96,65,7,9,128,-119,-92.96875
96,65,8,182,256,-74,-28.90625
96,65,9,39,512,-473,-92.3828125
96,65,10,1651,1024,627,61.23046875
96,65,11,411,2048,-1637,-79.931640625
96,65,12,796,4096,-3300,-80.56640625
96,65,13,255,8192,-7937,-96.88720703125
96,65,14,15816,16384,-568,-3.466796875
96,65,15,5991,32768,-26777,-81.7169189453125
96,66,1,0,2,-2,-100.0
96,66,2,1,4,-3,-75.0
96,66,3,3,8,-5,-62.5
96,66,4,17,16,1,6.25
96,66,5,10,32,-22,-68.75
96,66,6,222,64,158,246.875
96,66,7,116,128,-12,-9.375
96,66,8,62,256,-194,-75.78125
96,66,9,1941,512,1429,279.1015625
96,66,10,831,1024,-193,-18.84765625
96,66,11,529,2048,-1519,-74.169921875
96,66,12,2798,4096,-1298,-31.689453125
96,66,13,828,8192,-7364,-89.892578125
96,66,14,1959,16384,-14425,-88.043212890625
96,66,15,5807,32768,-26961,-82.2784423828125
96,67,1,0,2,-2,-100.0
96,67,2,3,4,-1,-25.0
96,67,3,3,8,-5,-62.5
96,67,4,10,16,-6,-37.5
96,67,5,13,32,-19,-59.375
96,67,6,57,64,-7,-10.9375
96,67,7,12,128,-116,-90.625
96,67,8,313,256,57,22.265625
96,67,9,1780,512,1268,247.65625
96,67,10,671,1024,-353,-34.47265625
96,67,11,589,2048,-1459,-71.240234375
96,67,12,1807,4096,-2289,-55.8837890625
96,67,13,1704,8192,-6488,-79.19921875
96,67,14,32886,16384,16502,100.72021484375
96,67,15,20154,32768,-12614,-38.494873046875
96,68,1,0,2,-2,-100.0
96,68,2,1,4,-3,-75.0
96,68,3,16,8,8,100.0
96,68,4,30,16,14,87.5
96,68,5,4,32,-28,-87.5
96,68,6,5,64,-59,-92.1875
96,68,7,180,128,52,40.625
96,68,8,75,256,-181,-70.703125
96,68,9,460,512,-52,-10.15625
96,68,10,1122,1024,98,9.5703125
96,68,11,1947,2048,-101,-4.931640625
96,68,12,4851,4096,755,18.4326171875
96,68,13,21225,8192,13033,159.09423828125
96,68,14,249,16384,-16135,-98.480224609375
96,68,15,2148,32768,-30620,-93.44482421875
96,69,1,0,2,-2,-100.0
96,69,2,1,4,-3,-75.0
96,69,3,10,8,2,25.0
96,69,4,16,16,0,0.0
96,69,5,13,32,-19,-59.375
96,69,6,9,64,-55,-85.9375
96,69,7,55,128,-73,-57.03125
96,69,8,115,256,-141,-55.078125
96,69,9,389,512,-123,-24.0234375
96,69,10,3446,1024,2422,236.5234375
96,69,11,10798,2048,8750,427.24609375
96,69,12,2089,4096,-2007,-48.9990234375
96,69,13,2325,8192,-5867,-71.61865234375
96,69,14,2850,16384,-13534,-82.60498046875
96,69,15,45208,32768,12440,37.9638671875
96,70,1,0,2,-2,-100.0
96,70,2,4,4,0,0.0
96,70,3,5,8,-3,-37.5
96,70,4,11,16,-5,-31.25
96,70,5,11,32,-21,-65.625
96,70,6,50,64,-14,-21.875
96,70,7,395,128,267,208.59375
96,70,8,663,256,407,158.984375
96,70,9,2157,512,1645,321.2890625
96,70,10,732,1024,-292,-28.515625
96,70,11,899,2048,-1149,-56.103515625
96,70,12,1801,4096,-2295,-56.0302734375
96,70,13,28593,8192,20401,249.03564453125
96,70,14,25813,16384,9429,57.550048828125
96,70,15,35793,32768,3025,9.2315673828125
96,71,1,0,2,-2,-100.0
96,71,2,1,4,-3,-75.0
96,71,3,2,8,-6,-75.0
96,71,4,14,16,-2,-12.5
96,71,5,6,32,-26,-81.25
96,71,6,122,64,58,90.625
96,71,7,31,128,-97,-75.78125
96,71,8,28,256,-228,-89.0625
96,71,9,342,512,-170,-33.203125
96,71,10,189,1024,-835,-81.54296875
96,71,11,3775,2048,1727,84.326171875
96,71,12,1398,4096,-2698,-65.869140625
96,71,13,5476,8192,-2716,-33.154296875
96,71,14,13274,16384,-3110,-18.98193359375
96,71,15,40876,32768,8108,24.74365234375
96,72,1,0,2,-2,-100.0
96,72,2,1,4,-3,-75.0
96,72,3,3,8,-5,-62.5
96,72,4,36,16,20,125.0
96,72,5,23,32,-9,-28.125
96,72,6,62,64,-2,-3.125
96,72,7,105,128,-23,-17.96875
96,72,8,99,256,-157,-61.328125
96,72,9,219,512,-293,-57.2265625
96,72,10,320,1024,-704,-68.75
96,72,11,156,2048,-1892,-92.3828125
96,72,12,310,4096,-3786,-92.431640625
96,72,13,2016,8192,-6176,-75.390625
96,72,14,17192,16384,808,4.931640625
96,72,15,49968,32768,17200,52.490234375
96,73,1,0,2,-2,-100.0
96,73,2,1,4,-3,-75.0
96,73,3,19,8,11,137.5
96,73,4,3,16,-13,-81.25
96,73,5,27,32,-5,-15.625
96,73,6,297,64,233,364.0625
96,73,7,19,128,-109,-85.15625
96,73,8,210,256,-46,-17.96875
96,73,9,170,512,-342,-66.796875
96,73,10,227,1024,-797,-77.83203125
96,73,11,1763,2048,-285,-13.916015625
96,73,12,2488,4096,-1608,-39.2578125
96,73,13,11272,8192,3080,37.59765625
96,73,14,7573,16384,-8811,-53.778076171875
96,73,15,68330,32768,35562,108.526611328125
96,74,1,0,2,-2,-100.0
96,74,2,1,4,-3,-75.0
96,74,3,4,8,-4,-50.0
96,74,4,31,16,15,93.75
96,74,5,9,32,-23,-71.875
96,74,6,79,64,15,23.4375
96,74,7,22,128,-106,-82.8125
96,74,8,27,256,-229,-89.453125
96,74,9,66,512,-446,-87.109375
96,74,10,149,1024,-875,-85.44921875
96,74,11,175,2048,-1873,-91.455078125
96,74,12,4423,4096,327,7.9833984375
96,74,13,9435,8192,1243,15.17333984375
96,74,14,15140,16384,-1244,-7.5927734375
96,74,15,6476,32768,-26292,-80.23681640625
96,75,1,0,2,-2,-100.0
96,75,2,1,4,-3,-75.0
96,75,3,2,8,-6,-75.0
96,75,4,30,16,14,87.5
96,75,5,5,32,-27,-84.375
96,75,6,17,64,-47,-73.4375
96,75,7,329,128,201,157.03125
96,75,8,24,256,-232,-90.625
96,75,9,966,512,454,88.671875
96,75,10,5133,1024,4109,401.26953125
96,75,11,3792,2048,1744,85.15625
96,75,12,1692,4096,-2404,-58.69140625
96,75,13,26555,8192,18363,224.15771484375
96,75,14,4803,16384,-11581,-70.684814453125
96,75,15,4613,32768,-28155,-85.9222412109375
96,76,1,0,2,-2,-100.0
96,76,2,2,4,-2,-50.0
96,76,3,11,8,3,37.5
96,76,4,3,16,-13,-81.25
96,76,5,23,32,-9,-28.125
96,76,6,114,64,50,78.125
96,76,7,212,128,84,65.625
96,76,8,94,256,-162,-63.28125
96,76,9,641,512,129,25.1953125
96,76,10,148,1024,-876,-85.546875
96,76,11,214,2048,-1834,-89.55078125
96,76,12,10346,4096,6250,152.587890625
96,76,13,3643,8192,-4549,-55.52978515625
96,76,14,10767,16384,-5617,-34.283447265625
96,76,15,49853,32768,17085,52.1392822265625
96,77,1,0,2,-2,-100.0
96,77,2,3,4,-1,-25.0
96,77,3,20,8,12,150.0
96,77,4,8,16,-8,-50.0
96,77,5,44,32,12,37.5
96,77,6,52,64,-12,-18.75
96,77,7,50,128,-78,-60.9375
96,77,8,52,256,-204,-79.6875
96,77,9,2674,512,2162,422.265625
96,77,10,679,1024,-345,-33.69140625
96,77,11,98,2048,-1950,-95.21484375
96,77,12,6313,4096,2217,54.1259765625
96,77,13,8646,8192,454,5.5419921875
96,77,14,24114,16384,7730,47.18017578125
96,77,15,61048,32768,28280,86.3037109375
96,78,1,0,2,-2,-100.0
96,78,2,1,4,-3,-75.0
96,78,3,6,8,-2,-25.0
96,78,4,16,16,0,0.0
96,78,5,49,32,17,53.125
96,78,6,19,64,-45,-70.3125
96,78,7,61,128,-67,-52.34375
96,78,8,523,256,267,104.296875
96,78,9,138,512,-374,-73.046875
96,78,10,2148,1024,1124,109.765625
96,78,11,828,2048,-1220,-59.5703125
96,78,12,2317,4096,-1779,-43.4326171875
96,78,13,13033,8192,4841,59.09423828125
96,78,14,19211,16384,2827,17.254638671875
96,78,15,24776,32768,-7992,-24.3896484375
96,79,1,0,2,-2,-100.0
96,79,2,3,4,-1,-25.0
96,79,3,7,8,-1,-12.5
96,79,4,3,16,-13,-81.25
96,79,5,48,32,16,50.0
96,79,6,40,64,-24,-37.5
96,79,7,34,128,-94,-73.4375
96,79,8,283,256,27,10.546875
96,79,9,489,512,-23,-4.4921875
96,79,10,600,1024,-424,-41.40625
96,79,11,227,2048,-1821,-88.916015625
96,79,12,12558,4096,8462,206.591796875
96,79,13,15733,8192,7541,92.05322265625
96,79,14,12282,16384,-4102,-25.03662109375
96,79,15,7401,32768,-25367,-77.4139404296875
96,80,1,0,2,-2,-100.0
96,80,2,4,4,0,0.0
96,80,3,12,8,4,50.0
96,80,4,24,16,8,50.0
96,80,5,5,32,-27,-84.375
96,80,6,62,64,-2,-3.125
96,80,7,251,128,123,96.09375
96,80,8,136,256,-120,-46.875
96,80,9,40,512,-472,-92.1875
96,80,10,2566,1024,1542,150.5859375
96,80,11,3892,2048,1844,90.0390625
96,80,12,170,4096,-3926,-95.849609375
96,80,13,7679,8192,-513,-6.26220703125
96,80,14,767,16384,-15617,-95.318603515625
96,80,15,5361,32768,-27407,-83.6395263671875
96,81,1,0,2,-2,-100.0
96,81,2,2,4,-2,-50.0
96,81,3,9,8,1,12.5
96,81,4,6,16,-10,-62.5
96,81,5,28,32,-4,-12.5
96,81,6,60,64,-4,-6.25
96,81,7,85,128,-43,-33.59375
96,81,8,44,256,-212,-82.8125
96,81,9,793,512,281,54.8828125
96,81,10,975,1024,-49,-4.78515625
96,81,11,1250,2048,-798,-38.96484375
96,81,12,112,4096,-3984,-97.265625
96,81,13,15891,8192,7699,93.98193359375
96,81,14,19822,16384,3438,20.98388671875
96,81,15,22127,32768,-10641,-32.4737548828125
96,82,1,0,2,-2,-100.0
96,82,2,1,4,-3,-75.0
96,82,3,2,8,-6,-75.0
96,82,4,20,16,4,25.0
96,82,5,9,32,-23,-71.875
96,82,6,5,64,-59,-92.1875
96,82,7,18,128,-110,-85.9375
96,82,8,263,256,7,2.734375
96,82,9,745,512,233,45.5078125
96,82,10,1579,1024,555,54.19921875
96,82,11,2244,2048,196,9.5703125
96,82,12,12257,4096,8161,199.2431640625
96,82,13,1179,8192,-7013,-85.60791015625
96,82,14,18960,16384,2576,15.72265625
96,82,15,43730,32768,10962,33.453369140625
96,83,1,0,2,-2,-100.0
96,83,2,2,4,-2,-50.0
96,83,3,9,8,1,12.5
96,83,4,3,16,-13,-81.25
96,83,5,42,32,10,31.25
96,83,6,70,64,6,9.375
96,83,7,152,128,24,18.75
96,83,8,90,256,-166,-64.84375
96,83,9,10,512,-502,-98.046875
96,83,10,2617,1024,1593,155.56640625
96,83,11,851,2048,-1197,-58.447265625
96,83,12,9356,4096,5260,128.41796875
96,83,13,4576,8192,-3616,-44.140625
96,83,14,20715,16384,4331,26.434326171875
96,83,15,84111,32768,51343,156.6864013671875
96,84,1,0,2,-2,-100.0
96,84,2,2,4,-2,-50.0
96,84,3,5,8,-3,-37.5
96,84,4,15,16,-1,-6.25
96,84,5,23,32,-9,-28.125
96,84,6,20,64,-44,-68.75
96,84,7,91,128,-37,-28.90625
96,84,8,15,256,-241,-94.140625
96,84,9,690,512,178,34.765625
96,84,10,349,1024,-675,-65.91796875
96,84,11,1949,2048,-99,-4.833984375
96,84,12,348,4096,-3748,-91.50390625
96,84,13,497,8192,-7695,-93.93310546875
96,84,14,14459,16384,-1925,-11.749267578125
96,84,15,6937,32768,-25831,-78.8299560546875
96,85,1,0,2,-2,-100.0
96,85,2,5,4,1,25.0
96,85,3,3,8,-5,-62.5
96,85,4,28,16,12,75.0
96,85,5,16,32,-16,-50.0
96,85,6,8,64,-56,-87.5
96,85,7,10,128,-118,-92.1875
96,85,8,69,256,-187,-73.046875
96,85,9,240,512,-272,-53.125
96,85,10,3078,1024,2054,200.5859375
96,85,11,4153,2048,2105,102.783203125
96,85,12,2376,4096,-1720,-41.9921875
96,85,13,8582,8192,390,4.7607421875
96,85,14,10380,16384,-6004,-36.6455078125
96,85,15,28861,32768,-3907,-11.9232177734375
96,86,1,0,2,-2,-100.0
96,86,2,1,4,-3,-75.0
96,86,3,2,8,-6,-75.0
96,86,4,24,16,8,50.0
96,86,5,50,32,18,56.25
96,86,6,5,64,-59,-92.1875
96,86,7,34,128,-94,-73.4375
96,86,8,50,256,-206,-80.46875
96,86,9,422,512,-90,-17.578125
96,86,10,1288,1024,264,25.78125
96,86,11,1541,2048,-507,-24.755859375
96,86,12,16728,4096,12632,308.3984375
96,86,13,4475,8192,-3717,-45.37353515625
96,86,14,16454,16384,70,0.42724609375
96,86,15,61826,32768,29058,88.677978515625
96,87,1,0,2,-2,-100.0
96,87,2,6,4,2,50.0
96,87,3,3,8,-5,-62.5
96,87,4,5,16,-11,-68.75
96,87,5,33,32,1,3.125
96,87,6,102,64,38,59.375
96,87,7,42,128,-86,-67.1875
96,87,8,49,256,-207,-80.859375
96,87,9,1180,512,668,130.46875
96,87,10,588,1024,-436,-42.578125
96,87,11,256,2048,-1792,-87.5
96,87,12,3340,4096,-756,-18.45703125
96,87,13,1702,8192,-6490,-79.2236328125
96,87,14,315,16384,-16069,-98.077392578125
96,87,15,12570,32768,-20198,-61.639404296875
96,88,1,0,2,-2,-100.0
96,88,2,1,4,-3,-75.0
96,88,3,7,8,-1,-12.5
96,88,4,16,16,0,0.0
96,88,5,24,32,-8,-25.0
96,88,6,236,64,172,268.75
96,88,7,26,128,-102,-79.6875
96,88,8,255,256,-1,-0.390625
96,88,9,8,512,-504,-98.4375
96,88,10,3041,1024,2017,196.97265625
96,88,11,2618,2048,570,27.83203125
96,88,12,4732,4096,636,15.52734375
96,88,13,4322,8192,-3870,-47.2412109375
96,88,14,8717,16384,-7667,-46.795654296875
96,88,15,40077,32768,7309,22.3052978515625
96,89,1,0,2,-2,-100.0
96,89,2,1,4,-3,-75.0
96,89,3,5,8,-3,-37.5
96,89,4,5,16,-11,-68.75
96,89,5,52,32,20,62.5
96,89,6,35,64,-29,-45.3125
96,89,7,110,128,-18,-14.0625
96,89,8,245,256,-11,-4.296875
96,89,9,646,512,134,26.171875
96,89,10,261,1024,-763,-74.51171875
96,89,11,261,2048,-1787,-87.255859375
96,89,12,48,4096,-4048,-98.828125
96,89,13,13881,8192,5689,69.44580078125
96,89,14,33302,16384,16918,103.25927734375
96,89,15,39135,32768,6367,19.4305419921875
96,90,1,0,2,-2,-100.0
96,90,2,1,4,-3,-75.0
96,90,3,3,8,-5,-62.5
96,90,4,3,16,-13,-81.25
96,90,5,20,32,-12,-37.5
96,90,6,144,64,80,125.0
96,90,7,56,128,-72,-56.25
96,90,8,188,256,-68,-26.5625
96,90,9,741,512,229,44.7265625
96,90,10,764,1024,-260,-25.390625
96,90,11,1208,2048,-840,-41.015625
96,90,12,50,4096,-4046,-98.779296875
96,90,13,1440,8192,-6752,-82.421875
96,90,14,47172,16384,30788,187.9150390625
96,90,15,23524,32768,-9244,-28.21044921875
96,91,1,0,2,-2,-100.0
96,91,2,2,4,-2,-50.0
96,91,3,3,8,-5,-62.5
96,91,4,4,16,-12,-75.0
96,91,5,26,32,-6,-18.75
96,91,6,14,64,-50,-78.125
96,91,7,34,128,-94,-73.4375
96,91,8,919,256,663,258.984375
96,91,9,238,512,-274,-53.515625
96,91,10,340,1024,-684,-66.796875
96,91,11,6514,2048,4466,218.06640625
96,91,12,130,4096,-3966,-96.826171875
96,91,13,23285,8192,15093,184.24072265625
96,91,14,33194,16384,16810,102.60009765625
96,91,15,21332,32768,-11436,-34.89990234375
96,92,1,0,2,-2,-100.0
96,92,2,1,4,-3,-75.0
96,92,3,2,8,-6,-75.0
96,92,4,3,16,-13,-81.25
96,92,5,54,32,22,68.75
96,92,6,11,64,-53,-82.8125
96,92,7,218,128,90,70.3125
96,92,8,81,256,-175,-68.359375
96,92,9,308,512,-204,-39.84375
96,92,10,3694,1024,2670,260.7421875
96,92,11,576,2048,-1472,-71.875
96,92,12,7132,4096,3036,74.12109375
96,92,13,25086,8192,16894,206.2255859375
96,92,14,6976,16384,-9408,-57.421875
96,92,15,1976,32768,-30792,-93.9697265625
96,93,1,0,2,-2,-100.0
96,93,2,2,4,-2,-50.0
96,93,3,2,8,-6,-75.0
96,93,4,4,16,-12,-75.0
96,93,5,28,32,-4,-12.5
96,93,6,8,64,-56,-87.5
96,93,7,81,128,-47,-36.71875
96,93,8,314,256,58,22.65625
96,93,9,201,512,-311,-60.7421875
96,93,10,674,1024,-350,-34.1796875
96,93,11,590,2048,-1458,-71.19140625
96,93,12,597,4096,-3499,-85.4248046875
96,93,13,11911,8192,3719,45.39794921875
96,93,14,10915,16384,-5469,-33.380126953125
96,93,15,3663,32768,-29105,-88.8214111328125
96,94,1,0,2,-2,-100.0
96,94,2,2,4,-2,-50.0
96,94,3,21,8,13,162.5
96,94,4,6,16,-10,-62.5
96,94,5,40,32,8,25.0
96,94,6,50,64,-14,-21.875
96,94,7,27,128,-101,-78.90625
96,94,8,346,256,90,35.15625
96,94,9,536,512,24,4.6875
96,94,10,1323,1024,299,29.19921875
96,94,11,1258,2048,-790,-38.57421875
96,94,12,190,4096,-3906,-95.361328125
96,94,13,1200,8192,-6992,-85.3515625
96,94,14,9944,16384,-6440,-39.306640625
96,94,15,12665,32768,-20103,-61.3494873046875
96,95,1,0,2,-2,-100.0
96,95,2,2,4,-2,-50.0
96,95,3,3,8,-5,-62.5
96,95,4,5,16,-11,-68.75
96,95,5,11,32,-21,-65.625
96,95,6,201,64,137,214.0625
96,95,7,10,128,-118,-92.1875
96,95,8,10,256,-246,-96.09375
96,95,9,647,512,135,26.3671875
96,95,10,463,1024,-561,-54.78515625
96,95,11,1253,2048,-795,-38.818359375
96,95,12,843,4096,-3253,-79.4189453125
96,95,13,22391,8192,14199,173.32763671875
96,95,14,35386,16384,19002,115.97900390625
96,95,15,1601,32768,-31167,-95.1141357421875
96,96,1,0,2,-2,-100.0
96,96,2,1,4,-3,-75.0
96,96,3,3,8,-5,-62.5
96,96,4,19,16,3,18.75
96,96,5,9,32,-23,-71.875
96,96,6,17,64,-47,-73.4375
96,96,7,68,128,-60,-46.875
96,96,8,289,256,33,12.890625
96,96,9,65,512,-447,-87.3046875
96,96,10,775,1024,-249,-24.31640625
96,96,11,2991,2048,943,46.044921875
96,96,12,5065,4096,969,23.6572265625
96,96,13,38529,8192,30337,370.32470703125
96,96,14,39818,16384,23434,143.02978515625
96,96,15,744,32768,-32024,-97.7294921875
97,1,1,0,2,-2,-100.0
97,1,2,1,4,-3,-75.0
97,1,3,6,8,-2,-25.0
97,1,4,18,16,2,12.5
97,1,5,14,32,-18,-56.25
97,1,6,61,64,-3,-4.6875
97,1,7,360,128,232,181.25
97,1,8,165,256,-91,-35.546875
97,1,9,156,512,-356,-69.53125
97,1,10,902,1024,-122,-11.9140625
97,1,11,1315,2048,-733,-35.791015625
97,1,12,4770,4096,674,16.455078125
97,1,13,822,8192,-7370,-89.9658203125
97,1,14,41164,16384,24780,151.2451171875
97,1,15,41793,32768,9025,27.5421142578125
97,2,1,0,2,-2,-100.0
97,2,2,1,4,-3,-75.0
97,2,3,10,8,2,25.0
97,2,4,4,16,-12,-75.0
97,2,5,24,32,-8,-25.0
97,2,6,15,64,-49,-76.5625
97,2,7,54,128,-74,-57.8125
97,2,8,716,256,460,179.6875
97,2,9,217,512,-295,-57.6171875
97,2,10,346,1024,-678,-66.2109375
97,2,11,1261,2048,-787,-38.427734375
97,2,12,101,4096,-3995,-97.5341796875
97,2,13,10468,8192,2276,27.783203125
97,2,14,78350,16384,61966,378.21044921875
97,2,15,30529,32768,-2239,-6.8328857421875
97,3,1,0,2,-2,-100.0
97,3,2,4,4,0,0.0
97,3,3,14,8,6,75.0
97,3,4,28,16,12,75.0
97,3,5,42,32,10,31.25
97,3,6,123,64,59,92.1875
97,3,7,29,128,-99,-77.34375
97,3,8,302,256,46,17.96875
97,3,9,644,512,132,25.78125
97,3,10,2756,1024,1732,169.140625
97,3,11,1531,2048,-517,-25.244140625
97,3,12,5710,4096,1614,39.404296875
97,3,13,4457,8192,-3735,-45.59326171875
97,3,14,5313,16384,-11071,-67.572021484375
97,3,15,29404,32768,-3364,-10.26611328125
97,4,1,0,2,-2,-100.0
97,4,2,2,4,-2,-50.0
97,4,3,2,8,-6,-75.0
97,4,4,18,16,2,12.5
97,4,5,16,32,-16,-50.0
97,4,6,86,64,22,34.375
97,4,7,290,128,162,126.5625
97,4,8,931,256,675,263.671875
97,4,9,49,512,-463,-90.4296875
97,4,10,639,1024,-385,-37.59765625
97,4,11,738,2048,-1310,-63.96484375
97,4,12,1233,4096,-2863,-69.8974609375
97,4,13,9136,8192,944,11.5234375
97,4,14,9223,16384,-7161,-43.707275390625
97,4,15,23088,32768,-9680,-29.541015625
97,5,1,0,2,-2,-100.0
97,5,2,1,4,-3,-75.0
97,5,3,2,8,-6,-75.0
97,5,4,32,16,16,100.0
97,5,5,24,32,-8,-25.0
97,5,6,6,64,-58,-90.625
97,5,7,53,128,-75,-58.59375
97,5,8,168,256,-88,-34.375
97,5,9,18,512,-494,-96.484375
97,5,10,2218,1024,1194,116.6015625
97,5,11,1207,2048,-841,-41.064453125
97,5,12,6192,4096,2096,51.171875
97,5,13,4772,8192,-3420,-41.748046875
97,5,14,1340,16384,-15044,-91.8212890625
97,5,15,67201,32768,34433,105.0811767578125
97,6,1,0,2,-2,-100.0
97,6,2,1,4,-3,-75.0
97,6,3,6,8,-2,-25.0
97,6,4,4,16,-12,-75.0
97,6,5,7,32,-25,-78.125
97,6,6,135,64,71,110.9375
97,6,7,81,128,-47,-36.71875
97,6,8,329,256,73,28.515625
97,6,9,86,512,-426,-83.203125
97,6,10,792,1024,-232,-22.65625
97,6,11,3297,2048,1249,60.986328125
97,6,12,9556,4096,5460,133.30078125
97,6,13,544,8192,-7648,-93.359375
97,6,14,6804,16384,-9580,-58.4716796875
97,6,15,1399,32768,-31369,-95.7305908203125
97,7,1,0,2,-2,-100.0
97,7,2,2,4,-2,-50.0
97,7,3,2,8,-6,-75.0
97,7,4,5,16,-11,-68.75
97,7,5,4,32,-28,-87.5
97,7,6,66,64,2,3.125
97,7,7,212,128,84,65.625
97,7,8,634,256,378,147.65625
97,7,9,208,512,-304,-59.375
97,7,10,2015,1024,991,96.77734375
97,7,11,538,2048,-1510,-73.73046875
97,7,12,5008,4096,912,22.265625
97,7,13,3984,8192,-4208,-51.3671875
97,7,14,49896,16384,33512,204.541015625
97,7,15,28391,32768,-4377,-13.3575439453125
97,8,1,0,2,-2,-100.0
97,8,2,1,4,-3,-75.0
97,8,3,17,8,9,112.5
97,8,4,7,16,-9,-56.25
97,8,5,66,32,34,106.25
97,8,6,108,64,44,68.75
97,8,7,134,128,6,4.6875
97,8,8,294,256,38,14.84375
97,8,9,1465,512,953,186.1328125
97,8,10,85,1024,-939,-91.69921875
97,8,11,6655,2048,4607,224.951171875
97,8,12,3084,4096,-1012,-24.70703125
97,8,13,28835,8192,20643,251.98974609375
97,8,14,13908,16384,-2476,-15.1123046875
97,8,15,8156,32768,-24612,-75.10986328125
97,9,1,0,2,-2,-100.0
97,9,2,1,4,-3,-75.0
97,9,3,14,8,6,75.0
97,9,4,4,16,-12,-75.0
97,9,5,68,32,36,112.5
97,9,6,93,64,29,45.3125
97,9,7,35,128,-93,-72.65625
97,9,8,118,256,-138,-53.90625
97,9,9,283,512,-229,-44.7265625
97,9,10,1611,1024,587,57.32421875
97,9,11,2772,2048,724,35.3515625
97,9,12,1112,4096,-2984,-72.8515625
97,9,13,428,8192,-7764,-94.775390625
97,9,14,22505,16384,6121,37.359619140625
97,9,15,12637,32768,-20131,-61.4349365234375
97,10,1,0,2,-2,-100.0
97,10,2,1,4,-3,-75.0
97,10,3,19,8,11,137.5
97,10,4,6,16,-10,-62.5
97,10,5,53,32,21,65.625
97,10,6,32,64,-32,-50.0
97,10,7,267,128,139,108.59375
97,10,8,10,256,-246,-96.09375
97,10,9,157,512,-355,-69.3359375
97,10,10,573,1024,-451,-44.04296875
97,10,11,979,2048,-1069,-52.197265625
97,10,12,3736,4096,-360,-8.7890625
97,10,13,15241,8192,7049,86.04736328125
97,10,14,21341,16384,4957,30.255126953125
97,10,15,43768,32768,11000,33.5693359375
97,11,1,0,2,-2,-100.0
97,11,2,1,4,-3,-75.0
97,11,3,3,8,-5,-62.5
97,11,4,23,16,7,43.75
97,11,5,9,32,-23,-71.875
97,11,6,38,64,-26,-40.625
97,11,7,141,128,13,10.15625
97,11,8,863,256,607,237.109375
97,11,9,474,512,-38,-7.421875
97,11,10,566,1024,-458,-44.7265625
97,11,11,3053,2048,1005,49.072265625
97,11,12,6709,4096,2613,63.7939453125
97,11,13,8655,8192,463,5.65185546875
97,11,14,55220,16384,38836,237.0361328125
97,11,15,141545,32768,108777,331.9610595703125
97,12,1,0,2,-2,-100.0
97,12,2,4,4,0,0.0
97,12,3,3,8,-5,-62.5
97,12,4,5,16,-11,-68.75
97,12,5,23,32,-9,-28.125
97,12,6,133,64,69,107.8125
97,12,7,19,128,-109,-85.15625
97,12,8,200,256,-56,-21.875
97,12,9,233,512,-279,-54.4921875
97,12,10,1224,1024,200,19.53125
97,12,11,3016,2048,968,47.265625
97,12,12,1312,4096,-2784,-67.96875
97,12,13,4010,8192,-4182,-51.0498046875
97,12,14,25015,16384,8631,52.679443359375
97,12,15,9808,32768,-22960,-70.068359375
97,13,1,0,2,-2,-100.0
97,13,2,3,4,-1,-25.0
97,13,3,4,8,-4,-50.0
97,13,4,11,16,-5,-31.25
97,13,5,15,32,-17,-53.125
97,13,6,57,64,-7,-10.9375
97,13,7,158,128,30,23.4375
97,13,8,179,256,-77,-30.078125
97,13,9,560,512,48,9.375
97,13,10,35,1024,-989,-96.58203125
97,13,11,225,2048,-1823,-89.013671875
97,13,12,5221,4096,1125,27.4658203125
97,13,13,19387,8192,11195,136.65771484375
97,13,14,7219,16384,-9165,-55.938720703125
97,13,15,9059,32768,-23709,-72.3541259765625
97,14,1,0,2,-2,-100.0
97,14,2,1,4,-3,-75.0
97,14,3,21,8,13,162.5
97,14,4,7,16,-9,-56.25
97,14,5,69,32,37,115.625
97,14,6,127,64,63,98.4375
97,14,7,313,128,185,144.53125
97,14,8,152,256,-104,-40.625
97,14,9,81,512,-431,-84.1796875
97,14,10,887,1024,-137,-13.37890625
97,14,11,176,2048,-1872,-91.40625
97,14,12,8298,4096,4202,102.587890625
97,14,13,1685,8192,-6507,-79.43115234375
97,14,14,1134,16384,-15250,-93.07861328125
97,14,15,43773,32768,11005,33.5845947265625
97,15,1,0,2,-2,-100.0
97,15,2,3,4,-1,-25.0
97,15,3,27,8,19,237.5
97,15,4,36,16,20,125.0
97,15,5,31,32,-1,-3.125
97,15,6,161,64,97,151.5625
97,15,7,268,128,140,109.375
97,15,8,166,256,-90,-35.15625
97,15,9,172,512,-340,-66.40625
97,15,10,1886,1024,862,84.1796875
97,15,11,2523,2048,475,23.193359375
97,15,12,3322,4096,-774,-18.896484375
97,15,13,1386,8192,-6806,-83.0810546875
97,15,14,1683,16384,-14701,-89.727783203125
97,15,15,5502,32768,-27266,-83.209228515625
97,16,1,0,2,-2,-100.0
97,16,2,1,4,-3,-75.0
97,16,3,2,8,-6,-75.0
97,16,4,9,16,-7,-43.75
97,16,5,15,32,-17,-53.125
97,16,6,25,64,-39,-60.9375
97,16,7,162,128,34,26.5625
97,16,8,67,256,-189,-73.828125
97,16,9,1451,512,939,183.3984375
97,16,10,1094,1024,70,6.8359375
97,16,11,3263,2048,1215,59.326171875
97,16,12,6161,4096,2065,50.4150390625
97,16,13,6275,8192,-1917,-23.40087890625
97,16,14,41400,16384,25016,152.685546875
97,16,15,30059,32768,-2709,-8.2672119140625
97,17,1,0,2,-2,-100.0
97,17,2,2,4,-2,-50.0
97,17,3,8,8,0,0.0
97,17,4,3,16,-13,-81.25
97,17,5,20,32,-12,-37.5
97,17,6,7,64,-57,-89.0625
97,17,7,191,128,63,49.21875
97,17,8,770,256,514,200.78125
97,17,9,250,512,-262,-51.171875
97,17,10,1203,1024,179,17.48046875
97,17,11,4281,2048,2233,109.033203125
97,17,12,3916,4096,-180,-4.39453125
97,17,13,10779,8192,2587,31.57958984375
97,17,14,5054,16384,-11330,-69.15283203125
97,17,15,5115,32768,-27653,-84.3902587890625
97,18,1,0,2,-2,-100.0
97,18,2,4,4,0,0.0
97,18,3,2,8,-6,-75.0
97,18,4,10,16,-6,-37.5
97,18,5,9,32,-23,-71.875
97,18,6,35,64,-29,-45.3125
97,18,7,37,128,-91,-71.09375
97,18,8,615,256,359,140.234375
97,18,9,88,512,-424,-82.8125
97,18,10,278,1024,-746,-72.8515625
97,18,11,2056,2048,8,0.390625
97,18,12,1859,4096,-2237,-54.6142578125
97,18,13,15313,8192,7121,86.92626953125
97,18,14,6825,16384,-9559,-58.343505859375
97,18,15,70634,32768,37866,115.557861328125
97,19,1,0,2,-2,-100.0
97,19,2,1,4,-3,-75.0
97,19,3,2,8,-6,-75.0
97,19,4,3,16,-13,-81.25
97,19,5,38,32,6,18.75
97,19,6,17,64,-47,-73.4375
97,19,7,127,128,-1,-0.78125
97,19,8,67,256,-189,-73.828125
97,19,9,145,512,-367,-71.6796875
97,19,10,93,1024,-931,-90.91796875
97,19,11,2527,2048,479,23.388671875
97,19,12,2659,4096,-1437,-35.0830078125
97,19,13,6125,8192,-2067,-25.23193359375
97,19,14,31250,16384,14866,90.73486328125
97,19,15,20080,32768,-12688,-38.720703125
97,20,1,0,2,-2,-100.0
97,20,2,2,4,-2,-50.0
97,20,3,2,8,-6,-75.0
97,20,4,4,16,-12,-75.0
97,20,5,31,32,-1,-3.125
97,20,6,63,64,-1,-1.5625
97,20,7,11,128,-117,-91.40625
97,20,8,271,256,15,5.859375
97,20,9,249,512,-263,-51.3671875
97,20,10,199,1024,-825,-80.56640625
97,20,11,1520,2048,-528,-25.78125
97,20,12,2004,4096,-2092,-51.07421875
97,20,13,3250,8192,-4942,-60.3271484375
97,20,14,8001,16384,-8383,-51.165771484375
97,20,15,56898,32768,24130,73.638916015625
97,21,1,0,2,-2,-100.0
97,21,2,1,4,-3,-75.0
97,21,3,8,8,0,0.0
97,21,4,8,16,-8,-50.0
97,21,5,30,32,-2,-6.25
97,21,6,17,64,-47,-73.4375
97,21,7,133,128,5,3.90625
97,21,8,451,256,195,76.171875
97,21,9,206,512,-306,-59.765625
97,21,10,1120,1024,96,9.375
97,21,11,236,2048,-1812,-88.4765625
97,21,12,3076,4096,-1020,-24.90234375
97,21,13,3350,8192,-4842,-59.1064453125
97,21,14,6113,16384,-10271,-62.689208984375
97,21,15,66507,32768,33739,102.9632568359375
97,22,1,0,2,-2,-100.0
97,22,2,4,4,0,0.0
97,22,3,3,8,-5,-62.5
97,22,4,5,16,-11,-68.75
97,22,5,12,32,-20,-62.5
97,22,6,183,64,119,185.9375
97,22,7,22,128,-106,-82.8125
97,22,8,123,256,-133,-51.953125
97,22,9,836,512,324,63.28125
97,22,10,314,1024,-710,-69.3359375
97,22,11,3376,2048,1328,64.84375
97,22,12,442,4096,-3654,-89.208984375
97,22,13,464,8192,-7728,-94.3359375
97,22,14,14662,16384,-1722,-10.51025390625
97,22,15,9871,32768,-22897,-69.8760986328125
97,23,1,0,2,-2,-100.0
97,23,2,5,4,1,25.0
97,23,3,29,8,21,262.5
97,23,4,5,16,-11,-68.75
97,23,5,12,32,-20,-62.5
97,23,6,48,64,-16,-25.0
97,23,7,89,128,-39,-30.46875
97,23,8,263,256,7,2.734375
97,23,9,771,512,259,50.5859375
97,23,10,1348,1024,324,31.640625
97,23,11,356,2048,-1692,-82.6171875
97,23,12,12257,4096,8161,199.2431640625
97,23,13,18969,8192,10777,131.55517578125
97,23,14,53353,16384,36969,225.640869140625
97,23,15,25603,32768,-7165,-21.8658447265625
97,24,1,0,2,-2,-100.0
97,24,2,1,4,-3,-75.0
97,24,3,9,8,1,12.5
97,24,4,25,16,9,56.25
97,24,5,90,32,58,181.25
97,24,6,5,64,-59,-92.1875
97,24,7,143,128,15,11.71875
97,24,8,145,256,-111,-43.359375
97,24,9,497,512,-15,-2.9296875
97,24,10,476,1024,-548,-53.515625
97,24,11,1752,2048,-296,-14.453125
97,24,12,2320,4096,-1776,-43.359375
97,24,13,1230,8192,-6962,-84.9853515625
97,24,14,21228,16384,4844,29.5654296875
97,24,15,64071,32768,31303,95.5291748046875
97,25,1,0,2,-2,-100.0
97,25,2,1,4,-3,-75.0
97,25,3,14,8,6,75.0
97,25,4,10,16,-6,-37.5
97,25,5,11,32,-21,-65.625
97,25,6,14,64,-50,-78.125
97,25,7,83,128,-45,-35.15625
97,25,8,37,256,-219,-85.546875
97,25,9,289,512,-223,-43.5546875
97,25,10,2078,1024,1054,102.9296875
97,25,11,58,2048,-1990,-97.16796875
97,25,12,2161,4096,-1935,-47.2412109375
97,25,13,6800,8192,-1392,-16.9921875
97,25,14,10105,16384,-6279,-38.323974609375
97,25,15,478,32768,-32290,-98.541259765625
97,26,1,0,2,-2,-100.0
97,26,2,1,4,-3,-75.0
97,26,3,4,8,-4,-50.0
97,26,4,4,16,-12,-75.0
97,26,5,5,32,-27,-84.375
97,26,6,17,64,-47,-73.4375
97,26,7,174,128,46,35.9375
97,26,8,397,256,141,55.078125
97,26,9,489,512,-23,-4.4921875
97,26,10,671,1024,-353,-34.47265625
97,26,11,409,2048,-1639,-80.029296875
97,26,12,5110,4096,1014,24.755859375
97,26,13,5178,8192,-3014,-36.7919921875
97,26,14,788,16384,-15596,-95.1904296875
97,26,15,9390,32768,-23378,-71.343994140625
97,27,1,0,2,-2,-100.0
97,27,2,3,4,-1,-25.0
97,27,3,15,8,7,87.5
97,27,4,13,16,-3,-18.75
97,27,5,27,32,-5,-15.625
97,27,6,50,64,-14,-21.875
97,27,7,180,128,52,40.625
97,27,8,244,256,-12,-4.6875
97,27,9,574,512,62,12.109375
97,27,10,351,1024,-673,-65.72265625
97,27,11,1629,2048,-419,-20.458984375
97,27,12,1759,4096,-2337,-57.0556640625
97,27,13,19129,8192,10937,133.50830078125
97,27,14,24244,16384,7860,47.9736328125
97,27,15,19549,32768,-13219,-40.3411865234375
97,28,1,0,2,-2,-100.0
97,28,2,1,4,-3,-75.0
97,28,3,2,8,-6,-75.0
97,28,4,5,16,-11,-68.75
97,28,5,17,32,-15,-46.875
97,28,6,33,64,-31,-48.4375
97,28,7,163,128,35,27.34375
97,28,8,365,256,109,42.578125
97,28,9,167,512,-345,-67.3828125
97,28,10,355,1024,-669,-65.33203125
97,28,11,679,2048,-1369,-66.845703125
97,28,12,1967,4096,-2129,-51.9775390625
97,28,13,7346,8192,-846,-10.3271484375
97,28,14,2356,16384,-14028,-85.6201171875
97,28,15,97410,32768,64642,197.271728515625
97,29,1,0,2,-2,-100.0
97,29,2,3,4,-1,-25.0
97,29,3,14,8,6,75.0
97,29,4,7,16,-9,-56.25
97,29,5,9,32,-23,-71.875
97,29,6,38,64,-26,-40.625
97,29,7,83,128,-45,-35.15625
97,29,8,153,256,-103,-40.234375
97,29,9,585,512,73,14.2578125
97,29,10,642,1024,-382,-37.3046875
97,29,11,3202,2048,1154,56.34765625
97,29,12,9019,4096,4923,120.1904296875
97,29,13,7613,8192,-579,-7.06787109375
97,29,14,102479,16384,86095,525.482177734375
97,29,15,2500,32768,-30268,-92.37060546875
97,30,1,0,2,-2,-100.0
97,30,2,1,4,-3,-75.0
97,30,3,4,8,-4,-50.0
97,30,4,3,16,-13,-81.25
97,30,5,35,32,3,9.375
97,30,6,37,64,-27,-42.1875
97,30,7,185,128,57,44.53125
97,30,8,33,256,-223,-87.109375
97,30,9,447,512,-65,-12.6953125
97,30,10,1722,1024,698,68.1640625
97,30,11,4172,2048,2124,103.7109375
97,30,12,651,4096,-3445,-84.1064453125
97,30,13,2614,8192,-5578,-68.0908203125
97,30,14,1061,16384,-15323,-93.524169921875
97,30,15,106158,32768,73390,223.968505859375
97,31,1,0,2,-2,-100.0
97,31,2,1,4,-3,-75.0
97,31,3,7,8,-1,-12.5
97,31,4,20,16,4,25.0
97,31,5,49,32,17,53.125
97,31,6,14,64,-50,-78.125
97,31,7,309,128,181,141.40625
97,31,8,69,256,-187,-73.046875
97,31,9,1423,512,911,177.9296875
97,31,10,1218,1024,194,18.9453125
97,31,11,937,2048,-1111,-54.248046875
97,31,12,3071,4096,-1025,-25.0244140625
97,31,13,3028,8192,-5164,-63.037109375
97,31,14,2898,16384,-13486,-82.31201171875
97,31,15,19888,32768,-12880,-39.306640625
97,32,1,0,2,-2,-100.0
97,32,2,1,4,-3,-75.0
97,32,3,7,8,-1,-12.5
97,32,4,3,16,-13,-81.25
97,32,5,14,32,-18,-56.25
97,32,6,140,64,76,118.75
97,32,7,65,128,-63,-49.21875
97,32,8,496,256,240,93.75
97,32,9,2546,512,2034,397.265625
97,32,10,57,1024,-967,-94.43359375
97,32,11,2885,2048,837,40.869140625
97,32,12,21359,4096,17263,421.4599609375
97,32,13,10550,8192,2358,28.7841796875
97,32,14,8318,16384,-8066,-49.23095703125
97,32,15,19646,32768,-13122,-40.045166015625
97,33,1,0,2,-2,-100.0
97,33,2,1,4,-3,-75.0
97,33,3,4,8,-4,-50.0
97,33,4,11,16,-5,-31.25
97,33,5,15,32,-17,-53.125
97,33,6,26,64,-38,-59.375
97,33,7,106,128,-22,-17.1875
97,33,8,413,256,157,61.328125
97,33,9,77,512,-435,-84.9609375
97,33,10,713,1024,-311,-30.37109375
97,33,11,7669,2048,5621,274.462890625
97,33,12,4252,4096,156,3.80859375
97,33,13,2625,8192,-5567,-67.95654296875
97,33,14,3822,16384,-12562,-76.67236328125
97,33,15,8951,32768,-23817,-72.6837158203125
97,34,1,0,2,-2,-100.0
97,34,2,2,4,-2,-50.0
97,34,3,7,8,-1,-12.5
97,34,4,56,16,40,250.0
97,34,5,55,32,23,71.875
97,34,6,100,64,36,56.25
97,34,7,131,128,3,2.34375
97,34,8,333,256,77,30.078125
97,34,9,82,512,-430,-83.984375
97,34,10,1490,1024,466,45.5078125
97,34,11,3759,2048,1711,83.544921875
97,34,12,1600,4096,-2496,-60.9375
97,34,13,7292,8192,-900,-10.986328125
97,34,14,29001,16384,12617,77.008056640625
97,34,15,17260,32768,-15508,-47.32666015625
97,35,1,0,2,-2,-100.0
97,35,2,2,4,-2,-50.0
97,35,3,15,8,7,87.5
97,35,4,55,16,39,243.75
97,35,5,7,32,-25,-78.125
97,35,6,19,64,-45,-70.3125
97,35,7,141,128,13,10.15625
97,35,8,252,256,-4,-1.5625
97,35,9,197,512,-315,-61.5234375
97,35,10,1154,1024,130,12.6953125
97,35,11,198,2048,-1850,-90.33203125
97,35,12,8479,4096,4383,107.0068359375
97,35,13,2158,8192,-6034,-73.6572265625
97,35,14,1111,16384,-15273,-93.218994140625
97,35,15,3554,32768,-29214,-89.154052734375
97,36,1,0,2,-2,-100.0
97,36,2,1,4,-3,-75.0
97,36,3,3,8,-5,-62.5
97,36,4,36,16,20,125.0
97,36,5,50,32,18,56.25
97,36,6,12,64,-52,-81.25
97,36,7,529,128,401,313.28125
97,36,8,263,256,7,2.734375
97,36,9,130,512,-382,-74.609375
97,36,10,212,1024,-812,-79.296875
97,36,11,600,2048,-1448,-70.703125
97,36,12,1521,4096,-2575,-62.8662109375
97,36,13,13991,8192,5799,70.78857421875
97,36,14,6183,16384,-10201,-62.261962890625
97,36,15,13916,32768,-18852,-57.53173828125
97,37,1,0,2,-2,-100.0
97,37,2,3,4,-1,-25.0
97,37,3,2,8,-6,-75.0
97,37,4,27,16,11,68.75
97,37,5,36,32,4,12.5
97,37,6,7,64,-57,-89.0625
97,37,7,637,128,509,397.65625
97,37,8,70,256,-186,-72.65625
97,37,9,132,512,-380,-74.21875
97,37,10,3301,1024,2277,222.36328125
97,37,11,656,2048,-1392,-67.96875
97,37,12,14017,4096,9921,242.2119140625
97,37,13,3437,8192,-4755,-58.04443359375
97,37,14,1061,16384,-15323,-93.524169921875
97,37,15,68996,32768,36228,110.55908203125
97,38,1,0,2,-2,-100.0
97,38,2,2,4,-2,-50.0
97,38,3,4,8,-4,-50.0
97,38,4,7,16,-9,-56.25
97,38,5,12,32,-20,-62.5
97,38,6,33,64,-31,-48.4375
97,38,7,659,128,531,414.84375
97,38,8,91,256,-165,-64.453125
97,38,9,266,512,-246,-48.046875
97,38,10,820,1024,-204,-19.921875
97,38,11,5167,2048,3119,152.294921875
97,38,12,6219,4096,2123,51.8310546875
97,38,13,1991,8192,-6201,-75.69580078125
97,38,14,1954,16384,-14430,-88.07373046875
97,38,15,9173,32768,-23595,-72.0062255859375
97,39,1,0,2,-2,-100.0
97,39,2,1,4,-3,-75.0
97,39,3,13,8,5,62.5
97,39,4,13,16,-3,-18.75
97,39,5,7,32,-25,-78.125
97,39,6,138,64,74,115.625
97,39,7,551,128,423,330.46875
97,39,8,57,256,-199,-77.734375
97,39,9,155,512,-357,-69.7265625
97,39,10,117,1024,-907,-88.57421875
97,39,11,936,2048,-1112,-54.296875
97,39,12,1254,4096,-2842,-69.384765625
97,39,13,7447,8192,-745,-9.09423828125
97,39,14,11022,16384,-5362,-32.72705078125
97,39,15,12810,32768,-19958,-60.906982421875
97,40,1,0,2,-2,-100.0
97,40,2,2,4,-2,-50.0
97,40,3,10,8,2,25.0
97,40,4,7,16,-9,-56.25
97,40,5,29,32,-3,-9.375
97,40,6,15,64,-49,-76.5625
97,40,7,82,128,-46,-35.9375
97,40,8,89,256,-167,-65.234375
97,40,9,409,512,-103,-20.1171875
97,40,10,952,1024,-72,-7.03125
97,40,11,721,2048,-1327,-64.794921875
97,40,12,2000,4096,-2096,-51.171875
97,40,13,16245,8192,8053,98.30322265625
97,40,14,9185,16384,-7199,-43.939208984375
97,40,15,61781,32768,29013,88.5406494140625
97,41,1,0,2,-2,-100.0
97,41,2,1,4,-3,-75.0
97,41,3,2,8,-6,-75.0
97,41,4,18,16,2,12.5
97,41,5,74,32,42,131.25
97,41,6,21,64,-43,-67.1875
97,41,7,45,128,-83,-64.84375
97,41,8,254,256,-2,-0.78125
97,41,9,109,512,-403,-78.7109375
97,41,10,35,1024,-989,-96.58203125
97,41,11,118,2048,-1930,-94.23828125
97,41,12,19185,4096,15089,368.3837890625
97,41,13,12403,8192,4211,51.40380859375
97,41,14,3889,16384,-12495,-76.263427734375
97,41,15,670,32768,-32098,-97.955322265625
97,42,1,0,2,-2,-100.0
97,42,2,1,4,-3,-75.0
97,42,3,6,8,-2,-25.0
97,42,4,22,16,6,37.5
97,42,5,5,32,-27,-84.375
97,42,6,7,64,-57,-89.0625
97,42,7,115,128,-13,-10.15625
97,42,8,193,256,-63,-24.609375
97,42,9,649,512,137,26.7578125
97,42,10,2209,1024,1185,115.72265625
97,42,11,642,2048,-1406,-68.65234375
97,42,12,1112,4096,-2984,-72.8515625
97,42,13,2309,8192,-5883,-71.81396484375
97,42,14,20727,16384,4343,26.507568359375
97,42,15,902,32768,-31866,-97.247314453125
97,43,1,0,2,-2,-100.0
97,43,2,1,4,-3,-75.0
97,43,3,8,8,0,0.0
97,43,4,20,16,4,25.0
97,43,5,20,32,-12,-37.5
97,43,6,137,64,73,114.0625
97,43,7,91,128,-37,-28.90625
97,43,8,28,256,-228,-89.0625
97,43,9,484,512,-28,-5.46875
97,43,10,2796,1024,1772,173.046875
97,43,11,191,2048,-1857,-90.673828125
97,43,12,4863,4096,767,18.7255859375
97,43,13,3939,8192,-4253,-51.91650390625
97,43,14,7043,16384,-9341,-57.012939453125
97,43,15,301332,32768,268564,819.59228515625
97,44,1,0,2,-2,-100.0
97,44,2,2,4,-2,-50.0
97,44,3,3,8,-5,-62.5
97,44,4,39,16,23,143.75
97,44,5,4,32,-28,-87.5
97,44,6,25,64,-39,-60.9375
97,44,7,89,128,-39,-30.46875
97,44,8,412,256,156,60.9375
97,44,9,93,512,-419,-81.8359375
97,44,10,308,1024,-716,-69.921875
97,44,11,2834,2048,786,38.37890625
97,44,12,2442,4096,-1654,-40.380859375
97,44,13,1608,8192,-6584,-80.37109375
97,44,14,8825,16384,-7559,-46.136474609375
97,44,15,108178,32768,75410,230.133056640625
97,45,1,0,2,-2,-100.0
97,45,2,1,4,-3,-75.0
97,45,3,2,8,-6,-75.0
97,45,4,9,16,-7,-43.75
97,45,5,12,32,-20,-62.5
97,45,6,52,64,-12,-18.75
97,45,7,109,128,-19,-14.84375
97,45,8,331,256,75,29.296875
97,45,9,511,512,-1,-0.1953125
97,45,10,989,1024,-35,-3.41796875
97,45,11,5905,2048,3857,188.330078125
97,45,12,4121,4096,25,0.6103515625
97,45,13,5544,8192,-2648,-32.32421875
97,45,14,6190,16384,-10194,-62.21923828125
97,45,15,27246,32768,-5522,-16.851806640625
97,46,1,0,2,-2,-100.0
97,46,2,1,4,-3,-75.0
97,46,3,5,8,-3,-37.5
97,46,4,15,16,-1,-6.25
97,46,5,11,32,-21,-65.625
97,46,6,181,64,117,182.8125
97,46,7,403,128,275,214.84375
97,46,8,38,256,-218,-85.15625
97,46,9,849,512,337,65.8203125
97,46,10,1887,1024,863,84.27734375
97,46,11,2075,2048,27,1.318359375
97,46,12,67,4096,-4029,-98.3642578125
97,46,13,22565,8192,14373,175.45166015625
97,46,14,1218,16384,-15166,-92.56591796875
97,46,15,103268,32768,70500,215.14892578125
97,47,1,0,2,-2,-100.0
97,47,2,1,4,-3,-75.0
97,47,3,15,8,7,87.5
97,47,4,3,16,-13,-81.25
97,47,5,38,32,6,18.75
97,47,6,21,64,-43,-67.1875
97,47,7,70,128,-58,-45.3125
97,47,8,379,256,123,48.046875
97,47,9,1506,512,994,194.140625
97,47,10,57,1024,-967,-94.43359375
97,47,11,1474,2048,-574,-28.02734375
97,47,12,4682,4096,586,14.306640625
97,47,13,2069,8192,-6123,-74.74365234375
97,47,14,15186,16384,-1198,-7.31201171875
97,47,15,19903,32768,-12865,-39.2608642578125
97,48,1,0,2,-2,-100.0
97,48,2,3,4,-1,-25.0
97,48,3,6,8,-2,-25.0
97,48,4,5,16,-11,-68.75
97,48,5,171,32,139,434.375
97,48,6,18,64,-46,-71.875
97,48,7,131,128,3,2.34375
97,48,8,284,256,28,10.9375
97,48,9,602,512,90,17.578125
97,48,10,1367,1024,343,33.49609375
97,48,11,2325,2048,277,13.525390625
97,48,12,4895,4096,799,19.5068359375
97,48,13,2341,8192,-5851,-71.42333984375
97,48,14,16916,16384,532,3.2470703125
97,48,15,10960,32768,-21808,-66.552734375
97,49,1,0,2,-2,-100.0
97,49,2,1,4,-3,-75.0
97,49,3,2,8,-6,-75.0
97,49,4,6,16,-10,-62.5
97,49,5,27,32,-5,-15.625
97,49,6,63,64,-1,-1.5625
97,49,7,30,128,-98,-76.5625
97,49,8,390,256,134,52.34375
97,49,9,730,512,218,42.578125
97,49,10,804,1024,-220,-21.484375
97,49,11,101,2048,-1947,-95.068359375
97,49,12,8919,4096,4823,117.7490234375
97,49,13,2772,8192,-5420,-66.162109375
97,49,14,44913,16384,28529,174.127197265625
97,49,15,13036,32768,-19732,-60.21728515625
97,50,1,0,2,-2,-100.0
97,50,2,1,4,-3,-75.0
97,50,3,5,8,-3,-37.5
97,50,4,8,16,-8,-50.0
97,50,5,11,32,-21,-65.625
97,50,6,11,64,-53,-82.8125
97,50,7,100,128,-28,-21.875
97,50,8,971,256,715,279.296875
97,50,9,217,512,-295,-57.6171875
97,50,10,909,1024,-115,-11.23046875
97,50,11,412,2048,-1636,-79.8828125
97,50,12,3933,4096,-163,-3.9794921875
97,50,13,30506,8192,22314,272.3876953125
97,50,14,9218,16384,-7166,-43.73779296875
97,50,15,64763,32768,31995,97.6409912109375
97,51,1,0,2,-2,-100.0
97,51,2,1,4,-3,-75.0
97,51,3,5,8,-3,-37.5
97,51,4,24,16,8,50.0
97,51,5,179,32,147,459.375
97,51,6,17,64,-47,-73.4375
97,51,7,254,128,126,98.4375
97,51,8,83,256,-173,-67.578125
97,51,9,35,512,-477,-93.1640625
97,51,10,890,1024,-134,-13.0859375
97,51,11,12,2048,-2036,-99.4140625
97,51,12,1733,4096,-2363,-57.6904296875
97,51,13,5688,8192,-2504,-30.56640625
97,51,14,8472,16384,-7912,-48.291015625
97,51,15,5871,32768,-26897,-82.0831298828125
97,52,1,0,2,-2,-100.0
97,52,2,1,4,-3,-75.0
97,52,3,2,8,-6,-75.0
97,52,4,23,16,7,43.75
97,52,5,31,32,-1,-3.125
97,52,6,18,64,-46,-71.875
97,52,7,120,128,-8,-6.25
97,52,8,403,256,147,57.421875
97,52,9,342,512,-170,-33.203125
97,52,10,1655,1024,631,61.62109375
97,52,11,478,2048,-1570,-76.66015625
97,52,12,366,4096,-3730,-91.064453125
97,52,13,4496,8192,-3696,-45.1171875
97,52,14,44574,16384,28190,172.05810546875
97,52,15,19587,32768,-13181,-40.2252197265625
97,53,1,0,2,-2,-100.0
97,53,2,4,4,0,0.0
97,53,3,2,8,-6,-75.0
97,53,4,16,16,0,0.0
97,53,5,7,32,-25,-78.125
97,53,6,54,64,-10,-15.625
97,53,7,101,128,-27,-21.09375
97,53,8,419,256,163,63.671875
97,53,9,80,512,-432,-84.375
97,53,10,139,1024,-885,-86.42578125
97,53,11,1341,2048,-707,-34.521484375
97,53,12,3186,4096,-910,-22.216796875
97,53,13,13882,8192,5690,69.4580078125
97,53,14,23131,16384,6747,41.180419921875
97,53,15,7682,32768,-25086,-76.556396484375
97,54,1,0,2,-2,-100.0
97,54,2,2,4,-2,-50.0
97,54,3,4,8,-4,-50.0
97,54,4,49,16,33,206.25
97,54,5,36,32,4,12.5
97,54,6,50,64,-14,-21.875
97,54,7,145,128,17,13.28125
97,54,8,625,256,369,144.140625
97,54,9,1135,512,623,121.6796875
97,54,10,278,1024,-746,-72.8515625
97,54,11,3265,2048,1217,59.423828125
97,54,12,3602,4096,-494,-12.060546875
97,54,13,151,8192,-8041,-98.15673828125
97,54,14,6596,16384,-9788,-59.7412109375
97,54,15,3160,32768,-29608,-90.3564453125
97,55,1,0,2,-2,-100.0
97,55,2,1,4,-3,-75.0
97,55,3,9,8,1,12.5
97,55,4,3,16,-13,-81.25
97,55,5,32,32,0,0.0
97,55,6,65,64,1,1.5625
97,55,7,224,128,96,75.0
97,55,8,1251,256,995,388.671875
97,55,9,1229,512,717,140.0390625
97,55,10,26,1024,-998,-97.4609375
97,55,11,3098,2048,1050,51.26953125
97,55,12,12497,4096,8401,205.1025390625
97,55,13,4999,8192,-3193,-38.97705078125
97,55,14,21287,16384,4903,29.925537109375
97,55,15,74503,32768,41735,127.3651123046875
97,56,1,0,2,-2,-100.0
97,56,2,1,4,-3,-75.0
97,56,3,3,8,-5,-62.5
97,56,4,13,16,-3,-18.75
97,56,5,6,32,-26,-81.25
97,56,6,48,64,-16,-25.0
97,56,7,80,128,-48,-37.5
97,56,8,407,256,151,58.984375
97,56,9,201,512,-311,-60.7421875
97,56,10,15,1024,-1009,-98.53515625
97,56,11,3345,2048,1297,63.330078125
97,56,12,1396,4096,-2700,-65.91796875
97,56,13,6885,8192,-1307,-15.95458984375
97,56,14,16042,16384,-342,-2.08740234375
97,56,15,97121,32768,64353,196.3897705078125
97,57,1,0,2,-2,-100.0
97,57,2,5,4,1,25.0
97,57,3,12,8,4,50.0
97,57,4,26,16,10,62.5
97,57,5,44,32,12,37.5
97,57,6,13,64,-51,-79.6875
97,57,7,126,128,-2,-1.5625
97,57,8,351,256,95,37.109375
97,57,9,87,512,-425,-83.0078125
97,57,10,1363,1024,339,33.10546875
97,57,11,913,2048,-1135,-55.419921875
97,57,12,10214,4096,6118,149.365234375
97,57,13,593,8192,-7599,-92.76123046875
97,57,14,503,16384,-15881,-96.929931640625
97,57,15,83325,32768,50557,154.2877197265625
97,58,1,0,2,-2,-100.0
97,58,2,1,4,-3,-75.0
97,58,3,2,8,-6,-75.0
97,58,4,4,16,-12,-75.0
97,58,5,29,32,-3,-9.375
97,58,6,67,64,3,4.6875
97,58,7,223,128,95,74.21875
97,58,8,182,256,-74,-28.90625
97,58,9,198,512,-314,-61.328125
97,58,10,1072,1024,48,4.6875
97,58,11,1419,2048,-629,-30.712890625
97,58,12,4636,4096,540,13.18359375
97,58,13,1172,8192,-7020,-85.693359375
97,58,14,2405,16384,-13979,-85.321044921875
97,58,15,34762,32768,1994,6.085205078125
97,59,1,0,2,-2,-100.0
97,59,2,2,4,-2,-50.0
97,59,3,7,8,-1,-12.5
97,59,4,22,16,6,37.5
97,59,5,26,32,-6,-18.75
97,59,6,145,64,81,126.5625
97,59,7,382,128,254,198.4375
97,59,8,501,256,245,95.703125
97,59,9,658,512,146,28.515625
97,59,10,3178,1024,2154,210.3515625
97,59,11,379,2048,-1669,-81.494140625
97,59,12,2097,4096,-1999,-48.8037109375
97,59,13,1682,8192,-6510,-79.4677734375
97,59,14,40574,16384,24190,147.64404296875
97,59,15,13724,32768,-19044,-58.11767578125
97,60,1,0,2,-2,-100.0
97,60,2,2,4,-2,-50.0
97,60,3,6,8,-2,-25.0
97,60,4,3,16,-13,-81.25
97,60,5,17,32,-15,-46.875
97,60,6,29,64,-35,-54.6875
97,60,7,47,128,-81,-63.28125
97,60,8,67,256,-189,-73.828125
97,60,9,17,512,-495,-96.6796875
97,60,10,2561,1024,1537,150.09765625
97,60,11,5690,2048,3642,177.83203125
97,60,12,13303,4096,9207,224.7802734375
97,60,13,2391,8192,-5801,-70.81298828125
97,60,14,638,16384,-15746,-96.10595703125
97,60,15,5763,32768,-27005,-82.4127197265625
97,61,1,0,2,-2,-100.0
97,61,2,4,4,0,0.0
97,61,3,5,8,-3,-37.5
97,61,4,15,16,-1,-6.25
97,61,5,21,32,-11,-34.375
97,61,6,13,64,-51,-79.6875
97,61,7,28,128,-100,-78.125
97,61,8,236,256,-20,-7.8125
97,61,9,235,512,-277,-54.1015625
97,61,10,2297,1024,1273,124.31640625
97,61,11,1481,2048,-567,-27.685546875
97,61,12,9245,4096,5149,125.7080078125
97,61,13,13029,8192,4837,59.04541015625
97,61,14,6396,16384,-9988,-60.9619140625
97,61,15,930,32768,-31838,-97.161865234375
97,62,1,0,2,-2,-100.0
97,62,2,1,4,-3,-75.0
97,62,3,2,8,-6,-75.0
97,62,4,8,16,-8,-50.0
97,62,5,48,32,16,50.0
97,62,6,57,64,-7,-10.9375
97,62,7,7,128,-121,-94.53125
97,62,8,388,256,132,51.5625
97,62,9,758,512,246,48.046875
97,62,10,5025,1024,4001,390.72265625
97,62,11,2203,2048,155,7.568359375
97,62,12,1170,4096,-2926,-71.435546875
97,62,13,9711,8192,1519,18.54248046875
97,62,14,13320,16384,-3064,-18.701171875
97,62,15,9967,32768,-22801,-69.5831298828125
97,63,1,0,2,-2,-100.0
97,63,2,4,4,0,0.0
97,63,3,19,8,11,137.5
97,63,4,29,16,13,81.25
97,63,5,73,32,41,128.125
97,63,6,41,64,-23,-35.9375
97,63,7,193,128,65,50.78125
97,63,8,557,256,301,117.578125
97,63,9,402,512,-110,-21.484375
97,63,10,104,1024,-920,-89.84375
97,63,11,163,2048,-1885,-92.041015625
97,63,12,895,4096,-3201,-78.1494140625
97,63,13,13717,8192,5525,67.44384765625
97,63,14,6766,16384,-9618,-58.70361328125
97,63,15,5576,32768,-27192,-82.9833984375
97,64,1,0,2,-2,-100.0
97,64,2,2,4,-2,-50.0
97,64,3,7,8,-1,-12.5
97,64,4,26,16,10,62.5
97,64,5,30,32,-2,-6.25
97,64,6,49,64,-15,-23.4375
97,64,7,127,128,-1,-0.78125
97,64,8,286,256,30,11.71875
97,64,9,35,512,-477,-93.1640625
97,64,10,48,1024,-976,-95.3125
97,64,11,5731,2048,3683,179.833984375
97,64,12,3013,4096,-1083,-26.4404296875
97,64,13,1512,8192,-6680,-81.54296875
97,64,14,14869,16384,-1515,-9.246826171875
97,64,15,32997,32768,229,0.6988525390625
97,65,1,0,2,-2,-100.0
97,65,2,2,4,-2,-50.0
97,65,3,6,8,-2,-25.0
97,65,4,9,16,-7,-43.75
97,65,5,13,32,-19,-59.375
97,65,6,25,64,-39,-60.9375
97,65,7,142,128,14,10.9375
97,65,8,142,256,-114,-44.53125
97,65,9,229,512,-283,-55.2734375
97,65,10,1234,1024,210,20.5078125
97,65,11,1024,2048,-1024,-50.0
97,65,12,747,4096,-3349,-81.7626953125
97,65,13,192,8192,-8000,-97.65625
97,65,14,14539,16384,-1845,-11.260986328125
97,65,15,14085,32768,-18683,-57.0159912109375
97,66,1,0,2,-2,-100.0
97,66,2,2,4,-2,-50.0
97,66,3,5,8,-3,-37.5
97,66,4,15,16,-1,-6.25
97,66,5,4,32,-28,-87.5
97,66,6,32,64,-32,-50.0
97,66,7,20,128,-108,-84.375
97,66,8,196,256,-60,-23.4375
97,66,9,798,512,286,55.859375
97,66,10,194,1024,-830,-81.0546875
97,66,11,459,2048,-1589,-77.587890625
97,66,12,5139,4096,1043,25.4638671875
97,66,13,19800,8192,11608,141.69921875
97,66,14,8973,16384,-7411,-45.233154296875
97,66,15,60677,32768,27909,85.1715087890625
97,67,1,0,2,-2,-100.0
97,67,2,3,4,-1,-25.0
97,67,3,6,8,-2,-25.0
97,67,4,6,16,-10,-62.5
97,67,5,12,32,-20,-62.5
97,67,6,33,64,-31,-48.4375
97,67,7,214,128,86,67.1875
97,67,8,215,256,-41,-16.015625
97,67,9,805,512,293,57.2265625
97,67,10,560,1024,-464,-45.3125
97,67,11,1397,2048,-651,-31.787109375
97,67,12,102,4096,-3994,-97.509765625
97,67,13,2896,8192,-5296,-64.6484375
97,67,14,28520,16384,12136,74.072265625
97,67,15,49434,32768,16666,50.860595703125
97,68,1,0,2,-2,-100.0
97,68,2,1,4,-3,-75.0
97,68,3,8,8,0,0.0
97,68,4,5,16,-11,-68.75
97,68,5,67,32,35,109.375
97,68,6,31,64,-33,-51.5625
97,68,7,30,128,-98,-76.5625
97,68,8,115,256,-141,-55.078125
97,68,9,2003,512,1491,291.2109375
97,68,10,2283,1024,1259,122.94921875
97,68,11,3727,2048,1679,81.982421875
97,68,12,5089,4096,993,24.2431640625
97,68,13,33041,8192,24849,303.33251953125
97,68,14,50615,16384,34231,208.929443359375
97,68,15,7573,32768,-25195,-76.8890380859375
97,69,1,0,2,-2,-100.0
97,69,2,1,4,-3,-75.0
97,69,3,18,8,10,125.0
97,69,4,20,16,4,25.0
97,69,5,15,32,-17,-53.125
97,69,6,26,64,-38,-59.375
97,69,7,84,128,-44,-34.375
97,69,8,13,256,-243,-94.921875
97,69,9,197,512,-315,-61.5234375
97,69,10,2511,1024,1487,145.21484375
97,69,11,5903,2048,3855,188.232421875
97,69,12,10138,4096,6042,147.509765625
97,69,13,1116,8192,-7076,-86.376953125
97,69,14,2315,16384,-14069,-85.870361328125
97,69,15,11460,32768,-21308,-65.02685546875
97,70,1,0,2,-2,-100.0
97,70,2,2,4,-2,-50.0
97,70,3,3,8,-5,-62.5
97,70,4,9,16,-7,-43.75
97,70,5,4,32,-28,-87.5
97,70,6,81,64,17,26.5625
97,70,7,91,128,-37,-28.90625
97,70,8,66,256,-190,-74.21875
97,70,9,856,512,344,67.1875
97,70,10,1588,1024,564,55.078125
97,70,11,8300,2048,6252,305.2734375
97,70,12,2739,4096,-1357,-33.1298828125
97,70,13,6246,8192,-1946,-23.7548828125
97,70,14,29799,16384,13415,81.878662109375
97,70,15,82229,32768,49461,150.9429931640625
97,71,1,0,2,-2,-100.0
97,71,2,1,4,-3,-75.0
97,71,3,7,8,-1,-12.5
97,71,4,7,16,-9,-56.25
97,71,5,34,32,2,6.25
97,71,6,31,64,-33,-51.5625
97,71,7,60,128,-68,-53.125
97,71,8,25,256,-231,-90.234375
97,71,9,683,512,171,33.3984375
97,71,10,68,1024,-956,-93.359375
97,71,11,2698,2048,650,31.73828125
97,71,12,320,4096,-3776,-92.1875
97,71,13,14543,8192,6351,77.52685546875
97,71,14,18170,16384,1786,10.90087890625
97,71,15,24077,32768,-8691,-26.5228271484375
97,72,1,0,2,-2,-100.0
97,72,2,3,4,-1,-25.0
97,72,3,3,8,-5,-62.5
97,72,4,11,16,-5,-31.25
97,72,5,40,32,8,25.0
97,72,6,17,64,-47,-73.4375
97,72,7,114,128,-14,-10.9375
97,72,8,60,256,-196,-76.5625
97,72,9,1749,512,1237,241.6015625
97,72,10,619,1024,-405,-39.55078125
97,72,11,2876,2048,828,40.4296875
97,72,12,576,4096,-3520,-85.9375
97,72,13,885,8192,-7307,-89.19677734375
97,72,14,40487,16384,24103,147.113037109375
97,72,15,95840,32768,63072,192.48046875
97,73,1,0,2,-2,-100.0
97,73,2,1,4,-3,-75.0
97,73,3,12,8,4,50.0
97,73,4,7,16,-9,-56.25
97,73,5,41,32,9,28.125
97,73,6,32,64,-32,-50.0
97,73,7,25,128,-103,-80.46875
97,73,8,217,256,-39,-15.234375
97,73,9,95,512,-417,-81.4453125
97,73,10,323,1024,-701,-68.45703125
97,73,11,1638,2048,-410,-20.01953125
97,73,12,1220,4096,-2876,-70.21484375
97,73,13,11624,8192,3432,41.89453125
97,73,14,12155,16384,-4229,-25.811767578125
97,73,15,5273,32768,-27495,-83.9080810546875
97,74,1,0,2,-2,-100.0
97,74,2,2,4,-2,-50.0
97,74,3,2,8,-6,-75.0
97,74,4,4,16,-12,-75.0
97,74,5,18,32,-14,-43.75
97,74,6,48,64,-16,-25.0
97,74,7,518,128,390,304.6875
97,74,8,317,256,61,23.828125
97,74,9,726,512,214,41.796875
97,74,10,3064,1024,2040,199.21875
97,74,11,961,2048,-1087,-53.076171875
97,74,12,599,4096,-3497,-85.3759765625
97,74,13,641,8192,-7551,-92.17529296875
97,74,14,14147,16384,-2237,-13.653564453125
97,74,15,34636,32768,1868,5.70068359375
97,75,1,0,2,-2,-100.0
97,75,2,7,4,3,75.0
97,75,3,7,8,-1,-12.5
97,75,4,12,16,-4,-25.0
97,75,5,23,32,-9,-28.125
97,75,6,8,64,-56,-87.5
97,75,7,49,128,-79,-61.71875
97,75,8,1315,256,1059,413.671875
97,75,9,60,512,-452,-88.28125
97,75,10,165,1024,-859,-83.88671875
97,75,11,116,2048,-1932,-94.3359375
97,75,12,2209,4096,-1887,-46.0693359375
97,75,13,25523,8192,17331,211.56005859375
97,75,14,35353,16384,18969,115.777587890625
97,75,15,37246,32768,4478,13.665771484375
97,76,1,0,2,-2,-100.0
97,76,2,3,4,-1,-25.0
97,76,3,8,8,0,0.0
97,76,4,5,16,-11,-68.75
97,76,5,6,32,-26,-81.25
97,76,6,40,64,-24,-37.5
97,76,7,244,128,116,90.625
97,76,8,99,256,-157,-61.328125
97,76,9,390,512,-122,-23.828125
97,76,10,518,1024,-506,-49.4140625
97,76,11,2069,2048,21,1.025390625
97,76,12,5551,4096,1455,35.5224609375
97,76,13,3936,8192,-4256,-51.953125
97,76,14,14468,16384,-1916,-11.6943359375
97,76,15,11004,32768,-21764,-66.41845703125
97,77,1,0,2,-2,-100.0
97,77,2,3,4,-1,-25.0
97,77,3,6,8,-2,-25.0
97,77,4,4,16,-12,-75.0
97,77,5,53,32,21,65.625
97,77,6,7,64,-57,-89.0625
97,77,7,41,128,-87,-67.96875
97,77,8,135,256,-121,-47.265625
97,77,9,75,512,-437,-85.3515625
97,77,10,2745,1024,1721,168.06640625
97,77,11,2076,2048,28,1.3671875
97,77,12,2675,4096,-1421,-34.6923828125
97,77,13,2522,8192,-5670,-69.2138671875
97,77,14,32668,16384,16284,99.3896484375
97,77,15,2782,32768,-29986,-91.510009765625
97,78,1,0,2,-2,-100.0
97,78,2,1,4,-3,-75.0
97,78,3,3,8,-5,-62.5
97,78,4,3,16,-13,-81.25
97,78,5,10,32,-22,-68.75
97,78,6,186,64,122,190.625
97,78,7,8,128,-120,-93.75
97,78,8,456,256,200,78.125
97,78,9,1365,512,853,166.6015625
97,78,10,694,1024,-330,-32.2265625
97,78,11,929,2048,-1119,-54.638671875
97,78,12,1526,4096,-2570,-62.744140625
97,78,13,1246,8192,-6946,-84.7900390625
97,78,14,26025,16384,9641,58.843994140625
97,78,15,34192,32768,1424,4.345703125
97,79,1,0,2,-2,-100.0
97,79,2,4,4,0,0.0
97,79,3,3,8,-5,-62.5
97,79,4,22,16,6,37.5
97,79,5,20,32,-12,-37.5
97,79,6,5,64,-59,-92.1875
97,79,7,137,128,9,7.03125
97,79,8,27,256,-229,-89.453125
97,79,9,1016,512,504,98.4375
97,79,10,1711,1024,687,67.08984375
97,79,11,3791,2048,1743,85.107421875
97,79,12,2545,4096,-1551,-37.8662109375
97,79,13,8427,8192,235,2.86865234375
97,79,14,5476,16384,-10908,-66.5771484375
97,79,15,36696,32768,3928,11.9873046875
97,80,1,0,2,-2,-100.0
97,80,2,4,4,0,0.0
97,80,3,3,8,-5,-62.5
97,80,4,11,16,-5,-31.25
97,80,5,28,32,-4,-12.5
97,80,6,110,64,46,71.875
97,80,7,53,128,-75,-58.59375
97,80,8,419,256,163,63.671875
97,80,9,284,512,-228,-44.53125
97,80,10,49,1024,-975,-95.21484375
97,80,11,21,2048,-2027,-98.974609375
97,80,12,151,4096,-3945,-96.3134765625
97,80,13,8085,8192,-107,-1.30615234375
97,80,14,40401,16384,24017,146.588134765625
97,80,15,33980,32768,1212,3.69873046875
97,81,1,0,2,-2,-100.0
97,81,2,2,4,-2,-50.0
97,81,3,5,8,-3,-37.5
97,81,4,53,16,37,231.25
97,81,5,7,32,-25,-78.125
97,81,6,69,64,5,7.8125
97,81,7,382,128,254,198.4375
97,81,8,161,256,-95,-37.109375
97,81,9,82,512,-430,-83.984375
97,81,10,282,1024,-742,-72.4609375
97,81,11,2733,2048,685,33.447265625
97,81,12,7171,4096,3075,75.0732421875
97,81,13,4633,8192,-3559,-43.44482421875
97,81,14,34091,16384,17707,108.074951171875
97,81,15,4272,32768,-28496,-86.962890625
97,82,1,0,2,-2,-100.0
97,82,2,1,4,-3,-75.0
97,82,3,8,8,0,0.0
97,82,4,12,16,-4,-25.0
97,82,5,25,32,-7,-21.875
97,82,6,46,64,-18,-28.125
97,82,7,100,128,-28,-21.875
97,82,8,317,256,61,23.828125
97,82,9,122,512,-390,-76.171875
97,82,10,3936,1024,2912,284.375
97,82,11,5246,2048,3198,156.15234375
97,82,12,354,4096,-3742,-91.357421875
97,82,13,4129,8192,-4063,-49.59716796875
97,82,14,50296,16384,33912,206.982421875
97,82,15,31720,32768,-1048,-3.1982421875
97,83,1,0,2,-2,-100.0
97,83,2,4,4,0,0.0
97,83,3,15,8,7,87.5
97,83,4,4,16,-12,-75.0
97,83,5,9,32,-23,-71.875
97,83,6,7,64,-57,-89.0625
97,83,7,219,128,91,71.09375
97,83,8,306,256,50,19.53125
97,83,9,1371,512,859,167.7734375
97,83,10,400,1024,-624,-60.9375
97,83,11,4746,2048,2698,131.73828125
97,83,12,4995,4096,899,21.9482421875
97,83,13,2699,8192,-5493,-67.05322265625
97,83,14,8781,16384,-7603,-46.405029296875
97,83,15,69183,32768,36415,111.1297607421875
97,84,1,0,2,-2,-100.0
97,84,2,1,4,-3,-75.0
97,84,3,4,8,-4,-50.0
97,84,4,38,16,22,137.5
97,84,5,43,32,11,34.375
97,84,6,136,64,72,112.5
97,84,7,116,128,-12,-9.375
97,84,8,368,256,112,43.75
97,84,9,425,512,-87,-16.9921875
97,84,10,362,1024,-662,-64.6484375
97,84,11,4353,2048,2305,112.548828125
97,84,12,1006,4096,-3090,-75.439453125
97,84,13,5815,8192,-2377,-29.01611328125
97,84,14,282,16384,-16102,-98.27880859375
97,84,15,1253,32768,-31515,-96.1761474609375
97,85,1,0,2,-2,-100.0
97,85,2,1,4,-3,-75.0
97,85,3,6,8,-2,-25.0
97,85,4,25,16,9,56.25
97,85,5,28,32,-4,-12.5
97,85,6,28,64,-36,-56.25
97,85,7,42,128,-86,-67.1875
97,85,8,450,256,194,75.78125
97,85,9,48,512,-464,-90.625
97,85,10,1769,1024,745,72.75390625
97,85,11,463,2048,-1585,-77.392578125
97,85,12,4310,4096,214,5.224609375
97,85,13,568,8192,-7624,-93.06640625
97,85,14,1425,16384,-14959,-91.302490234375
97,85,15,18918,32768,-13850,-42.266845703125
97,86,1,0,2,-2,-100.0
97,86,2,2,4,-2,-50.0
97,86,3,17,8,9,112.5
97,86,4,5,16,-11,-68.75
97,86,5,53,32,21,65.625
97,86,6,33,64,-31,-48.4375
97,86,7,86,128,-42,-32.8125
97,86,8,142,256,-114,-44.53125
97,86,9,983,512,471,91.9921875
97,86,10,75,1024,-949,-92.67578125
97,86,11,1694,2048,-354,-17.28515625
97,86,12,333,4096,-3763,-91.8701171875
97,86,13,169,8192,-8023,-97.93701171875
97,86,14,9120,16384,-7264,-44.3359375
97,86,15,6915,32768,-25853,-78.8970947265625
97,87,1,0,2,-2,-100.0
97,87,2,3,4,-1,-25.0
97,87,3,5,8,-3,-37.5
97,87,4,29,16,13,81.25
97,87,5,34,32,2,6.25
97,87,6,77,64,13,20.3125
97,87,7,103,128,-25,-19.53125
97,87,8,281,256,25,9.765625
97,87,9,1998,512,1486,290.234375
97,87,10,514,1024,-510,-49.8046875
97,87,11,1478,2048,-570,-27.83203125
97,87,12,4125,4096,29,0.7080078125
97,87,13,4283,8192,-3909,-47.71728515625
97,87,14,23961,16384,7577,46.246337890625
97,87,15,26617,32768,-6151,-18.7713623046875
97,88,1,0,2,-2,-100.0
97,88,2,3,4,-1,-25.0
97,88,3,8,8,0,0.0
97,88,4,10,16,-6,-37.5
97,88,5,12,32,-20,-62.5
97,88,6,94,64,30,46.875
97,88,7,12,128,-116,-90.625
97,88,8,62,256,-194,-75.78125
97,88,9,437,512,-75,-14.6484375
97,88,10,123,1024,-901,-87.98828125
97,88,11,206,2048,-1842,-89.94140625
97,88,12,10896,4096,6800,166.015625
97,88,13,5633,8192,-2559,-31.23779296875
97,88,14,12938,16384,-3446,-21.03271484375
97,88,15,106615,32768,73847,225.3631591796875
97,89,1,0,2,-2,-100.0
97,89,2,1,4,-3,-75.0
97,89,3,7,8,-1,-12.5
97,89,4,23,16,7,43.75
97,89,5,8,32,-24,-75.0
97,89,6,26,64,-38,-59.375
97,89,7,9,128,-119,-92.96875
97,89,8,1377,256,1121,437.890625
97,89,9,26,512,-486,-94.921875
97,89,10,862,1024,-162,-15.8203125
97,89,11,69,2048,-1979,-96.630859375
97,89,12,6538,4096,2442,59.619140625
97,89,13,2393,8192,-5799,-70.78857421875
97,89,14,3248,16384,-13136,-80.17578125
97,89,15,7933,32768,-24835,-75.7904052734375
97,90,1,0,2,-2,-100.0
97,90,2,1,4,-3,-75.0
97,90,3,2,8,-6,-75.0
97,90,4,19,16,3,18.75
97,90,5,105,32,73,228.125
97,90,6,41,64,-23,-35.9375
97,90,7,18,128,-110,-85.9375
97,90,8,168,256,-88,-34.375
97,90,9,717,512,205,40.0390625
97,90,10,1031,1024,7,0.68359375
97,90,11,401,2048,-1647,-80.419921875
97,90,12,750,4096,-3346,-81.689453125
97,90,13,3250,8192,-4942,-60.3271484375
97,90,14,5960,16384,-10424,-63.623046875
97,90,15,16066,32768,-16702,-50.970458984375
97,91,1,0,2,-2,-100.0
97,91,2,1,4,-3,-75.0
97,91,3,11,8,3,37.5
97,91,4,4,16,-12,-75.0
97,91,5,75,32,43,134.375
97,91,6,55,64,-9,-14.0625
97,91,7,6,128,-122,-95.3125
97,91,8,249,256,-7,-2.734375
97,91,9,1642,512,1130,220.703125
97,91,10,4457,1024,3433,335.25390625
97,91,11,909,2048,-1139,-55.615234375
97,91,12,9739,4096,5643,137.7685546875
97,91,13,351,8192,-7841,-95.71533203125
97,91,14,4630,16384,-11754,-71.74072265625
97,91,15,196786,32768,164018,500.543212890625
97,92,1,0,2,-2,-100.0
97,92,2,1,4,-3,-75.0
97,92,3,2,8,-6,-75.0
97,92,4,25,16,9,56.25
97,92,5,36,32,4,12.5
97,92,6,109,64,45,70.3125
97,92,7,179,128,51,39.84375
97,92,8,300,256,44,17.1875
97,92,9,86,512,-426,-83.203125
97,92,10,176,1024,-848,-82.8125
97,92,11,3463,2048,1415,69.091796875
97,92,12,1733,4096,-2363,-57.6904296875
97,92,13,14835,8192,6643,81.09130859375
97,92,14,19636,16384,3252,19.8486328125
97,92,15,43088,32768,10320,31.494140625
97,93,1,0,2,-2,-100.0
97,93,2,1,4,-3,-75.0
97,93,3,5,8,-3,-37.5
97,93,4,17,16,1,6.25
97,93,5,5,32,-27,-84.375
97,93,6,6,64,-58,-90.625
97,93,7,82,128,-46,-35.9375
97,93,8,197,256,-59,-23.046875
97,93,9,343,512,-169,-33.0078125
97,93,10,2443,1024,1419,138.57421875
97,93,11,1077,2048,-971,-47.412109375
97,93,12,747,4096,-3349,-81.7626953125
97,93,13,17015,8192,8823,107.70263671875
97,93,14,17304,16384,920,5.615234375
97,93,15,14807,32768,-17961,-54.8126220703125
97,94,1,0,2,-2,-100.0
97,94,2,2,4,-2,-50.0
97,94,3,3,8,-5,-62.5
97,94,4,3,16,-13,-81.25
97,94,5,49,32,17,53.125
97,94,6,65,64,1,1.5625
97,94,7,35,128,-93,-72.65625
97,94,8,369,256,113,44.140625
97,94,9,138,512,-374,-73.046875
97,94,10,1807,1024,783,76.46484375
97,94,11,108,2048,-1940,-94.7265625
97,94,12,6192,4096,2096,51.171875
97,94,13,8170,8192,-22,-0.2685546875
97,94,14,16576,16384,192,1.171875
97,94,15,38741,32768,5973,18.2281494140625
97,95,1,0,2,-2,-100.0
97,95,2,1,4,-3,-75.0
97,95,3,12,8,4,50.0
97,95,4,3,16,-13,-81.25
97,95,5,22,32,-10,-31.25
97,95,6,72,64,8,12.5
97,95,7,441,128,313,244.53125
97,95,8,724,256,468,182.8125
97,95,9,903,512,391,76.3671875
97,95,10,294,1024,-730,-71.2890625
97,95,11,167,2048,-1881,-91.845703125
97,95,12,21437,4096,17341,423.3642578125
97,95,13,3527,8192,-4665,-56.94580078125
97,95,14,5303,16384,-11081,-67.633056640625
97,95,15,32823,32768,55,0.1678466796875
97,96,1,0,2,-2,-100.0
97,96,2,2,4,-2,-50.0
97,96,3,2,8,-6,-75.0
97,96,4,11,16,-5,-31.25
97,96,5,69,32,37,115.625
97,96,6,9,64,-55,-85.9375
97,96,7,37,128,-91,-71.09375
97,96,8,276,256,20,7.8125
97,96,9,857,512,345,67.3828125
97,96,10,625,1024,-399,-38.96484375
97,96,11,255,2048,-1793,-87.548828125
97,96,12,1130,4096,-2966,-72.412109375
97,96,13,14938,8192,6746,82.3486328125
97,96,14,19171,16384,2787,17.010498046875
97,96,15,35639,32768,2871,8.7615966796875
97,97,1,0,2,-2,-100.0
97,97,2,3,4,-1,-25.0
97,97,3,10,8,2,25.0
97,97,4,35,16,19,118.75
97,97,5,12,32,-20,-62.5
97,97,6,110,64,46,71.875
97,97,7,79,128,-49,-38.28125
97,97,8,272,256,16,6.25
97,97,9,158,512,-354,-69.140625
97,97,10,51,1024,-973,-95.01953125
97,97,11,328,2048,-1720,-83.984375
97,97,12,8226,4096,4130,100.830078125
97,97,13,3203,8192,-4989,-60.90087890625
97,97,14,8672,16384,-7712,-47.0703125
97,97,15,10649,32768,-22119,-67.5018310546875
98,1,1,0,2,-2,-100.0
98,1,2,5,4,1,25.0
98,1,3,9,8,1,12.5
98,1,4,5,16,-11,-68.75
98,1,5,19,32,-13,-40.625
98,1,6,72,64,8,12.5
98,1,7,191,128,63,49.21875
98,1,8,431,256,175,68.359375
98,1,9,341,512,-171,-33.3984375
98,1,10,201,1024,-823,-80.37109375
98,1,11,5791,2048,3743,182.763671875
98,1,12,557,4096,-3539,-86.4013671875
98,1,13,3902,8192,-4290,-52.3681640625
98,1,14,17649,16384,1265,7.720947265625
98,1,15,44026,32768,11258,34.356689453125
98,2,1,0,2,-2,-100.0
98,2,2,3,4,-1,-25.0
98,2,3,21,8,13,162.5
98,2,4,11,16,-5,-31.25
98,2,5,55,32,23,71.875
98,2,6,56,64,-8,-12.5
98,2,7,119,128,-9,-7.03125
98,2,8,190,256,-66,-25.78125
98,2,9,28,512,-484,-94.53125
98,2,10,247,1024,-777,-75.87890625
98,2,11,2039,2048,-9,-0.439453125
98,2,12,325,4096,-3771,-92.0654296875
98,2,13,5639,8192,-2553,-31.16455078125
98,2,14,18095,16384,1711,10.443115234375
98,2,15,129557,32768,96789,295.3765869140625
98,3,1,0,2,-2,-100.0
98,3,2,1,4,-3,-75.0
98,3,3,7,8,-1,-12.5
98,3,4,44,16,28,175.0
98,3,5,4,32,-28,-87.5
98,3,6,61,64,-3,-4.6875
98,3,7,63,128,-65,-50.78125
98,3,8,474,256,218,85.15625
98,3,9,1648,512,1136,221.875
98,3,10,979,1024,-45,-4.39453125
98,3,11,752,2048,-1296,-63.28125
98,3,12,3668,4096,-428,-10.44921875
98,3,13,3461,8192,-4731,-57.75146484375
98,3,14,5713,16384,-10671,-65.130615234375
98,3,15,45802,32768,13034,39.776611328125
98,4,1,0,2,-2,-100.0
98,4,2,3,4,-1,-25.0
98,4,3,3,8,-5,-62.5
98,4,4,5,16,-11,-68.75
98,4,5,57,32,25,78.125
98,4,6,8,64,-56,-87.5
98,4,7,14,128,-114,-89.0625
98,4,8,667,256,411,160.546875
98,4,9,58,512,-454,-88.671875
98,4,10,1711,1024,687,67.08984375
98,4,11,4424,2048,2376,116.015625
98,4,12,2415,4096,-1681,-41.0400390625
98,4,13,5984,8192,-2208,-26.953125
98,4,14,13815,16384,-2569,-15.679931640625
98,4,15,72310,32768,39542,120.672607421875
98,5,1,0,2,-2,-100.0
98,5,2,1,4,-3,-75.0
98,5,3,6,8,-2,-25.0
98,5,4,5,16,-11,-68.75
98,5,5,36,32,4,12.5
98,5,6,17,64,-47,-73.4375
98,5,7,253,128,125,97.65625
98,5,8,63,256,-193,-75.390625
98,5,9,279,512,-233,-45.5078125
98,5,10,948,1024,-76,-7.421875
98,5,11,785,2048,-1263,-61.669921875
98,5,12,4257,4096,161,3.9306640625
98,5,13,650,8192,-7542,-92.0654296875
98,5,14,16870,16384,486,2.96630859375
98,5,15,17476,32768,-15292,-46.66748046875
98,6,1,0,2,-2,-100.0
98,6,2,1,4,-3,-75.0
98,6,3,2,8,-6,-75.0
98,6,4,8,16,-8,-50.0
98,6,5,16,32,-16,-50.0
98,6,6,11,64,-53,-82.8125
98,6,7,11,128,-117,-91.40625
98,6,8,34,256,-222,-86.71875
98,6,9,65,512,-447,-87.3046875
98,6,10,103,1024,-921,-89.94140625
98,6,11,6582,2048,4534,221.38671875
98,6,12,652,4096,-3444,-84.08203125
98,6,13,20219,8192,12027,146.81396484375
98,6,14,6910,16384,-9474,-57.82470703125
98,6,15,7266,32768,-25502,-77.825927734375
98,7,1,0,2,-2,-100.0
98,7,2,2,4,-2,-50.0
98,7,3,6,8,-2,-25.0
98,7,4,15,16,-1,-6.25
98,7,5,32,32,0,0.0
98,7,6,54,64,-10,-15.625
98,7,7,271,128,143,111.71875
98,7,8,87,256,-169,-66.015625
98,7,9,178,512,-334,-65.234375
98,7,10,1104,1024,80,7.8125
98,7,11,571,2048,-1477,-72.119140625
98,7,12,3820,4096,-276,-6.73828125
98,7,13,444,8192,-7748,-94.580078125
98,7,14,7381,16384,-9003,-54.949951171875
98,7,15,31401,32768,-1367,-4.1717529296875
98,8,1,0,2,-2,-100.0
98,8,2,1,4,-3,-75.0
98,8,3,8,8,0,0.0
98,8,4,3,16,-13,-81.25
98,8,5,14,32,-18,-56.25
98,8,6,34,64,-30,-46.875
98,8,7,52,128,-76,-59.375
98,8,8,483,256,227,88.671875
98,8,9,503,512,-9,-1.7578125
98,8,10,2308,1024,1284,125.390625
98,8,11,1372,2048,-676,-33.0078125
98,8,12,1673,4096,-2423,-59.1552734375
98,8,13,7683,8192,-509,-6.21337890625
98,8,14,16201,16384,-183,-1.116943359375
98,8,15,22685,32768,-10083,-30.7708740234375
98,9,1,0,2,-2,-100.0
98,9,2,1,4,-3,-75.0
98,9,3,5,8,-3,-37.5
98,9,4,3,16,-13,-81.25
98,9,5,49,32,17,53.125
98,9,6,35,64,-29,-45.3125
98,9,7,200,128,72,56.25
98,9,8,13,256,-243,-94.921875
98,9,9,726,512,214,41.796875
98,9,10,370,1024,-654,-63.8671875
98,9,11,1768,2048,-280,-13.671875
98,9,12,864,4096,-3232,-78.90625
98,9,13,6014,8192,-2178,-26.5869140625
98,9,14,721,16384,-15663,-95.599365234375
98,9,15,8253,32768,-24515,-74.8138427734375
98,10,1,0,2,-2,-100.0
98,10,2,3,4,-1,-25.0
98,10,3,2,8,-6,-75.0
98,10,4,16,16,0,0.0
98,10,5,15,32,-17,-53.125
98,10,6,23,64,-41,-64.0625
98,10,7,47,128,-81,-63.28125
98,10,8,45,256,-211,-82.421875
98,10,9,145,512,-367,-71.6796875
98,10,10,2659,1024,1635,159.66796875
98,10,11,219,2048,-1829,-89.306640625
98,10,12,3327,4096,-769,-18.7744140625
98,10,13,20576,8192,12384,151.171875
98,10,14,15748,16384,-636,-3.8818359375
98,10,15,22925,32768,-9843,-30.0384521484375
98,11,1,0,2,-2,-100.0
98,11,2,1,4,-3,-75.0
98,11,3,3,8,-5,-62.5
98,11,4,4,16,-12,-75.0
98,11,5,9,32,-23,-71.875
98,11,6,140,64,76,118.75
98,11,7,78,128,-50,-39.0625
98,11,8,409,256,153,59.765625
98,11,9,706,512,194,37.890625
98,11,10,1337,1024,313,30.56640625
98,11,11,5421,2048,3373,164.697265625
98,11,12,3292,4096,-804,-19.62890625
98,11,13,17209,8192,9017,110.07080078125
98,11,14,8642,16384,-7742,-47.25341796875
98,11,15,3200,32768,-29568,-90.234375
98,12,1,0,2,-2,-100.0
98,12,2,3,4,-1,-25.0
98,12,3,5,8,-3,-37.5
98,12,4,14,16,-2,-12.5
98,12,5,4,32,-28,-87.5
98,12,6,7,64,-57,-89.0625
98,12,7,52,128,-76,-59.375
98,12,8,73,256,-183,-71.484375
98,12,9,262,512,-250,-48.828125
98,12,10,779,1024,-245,-23.92578125
98,12,11,1162,2048,-886,-43.26171875
98,12,12,586,4096,-3510,-85.693359375
98,12,13,371,8192,-7821,-95.47119140625
98,12,14,9294,16384,-7090,-43.27392578125
98,12,15,4831,32768,-27937,-85.2569580078125
98,13,1,0,2,-2,-100.0
98,13,2,4,4,0,0.0
98,13,3,4,8,-4,-50.0
98,13,4,9,16,-7,-43.75
98,13,5,4,32,-28,-87.5
98,13,6,57,64,-7,-10.9375
98,13,7,31,128,-97,-75.78125
98,13,8,226,256,-30,-11.71875
98,13,9,2388,512,1876,366.40625
98,13,10,275,1024,-749,-73.14453125
98,13,11,629,2048,-1419,-69.287109375
98,13,12,441,4096,-3655,-89.2333984375
98,13,13,25900,8192,17708,216.162109375
98,13,14,21162,16384,4778,29.16259765625
98,13,15,98434,32768,65666,200.396728515625
98,14,1,0,2,-2,-100.0
98,14,2,1,4,-3,-75.0
98,14,3,2,8,-6,-75.0
98,14,4,16,16,0,0.0
98,14,5,7,32,-25,-78.125
98,14,6,24,64,-40,-62.5
98,14,7,550,128,422,329.6875
98,14,8,364,256,108,42.1875
98,14,9,849,512,337,65.8203125
98,14,10,344,1024,-680,-66.40625
98,14,11,1163,2048,-885,-43.212890625
98,14,12,292,4096,-3804,-92.87109375
98,14,13,6716,8192,-1476,-18.017578125
98,14,14,29365,16384,12981,79.229736328125
98,14,15,38505,32768,5737,17.5079345703125
98,15,1,0,2,-2,-100.0
98,15,2,2,4,-2,-50.0
98,15,3,6,8,-2,-25.0
98,15,4,5,16,-11,-68.75
98,15,5,29,32,-3,-9.375
98,15,6,45,64,-19,-29.6875
98,15,7,61,128,-67,-52.34375
98,15,8,112,256,-144,-56.25
98,15,9,75,512,-437,-85.3515625
98,15,10,960,1024,-64,-6.25
98,15,11,1970,2048,-78,-3.80859375
98,15,12,19443,4096,15347,374.6826171875
98,15,13,314,8192,-7878,-96.1669921875
98,15,14,7942,16384,-8442,-51.52587890625
98,15,15,21503,32768,-11265,-34.3780517578125
98,16,1,0,2,-2,-100.0
98,16,2,2,4,-2,-50.0
98,16,3,7,8,-1,-12.5
98,16,4,4,16,-12,-75.0
98,16,5,6,32,-26,-81.25
98,16,6,85,64,21,32.8125
98,16,7,98,128,-30,-23.4375
98,16,8,147,256,-109,-42.578125
98,16,9,204,512,-308,-60.15625
98,16,10,151,1024,-873,-85.25390625
98,16,11,56,2048,-1992,-97.265625
98,16,12,18802,4096,14706,359.033203125
98,16,13,377,8192,-7815,-95.39794921875
98,16,14,8060,16384,-8324,-50.8056640625
98,16,15,70667,32768,37899,115.6585693359375
98,17,1,0,2,-2,-100.0
98,17,2,1,4,-3,-75.0
98,17,3,4,8,-4,-50.0
98,17,4,30,16,14,87.5
98,17,5,31,32,-1,-3.125
98,17,6,81,64,17,26.5625
98,17,7,181,128,53,41.40625
98,17,8,276,256,20,7.8125
98,17,9,392,512,-120,-23.4375
98,17,10,787,1024,-237,-23.14453125
98,17,11,590,2048,-1458,-71.19140625
98,17,12,6228,4096,2132,52.05078125
98,17,13,806,8192,-7386,-90.1611328125
98,17,14,6288,16384,-10096,-61.62109375
98,17,15,62688,32768,29920,91.30859375
98,18,1,0,2,-2,-100.0
98,18,2,2,4,-2,-50.0
98,18,3,12,8,4,50.0
98,18,4,16,16,0,0.0
98,18,5,14,32,-18,-56.25
98,18,6,86,64,22,34.375
98,18,7,172,128,44,34.375
98,18,8,351,256,95,37.109375
98,18,9,2485,512,1973,385.3515625
98,18,10,4188,1024,3164,308.984375
98,18,11,1251,2048,-797,-38.916015625
98,18,12,2119,4096,-1977,-48.2666015625
98,18,13,280,8192,-7912,-96.58203125
98,18,14,6641,16384,-9743,-59.466552734375
98,18,15,8569,32768,-24199,-73.8494873046875
98,19,1,0,2,-2,-100.0
98,19,2,1,4,-3,-75.0
98,19,3,2,8,-6,-75.0
98,19,4,10,16,-6,-37.5
98,19,5,39,32,7,21.875
98,19,6,416,64,352,550.0
98,19,7,68,128,-60,-46.875
98,19,8,148,256,-108,-42.1875
98,19,9,35,512,-477,-93.1640625
98,19,10,1149,1024,125,12.20703125
98,19,11,2775,2048,727,35.498046875
98,19,12,5042,4096,946,23.095703125
98,19,13,2220,8192,-5972,-72.900390625
98,19,14,39727,16384,23343,142.474365234375
98,19,15,56872,32768,24104,73.5595703125
98,20,1,0,2,-2,-100.0
98,20,2,1,4,-3,-75.0
98,20,3,4,8,-4,-50.0
98,20,4,11,16,-5,-31.25
98,20,5,9,32,-23,-71.875
98,20,6,80,64,16,25.0
98,20,7,130,128,2,1.5625
98,20,8,482,256,226,88.28125
98,20,9,127,512,-385,-75.1953125
98,20,10,1001,1024,-23,-2.24609375
98,20,11,2847,2048,799,39.013671875
98,20,12,4148,4096,52,1.26953125
98,20,13,18029,8192,9837,120.08056640625
98,20,14,10390,16384,-5994,-36.58447265625
98,20,15,74473,32768,41705,127.2735595703125
98,21,1,0,2,-2,-100.0
98,21,2,2,4,-2,-50.0
98,21,3,5,8,-3,-37.5
98,21,4,11,16,-5,-31.25
98,21,5,9,32,-23,-71.875
98,21,6,56,64,-8,-12.5
98,21,7,129,128,1,0.78125
98,21,8,301,256,45,17.578125
98,21,9,1005,512,493,96.2890625
98,21,10,201,1024,-823,-80.37109375
98,21,11,659,2048,-1389,-67.822265625
98,21,12,3274,4096,-822,-20.068359375
98,21,13,22795,8192,14603,178.25927734375
98,21,14,2728,16384,-13656,-83.349609375
98,21,15,25849,32768,-6919,-21.1151123046875
98,22,1,0,2,-2,-100.0
98,22,2,1,4,-3,-75.0
98,22,3,4,8,-4,-50.0
98,22,4,13,16,-3,-18.75
98,22,5,8,32,-24,-75.0
98,22,6,44,64,-20,-31.25
98,22,7,260,128,132,103.125
98,22,8,151,256,-105,-41.015625
98,22,9,998,512,486,94.921875
98,22,10,1324,1024,300,29.296875
98,22,11,6952,2048,4904,239.453125
98,22,12,4228,4096,132,3.22265625
98,22,13,3996,8192,-4196,-51.220703125
98,22,14,25740,16384,9356,57.1044921875
98,22,15,7112,32768,-25656,-78.2958984375
98,23,1,0,2,-2,-100.0
98,23,2,5,4,1,25.0
98,23,3,11,8,3,37.5
98,23,4,5,16,-11,-68.75
98,23,5,10,32,-22,-68.75
98,23,6,86,64,22,34.375
98,23,7,61,128,-67,-52.34375
98,23,8,13,256,-243,-94.921875
98,23,9,1068,512,556,108.59375
98,23,10,1304,1024,280,27.34375
98,23,11,1231,2048,-817,-39.892578125
98,23,12,84,4096,-4012,-97.94921875
98,23,13,8580,8192,388,4.736328125
98,23,14,41005,16384,24621,150.274658203125
98,23,15,20498,32768,-12270,-37.445068359375
98,24,1,0,2,-2,-100.0
98,24,2,2,4,-2,-50.0
98,24,3,2,8,-6,-75.0
98,24,4,3,16,-13,-81.25
98,24,5,4,32,-28,-87.5
98,24,6,117,64,53,82.8125
98,24,7,206,128,78,60.9375
98,24,8,106,256,-150,-58.59375
98,24,9,494,512,-18,-3.515625
98,24,10,566,1024,-458,-44.7265625
98,24,11,2377,2048,329,16.064453125
98,24,12,10280,4096,6184,150.9765625
98,24,13,18604,8192,10412,127.099609375
98,24,14,20345,16384,3961,24.176025390625
98,24,15,4854,32768,-27914,-85.186767578125
98,25,1,0,2,-2,-100.0
98,25,2,1,4,-3,-75.0
98,25,3,2,8,-6,-75.0
98,25,4,7,16,-9,-56.25
98,25,5,28,32,-4,-12.5
98,25,6,51,64,-13,-20.3125
98,25,7,60,128,-68,-53.125
98,25,8,55,256,-201,-78.515625
98,25,9,456,512,-56,-10.9375
98,25,10,2557,1024,1533,149.70703125
98,25,11,1877,2048,-171,-8.349609375
98,25,12,2949,4096,-1147,-28.0029296875
98,25,13,4001,8192,-4191,-51.15966796875
98,25,14,11724,16384,-4660,-28.4423828125
98,25,15,33907,32768,1139,3.4759521484375
98,26,1,0,2,-2,-100.0
98,26,2,1,4,-3,-75.0
98,26,3,2,8,-6,-75.0
98,26,4,10,16,-6,-37.5
98,26,5,23,32,-9,-28.125
98,26,6,48,64,-16,-25.0
98,26,7,309,128,181,141.40625
98,26,8,32,256,-224,-87.5
98,26,9,32,512,-480,-93.75
98,26,10,2481,1024,1457,142.28515625
98,26,11,3347,2048,1299,63.427734375
98,26,12,633,4096,-3463,-84.5458984375
98,26,13,3695,8192,-4497,-54.89501953125
98,26,14,18993,16384,2609,15.924072265625
98,26,15,62485,32768,29717,90.6890869140625
98,27,1,0,2,-2,-100.0
98,27,2,1,4,-3,-75.0
98,27,3,8,8,0,0.0
98,27,4,6,16,-10,-62.5
98,27,5,7,32,-25,-78.125
98,27,6,5,64,-59,-92.1875
98,27,7,67,128,-61,-47.65625
98,27,8,16,256,-240,-93.75
98,27,9,1424,512,912,178.125
98,27,10,3822,1024,2798,273.2421875
98,27,11,45,2048,-2003,-97.802734375
98,27,12,3571,4096,-525,-12.8173828125
98,27,13,21362,8192,13170,160.7666015625
98,27,14,38672,16384,22288,136.03515625
98,27,15,5886,32768,-26882,-82.037353515625
98,28,1,0,2,-2,-100.0
98,28,2,2,4,-2,-50.0
98,28,3,3,8,-5,-62.5
98,28,4,5,16,-11,-68.75
98,28,5,15,32,-17,-53.125
98,28,6,184,64,120,187.5
98,28,7,180,128,52,40.625
98,28,8,80,256,-176,-68.75
98,28,9,249,512,-263,-51.3671875
98,28,10,277,1024,-747,-72.94921875
98,28,11,1512,2048,-536,-26.171875
98,28,12,1598,4096,-2498,-60.986328125
98,28,13,7900,8192,-292,-3.564453125
98,28,14,33509,16384,17125,104.522705078125
98,28,15,8256,32768,-24512,-74.8046875
98,29,1,0,2,-2,-100.0
98,29,2,1,4,-3,-75.0
98,29,3,2,8,-6,-75.0
98,29,4,8,16,-8,-50.0
98,29,5,89,32,57,178.125
98,29,6,5,64,-59,-92.1875
98,29,7,205,128,77,60.15625
98,29,8,241,256,-15,-5.859375
98,29,9,695,512,183,35.7421875
98,29,10,2400,1024,1376,134.375
98,29,11,27,2048,-2021,-98.681640625
98,29,12,15530,4096,11434,279.150390625
98,29,13,7205,8192,-987,-12.04833984375
98,29,14,1458,16384,-14926,-91.10107421875
98,29,15,94644,32768,61876,188.83056640625
98,30,1,0,2,-2,-100.0
98,30,2,2,4,-2,-50.0
98,30,3,2,8,-6,-75.0
98,30,4,4,16,-12,-75.0
98,30,5,38,32,6,18.75
98,30,6,15,64,-49,-76.5625
98,30,7,396,128,268,209.375
98,30,8,57,256,-199,-77.734375
98,30,9,135,512,-377,-73.6328125
98,30,10,892,1024,-132,-12.890625
98,30,11,539,2048,-1509,-73.681640625
98,30,12,1783,4096,-2313,-56.4697265625
98,30,13,3127,8192,-5065,-61.82861328125
98,30,14,28743,16384,12359,75.433349609375
98,30,15,34612,32768,1844,5.62744140625
98,31,1,0,2,-2,-100.0
98,31,2,1,4,-3,-75.0
98,31,3,3,8,-5,-62.5
98,31,4,9,16,-7,-43.75
98,31,5,6,32,-26,-81.25
98,31,6,119,64,55,85.9375
98,31,7,98,128,-30,-23.4375
98,31,8,263,256,7,2.734375
98,31,9,118,512,-394,-76.953125
98,31,10,760,1024,-264,-25.78125
98,31,11,214,2048,-1834,-89.55078125
98,31,12,5316,4096,1220,29.78515625
98,31,13,5252,8192,-2940,-35.888671875
98,31,14,8578,16384,-7806,-47.64404296875
98,31,15,103745,32768,70977,216.6046142578125
98,32,1,0,2,-2,-100.0
98,32,2,2,4,-2,-50.0
98,32,3,6,8,-2,-25.0
98,32,4,7,16,-9,-56.25
98,32,5,79,32,47,146.875
98,32,6,108,64,44,68.75
98,32,7,24,128,-104,-81.25
98,32,8,198,256,-58,-22.65625
98,32,9,565,512,53,10.3515625
98,32,10,3605,1024,2581,252.05078125
98,32,11,97,2048,-1951,-95.263671875
98,32,12,3912,4096,-184,-4.4921875
98,32,13,687,8192,-7505,-91.61376953125
98,32,14,30854,16384,14470,88.31787109375
98,32,15,18403,32768,-14365,-43.8385009765625
98,33,1,0,2,-2,-100.0
98,33,2,1,4,-3,-75.0
98,33,3,3,8,-5,-62.5
98,33,4,9,16,-7,-43.75
98,33,5,72,32,40,125.0
98,33,6,92,64,28,43.75
98,33,7,154,128,26,20.3125
98,33,8,189,256,-67,-26.171875
98,33,9,514,512,2,0.390625
98,33,10,3033,1024,2009,196.19140625
98,33,11,841,2048,-1207,-58.935546875
98,33,12,4095,4096,-1,-0.0244140625
98,33,13,7081,8192,-1111,-13.56201171875
98,33,14,57285,16384,40901,249.639892578125
98,33,15,8237,32768,-24531,-74.8626708984375
98,34,1,0,2,-2,-100.0
98,34,2,1,4,-3,-75.0
98,34,3,4,8,-4,-50.0
98,34,4,4,16,-12,-75.0
98,34,5,13,32,-19,-59.375
98,34,6,61,64,-3,-4.6875
98,34,7,274,128,146,114.0625
98,34,8,123,256,-133,-51.953125
98,34,9,55,512,-457,-89.2578125
98,34,10,14,1024,-1010,-98.6328125
98,34,11,2212,2048,164,8.0078125
98,34,12,12181,4096,8085,197.3876953125
98,34,13,12830,8192,4638,56.6162109375
98,34,14,6277,16384,-10107,-61.688232421875
98,34,15,1364,32768,-31404,-95.83740234375
98,35,1,0,2,-2,-100.0
98,35,2,1,4,-3,-75.0
98,35,3,5,8,-3,-37.5
98,35,4,4,16,-12,-75.0
98,35,5,99,32,67,209.375
98,35,6,133,64,69,107.8125
98,35,7,9,128,-119,-92.96875
98,35,8,142,256,-114,-44.53125
98,35,9,34,512,-478,-93.359375
98,35,10,608,1024,-416,-40.625
98,35,11,2631,2048,583,28.466796875
98,35,12,1286,4096,-2810,-68.603515625
98,35,13,892,8192,-7300,-89.111328125
98,35,14,19536,16384,3152,19.23828125
98,35,15,14881,32768,-17887,-54.5867919921875
98,36,1,0,2,-2,-100.0
98,36,2,2,4,-2,-50.0
98,36,3,2,8,-6,-75.0
98,36,4,3,16,-13,-81.25
98,36,5,48,32,16,50.0
98,36,6,52,64,-12,-18.75
98,36,7,272,128,144,112.5
98,36,8,109,256,-147,-57.421875
98,36,9,975,512,463,90.4296875
98,36,10,263,1024,-761,-74.31640625
98,36,11,618,2048,-1430,-69.82421875
98,36,12,3944,4096,-152,-3.7109375
98,36,13,2321,8192,-5871,-71.66748046875
98,36,14,17446,16384,1062,6.48193359375
98,36,15,15717,32768,-17051,-52.0355224609375
98,37,1,0,2,-2,-100.0
98,37,2,1,4,-3,-75.0
98,37,3,10,8,2,25.0
98,37,4,33,16,17,106.25
98,37,5,59,32,27,84.375
98,37,6,5,64,-59,-92.1875
98,37,7,41,128,-87,-67.96875
98,37,8,207,256,-49,-19.140625
98,37,9,1027,512,515,100.5859375
98,37,10,6017,1024,4993,487.59765625
98,37,11,3496,2048,1448,70.703125
98,37,12,3636,4096,-460,-11.23046875
98,37,13,8679,8192,487,5.94482421875
98,37,14,25552,16384,9168,55.95703125
98,37,15,99165,32768,66397,202.6275634765625
98,38,1,0,2,-2,-100.0
98,38,2,1,4,-3,-75.0
98,38,3,6,8,-2,-25.0
98,38,4,10,16,-6,-37.5
98,38,5,20,32,-12,-37.5
98,38,6,27,64,-37,-57.8125
98,38,7,240,128,112,87.5
98,38,8,362,256,106,41.40625
98,38,9,47,512,-465,-90.8203125
98,38,10,1704,1024,680,66.40625
98,38,11,860,2048,-1188,-58.0078125
98,38,12,5570,4096,1474,35.986328125
98,38,13,5582,8192,-2610,-31.8603515625
98,38,14,41987,16384,25603,156.268310546875
98,38,15,20717,32768,-12051,-36.7767333984375
98,39,1,0,2,-2,-100.0
98,39,2,1,4,-3,-75.0
98,39,3,5,8,-3,-37.5
98,39,4,62,16,46,287.5
98,39,5,6,32,-26,-81.25
98,39,6,70,64,6,9.375
98,39,7,82,128,-46,-35.9375
98,39,8,164,256,-92,-35.9375
98,39,9,209,512,-303,-59.1796875
98,39,10,385,1024,-639,-62.40234375
98,39,11,2224,2048,176,8.59375
98,39,12,7615,4096,3519,85.9130859375
98,39,13,20291,8192,12099,147.69287109375
98,39,14,4572,16384,-11812,-72.0947265625
98,39,15,8913,32768,-23855,-72.7996826171875
98,40,1,0,2,-2,-100.0
98,40,2,1,4,-3,-75.0
98,40,3,3,8,-5,-62.5
98,40,4,42,16,26,162.5
98,40,5,42,32,10,31.25
98,40,6,11,64,-53,-82.8125
98,40,7,6,128,-122,-95.3125
98,40,8,766,256,510,199.21875
98,40,9,344,512,-168,-32.8125
98,40,10,486,1024,-538,-52.5390625
98,40,11,7215,2048,5167,252.294921875
98,40,12,1516,4096,-2580,-62.98828125
98,40,13,9927,8192,1735,21.17919921875
98,40,14,37506,16384,21122,128.91845703125
98,40,15,85745,32768,52977,161.6729736328125
98,41,1,0,2,-2,-100.0
98,41,2,1,4,-3,-75.0
98,41,3,5,8,-3,-37.5
98,41,4,7,16,-9,-56.25
98,41,5,38,32,6,18.75
98,41,6,91,64,27,42.1875
98,41,7,75,128,-53,-41.40625
98,41,8,260,256,4,1.5625
98,41,9,432,512,-80,-15.625
98,41,10,234,1024,-790,-77.1484375
98,41,11,3151,2048,1103,53.857421875
98,41,12,1367,4096,-2729,-66.6259765625
98,41,13,3247,8192,-4945,-60.36376953125
98,41,14,8975,16384,-7409,-45.220947265625
98,41,15,20449,32768,-12319,-37.5946044921875
98,42,1,0,2,-2,-100.0
98,42,2,3,4,-1,-25.0
98,42,3,2,8,-6,-75.0
98,42,4,11,16,-5,-31.25
98,42,5,46,32,14,43.75
98,42,6,54,64,-10,-15.625
98,42,7,31,128,-97,-75.78125
98,42,8,176,256,-80,-31.25
98,42,9,389,512,-123,-24.0234375
98,42,10,329,1024,-695,-67.87109375
98,42,11,2682,2048,634,30.95703125
98,42,12,2912,4096,-1184,-28.90625
98,42,13,2390,8192,-5802,-70.8251953125
98,42,14,7265,16384,-9119,-55.657958984375
98,42,15,22655,32768,-10113,-30.8624267578125
98,43,1,0,2,-2,-100.0
98,43,2,1,4,-3,-75.0
98,43,3,4,8,-4,-50.0
98,43,4,34,16,18,112.5
98,43,5,106,32,74,231.25
98,43,6,50,64,-14,-21.875
98,43,7,177,128,49,38.28125
98,43,8,20,256,-236,-92.1875
98,43,9,87,512,-425,-83.0078125
98,43,10,268,1024,-756,-73.828125
98,43,11,3607,2048,1559,76.123046875
98,43,12,2105,4096,-1991,-48.6083984375
98,43,13,277,8192,-7915,-96.61865234375
98,43,14,14843,16384,-1541,-9.405517578125
98,43,15,28823,32768,-3945,-12.0391845703125
98,44,1,0,2,-2,-100.0
98,44,2,1,4,-3,-75.0
98,44,3,5,8,-3,-37.5
98,44,4,14,16,-2,-12.5
98,44,5,19,32,-13,-40.625
98,44,6,37,64,-27,-42.1875
98,44,7,15,128,-113,-88.28125
98,44,8,36,256,-220,-85.9375
98,44,9,73,512,-439,-85.7421875
98,44,10,1235,1024,211,20.60546875
98,44,11,811,2048,-1237,-60.400390625
98,44,12,4162,4096,66,1.611328125
98,44,13,450,8192,-7742,-94.5068359375
98,44,14,9506,16384,-6878,-41.97998046875
98,44,15,74324,32768,41556,126.81884765625
98,45,1,0,2,-2,-100.0
98,45,2,2,4,-2,-50.0
98,45,3,16,8,8,100.0
98,45,4,30,16,14,87.5
98,45,5,24,32,-8,-25.0
98,45,6,74,64,10,15.625
98,45,7,37,128,-91,-71.09375
98,45,8,11,256,-245,-95.703125
98,45,9,330,512,-182,-35.546875
98,45,10,2688,1024,1664,162.5
98,45,11,9129,2048,7081,345.751953125
98,45,12,14623,4096,10527,257.0068359375
98,45,13,6748,8192,-1444,-17.626953125
98,45,14,62794,16384,46410,283.26416015625
98,45,15,34094,32768,1326,4.046630859375
98,46,1,0,2,-2,-100.0
98,46,2,2,4,-2,-50.0
98,46,3,3,8,-5,-62.5
98,46,4,3,16,-13,-81.25
98,46,5,10,32,-22,-68.75
98,46,6,53,64,-11,-17.1875
98,46,7,54,128,-74,-57.8125
98,46,8,253,256,-3,-1.171875
98,46,9,741,512,229,44.7265625
98,46,10,1204,1024,180,17.578125
98,46,11,448,2048,-1600,-78.125
98,46,12,1794,4096,-2302,-56.201171875
98,46,13,16711,8192,8519,103.99169921875
98,46,14,9130,16384,-7254,-44.27490234375
98,46,15,3039,32768,-29729,-90.7257080078125
98,47,1,0,2,-2,-100.0
98,47,2,1,4,-3,-75.0
98,47,3,8,8,0,0.0
98,47,4,9,16,-7,-43.75
98,47,5,53,32,21,65.625
98,47,6,36,64,-28,-43.75
98,47,7,142,128,14,10.9375
98,47,8,775,256,519,202.734375
98,47,9,364,512,-148,-28.90625
98,47,10,1522,1024,498,48.6328125
98,47,11,2780,2048,732,35.7421875
98,47,12,1968,4096,-2128,-51.953125
98,47,13,8807,8192,615,7.50732421875
98,47,14,14932,16384,-1452,-8.8623046875
98,47,15,11142,32768,-21626,-65.997314453125
98,48,1,0,2,-2,-100.0
98,48,2,1,4,-3,-75.0
98,48,3,17,8,9,112.5
98,48,4,21,16,5,31.25
98,48,5,4,32,-28,-87.5
98,48,6,93,64,29,45.3125
98,48,7,52,128,-76,-59.375
98,48,8,112,256,-144,-56.25
98,48,9,656,512,144,28.125
98,48,10,566,1024,-458,-44.7265625
98,48,11,3663,2048,1615,78.857421875
98,48,12,5707,4096,1611,39.3310546875
98,48,13,8966,8192,774,9.4482421875
98,48,14,8748,16384,-7636,-46.6064453125
98,48,15,35752,32768,2984,9.1064453125
98,49,1,0,2,-2,-100.0
98,49,2,1,4,-3,-75.0
98,49,3,11,8,3,37.5
98,49,4,4,16,-12,-75.0
98,49,5,15,32,-17,-53.125
98,49,6,11,64,-53,-82.8125
98,49,7,185,128,57,44.53125
98,49,8,98,256,-158,-61.71875
98,49,9,491,512,-21,-4.1015625
98,49,10,96,1024,-928,-90.625
98,49,11,671,2048,-1377,-67.236328125
98,49,12,433,4096,-3663,-89.4287109375
98,49,13,5158,8192,-3034,-37.0361328125
98,49,14,20985,16384,4601,28.082275390625
98,49,15,15555,32768,-17213,-52.5299072265625
98,50,1,0,2,-2,-100.0
98,50,2,2,4,-2,-50.0
98,50,3,2,8,-6,-75.0
98,50,4,15,16,-1,-6.25
98,50,5,21,32,-11,-34.375
98,50,6,97,64,33,51.5625
98,50,7,116,128,-12,-9.375
98,50,8,100,256,-156,-60.9375
98,50,9,217,512,-295,-57.6171875
98,50,10,35,1024,-989,-96.58203125
98,50,11,154,2048,-1894,-92.48046875
98,50,12,325,4096,-3771,-92.0654296875
98,50,13,746,8192,-7446,-90.8935546875
98,50,14,29230,16384,12846,78.40576171875
98,50,15,41338,32768,8570,26.153564453125
98,51,1,0,2,-2,-100.0
98,51,2,2,4,-2,-50.0
98,51,3,2,8,-6,-75.0
98,51,4,12,16,-4,-25.0
98,51,5,18,32,-14,-43.75
98,51,6,23,64,-41,-64.0625
98,51,7,13,128,-115,-89.84375
98,51,8,109,256,-147,-57.421875
98,51,9,279,512,-233,-45.5078125
98,51,10,3344,1024,2320,226.5625
98,51,11,1957,2048,-91,-4.443359375
98,51,12,11659,4096,7563,184.6435546875
98,51,13,4408,8192,-3784,-46.19140625
98,51,14,22970,16384,6586,40.19775390625
98,51,15,6937,32768,-25831,-78.8299560546875
98,52,1,0,2,-2,-100.0
98,52,2,1,4,-3,-75.0
98,52,3,3,8,-5,-62.5
98,52,4,15,16,-1,-6.25
98,52,5,44,32,12,37.5
98,52,6,56,64,-8,-12.5
98,52,7,19,128,-109,-85.15625
98,52,8,84,256,-172,-67.1875
98,52,9,25,512,-487,-95.1171875
98,52,10,1154,1024,130,12.6953125
98,52,11,71,2048,-1977,-96.533203125
98,52,12,4642,4096,546,13.330078125
98,52,13,4928,8192,-3264,-39.84375
98,52,14,2444,16384,-13940,-85.0830078125
98,52,15,18920,32768,-13848,-42.2607421875
98,53,1,0,2,-2,-100.0
98,53,2,1,4,-3,-75.0
98,53,3,4,8,-4,-50.0
98,53,4,4,16,-12,-75.0
98,53,5,5,32,-27,-84.375
98,53,6,64,64,0,0.0
98,53,7,197,128,69,53.90625
98,53,8,62,256,-194,-75.78125
98,53,9,670,512,158,30.859375
98,53,10,3050,1024,2026,197.8515625
98,53,11,2939,2048,891,43.505859375
98,53,12,4185,4096,89,2.1728515625
98,53,13,1769,8192,-6423,-78.40576171875
98,53,14,19422,16384,3038,18.54248046875
98,53,15,48235,32768,15467,47.2015380859375
98,54,1,0,2,-2,-100.0
98,54,2,8,4,4,100.0
98,54,3,5,8,-3,-37.5
98,54,4,10,16,-6,-37.5
98,54,5,18,32,-14,-43.75
98,54,6,11,64,-53,-82.8125
98,54,7,49,128,-79,-61.71875
98,54,8,118,256,-138,-53.90625
98,54,9,273,512,-239,-46.6796875
98,54,10,62,1024,-962,-93.9453125
98,54,11,8168,2048,6120,298.828125
98,54,12,3119,4096,-977,-23.8525390625
98,54,13,6967,8192,-1225,-14.95361328125
98,54,14,11261,16384,-5123,-31.268310546875
98,54,15,8670,32768,-24098,-73.541259765625
98,55,1,0,2,-2,-100.0
98,55,2,2,4,-2,-50.0
98,55,3,3,8,-5,-62.5
98,55,4,5,16,-11,-68.75
98,55,5,131,32,99,309.375
98,55,6,30,64,-34,-53.125
98,55,7,85,128,-43,-33.59375
98,55,8,501,256,245,95.703125
98,55,9,490,512,-22,-4.296875
98,55,10,3600,1024,2576,251.5625
98,55,11,11019,2048,8971,438.037109375
98,55,12,3709,4096,-387,-9.4482421875
98,55,13,13932,8192,5740,70.068359375
98,55,14,51465,16384,35081,214.117431640625
98,55,15,3009,32768,-29759,-90.8172607421875
98,56,1,0,2,-2,-100.0
98,56,2,1,4,-3,-75.0
98,56,3,12,8,4,50.0
98,56,4,5,16,-11,-68.75
98,56,5,119,32,87,271.875
98,56,6,5,64,-59,-92.1875
98,56,7,147,128,19,14.84375
98,56,8,20,256,-236,-92.1875
98,56,9,250,512,-262,-51.171875
98,56,10,23,1024,-1001,-97.75390625
98,56,11,865,2048,-1183,-57.763671875
98,56,12,4270,4096,174,4.248046875
98,56,13,2210,8192,-5982,-73.0224609375
98,56,14,4186,16384,-12198,-74.45068359375
98,56,15,77878,32768,45110,137.664794921875
98,57,1,0,2,-2,-100.0
98,57,2,2,4,-2,-50.0
98,57,3,9,8,1,12.5
98,57,4,33,16,17,106.25
98,57,5,41,32,9,28.125
98,57,6,55,64,-9,-14.0625
98,57,7,817,128,689,538.28125
98,57,8,75,256,-181,-70.703125
98,57,9,153,512,-359,-70.1171875
98,57,10,561,1024,-463,-45.21484375
98,57,11,1474,2048,-574,-28.02734375
98,57,12,4748,4096,652,15.91796875
98,57,13,1743,8192,-6449,-78.72314453125
98,57,14,2792,16384,-13592,-82.958984375
98,57,15,37477,32768,4709,14.3707275390625
98,58,1,0,2,-2,-100.0
98,58,2,1,4,-3,-75.0
98,58,3,2,8,-6,-75.0
98,58,4,11,16,-5,-31.25
98,58,5,19,32,-13,-40.625
98,58,6,23,64,-41,-64.0625
98,58,7,80,128,-48,-37.5
98,58,8,267,256,11,4.296875
98,58,9,94,512,-418,-81.640625
98,58,10,736,1024,-288,-28.125
98,58,11,1761,2048,-287,-14.013671875
98,58,12,432,4096,-3664,-89.453125
98,58,13,3017,8192,-5175,-63.17138671875
98,58,14,2038,16384,-14346,-87.56103515625
98,58,15,66463,32768,33695,102.8289794921875
98,59,1,0,2,-2,-100.0
98,59,2,2,4,-2,-50.0
98,59,3,4,8,-4,-50.0
98,59,4,19,16,3,18.75
98,59,5,33,32,1,3.125
98,59,6,192,64,128,200.0
98,59,7,165,128,37,28.90625
98,59,8,226,256,-30,-11.71875
98,59,9,21,512,-491,-95.8984375
98,59,10,384,1024,-640,-62.5
98,59,11,77,2048,-1971,-96.240234375
98,59,12,6010,4096,1914,46.728515625
98,59,13,4539,8192,-3653,-44.59228515625
98,59,14,29360,16384,12976,79.19921875
98,59,15,165649,32768,132881,405.5206298828125
98,60,1,0,2,-2,-100.0
98,60,2,2,4,-2,-50.0
98,60,3,3,8,-5,-62.5
98,60,4,3,16,-13,-81.25
98,60,5,5,32,-27,-84.375
98,60,6,84,64,20,31.25
98,60,7,126,128,-2,-1.5625
98,60,8,58,256,-198,-77.34375
98,60,9,512,512,0,0.0
98,60,10,1143,1024,119,11.62109375
98,60,11,32,2048,-2016,-98.4375
98,60,12,7170,4096,3074,75.048828125
98,60,13,459,8192,-7733,-94.39697265625
98,60,14,15370,16384,-1014,-6.18896484375
98,60,15,43812,32768,11044,33.70361328125
98,61,1,0,2,-2,-100.0
98,61,2,1,4,-3,-75.0
98,61,3,4,8,-4,-50.0
98,61,4,5,16,-11,-68.75
98,61,5,4,32,-28,-87.5
98,61,6,17,64,-47,-73.4375
98,61,7,36,128,-92,-71.875
98,61,8,110,256,-146,-57.03125
98,61,9,1220,512,708,138.28125
98,61,10,241,1024,-783,-76.46484375
98,61,11,1497,2048,-551,-26.904296875
98,61,12,5217,4096,1121,27.3681640625
98,61,13,597,8192,-7595,-92.71240234375
98,61,14,1849,16384,-14535,-88.714599609375
98,61,15,50242,32768,17474,53.326416015625
98,62,1,0,2,-2,-100.0
98,62,2,4,4,0,0.0
98,62,3,4,8,-4,-50.0
98,62,4,18,16,2,12.5
98,62,5,10,32,-22,-68.75
98,62,6,93,64,29,45.3125
98,62,7,34,128,-94,-73.4375
98,62,8,130,256,-126,-49.21875
98,62,9,961,512,449,87.6953125
98,62,10,438,1024,-586,-57.2265625
98,62,11,2167,2048,119,5.810546875
98,62,12,3357,4096,-739,-18.0419921875
98,62,13,26386,8192,18194,222.0947265625
98,62,14,13920,16384,-2464,-15.0390625
98,62,15,95904,32768,63136,192.67578125
98,63,1,0,2,-2,-100.0
98,63,2,1,4,-3,-75.0
98,63,3,18,8,10,125.0
98,63,4,10,16,-6,-37.5
98,63,5,56,32,24,75.0
98,63,6,123,64,59,92.1875
98,63,7,152,128,24,18.75
98,63,8,980,256,724,282.8125
98,63,9,659,512,147,28.7109375
98,63,10,558,1024,-466,-45.5078125
98,63,11,485,2048,-1563,-76.318359375
98,63,12,980,4096,-3116,-76.07421875
98,63,13,6053,8192,-2139,-26.11083984375
98,63,14,52371,16384,35987,219.647216796875
98,63,15,10630,32768,-22138,-67.559814453125
98,64,1,0,2,-2,-100.0
98,64,2,1,4,-3,-75.0
98,64,3,2,8,-6,-75.0
98,64,4,16,16,0,0.0
98,64,5,5,32,-27,-84.375
98,64,6,90,64,26,40.625
98,64,7,37,128,-91,-71.09375
98,64,8,143,256,-113,-44.140625
98,64,9,190,512,-322,-62.890625
98,64,10,179,1024,-845,-82.51953125
98,64,11,1537,2048,-511,-24.951171875
98,64,12,7798,4096,3702,90.380859375
98,64,13,16404,8192,8212,100.244140625
98,64,14,1603,16384,-14781,-90.216064453125
98,64,15,1333,32768,-31435,-95.9320068359375
98,65,1,0,2,-2,-100.0
98,65,2,1,4,-3,-75.0
98,65,3,2,8,-6,-75.0
98,65,4,11,16,-5,-31.25
98,65,5,8,32,-24,-75.0
98,65,6,6,64,-58,-90.625
98,65,7,639,128,511,399.21875
98,65,8,108,256,-148,-57.8125
98,65,9,157,512,-355,-69.3359375
98,65,10,59,1024,-965,-94.23828125
98,65,11,1221,2048,-827,-40.380859375
98,65,12,5504,4096,1408,34.375
98,65,13,1582,8192,-6610,-80.6884765625
98,65,14,60532,16384,44148,269.4580078125
98,65,15,73118,32768,40350,123.138427734375
98,66,1,0,2,-2,-100.0
98,66,2,4,4,0,0.0
98,66,3,3,8,-5,-62.5
98,66,4,16,16,0,0.0
98,66,5,10,32,-22,-68.75
98,66,6,76,64,12,18.75
98,66,7,323,128,195,152.34375
98,66,8,180,256,-76,-29.6875
98,66,9,352,512,-160,-31.25
98,66,10,3169,1024,2145,209.47265625
98,66,11,469,2048,-1579,-77.099609375
98,66,12,8597,4096,4501,109.8876953125
98,66,13,12330,8192,4138,50.5126953125
98,66,14,4375,16384,-12009,-73.297119140625
98,66,15,50199,32768,17431,53.1951904296875
98,67,1,0,2,-2,-100.0
98,67,2,2,4,-2,-50.0
98,67,3,18,8,10,125.0
98,67,4,9,16,-7,-43.75
98,67,5,17,32,-15,-46.875
98,67,6,46,64,-18,-28.125
98,67,7,44,128,-84,-65.625
98,67,8,103,256,-153,-59.765625
98,67,9,1775,512,1263,246.6796875
98,67,10,215,1024,-809,-79.00390625
98,67,11,4213,2048,2165,105.712890625
98,67,12,9005,4096,4909,119.8486328125
98,67,13,5253,8192,-2939,-35.87646484375
98,67,14,10100,16384,-6284,-38.3544921875
98,67,15,44993,32768,12225,37.3077392578125
98,68,1,0,2,-2,-100.0
98,68,2,2,4,-2,-50.0
98,68,3,4,8,-4,-50.0
98,68,4,3,16,-13,-81.25
98,68,5,7,32,-25,-78.125
98,68,6,22,64,-42,-65.625
98,68,7,120,128,-8,-6.25
98,68,8,45,256,-211,-82.421875
98,68,9,573,512,61,11.9140625
98,68,10,6725,1024,5701,556.73828125
98,68,11,799,2048,-1249,-60.986328125
98,68,12,10131,4096,6035,147.3388671875
98,68,13,1020,8192,-7172,-87.548828125
98,68,14,5058,16384,-11326,-69.12841796875
98,68,15,25459,32768,-7309,-22.3052978515625
98,69,1,0,2,-2,-100.0
98,69,2,1,4,-3,-75.0
98,69,3,18,8,10,125.0
98,69,4,5,16,-11,-68.75
98,69,5,37,32,5,15.625
98,69,6,26,64,-38,-59.375
98,69,7,66,128,-62,-48.4375
98,69,8,148,256,-108,-42.1875
98,69,9,628,512,116,22.65625
98,69,10,52,1024,-972,-94.921875
98,69,11,333,2048,-1715,-83.740234375
98,69,12,13559,4096,9463,231.0302734375
98,69,13,917,8192,-7275,-88.80615234375
98,69,14,9804,16384,-6580,-40.1611328125
98,69,15,49698,32768,16930,51.666259765625
98,70,1,0,2,-2,-100.0
98,70,2,1,4,-3,-75.0
98,70,3,4,8,-4,-50.0
98,70,4,11,16,-5,-31.25
98,70,5,16,32,-16,-50.0
98,70,6,85,64,21,32.8125
98,70,7,184,128,56,43.75
98,70,8,150,256,-106,-41.40625
98,70,9,2321,512,1809,353.3203125
98,70,10,1666,1024,642,62.6953125
98,70,11,1085,2048,-963,-47.021484375
98,70,12,2471,4096,-1625,-39.6728515625
98,70,13,6622,8192,-1570,-19.1650390625
98,70,14,5351,16384,-11033,-67.340087890625
98,70,15,18811,32768,-13957,-42.5933837890625
98,71,1,0,2,-2,-100.0
98,71,2,3,4,-1,-25.0
98,71,3,8,8,0,0.0
98,71,4,8,16,-8,-50.0
98,71,5,10,32,-22,-68.75
98,71,6,53,64,-11,-17.1875
98,71,7,32,128,-96,-75.0
98,71,8,102,256,-154,-60.15625
98,71,9,788,512,276,53.90625
98,71,10,69,1024,-955,-93.26171875
98,71,11,272,2048,-1776,-86.71875
98,71,12,1446,4096,-2650,-64.697265625
98,71,13,2893,8192,-5299,-64.68505859375
98,71,14,63056,16384,46672,284.86328125
98,71,15,700,32768,-32068,-97.86376953125
98,72,1,0,2,-2,-100.0
98,72,2,1,4,-3,-75.0
98,72,3,5,8,-3,-37.5
98,72,4,3,16,-13,-81.25
98,72,5,19,32,-13,-40.625
98,72,6,5,64,-59,-92.1875
98,72,7,30,128,-98,-76.5625
98,72,8,350,256,94,36.71875
98,72,9,581,512,69,13.4765625
98,72,10,1106,1024,82,8.0078125
98,72,11,1687,2048,-361,-17.626953125
98,72,12,3001,4096,-1095,-26.7333984375
98,72,13,8068,8192,-124,-1.513671875
98,72,14,7197,16384,-9187,-56.072998046875
98,72,15,5202,32768,-27566,-84.124755859375
98,73,1,0,2,-2,-100.0
98,73,2,1,4,-3,-75.0
98,73,3,4,8,-4,-50.0
98,73,4,6,16,-10,-62.5
98,73,5,4,32,-28,-87.5
98,73,6,26,64,-38,-59.375
98,73,7,17,128,-111,-86.71875
98,73,8,146,256,-110,-42.96875
98,73,9,1198,512,686,133.984375
98,73,10,3089,1024,2065,201.66015625
98,73,11,292,2048,-1756,-85.7421875
98,73,12,18959,4096,14863,362.8662109375
98,73,13,10917,8192,2725,33.26416015625
98,73,14,6683,16384,-9701,-59.210205078125
98,73,15,8376,32768,-24392,-74.4384765625
98,74,1,0,2,-2,-100.0
98,74,2,1,4,-3,-75.0
98,74,3,3,8,-5,-62.5
98,74,4,20,16,4,25.0
98,74,5,4,32,-28,-87.5
98,74,6,9,64,-55,-85.9375
98,74,7,50,128,-78,-60.9375
98,74,8,225,256,-31,-12.109375
98,74,9,1774,512,1262,246.484375
98,74,10,2033,1024,1009,98.53515625
98,74,11,3521,2048,1473,71.923828125
98,74,12,2291,4096,-1805,-44.0673828125
98,74,13,17784,8192,9592,117.08984375
98,74,14,11353,16384,-5031,-30.706787109375
98,74,15,68619,32768,35851,109.4085693359375
98,75,1,0,2,-2,-100.0
98,75,2,1,4,-3,-75.0
98,75,3,2,8,-6,-75.0
98,75,4,17,16,1,6.25
98,75,5,55,32,23,71.875
98,75,6,33,64,-31,-48.4375
98,75,7,202,128,74,57.8125
98,75,8,452,256,196,76.5625
98,75,9,667,512,155,30.2734375
98,75,10,114,1024,-910,-88.8671875
98,75,11,3088,2048,1040,50.78125
98,75,12,258,4096,-3838,-93.701171875
98,75,13,11196,8192,3004,36.669921875
98,75,14,31384,16384,15000,91.552734375
98,75,15,6635,32768,-26133,-79.7515869140625
98,76,1,0,2,-2,-100.0
98,76,2,3,4,-1,-25.0
98,76,3,15,8,7,87.5
98,76,4,3,16,-13,-81.25
98,76,5,17,32,-15,-46.875
98,76,6,125,64,61,95.3125
98,76,7,32,128,-96,-75.0
98,76,8,163,256,-93,-36.328125
98,76,9,84,512,-428,-83.59375
98,76,10,353,1024,-671,-65.52734375
98,76,11,471,2048,-1577,-77.001953125
98,76,12,6246,4096,2150,52.490234375
98,76,13,14394,8192,6202,75.7080078125
98,76,14,813,16384,-15571,-95.037841796875
98,76,15,59444,32768,26676,81.40869140625
98,77,1,0,2,-2,-100.0
98,77,2,3,4,-1,-25.0
98,77,3,5,8,-3,-37.5
98,77,4,35,16,19,118.75
98,77,5,17,32,-15,-46.875
98,77,6,76,64,12,18.75
98,77,7,12,128,-116,-90.625
98,77,8,105,256,-151,-58.984375
98,77,9,840,512,328,64.0625
98,77,10,44,1024,-980,-95.703125
98,77,11,3333,2048,1285,62.744140625
98,77,12,7580,4096,3484,85.05859375
98,77,13,5527,8192,-2665,-32.53173828125
98,77,14,22104,16384,5720,34.912109375
98,77,15,16411,32768,-16357,-49.9176025390625
98,78,1,0,2,-2,-100.0
98,78,2,1,4,-3,-75.0
98,78,3,5,8,-3,-37.5
98,78,4,12,16,-4,-25.0
98,78,5,85,32,53,165.625
98,78,6,50,64,-14,-21.875
98,78,7,36,128,-92,-71.875
98,78,8,199,256,-57,-22.265625
98,78,9,40,512,-472,-92.1875
98,78,10,1054,1024,30,2.9296875
98,78,11,1717,2048,-331,-16.162109375
98,78,12,1456,4096,-2640,-64.453125
98,78,13,28813,8192,20621,251.72119140625
98,78,14,28275,16384,11891,72.576904296875
98,78,15,4167,32768,-28601,-87.2833251953125
98,79,1,0,2,-2,-100.0
98,79,2,2,4,-2,-50.0
98,79,3,6,8,-2,-25.0
98,79,4,5,16,-11,-68.75
98,79,5,13,32,-19,-59.375
98,79,6,96,64,32,50.0
98,79,7,99,128,-29,-22.65625
98,79,8,126,256,-130,-50.78125
98,79,9,871,512,359,70.1171875
98,79,10,1728,1024,704,68.75
98,79,11,838,2048,-1210,-59.08203125
98,79,12,4752,4096,656,16.015625
98,79,13,24626,8192,16434,200.6103515625
98,79,14,14548,16384,-1836,-11.2060546875
98,79,15,13366,32768,-19402,-59.210205078125
98,80,1,0,2,-2,-100.0
98,80,2,3,4,-1,-25.0
98,80,3,12,8,4,50.0
98,80,4,3,16,-13,-81.25
98,80,5,39,32,7,21.875
98,80,6,28,64,-36,-56.25
98,80,7,213,128,85,66.40625
98,80,8,772,256,516,201.5625
98,80,9,375,512,-137,-26.7578125
98,80,10,48,1024,-976,-95.3125
98,80,11,1873,2048,-175,-8.544921875
98,80,12,138,4096,-3958,-96.630859375
98,80,13,5549,8192,-2643,-32.26318359375
98,80,14,1166,16384,-15218,-92.88330078125
98,80,15,22729,32768,-10039,-30.6365966796875
98,81,1,0,2,-2,-100.0
98,81,2,3,4,-1,-25.0
98,81,3,4,8,-4,-50.0
98,81,4,37,16,21,131.25
98,81,5,6,32,-26,-81.25
98,81,6,18,64,-46,-71.875
98,81,7,167,128,39,30.46875
98,81,8,177,256,-79,-30.859375
98,81,9,896,512,384,75.0
98,81,10,522,1024,-502,-49.0234375
98,81,11,415,2048,-1633,-79.736328125
98,81,12,11833,4096,7737,188.8916015625
98,81,13,1267,8192,-6925,-84.53369140625
98,81,14,5915,16384,-10469,-63.897705078125
98,81,15,12394,32768,-20374,-62.176513671875
98,82,1,0,2,-2,-100.0
98,82,2,3,4,-1,-25.0
98,82,3,21,8,13,162.5
98,82,4,14,16,-2,-12.5
98,82,5,16,32,-16,-50.0
98,82,6,40,64,-24,-37.5
98,82,7,123,128,-5,-3.90625
98,82,8,722,256,466,182.03125
98,82,9,2475,512,1963,383.3984375
98,82,10,1806,1024,782,76.3671875
98,82,11,1617,2048,-431,-21.044921875
98,82,12,4634,4096,538,13.134765625
98,82,13,24417,8192,16225,198.05908203125
98,82,14,7587,16384,-8797,-53.692626953125
98,82,15,11273,32768,-21495,-65.5975341796875
98,83,1,0,2,-2,-100.0
98,83,2,2,4,-2,-50.0
98,83,3,3,8,-5,-62.5
98,83,4,4,16,-12,-75.0
98,83,5,12,32,-20,-62.5
98,83,6,46,64,-18,-28.125
98,83,7,207,128,79,61.71875
98,83,8,358,256,102,39.84375
98,83,9,190,512,-322,-62.890625
98,83,10,697,1024,-327,-31.93359375
98,83,11,21,2048,-2027,-98.974609375
98,83,12,277,4096,-3819,-93.2373046875
98,83,13,23807,8192,15615,190.61279296875
98,83,14,8926,16384,-7458,-45.52001953125
98,83,15,41362,32768,8594,26.226806640625
98,84,1,0,2,-2,-100.0
98,84,2,1,4,-3,-75.0
98,84,3,2,8,-6,-75.0
98,84,4,12,16,-4,-25.0
98,84,5,34,32,2,6.25
98,84,6,5,64,-59,-92.1875
98,84,7,106,128,-22,-17.1875
98,84,8,328,256,72,28.125
98,84,9,168,512,-344,-67.1875
98,84,10,1581,1024,557,54.39453125
98,84,11,1106,2048,-942,-45.99609375
98,84,12,48,4096,-4048,-98.828125
98,84,13,25076,8192,16884,206.103515625
98,84,14,24269,16384,7885,48.126220703125
98,84,15,796,32768,-31972,-97.57080078125
98,85,1,0,2,-2,-100.0
98,85,2,4,4,0,0.0
98,85,3,12,8,4,50.0
98,85,4,14,16,-2,-12.5
98,85,5,34,32,2,6.25
98,85,6,57,64,-7,-10.9375
98,85,7,164,128,36,28.125
98,85,8,80,256,-176,-68.75
98,85,9,217,512,-295,-57.6171875
98,85,10,62,1024,-962,-93.9453125
98,85,11,3638,2048,1590,77.63671875
98,85,12,2244,4096,-1852,-45.21484375
98,85,13,14785,8192,6593,80.48095703125
98,85,14,6140,16384,-10244,-62.5244140625
98,85,15,3101,32768,-29667,-90.5364990234375
98,86,1,0,2,-2,-100.0
98,86,2,2,4,-2,-50.0
98,86,3,7,8,-1,-12.5
98,86,4,15,16,-1,-6.25
98,86,5,12,32,-20,-62.5
98,86,6,7,64,-57,-89.0625
98,86,7,150,128,22,17.1875
98,86,8,140,256,-116,-45.3125
98,86,9,211,512,-301,-58.7890625
98,86,10,1894,1024,870,84.9609375
98,86,11,5954,2048,3906,190.72265625
98,86,12,5696,4096,1600,39.0625
98,86,13,12362,8192,4170,50.9033203125
98,86,14,13550,16384,-2834,-17.29736328125
98,86,15,12614,32768,-20154,-61.505126953125
98,87,1,0,2,-2,-100.0
98,87,2,1,4,-3,-75.0
98,87,3,5,8,-3,-37.5
98,87,4,22,16,6,37.5
98,87,5,48,32,16,50.0
98,87,6,8,64,-56,-87.5
98,87,7,93,128,-35,-27.34375
98,87,8,411,256,155,60.546875
98,87,9,215,512,-297,-58.0078125
98,87,10,782,1024,-242,-23.6328125
98,87,11,6430,2048,4382,213.96484375
98,87,12,353,4096,-3743,-91.3818359375
98,87,13,4424,8192,-3768,-45.99609375
98,87,14,10304,16384,-6080,-37.109375
98,87,15,9899,32768,-22869,-69.7906494140625
98,88,1,0,2,-2,-100.0
98,88,2,1,4,-3,-75.0
98,88,3,16,8,8,100.0
98,88,4,9,16,-7,-43.75
98,88,5,32,32,0,0.0
98,88,6,50,64,-14,-21.875
98,88,7,7,128,-121,-94.53125
98,88,8,180,256,-76,-29.6875
98,88,9,287,512,-225,-43.9453125
98,88,10,807,1024,-217,-21.19140625
98,88,11,3971,2048,1923,93.896484375
98,88,12,2079,4096,-2017,-49.2431640625
98,88,13,989,8192,-7203,-87.92724609375
98,88,14,29589,16384,13205,80.596923828125
98,88,15,7639,32768,-25129,-76.6876220703125
98,89,1,0,2,-2,-100.0
98,89,2,3,4,-1,-25.0
98,89,3,4,8,-4,-50.0
98,89,4,18,16,2,12.5
98,89,5,22,32,-10,-31.25
98,89,6,37,64,-27,-42.1875
98,89,7,18,128,-110,-85.9375
98,89,8,409,256,153,59.765625
98,89,9,217,512,-295,-57.6171875
98,89,10,1176,1024,152,14.84375
98,89,11,5980,2048,3932,191.9921875
98,89,12,6232,4096,2136,52.1484375
98,89,13,8506,8192,314,3.8330078125
98,89,14,16680,16384,296,1.806640625
98,89,15,44536,32768,11768,35.9130859375
98,90,1,0,2,-2,-100.0
98,90,2,1,4,-3,-75.0
98,90,3,4,8,-4,-50.0
98,90,4,63,16,47,293.75
98,90,5,64,32,32,100.0
98,90,6,128,64,64,100.0
98,90,7,354,128,226,176.5625
98,90,8,44,256,-212,-82.8125
98,90,9,21,512,-491,-95.8984375
98,90,10,825,1024,-199,-19.43359375
98,90,11,520,2048,-1528,-74.609375
98,90,12,13790,4096,9694,236.669921875
98,90,13,21798,8192,13606,166.0888671875
98,90,14,4266,16384,-12118,-73.96240234375
98,90,15,44115,32768,11347,34.6282958984375
98,91,1,0,2,-2,-100.0
98,91,2,1,4,-3,-75.0
98,91,3,10,8,2,25.0
98,91,4,6,16,-10,-62.5
98,91,5,54,32,22,68.75
98,91,6,245,64,181,282.8125
98,91,7,79,128,-49,-38.28125
98,91,8,156,256,-100,-39.0625
98,91,9,574,512,62,12.109375
98,91,10,300,1024,-724,-70.703125
98,91,11,1807,2048,-241,-11.767578125
98,91,12,4012,4096,-84,-2.05078125
98,91,13,10162,8192,1970,24.0478515625
98,91,14,4858,16384,-11526,-70.34912109375
98,91,15,12728,32768,-20040,-61.1572265625
98,92,1,0,2,-2,-100.0
98,92,2,2,4,-2,-50.0
98,92,3,3,8,-5,-62.5
98,92,4,17,16,1,6.25
98,92,5,7,32,-25,-78.125
98,92,6,116,64,52,81.25
98,92,7,100,128,-28,-21.875
98,92,8,14,256,-242,-94.53125
98,92,9,417,512,-95,-18.5546875
98,92,10,412,1024,-612,-59.765625
98,92,11,5783,2048,3735,182.373046875
98,92,12,895,4096,-3201,-78.1494140625
98,92,13,11957,8192,3765,45.95947265625
98,92,14,31278,16384,14894,90.90576171875
98,92,15,801,32768,-31967,-97.5555419921875
98,93,1,0,2,-2,-100.0
98,93,2,2,4,-2,-50.0
98,93,3,4,8,-4,-50.0
98,93,4,16,16,0,0.0
98,93,5,14,32,-18,-56.25
98,93,6,147,64,83,129.6875
98,93,7,13,128,-115,-89.84375
98,93,8,21,256,-235,-91.796875
98,93,9,205,512,-307,-59.9609375
98,93,10,656,1024,-368,-35.9375
98,93,11,573,2048,-1475,-72.021484375
98,93,12,1007,4096,-3089,-75.4150390625
98,93,13,998,8192,-7194,-87.8173828125
98,93,14,2110,16384,-14274,-87.12158203125
98,93,15,12487,32768,-20281,-61.8927001953125
98,94,1,0,2,-2,-100.0
98,94,2,3,4,-1,-25.0
98,94,3,14,8,6,75.0
98,94,4,6,16,-10,-62.5
98,94,5,30,32,-2,-6.25
98,94,6,192,64,128,200.0
98,94,7,112,128,-16,-12.5
98,94,8,73,256,-183,-71.484375
98,94,9,1935,512,1423,277.9296875
98,94,10,328,1024,-696,-67.96875
98,94,11,3807,2048,1759,85.888671875
98,94,12,828,4096,-3268,-79.78515625
98,94,13,7036,8192,-1156,-14.111328125
98,94,14,37696,16384,21312,130.078125
98,94,15,7178,32768,-25590,-78.094482421875
98,95,1,0,2,-2,-100.0
98,95,2,1,4,-3,-75.0
98,95,3,15,8,7,87.5
98,95,4,38,16,22,137.5
98,95,5,26,32,-6,-18.75
98,95,6,14,64,-50,-78.125
98,95,7,14,128,-114,-89.0625
98,95,8,675,256,419,163.671875
98,95,9,355,512,-157,-30.6640625
98,95,10,2296,1024,1272,124.21875
98,95,11,3703,2048,1655,80.810546875
98,95,12,49,4096,-4047,-98.8037109375
98,95,13,45,8192,-8147,-99.45068359375
98,95,14,4593,16384,-11791,-71.966552734375
98,95,15,19912,32768,-12856,-39.2333984375
98,96,1,0,2,-2,-100.0
98,96,2,4,4,0,0.0
98,96,3,3,8,-5,-62.5
98,96,4,19,16,3,18.75
98,96,5,23,32,-9,-28.125
98,96,6,22,64,-42,-65.625
98,96,7,24,128,-104,-81.25
98,96,8,64,256,-192,-75.0
98,96,9,169,512,-343,-66.9921875
98,96,10,2203,1024,1179,115.13671875
98,96,11,763,2048,-1285,-62.744140625
98,96,12,4420,4096,324,7.91015625
98,96,13,9392,8192,1200,14.6484375
98,96,14,12586,16384,-3798,-23.18115234375
98,96,15,18737,32768,-14031,-42.8192138671875
98,97,1,0,2,-2,-100.0
98,97,2,1,4,-3,-75.0
98,97,3,19,8,11,137.5
98,97,4,16,16,0,0.0
98,97,5,20,32,-12,-37.5
98,97,6,136,64,72,112.5
98,97,7,180,128,52,40.625
98,97,8,348,256,92,35.9375
98,97,9,2310,512,1798,351.171875
98,97,10,656,1024,-368,-35.9375
98,97,11,1514,2048,-534,-26.07421875
98,97,12,666,4096,-3430,-83.740234375
98,97,13,12012,8192,3820,46.630859375
98,97,14,36580,16384,20196,123.2666015625
98,97,15,1918,32768,-30850,-94.146728515625
98,98,1,0,2,-2,-100.0
98,98,2,3,4,-1,-25.0
98,98,3,7,8,-1,-12.5
98,98,4,17,16,1,6.25
98,98,5,44,32,12,37.5
98,98,6,104,64,40,62.5
98,98,7,167,128,39,30.46875
98,98,8,19,256,-237,-92.578125
98,98,9,94,512,-418,-81.640625
98,98,10,725,1024,-299,-29.19921875
98,98,11,1885,2048,-163,-7.958984375
98,98,12,5799,4096,1703,41.5771484375
98,98,13,7629,8192,-563,-6.87255859375
98,98,14,19169,16384,2785,16.998291015625
98,98,15,156977,32768,124209,379.0557861328125
99,1,1,0,2,-2,-100.0
99,1,2,1,4,-3,-75.0
99,1,3,4,8,-4,-50.0
99,1,4,3,16,-13,-81.25
99,1,5,4,32,-28,-87.5
99,1,6,21,64,-43,-67.1875
99,1,7,75,128,-53,-41.40625
99,1,8,47,256,-209,-81.640625
99,1,9,550,512,38,7.421875
99,1,10,274,1024,-750,-73.2421875
99,1,11,807,2048,-1241,-60.595703125
99,1,12,13836,4096,9740,237.79296875
99,1,13,9586,8192,1394,17.0166015625
99,1,14,8870,16384,-7514,-45.86181640625
99,1,15,14455,32768,-18313,-55.8868408203125
99,2,1,0,2,-2,-100.0
99,2,2,1,4,-3,-75.0
99,2,3,11,8,3,37.5
99,2,4,25,16,9,56.25
99,2,5,7,32,-25,-78.125
99,2,6,24,64,-40,-62.5
99,2,7,160,128,32,25.0
99,2,8,220,256,-36,-14.0625
99,2,9,142,512,-370,-72.265625
99,2,10,720,1024,-304,-29.6875
99,2,11,3638,2048,1590,77.63671875
99,2,12,3824,4096,-272,-6.640625
99,2,13,20,8192,-8172,-99.755859375
99,2,14,13779,16384,-2605,-15.899658203125
99,2,15,18574,32768,-14194,-43.316650390625
99,3,1,0,2,-2,-100.0
99,3,2,2,4,-2,-50.0
99,3,3,2,8,-6,-75.0
99,3,4,3,16,-13,-81.25
99,3,5,11,32,-21,-65.625
99,3,6,36,64,-28,-43.75
99,3,7,27,128,-101,-78.90625
99,3,8,34,256,-222,-86.71875
99,3,9,273,512,-239,-46.6796875
99,3,10,1908,1024,884,86.328125
99,3,11,1071,2048,-977,-47.705078125
99,3,12,3469,4096,-627,-15.3076171875
99,3,13,3985,8192,-4207,-51.35498046875
99,3,14,26534,16384,10150,61.95068359375
99,3,15,46324,32768,13556,41.36962890625
99,4,1,0,2,-2,-100.0
99,4,2,1,4,-3,-75.0
99,4,3,7,8,-1,-12.5
99,4,4,9,16,-7,-43.75
99,4,5,39,32,7,21.875
99,4,6,5,64,-59,-92.1875
99,4,7,51,128,-77,-60.15625
99,4,8,601,256,345,134.765625
99,4,9,108,512,-404,-78.90625
99,4,10,932,1024,-92,-8.984375
99,4,11,6636,2048,4588,224.0234375
99,4,12,8594,4096,4498,109.814453125
99,4,13,1343,8192,-6849,-83.60595703125
99,4,14,7927,16384,-8457,-51.617431640625
99,4,15,73004,32768,40236,122.79052734375
99,5,1,0,2,-2,-100.0
99,5,2,1,4,-3,-75.0
99,5,3,2,8,-6,-75.0
99,5,4,10,16,-6,-37.5
99,5,5,16,32,-16,-50.0
99,5,6,5,64,-59,-92.1875
99,5,7,28,128,-100,-78.125
99,5,8,866,256,610,238.28125
99,5,9,49,512,-463,-90.4296875
99,5,10,339,1024,-685,-66.89453125
99,5,11,3492,2048,1444,70.5078125
99,5,12,6838,4096,2742,66.943359375
99,5,13,12537,8192,4345,53.03955078125
99,5,14,13989,16384,-2395,-14.617919921875
99,5,15,14959,32768,-17809,-54.3487548828125
99,6,1,0,2,-2,-100.0
99,6,2,1,4,-3,-75.0
99,6,3,6,8,-2,-25.0
99,6,4,54,16,38,237.5
99,6,5,157,32,125,390.625
99,6,6,161,64,97,151.5625
99,6,7,150,128,22,17.1875
99,6,8,84,256,-172,-67.1875
99,6,9,100,512,-412,-80.46875
99,6,10,2782,1024,1758,171.6796875
99,6,11,1090,2048,-958,-46.77734375
99,6,12,6732,4096,2636,64.35546875
99,6,13,17913,8192,9721,118.66455078125
99,6,14,19670,16384,3286,20.05615234375
99,6,15,30203,32768,-2565,-7.8277587890625
99,7,1,0,2,-2,-100.0
99,7,2,2,4,-2,-50.0
99,7,3,2,8,-6,-75.0
99,7,4,24,16,8,50.0
99,7,5,17,32,-15,-46.875
99,7,6,61,64,-3,-4.6875
99,7,7,26,128,-102,-79.6875
99,7,8,30,256,-226,-88.28125
99,7,9,624,512,112,21.875
99,7,10,1224,1024,200,19.53125
99,7,11,576,2048,-1472,-71.875
99,7,12,346,4096,-3750,-91.552734375
99,7,13,1262,8192,-6930,-84.5947265625
99,7,14,1131,16384,-15253,-93.096923828125
99,7,15,9896,32768,-22872,-69.7998046875
99,8,1,0,2,-2,-100.0
99,8,2,1,4,-3,-75.0
99,8,3,7,8,-1,-12.5
99,8,4,29,16,13,81.25
99,8,5,8,32,-24,-75.0
99,8,6,24,64,-40,-62.5
99,8,7,139,128,11,8.59375
99,8,8,99,256,-157,-61.328125
99,8,9,701,512,189,36.9140625
99,8,10,1369,1024,345,33.69140625
99,8,11,151,2048,-1897,-92.626953125
99,8,12,161,4096,-3935,-96.0693359375
99,8,13,1498,8192,-6694,-81.7138671875
99,8,14,5346,16384,-11038,-67.37060546875
99,8,15,69139,32768,36371,110.9954833984375
99,9,1,0,2,-2,-100.0
99,9,2,1,4,-3,-75.0
99,9,3,2,8,-6,-75.0
99,9,4,8,16,-8,-50.0
99,9,5,5,32,-27,-84.375
99,9,6,68,64,4,6.25
99,9,7,72,128,-56,-43.75
99,9,8,78,256,-178,-69.53125
99,9,9,263,512,-249,-48.6328125
99,9,10,159,1024,-865,-84.47265625
99,9,11,4312,2048,2264,110.546875
99,9,12,14993,4096,10897,266.0400390625
99,9,13,4006,8192,-4186,-51.0986328125
99,9,14,15486,16384,-898,-5.48095703125
99,9,15,6674,32768,-26094,-79.632568359375
99,10,1,0,2,-2,-100.0
99,10,2,1,4,-3,-75.0
99,10,3,5,8,-3,-37.5
99,10,4,23,16,7,43.75
99,10,5,12,32,-20,-62.5
99,10,6,29,64,-35,-54.6875
99,10,7,370,128,242,189.0625
99,10,8,112,256,-144,-56.25
99,10,9,17,512,-495,-96.6796875
99,10,10,101,1024,-923,-90.13671875
99,10,11,2458,2048,410,20.01953125
99,10,12,3035,4096,-1061,-25.9033203125
99,10,13,1430,8192,-6762,-82.5439453125
99,10,14,3234,16384,-13150,-80.26123046875
99,10,15,38808,32768,6040,18.4326171875
99,11,1,0,2,-2,-100.0
99,11,2,1,4,-3,-75.0
99,11,3,9,8,1,12.5
99,11,4,11,16,-5,-31.25
99,11,5,7,32,-25,-78.125
99,11,6,18,64,-46,-71.875
99,11,7,282,128,154,120.3125
99,11,8,69,256,-187,-73.046875
99,11,9,572,512,60,11.71875
99,11,10,315,1024,-709,-69.23828125
99,11,11,5344,2048,3296,160.9375
99,11,12,2269,4096,-1827,-44.6044921875
99,11,13,5503,8192,-2689,-32.82470703125
99,11,14,27228,16384,10844,66.1865234375
99,11,15,2810,32768,-29958,-91.424560546875
99,12,1,0,2,-2,-100.0
99,12,2,2,4,-2,-50.0
99,12,3,6,8,-2,-25.0
99,12,4,42,16,26,162.5
99,12,5,41,32,9,28.125
99,12,6,5,64,-59,-92.1875
99,12,7,177,128,49,38.28125
99,12,8,89,256,-167,-65.234375
99,12,9,182,512,-330,-64.453125
99,12,10,5468,1024,4444,433.984375
99,12,11,2776,2048,728,35.546875
99,12,12,1313,4096,-2783,-67.9443359375
99,12,13,2418,8192,-5774,-70.4833984375
99,12,14,15276,16384,-1108,-6.7626953125
99,12,15,367,32768,-32401,-98.8800048828125
99,13,1,0,2,-2,-100.0
99,13,2,1,4,-3,-75.0
99,13,3,10,8,2,25.0
99,13,4,7,16,-9,-56.25
99,13,5,12,32,-20,-62.5
99,13,6,22,64,-42,-65.625
99,13,7,104,128,-24,-18.75
99,13,8,8,256,-248,-96.875
99,13,9,73,512,-439,-85.7421875
99,13,10,1269,1024,245,23.92578125
99,13,11,3583,2048,1535,74.951171875
99,13,12,1119,4096,-2977,-72.6806640625
99,13,13,11568,8192,3376,41.2109375
99,13,14,10725,16384,-5659,-34.539794921875
99,13,15,89075,32768,56307,171.8353271484375
99,14,1,0,2,-2,-100.0
99,14,2,3,4,-1,-25.0
99,14,3,5,8,-3,-37.5
99,14,4,23,16,7,43.75
99,14,5,16,32,-16,-50.0
99,14,6,76,64,12,18.75
99,14,7,126,128,-2,-1.5625
99,14,8,93,256,-163,-63.671875
99,14,9,516,512,4,0.78125
99,14,10,307,1024,-717,-70.01953125
99,14,11,268,2048,-1780,-86.9140625
99,14,12,3975,4096,-121,-2.9541015625
99,14,13,6930,8192,-1262,-15.4052734375
99,14,14,2782,16384,-13602,-83.02001953125
99,14,15,1280,32768,-31488,-96.09375
99,15,1,0,2,-2,-100.0
99,15,2,2,4,-2,-50.0
99,15,3,12,8,4,50.0
99,15,4,5,16,-11,-68.75
99,15,5,19,32,-13,-40.625
99,15,6,143,64,79,123.4375
99,15,7,201,128,73,57.03125
99,15,8,558,256,302,117.96875
99,15,9,244,512,-268,-52.34375
99,15,10,566,1024,-458,-44.7265625
99,15,11,675,2048,-1373,-67.041015625
99,15,12,9236,4096,5140,125.48828125
99,15,13,7520,8192,-672,-8.203125
99,15,14,18862,16384,2478,15.12451171875
99,15,15,93637,32768,60869,185.7574462890625
99,16,1,0,2,-2,-100.0
99,16,2,4,4,0,0.0
99,16,3,10,8,2,25.0
99,16,4,15,16,-1,-6.25
99,16,5,32,32,0,0.0
99,16,6,23,64,-41,-64.0625
99,16,7,14,128,-114,-89.0625
99,16,8,81,256,-175,-68.359375
99,16,9,309,512,-203,-39.6484375
99,16,10,1983,1024,959,93.65234375
99,16,11,3145,2048,1097,53.564453125
99,16,12,3131,4096,-965,-23.5595703125
99,16,13,2438,8192,-5754,-70.2392578125
99,16,14,12171,16384,-4213,-25.714111328125
99,16,15,11374,32768,-21394,-65.289306640625
99,17,1,0,2,-2,-100.0
99,17,2,1,4,-3,-75.0
99,17,3,2,8,-6,-75.0
99,17,4,7,16,-9,-56.25
99,17,5,110,32,78,243.75
99,17,6,141,64,77,120.3125
99,17,7,79,128,-49,-38.28125
99,17,8,449,256,193,75.390625
99,17,9,153,512,-359,-70.1171875
99,17,10,458,1024,-566,-55.2734375
99,17,11,985,2048,-1063,-51.904296875
99,17,12,361,4096,-3735,-91.1865234375
99,17,13,1958,8192,-6234,-76.0986328125
99,17,14,1285,16384,-15099,-92.156982421875
99,17,15,20605,32768,-12163,-37.1185302734375
99,18,1,0,2,-2,-100.0
99,18,2,2,4,-2,-50.0
99,18,3,12,8,4,50.0
99,18,4,14,16,-2,-12.5
99,18,5,103,32,71,221.875
99,18,6,72,64,8,12.5
99,18,7,316,128,188,146.875
99,18,8,44,256,-212,-82.8125
99,18,9,2733,512,2221,433.7890625
99,18,10,1364,1024,340,33.203125
99,18,11,1770,2048,-278,-13.57421875
99,18,12,421,4096,-3675,-89.7216796875
99,18,13,15631,8192,7439,90.80810546875
99,18,14,39174,16384,22790,139.09912109375
99,18,15,155296,32768,122528,373.92578125
99,19,1,0,2,-2,-100.0
99,19,2,1,4,-3,-75.0
99,19,3,3,8,-5,-62.5
99,19,4,23,16,7,43.75
99,19,5,9,32,-23,-71.875
99,19,6,121,64,57,89.0625
99,19,7,34,128,-94,-73.4375
99,19,8,135,256,-121,-47.265625
99,19,9,903,512,391,76.3671875
99,19,10,543,1024,-481,-46.97265625
99,19,11,425,2048,-1623,-79.248046875
99,19,12,18126,4096,14030,342.529296875
99,19,13,6536,8192,-1656,-20.21484375
99,19,14,4234,16384,-12150,-74.15771484375
99,19,15,2153,32768,-30615,-93.4295654296875
99,20,1,0,2,-2,-100.0
99,20,2,1,4,-3,-75.0
99,20,3,7,8,-1,-12.5
99,20,4,8,16,-8,-50.0
99,20,5,15,32,-17,-53.125
99,20,6,34,64,-30,-46.875
99,20,7,13,128,-115,-89.84375
99,20,8,454,256,198,77.34375
99,20,9,384,512,-128,-25.0
99,20,10,1381,1024,357,34.86328125
99,20,11,4236,2048,2188,106.8359375
99,20,12,3436,4096,-660,-16.11328125
99,20,13,11723,8192,3531,43.10302734375
99,20,14,16633,16384,249,1.519775390625
99,20,15,9929,32768,-22839,-69.6990966796875
99,21,1,0,2,-2,-100.0
99,21,2,2,4,-2,-50.0
99,21,3,2,8,-6,-75.0
99,21,4,13,16,-3,-18.75
99,21,5,20,32,-12,-37.5
99,21,6,126,64,62,96.875
99,21,7,9,128,-119,-92.96875
99,21,8,498,256,242,94.53125
99,21,9,696,512,184,35.9375
99,21,10,183,1024,-841,-82.12890625
99,21,11,114,2048,-1934,-94.43359375
99,21,12,12585,4096,8489,207.2509765625
99,21,13,6144,8192,-2048,-25.0
99,21,14,17602,16384,1218,7.43408203125
99,21,15,513,32768,-32255,-98.4344482421875
99,22,1,0,2,-2,-100.0
99,22,2,1,4,-3,-75.0
99,22,3,2,8,-6,-75.0
99,22,4,10,16,-6,-37.5
99,22,5,15,32,-17,-53.125
99,22,6,10,64,-54,-84.375
99,22,7,6,128,-122,-95.3125
99,22,8,7,256,-249,-97.265625
99,22,9,912,512,400,78.125
99,22,10,1695,1024,671,65.52734375
99,22,11,6397,2048,4349,212.353515625
99,22,12,4811,4096,715,17.4560546875
99,22,13,5380,8192,-2812,-34.326171875
99,22,14,3781,16384,-12603,-76.922607421875
99,22,15,32100,32768,-668,-2.03857421875
99,23,1,0,2,-2,-100.0
99,23,2,1,4,-3,-75.0
99,23,3,10,8,2,25.0
99,23,4,22,16,6,37.5
99,23,5,5,32,-27,-84.375
99,23,6,13,64,-51,-79.6875
99,23,7,533,128,405,316.40625
99,23,8,252,256,-4,-1.5625
99,23,9,179,512,-333,-65.0390625
99,23,10,1147,1024,123,12.01171875
99,23,11,7027,2048,4979,243.115234375
99,23,12,9173,4096,5077,123.9501953125
99,23,13,5765,8192,-2427,-29.62646484375
99,23,14,17124,16384,740,4.5166015625
99,23,15,9014,32768,-23754,-72.491455078125
99,24,1,0,2,-2,-100.0
99,24,2,1,4,-3,-75.0
99,24,3,4,8,-4,-50.0
99,24,4,7,16,-9,-56.25
99,24,5,53,32,21,65.625
99,24,6,9,64,-55,-85.9375
99,24,7,191,128,63,49.21875
99,24,8,23,256,-233,-91.015625
99,24,9,339,512,-173,-33.7890625
99,24,10,1075,1024,51,4.98046875
99,24,11,2527,2048,479,23.388671875
99,24,12,840,4096,-3256,-79.4921875
99,24,13,12528,8192,4336,52.9296875
99,24,14,3138,16384,-13246,-80.84716796875
99,24,15,2388,32768,-30380,-92.71240234375
99,25,1,0,2,-2,-100.0
99,25,2,1,4,-3,-75.0
99,25,3,7,8,-1,-12.5
99,25,4,3,16,-13,-81.25
99,25,5,11,32,-21,-65.625
99,25,6,20,64,-44,-68.75
99,25,7,87,128,-41,-32.03125
99,25,8,54,256,-202,-78.90625
99,25,9,1360,512,848,165.625
99,25,10,145,1024,-879,-85.83984375
99,25,11,389,2048,-1659,-81.005859375
99,25,12,6090,4096,1994,48.681640625
99,25,13,1758,8192,-6434,-78.5400390625
99,25,14,41297,16384,24913,152.056884765625
99,25,15,5003,32768,-27765,-84.7320556640625
99,26,1,0,2,-2,-100.0
99,26,2,1,4,-3,-75.0
99,26,3,2,8,-6,-75.0
99,26,4,4,16,-12,-75.0
99,26,5,47,32,15,46.875
99,26,6,50,64,-14,-21.875
99,26,7,97,128,-31,-24.21875
99,26,8,22,256,-234,-91.40625
99,26,9,47,512,-465,-90.8203125
99,26,10,850,1024,-174,-16.9921875
99,26,11,4588,2048,2540,124.0234375
99,26,12,18377,4096,14281,348.6572265625
99,26,13,5184,8192,-3008,-36.71875
99,26,14,6134,16384,-10250,-62.56103515625
99,26,15,5270,32768,-27498,-83.917236328125
99,27,1,0,2,-2,-100.0
99,27,2,3,4,-1,-25.0
99,27,3,3,8,-5,-62.5
99,27,4,24,16,8,50.0
99,27,5,14,32,-18,-56.25
99,27,6,18,64,-46,-71.875
99,27,7,252,128,124,96.875
99,27,8,233,256,-23,-8.984375
99,27,9,193,512,-319,-62.3046875
99,27,10,180,1024,-844,-82.421875
99,27,11,1388,2048,-660,-32.2265625
99,27,12,24461,4096,20365,497.1923828125
99,27,13,14814,8192,6622,80.8349609375
99,27,14,9692,16384,-6692,-40.8447265625
99,27,15,2436,32768,-30332,-92.56591796875
99,28,1,0,2,-2,-100.0
99,28,2,1,4,-3,-75.0
99,28,3,10,8,2,25.0
99,28,4,4,16,-12,-75.0
99,28,5,42,32,10,31.25
99,28,6,89,64,25,39.0625
99,28,7,6,128,-122,-95.3125
99,28,8,1023,256,767,299.609375
99,28,9,106,512,-406,-79.296875
99,28,10,155,1024,-869,-84.86328125
99,28,11,9639,2048,7591,370.654296875
99,28,12,4726,4096,630,15.380859375
99,28,13,30973,8192,22781,278.08837890625
99,28,14,5334,16384,-11050,-67.44384765625
99,28,15,58371,32768,25603,78.1341552734375
99,29,1,0,2,-2,-100.0
99,29,2,1,4,-3,-75.0
99,29,3,3,8,-5,-62.5
99,29,4,4,16,-12,-75.0
99,29,5,11,32,-21,-65.625
99,29,6,10,64,-54,-84.375
99,29,7,25,128,-103,-80.46875
99,29,8,483,256,227,88.671875
99,29,9,19,512,-493,-96.2890625
99,29,10,261,1024,-763,-74.51171875
99,29,11,1759,2048,-289,-14.111328125
99,29,12,785,4096,-3311,-80.8349609375
99,29,13,1364,8192,-6828,-83.349609375
99,29,14,3835,16384,-12549,-76.593017578125
99,29,15,76508,32768,43740,133.48388671875
99,30,1,0,2,-2,-100.0
99,30,2,3,4,-1,-25.0
99,30,3,2,8,-6,-75.0
99,30,4,3,16,-13,-81.25
99,30,5,8,32,-24,-75.0
99,30,6,84,64,20,31.25
99,30,7,19,128,-109,-85.15625
99,30,8,730,256,474,185.15625
99,30,9,907,512,395,77.1484375
99,30,10,3022,1024,1998,195.1171875
99,30,11,162,2048,-1886,-92.08984375
99,30,12,1795,4096,-2301,-56.1767578125
99,30,13,1170,8192,-7022,-85.7177734375
99,30,14,32815,16384,16431,100.286865234375
99,30,15,142896,32768,110128,336.083984375
99,31,1,0,2,-2,-100.0
99,31,2,4,4,0,0.0
99,31,3,5,8,-3,-37.5
99,31,4,9,16,-7,-43.75
99,31,5,19,32,-13,-40.625
99,31,6,88,64,24,37.5
99,31,7,77,128,-51,-39.84375
99,31,8,759,256,503,196.484375
99,31,9,254,512,-258,-50.390625
99,31,10,1082,1024,58,5.6640625
99,31,11,2675,2048,627,30.615234375
99,31,12,14703,4096,10607,258.9599609375
99,31,13,2561,8192,-5631,-68.73779296875
99,31,14,2473,16384,-13911,-84.906005859375
99,31,15,27243,32768,-5525,-16.8609619140625
99,32,1,0,2,-2,-100.0
99,32,2,3,4,-1,-25.0
99,32,3,2,8,-6,-75.0
99,32,4,27,16,11,68.75
99,32,5,22,32,-10,-31.25
99,32,6,28,64,-36,-56.25
99,32,7,61,128,-67,-52.34375
99,32,8,195,256,-61,-23.828125
99,32,9,47,512,-465,-90.8203125
99,32,10,309,1024,-715,-69.82421875
99,32,11,1343,2048,-705,-34.423828125
99,32,12,14549,4096,10453,255.2001953125
99,32,13,1314,8192,-6878,-83.9599609375
99,32,14,3236,16384,-13148,-80.2490234375
99,32,15,20661,32768,-12107,-36.9476318359375
99,33,1,0,2,-2,-100.0
99,33,2,1,4,-3,-75.0
99,33,3,2,8,-6,-75.0
99,33,4,7,16,-9,-56.25
99,33,5,20,32,-12,-37.5
99,33,6,24,64,-40,-62.5
99,33,7,224,128,96,75.0
99,33,8,90,256,-166,-64.84375
99,33,9,1490,512,978,191.015625
99,33,10,1115,1024,91,8.88671875
99,33,11,268,2048,-1780,-86.9140625
99,33,12,2016,4096,-2080,-50.78125
99,33,13,17,8192,-8175,-99.79248046875
99,33,14,8667,16384,-7717,-47.100830078125
99,33,15,18707,32768,-14061,-42.9107666015625
99,34,1,0,2,-2,-100.0
99,34,2,1,4,-3,-75.0
99,34,3,12,8,4,50.0
99,34,4,27,16,11,68.75
99,34,5,4,32,-28,-87.5
99,34,6,24,64,-40,-62.5
99,34,7,167,128,39,30.46875
99,34,8,135,256,-121,-47.265625
99,34,9,832,512,320,62.5
99,34,10,38,1024,-986,-96.2890625
99,34,11,11,2048,-2037,-99.462890625
99,34,12,1848,4096,-2248,-54.8828125
99,34,13,13476,8192,5284,64.501953125
99,34,14,3608,16384,-12776,-77.978515625
99,34,15,30611,32768,-2157,-6.5826416015625
99,35,1,0,2,-2,-100.0
99,35,2,3,4,-1,-25.0
99,35,3,3,8,-5,-62.5
99,35,4,4,16,-12,-75.0
99,35,5,35,32,3,9.375
99,35,6,229,64,165,257.8125
99,35,7,54,128,-74,-57.8125
99,35,8,400,256,144,56.25
99,35,9,1118,512,606,118.359375
99,35,10,1338,1024,314,30.6640625
99,35,11,6018,2048,3970,193.84765625
99,35,12,2226,4096,-1870,-45.654296875
99,35,13,20951,8192,12759,155.74951171875
99,35,14,6054,16384,-10330,-63.04931640625
99,35,15,5241,32768,-27527,-84.0057373046875
99,36,1,0,2,-2,-100.0
99,36,2,5,4,1,25.0
99,36,3,2,8,-6,-75.0
99,36,4,8,16,-8,-50.0
99,36,5,11,32,-21,-65.625
99,36,6,400,64,336,525.0
99,36,7,19,128,-109,-85.15625
99,36,8,39,256,-217,-84.765625
99,36,9,1711,512,1199,234.1796875
99,36,10,1337,1024,313,30.56640625
99,36,11,6236,2048,4188,204.4921875
99,36,12,2261,4096,-1835,-44.7998046875
99,36,13,6815,8192,-1377,-16.80908203125
99,36,14,8268,16384,-8116,-49.5361328125
99,36,15,10669,32768,-22099,-67.4407958984375
99,37,1,0,2,-2,-100.0
99,37,2,2,4,-2,-50.0
99,37,3,4,8,-4,-50.0
99,37,4,5,16,-11,-68.75
99,37,5,26,32,-6,-18.75
99,37,6,38,64,-26,-40.625
99,37,7,37,128,-91,-71.09375
99,37,8,380,256,124,48.4375
99,37,9,26,512,-486,-94.921875
99,37,10,415,1024,-609,-59.47265625
99,37,11,241,2048,-1807,-88.232421875
99,37,12,5770,4096,1674,40.869140625
99,37,13,3900,8192,-4292,-52.392578125
99,37,14,18983,16384,2599,15.863037109375
99,37,15,15397,32768,-17371,-53.0120849609375
99,38,1,0,2,-2,-100.0
99,38,2,1,4,-3,-75.0
99,38,3,7,8,-1,-12.5
99,38,4,9,16,-7,-43.75
99,38,5,42,32,10,31.25
99,38,6,33,64,-31,-48.4375
99,38,7,6,128,-122,-95.3125
99,38,8,227,256,-29,-11.328125
99,38,9,25,512,-487,-95.1171875
99,38,10,1415,1024,391,38.18359375
99,38,11,2668,2048,620,30.2734375
99,38,12,14761,4096,10665,260.3759765625
99,38,13,16557,8192,8365,102.11181640625
99,38,14,29430,16384,13046,79.62646484375
99,38,15,10382,32768,-22386,-68.316650390625
99,39,1,0,2,-2,-100.0
99,39,2,2,4,-2,-50.0
99,39,3,8,8,0,0.0
99,39,4,31,16,15,93.75
99,39,5,13,32,-19,-59.375
99,39,6,17,64,-47,-73.4375
99,39,7,84,128,-44,-34.375
99,39,8,278,256,22,8.59375
99,39,9,510,512,-2,-0.390625
99,39,10,661,1024,-363,-35.44921875
99,39,11,1928,2048,-120,-5.859375
99,39,12,17900,4096,13804,337.01171875
99,39,13,926,8192,-7266,-88.6962890625
99,39,14,8304,16384,-8080,-49.31640625
99,39,15,9597,32768,-23171,-70.7122802734375
99,40,1,0,2,-2,-100.0
99,40,2,1,4,-3,-75.0
99,40,3,3,8,-5,-62.5
99,40,4,8,16,-8,-50.0
99,40,5,8,32,-24,-75.0
99,40,6,87,64,23,35.9375
99,40,7,40,128,-88,-68.75
99,40,8,595,256,339,132.421875
99,40,9,157,512,-355,-69.3359375
99,40,10,1072,1024,48,4.6875
99,40,11,952,2048,-1096,-53.515625
99,40,12,8352,4096,4256,103.90625
99,40,13,56,8192,-8136,-99.31640625
99,40,14,12981,16384,-3403,-20.770263671875
99,40,15,17282,32768,-15486,-47.259521484375
99,41,1,0,2,-2,-100.0
99,41,2,1,4,-3,-75.0
99,41,3,3,8,-5,-62.5
99,41,4,3,16,-13,-81.25
99,41,5,12,32,-20,-62.5
99,41,6,61,64,-3,-4.6875
99,41,7,23,128,-105,-82.03125
99,41,8,50,256,-206,-80.46875
99,41,9,1251,512,739,144.3359375
99,41,10,698,1024,-326,-31.8359375
99,41,11,3550,2048,1502,73.33984375
99,41,12,1816,4096,-2280,-55.6640625
99,41,13,49349,8192,41157,502.40478515625
99,41,14,27867,16384,11483,70.086669921875
99,41,15,17576,32768,-15192,-46.3623046875
99,42,1,0,2,-2,-100.0
99,42,2,1,4,-3,-75.0
99,42,3,2,8,-6,-75.0
99,42,4,3,16,-13,-81.25
99,42,5,18,32,-14,-43.75
99,42,6,6,64,-58,-90.625
99,42,7,66,128,-62,-48.4375
99,42,8,865,256,609,237.890625
99,42,9,445,512,-67,-13.0859375
99,42,10,307,1024,-717,-70.01953125
99,42,11,1827,2048,-221,-10.791015625
99,42,12,9935,4096,5839,142.5537109375
99,42,13,6368,8192,-1824,-22.265625
99,42,14,8965,16384,-7419,-45.281982421875
99,42,15,26066,32768,-6702,-20.452880859375
99,43,1,0,2,-2,-100.0
99,43,2,1,4,-3,-75.0
99,43,3,4,8,-4,-50.0
99,43,4,13,16,-3,-18.75
99,43,5,7,32,-25,-78.125
99,43,6,6,64,-58,-90.625
99,43,7,112,128,-16,-12.5
99,43,8,51,256,-205,-80.078125
99,43,9,740,512,228,44.53125
99,43,10,574,1024,-450,-43.9453125
99,43,11,371,2048,-1677,-81.884765625
99,43,12,3309,4096,-787,-19.2138671875
99,43,13,6377,8192,-1815,-22.15576171875
99,43,14,4752,16384,-11632,-70.99609375
99,43,15,22293,32768,-10475,-31.9671630859375
99,44,1,0,2,-2,-100.0
99,44,2,2,4,-2,-50.0
99,44,3,13,8,5,62.5
99,44,4,49,16,33,206.25
99,44,5,13,32,-19,-59.375
99,44,6,13,64,-51,-79.6875
99,44,7,134,128,6,4.6875
99,44,8,631,256,375,146.484375
99,44,9,57,512,-455,-88.8671875
99,44,10,142,1024,-882,-86.1328125
99,44,11,2256,2048,208,10.15625
99,44,12,11982,4096,7886,192.529296875
99,44,13,4978,8192,-3214,-39.2333984375
99,44,14,15578,16384,-806,-4.91943359375
99,44,15,9317,32768,-23451,-71.5667724609375
99,45,1,0,2,-2,-100.0
99,45,2,2,4,-2,-50.0
99,45,3,5,8,-3,-37.5
99,45,4,25,16,9,56.25
99,45,5,19,32,-13,-40.625
99,45,6,100,64,36,56.25
99,45,7,116,128,-12,-9.375
99,45,8,116,256,-140,-54.6875
99,45,9,188,512,-324,-63.28125
99,45,10,509,1024,-515,-50.29296875
99,45,11,4770,2048,2722,132.91015625
99,45,12,3323,4096,-773,-18.8720703125
99,45,13,16730,8192,8538,104.2236328125
99,45,14,3528,16384,-12856,-78.466796875
99,45,15,1845,32768,-30923,-94.3695068359375
99,46,1,0,2,-2,-100.0
99,46,2,1,4,-3,-75.0
99,46,3,12,8,4,50.0
99,46,4,92,16,76,475.0
99,46,5,12,32,-20,-62.5
99,46,6,13,64,-51,-79.6875
99,46,7,51,128,-77,-60.15625
99,46,8,84,256,-172,-67.1875
99,46,9,811,512,299,58.3984375
99,46,10,2302,1024,1278,124.8046875
99,46,11,1407,2048,-641,-31.298828125
99,46,12,1477,4096,-2619,-63.9404296875
99,46,13,2070,8192,-6122,-74.7314453125
99,46,14,3346,16384,-13038,-79.57763671875
99,46,15,10326,32768,-22442,-68.487548828125
99,47,1,0,2,-2,-100.0
99,47,2,2,4,-2,-50.0
99,47,3,4,8,-4,-50.0
99,47,4,8,16,-8,-50.0
99,47,5,8,32,-24,-75.0
99,47,6,15,64,-49,-76.5625
99,47,7,240,128,112,87.5
99,47,8,242,256,-14,-5.46875
99,47,9,474,512,-38,-7.421875
99,47,10,301,1024,-723,-70.60546875
99,47,11,1501,2048,-547,-26.708984375
99,47,12,2367,4096,-1729,-42.2119140625
99,47,13,3698,8192,-4494,-54.8583984375
99,47,14,9667,16384,-6717,-40.997314453125
99,47,15,41746,32768,8978,27.398681640625
99,48,1,0,2,-2,-100.0
99,48,2,3,4,-1,-25.0
99,48,3,4,8,-4,-50.0
99,48,4,3,16,-13,-81.25
99,48,5,4,32,-28,-87.5
99,48,6,21,64,-43,-67.1875
99,48,7,123,128,-5,-3.90625
99,48,8,98,256,-158,-61.71875
99,48,9,196,512,-316,-61.71875
99,48,10,448,1024,-576,-56.25
99,48,11,3314,2048,1266,61.81640625
99,48,12,3349,4096,-747,-18.2373046875
99,48,13,2808,8192,-5384,-65.72265625
99,48,14,12647,16384,-3737,-22.808837890625
99,48,15,38071,32768,5303,16.1834716796875
99,49,1,0,2,-2,-100.0
99,49,2,1,4,-3,-75.0
99,49,3,4,8,-4,-50.0
99,49,4,3,16,-13,-81.25
99,49,5,10,32,-22,-68.75
99,49,6,40,64,-24,-37.5
99,49,7,6,128,-122,-95.3125
99,49,8,93,256,-163,-63.671875
99,49,9,276,512,-236,-46.09375
99,49,10,116,1024,-908,-88.671875
99,49,11,6106,2048,4058,198.14453125
99,49,12,2423,4096,-1673,-40.8447265625
99,49,13,4788,8192,-3404,-41.552734375
99,49,14,65296,16384,48912,298.53515625
99,49,15,30760,32768,-2008,-6.1279296875
99,50,1,0,2,-2,-100.0
99,50,2,3,4,-1,-25.0
99,50,3,2,8,-6,-75.0
99,50,4,3,16,-13,-81.25
99,50,5,9,32,-23,-71.875
99,50,6,29,64,-35,-54.6875
99,50,7,75,128,-53,-41.40625
99,50,8,82,256,-174,-67.96875
99,50,9,246,512,-266,-51.953125
99,50,10,3278,1024,2254,220.1171875
99,50,11,726,2048,-1322,-64.55078125
99,50,12,3173,4096,-923,-22.5341796875
99,50,13,845,8192,-7347,-89.68505859375
99,50,14,53965,16384,37581,229.376220703125
99,50,15,11006,32768,-21762,-66.412353515625
99,51,1,0,2,-2,-100.0
99,51,2,1,4,-3,-75.0
99,51,3,5,8,-3,-37.5
99,51,4,11,16,-5,-31.25
99,51,5,117,32,85,265.625
99,51,6,8,64,-56,-87.5
99,51,7,49,128,-79,-61.71875
99,51,8,302,256,46,17.96875
99,51,9,232,512,-280,-54.6875
99,51,10,995,1024,-29,-2.83203125
99,51,11,836,2048,-1212,-59.1796875
99,51,12,192,4096,-3904,-95.3125
99,51,13,4989,8192,-3203,-39.09912109375
99,51,14,1370,16384,-15014,-91.63818359375
99,51,15,54334,32768,21566,65.814208984375
99,52,1,0,2,-2,-100.0
99,52,2,1,4,-3,-75.0
99,52,3,14,8,6,75.0
99,52,4,7,16,-9,-56.25
99,52,5,5,32,-27,-84.375
99,52,6,21,64,-43,-67.1875
99,52,7,7,128,-121,-94.53125
99,52,8,13,256,-243,-94.921875
99,52,9,79,512,-433,-84.5703125
99,52,10,1650,1024,626,61.1328125
99,52,11,2431,2048,383,18.701171875
99,52,12,4569,4096,473,11.5478515625
99,52,13,6750,8192,-1442,-17.6025390625
99,52,14,2609,16384,-13775,-84.075927734375
99,52,15,31079,32768,-1689,-5.1544189453125
99,53,1,0,2,-2,-100.0
99,53,2,1,4,-3,-75.0
99,53,3,9,8,1,12.5
99,53,4,34,16,18,112.5
99,53,5,11,32,-21,-65.625
99,53,6,29,64,-35,-54.6875
99,53,7,201,128,73,57.03125
99,53,8,92,256,-164,-64.0625
99,53,9,196,512,-316,-61.71875
99,53,10,1578,1024,554,54.1015625
99,53,11,2449,2048,401,19.580078125
99,53,12,290,4096,-3806,-92.919921875
99,53,13,5640,8192,-2552,-31.15234375
99,53,14,39231,16384,22847,139.447021484375
99,53,15,18870,32768,-13898,-42.413330078125
99,54,1,0,2,-2,-100.0
99,54,2,3,4,-1,-25.0
99,54,3,3,8,-5,-62.5
99,54,4,8,16,-8,-50.0
99,54,5,10,32,-22,-68.75
99,54,6,54,64,-10,-15.625
99,54,7,169,128,41,32.03125
99,54,8,1708,256,1452,567.1875
99,54,9,125,512,-387,-75.5859375
99,54,10,257,1024,-767,-74.90234375
99,54,11,3930,2048,1882,91.89453125
99,54,12,1407,4096,-2689,-65.6494140625
99,54,13,6419,8192,-1773,-21.64306640625
99,54,14,1400,16384,-14984,-91.455078125
99,54,15,30131,32768,-2637,-8.0474853515625
99,55,1,0,2,-2,-100.0
99,55,2,1,4,-3,-75.0
99,55,3,10,8,2,25.0
99,55,4,12,16,-4,-25.0
99,55,5,37,32,5,15.625
99,55,6,20,64,-44,-68.75
99,55,7,15,128,-113,-88.28125
99,55,8,124,256,-132,-51.5625
99,55,9,203,512,-309,-60.3515625
99,55,10,65,1024,-959,-93.65234375
99,55,11,137,2048,-1911,-93.310546875
99,55,12,966,4096,-3130,-76.416015625
99,55,13,6938,8192,-1254,-15.3076171875
99,55,14,7397,16384,-8987,-54.852294921875
99,55,15,30669,32768,-2099,-6.4056396484375
99,56,1,0,2,-2,-100.0
99,56,2,1,4,-3,-75.0
99,56,3,14,8,6,75.0
99,56,4,22,16,6,37.5
99,56,5,58,32,26,81.25
99,56,6,179,64,115,179.6875
99,56,7,54,128,-74,-57.8125
99,56,8,143,256,-113,-44.140625
99,56,9,145,512,-367,-71.6796875
99,56,10,1491,1024,467,45.60546875
99,56,11,1303,2048,-745,-36.376953125
99,56,12,293,4096,-3803,-92.8466796875
99,56,13,9090,8192,898,10.9619140625
99,56,14,72668,16384,56284,343.5302734375
99,56,15,165,32768,-32603,-99.4964599609375
99,57,1,0,2,-2,-100.0
99,57,2,2,4,-2,-50.0
99,57,3,4,8,-4,-50.0
99,57,4,15,16,-1,-6.25
99,57,5,90,32,58,181.25
99,57,6,7,64,-57,-89.0625
99,57,7,379,128,251,196.09375
99,57,8,182,256,-74,-28.90625
99,57,9,865,512,353,68.9453125
99,57,10,2053,1024,1029,100.48828125
99,57,11,932,2048,-1116,-54.4921875
99,57,12,2434,4096,-1662,-40.576171875
99,57,13,4884,8192,-3308,-40.380859375
99,57,14,44779,16384,28395,173.309326171875
99,57,15,14480,32768,-18288,-55.810546875
99,58,1,0,2,-2,-100.0
99,58,2,4,4,0,0.0
99,58,3,4,8,-4,-50.0
99,58,4,18,16,2,12.5
99,58,5,35,32,3,9.375
99,58,6,7,64,-57,-89.0625
99,58,7,629,128,501,391.40625
99,58,8,374,256,118,46.09375
99,58,9,362,512,-150,-29.296875
99,58,10,398,1024,-626,-61.1328125
99,58,11,1303,2048,-745,-36.376953125
99,58,12,753,4096,-3343,-81.6162109375
99,58,13,3498,8192,-4694,-57.2998046875
99,58,14,18133,16384,1749,10.675048828125
99,58,15,1291,32768,-31477,-96.0601806640625
99,59,1,0,2,-2,-100.0
99,59,2,4,4,0,0.0
99,59,3,4,8,-4,-50.0
99,59,4,5,16,-11,-68.75
99,59,5,13,32,-19,-59.375
99,59,6,33,64,-31,-48.4375
99,59,7,105,128,-23,-17.96875
99,59,8,51,256,-205,-80.078125
99,59,9,593,512,81,15.8203125
99,59,10,1009,1024,-15,-1.46484375
99,59,11,1024,2048,-1024,-50.0
99,59,12,3546,4096,-550,-13.427734375
99,59,13,34859,8192,26667,325.52490234375
99,59,14,13878,16384,-2506,-15.29541015625
99,59,15,26721,32768,-6047,-18.4539794921875
99,60,1,0,2,-2,-100.0
99,60,2,4,4,0,0.0
99,60,3,8,8,0,0.0
99,60,4,6,16,-10,-62.5
99,60,5,80,32,48,150.0
99,60,6,32,64,-32,-50.0
99,60,7,19,128,-109,-85.15625
99,60,8,106,256,-150,-58.59375
99,60,9,1343,512,831,162.3046875
99,60,10,1161,1024,137,13.37890625
99,60,11,1928,2048,-120,-5.859375
99,60,12,5819,4096,1723,42.0654296875
99,60,13,14324,8192,6132,74.853515625
99,60,14,2430,16384,-13954,-85.16845703125
99,60,15,5970,32768,-26798,-81.781005859375
99,61,1,0,2,-2,-100.0
99,61,2,1,4,-3,-75.0
99,61,3,4,8,-4,-50.0
99,61,4,3,16,-13,-81.25
99,61,5,58,32,26,81.25
99,61,6,44,64,-20,-31.25
99,61,7,83,128,-45,-35.15625
99,61,8,41,256,-215,-83.984375
99,61,9,1298,512,786,153.515625
99,61,10,1196,1024,172,16.796875
99,61,11,299,2048,-1749,-85.400390625
99,61,12,5015,4096,919,22.4365234375
99,61,13,2145,8192,-6047,-73.81591796875
99,61,14,32169,16384,15785,96.343994140625
99,61,15,33587,32768,819,2.4993896484375
99,62,1,0,2,-2,-100.0
99,62,2,1,4,-3,-75.0
99,62,3,13,8,5,62.5
99,62,4,6,16,-10,-62.5
99,62,5,24,32,-8,-25.0
99,62,6,34,64,-30,-46.875
99,62,7,80,128,-48,-37.5
99,62,8,109,256,-147,-57.421875
99,62,9,671,512,159,31.0546875
99,62,10,1003,1024,-21,-2.05078125
99,62,11,1435,2048,-613,-29.931640625
99,62,12,731,4096,-3365,-82.1533203125
99,62,13,4526,8192,-3666,-44.7509765625
99,62,14,43013,16384,26629,162.530517578125
99,62,15,45788,32768,13020,39.73388671875
99,63,1,0,2,-2,-100.0
99,63,2,1,4,-3,-75.0
99,63,3,9,8,1,12.5
99,63,4,14,16,-2,-12.5
99,63,5,12,32,-20,-62.5
99,63,6,121,64,57,89.0625
99,63,7,44,128,-84,-65.625
99,63,8,243,256,-13,-5.078125
99,63,9,392,512,-120,-23.4375
99,63,10,406,1024,-618,-60.3515625
99,63,11,55,2048,-1993,-97.314453125
99,63,12,259,4096,-3837,-93.6767578125
99,63,13,20023,8192,11831,144.42138671875
99,63,14,8933,16384,-7451,-45.477294921875
99,63,15,24584,32768,-8184,-24.9755859375
99,64,1,0,2,-2,-100.0
99,64,2,5,4,1,25.0
99,64,3,2,8,-6,-75.0
99,64,4,11,16,-5,-31.25
99,64,5,31,32,-1,-3.125
99,64,6,184,64,120,187.5
99,64,7,62,128,-66,-51.5625
99,64,8,649,256,393,153.515625
99,64,9,93,512,-419,-81.8359375
99,64,10,985,1024,-39,-3.80859375
99,64,11,2562,2048,514,25.09765625
99,64,12,8418,4096,4322,105.517578125
99,64,13,2236,8192,-5956,-72.705078125
99,64,14,19652,16384,3268,19.9462890625
99,64,15,130053,32768,97285,296.8902587890625
99,65,1,0,2,-2,-100.0
99,65,2,1,4,-3,-75.0
99,65,3,2,8,-6,-75.0
99,65,4,7,16,-9,-56.25
99,65,5,23,32,-9,-28.125
99,65,6,15,64,-49,-76.5625
99,65,7,115,128,-13,-10.15625
99,65,8,390,256,134,52.34375
99,65,9,430,512,-82,-16.015625
99,65,10,549,1024,-475,-46.38671875
99,65,11,1770,2048,-278,-13.57421875
99,65,12,5684,4096,1588,38.76953125
99,65,13,31042,8192,22850,278.9306640625
99,65,14,7221,16384,-9163,-55.926513671875
99,65,15,11288,32768,-21480,-65.5517578125
99,66,1,0,2,-2,-100.0
99,66,2,1,4,-3,-75.0
99,66,3,5,8,-3,-37.5
99,66,4,24,16,8,50.0
99,66,5,88,32,56,175.0
99,66,6,42,64,-22,-34.375
99,66,7,260,128,132,103.125
99,66,8,101,256,-155,-60.546875
99,66,9,427,512,-85,-16.6015625
99,66,10,380,1024,-644,-62.890625
99,66,11,3168,2048,1120,54.6875
99,66,12,6711,4096,2615,63.8427734375
99,66,13,10338,8192,2146,26.1962890625
99,66,14,22826,16384,6442,39.31884765625
99,66,15,22824,32768,-9944,-30.3466796875
99,67,1,0,2,-2,-100.0
99,67,2,4,4,0,0.0
99,67,3,13,8,5,62.5
99,67,4,9,16,-7,-43.75
99,67,5,4,32,-28,-87.5
99,67,6,46,64,-18,-28.125
99,67,7,6,128,-122,-95.3125
99,67,8,363,256,107,41.796875
99,67,9,926,512,414,80.859375
99,67,10,331,1024,-693,-67.67578125
99,67,11,1993,2048,-55,-2.685546875
99,67,12,11294,4096,7198,175.732421875
99,67,13,1111,8192,-7081,-86.43798828125
99,67,14,5617,16384,-10767,-65.716552734375
99,67,15,30086,32768,-2682,-8.184814453125
99,68,1,0,2,-2,-100.0
99,68,2,1,4,-3,-75.0
99,68,3,4,8,-4,-50.0
99,68,4,11,16,-5,-31.25
99,68,5,7,32,-25,-78.125
99,68,6,60,64,-4,-6.25
99,68,7,28,128,-100,-78.125
99,68,8,181,256,-75,-29.296875
99,68,9,80,512,-432,-84.375
99,68,10,484,1024,-540,-52.734375
99,68,11,1175,2048,-873,-42.626953125
99,68,12,3471,4096,-625,-15.2587890625
99,68,13,17940,8192,9748,118.994140625
99,68,14,15316,16384,-1068,-6.5185546875
99,68,15,77936,32768,45168,137.841796875
99,69,1,0,2,-2,-100.0
99,69,2,1,4,-3,-75.0
99,69,3,2,8,-6,-75.0
99,69,4,30,16,14,87.5
99,69,5,14,32,-18,-56.25
99,69,6,21,64,-43,-67.1875
99,69,7,112,128,-16,-12.5
99,69,8,643,256,387,151.171875
99,69,9,194,512,-318,-62.109375
99,69,10,69,1024,-955,-93.26171875
99,69,11,1950,2048,-98,-4.78515625
99,69,12,7543,4096,3447,84.1552734375
99,69,13,9480,8192,1288,15.72265625
99,69,14,7479,16384,-8905,-54.351806640625
99,69,15,8051,32768,-24717,-75.4302978515625
99,70,1,0,2,-2,-100.0
99,70,2,1,4,-3,-75.0
99,70,3,11,8,3,37.5
99,70,4,8,16,-8,-50.0
99,70,5,14,32,-18,-56.25
99,70,6,52,64,-12,-18.75
99,70,7,116,128,-12,-9.375
99,70,8,502,256,246,96.09375
99,70,9,192,512,-320,-62.5
99,70,10,4527,1024,3503,342.08984375
99,70,11,147,2048,-1901,-92.822265625
99,70,12,4829,4096,733,17.8955078125
99,70,13,11236,8192,3044,37.158203125
99,70,14,7044,16384,-9340,-57.0068359375
99,70,15,28801,32768,-3967,-12.1063232421875
99,71,1,0,2,-2,-100.0
99,71,2,2,4,-2,-50.0
99,71,3,4,8,-4,-50.0
99,71,4,5,16,-11,-68.75
99,71,5,22,32,-10,-31.25
99,71,6,14,64,-50,-78.125
99,71,7,49,128,-79,-61.71875
99,71,8,718,256,462,180.46875
99,71,9,449,512,-63,-12.3046875
99,71,10,231,1024,-793,-77.44140625
99,71,11,353,2048,-1695,-82.763671875
99,71,12,11307,4096,7211,176.0498046875
99,71,13,1077,8192,-7115,-86.85302734375
99,71,14,20745,16384,4361,26.617431640625
99,71,15,41127,32768,8359,25.5096435546875
99,72,1,0,2,-2,-100.0
99,72,2,6,4,2,50.0
99,72,3,12,8,4,50.0
99,72,4,8,16,-8,-50.0
99,72,5,25,32,-7,-21.875
99,72,6,69,64,5,7.8125
99,72,7,32,128,-96,-75.0
99,72,8,504,256,248,96.875
99,72,9,68,512,-444,-86.71875
99,72,10,4686,1024,3662,357.6171875
99,72,11,780,2048,-1268,-61.9140625
99,72,12,538,4096,-3558,-86.865234375
99,72,13,2024,8192,-6168,-75.29296875
99,72,14,1068,16384,-15316,-93.4814453125
99,72,15,89113,32768,56345,171.9512939453125
99,73,1,0,2,-2,-100.0
99,73,2,2,4,-2,-50.0
99,73,3,10,8,2,25.0
99,73,4,12,16,-4,-25.0
99,73,5,46,32,14,43.75
99,73,6,58,64,-6,-9.375
99,73,7,104,128,-24,-18.75
99,73,8,241,256,-15,-5.859375
99,73,9,807,512,295,57.6171875
99,73,10,3529,1024,2505,244.62890625
99,73,11,2178,2048,130,6.34765625
99,73,12,3473,4096,-623,-15.2099609375
99,73,13,21657,8192,13465,164.36767578125
99,73,14,4076,16384,-12308,-75.1220703125
99,73,15,37153,32768,4385,13.3819580078125
99,74,1,0,2,-2,-100.0
99,74,2,1,4,-3,-75.0
99,74,3,5,8,-3,-37.5
99,74,4,3,16,-13,-81.25
99,74,5,121,32,89,278.125
99,74,6,43,64,-21,-32.8125
99,74,7,436,128,308,240.625
99,74,8,44,256,-212,-82.8125
99,74,9,256,512,-256,-50.0
99,74,10,11,1024,-1013,-98.92578125
99,74,11,3466,2048,1418,69.23828125
99,74,12,1547,4096,-2549,-62.2314453125
99,74,13,4077,8192,-4115,-50.23193359375
99,74,14,25435,16384,9051,55.242919921875
99,74,15,18189,32768,-14579,-44.4915771484375
99,75,1,0,2,-2,-100.0
99,75,2,1,4,-3,-75.0
99,75,3,4,8,-4,-50.0
99,75,4,22,16,6,37.5
99,75,5,69,32,37,115.625
99,75,6,49,64,-15,-23.4375
99,75,7,81,128,-47,-36.71875
99,75,8,214,256,-42,-16.40625
99,75,9,292,512,-220,-42.96875
99,75,10,2029,1024,1005,98.14453125
99,75,11,2508,2048,460,22.4609375
99,75,12,3472,4096,-624,-15.234375
99,75,13,2997,8192,-5195,-63.41552734375
99,75,14,48253,16384,31869,194.512939453125
99,75,15,111700,32768,78932,240.88134765625
99,76,1,0,2,-2,-100.0
99,76,2,1,4,-3,-75.0
99,76,3,8,8,0,0.0
99,76,4,17,16,1,6.25
99,76,5,48,32,16,50.0
99,76,6,157,64,93,145.3125
99,76,7,452,128,324,253.125
99,76,8,73,256,-183,-71.484375
99,76,9,349,512,-163,-31.8359375
99,76,10,3897,1024,2873,280.56640625
99,76,11,7704,2048,5656,276.171875
99,76,12,917,4096,-3179,-77.6123046875
99,76,13,3508,8192,-4684,-57.177734375
99,76,14,13330,16384,-3054,-18.64013671875
99,76,15,20515,32768,-12253,-37.3931884765625
99,77,1,0,2,-2,-100.0
99,77,2,1,4,-3,-75.0
99,77,3,5,8,-3,-37.5
99,77,4,12,16,-4,-25.0
99,77,5,15,32,-17,-53.125
99,77,6,5,64,-59,-92.1875
99,77,7,363,128,235,183.59375
99,77,8,466,256,210,82.03125
99,77,9,16,512,-496,-96.875
99,77,10,908,1024,-116,-11.328125
99,77,11,2809,2048,761,37.158203125
99,77,12,1337,4096,-2759,-67.3583984375
99,77,13,496,8192,-7696,-93.9453125
99,77,14,5289,16384,-11095,-67.718505859375
99,77,15,68107,32768,35339,107.8460693359375
99,78,1,0,2,-2,-100.0
99,78,2,1,4,-3,-75.0
99,78,3,5,8,-3,-37.5
99,78,4,20,16,4,25.0
99,78,5,13,32,-19,-59.375
99,78,6,75,64,11,17.1875
99,78,7,189,128,61,47.65625
99,78,8,796,256,540,210.9375
99,78,9,40,512,-472,-92.1875
99,78,10,482,1024,-542,-52.9296875
99,78,11,94,2048,-1954,-95.41015625
99,78,12,224,4096,-3872,-94.53125
99,78,13,3871,8192,-4321,-52.74658203125
99,78,14,400,16384,-15984,-97.55859375
99,78,15,14354,32768,-18414,-56.195068359375
99,79,1,0,2,-2,-100.0
99,79,2,1,4,-3,-75.0
99,79,3,7,8,-1,-12.5
99,79,4,5,16,-11,-68.75
99,79,5,11,32,-21,-65.625
99,79,6,133,64,69,107.8125
99,79,7,207,128,79,61.71875
99,79,8,195,256,-61,-23.828125
99,79,9,1015,512,503,98.2421875
99,79,10,3108,1024,2084,203.515625
99,79,11,1330,2048,-718,-35.05859375
99,79,12,5374,4096,1278,31.201171875
99,79,13,9668,8192,1476,18.017578125
99,79,14,29572,16384,13188,80.4931640625
99,79,15,9319,32768,-23449,-71.5606689453125
99,80,1,0,2,-2,-100.0
99,80,2,1,4,-3,-75.0
99,80,3,26,8,18,225.0
99,80,4,23,16,7,43.75
99,80,5,86,32,54,168.75
99,80,6,41,64,-23,-35.9375
99,80,7,72,128,-56,-43.75
99,80,8,111,256,-145,-56.640625
99,80,9,1509,512,997,194.7265625
99,80,10,420,1024,-604,-58.984375
99,80,11,1033,2048,-1015,-49.560546875
99,80,12,1419,4096,-2677,-65.3564453125
99,80,13,11719,8192,3527,43.05419921875
99,80,14,8730,16384,-7654,-46.71630859375
99,80,15,12111,32768,-20657,-63.0401611328125
99,81,1,0,2,-2,-100.0
99,81,2,1,4,-3,-75.0
99,81,3,2,8,-6,-75.0
99,81,4,22,16,6,37.5
99,81,5,15,32,-17,-53.125
99,81,6,11,64,-53,-82.8125
99,81,7,48,128,-80,-62.5
99,81,8,71,256,-185,-72.265625
99,81,9,210,512,-302,-58.984375
99,81,10,185,1024,-839,-81.93359375
99,81,11,2950,2048,902,44.04296875
99,81,12,3932,4096,-164,-4.00390625
99,81,13,5967,8192,-2225,-27.16064453125
99,81,14,9271,16384,-7113,-43.414306640625
99,81,15,23194,32768,-9574,-29.217529296875
99,82,1,0,2,-2,-100.0
99,82,2,1,4,-3,-75.0
99,82,3,25,8,17,212.5
99,82,4,34,16,18,112.5
99,82,5,35,32,3,9.375
99,82,6,22,64,-42,-65.625
99,82,7,256,128,128,100.0
99,82,8,316,256,60,23.4375
99,82,9,194,512,-318,-62.109375
99,82,10,2012,1024,988,96.484375
99,82,11,3501,2048,1453,70.947265625
99,82,12,2619,4096,-1477,-36.0595703125
99,82,13,8722,8192,530,6.4697265625
99,82,14,36102,16384,19718,120.34912109375
99,82,15,11146,32768,-21622,-65.985107421875
99,83,1,0,2,-2,-100.0
99,83,2,3,4,-1,-25.0
99,83,3,2,8,-6,-75.0
99,83,4,3,16,-13,-81.25
99,83,5,38,32,6,18.75
99,83,6,94,64,30,46.875
99,83,7,13,128,-115,-89.84375
99,83,8,304,256,48,18.75
99,83,9,68,512,-444,-86.71875
99,83,10,285,1024,-739,-72.16796875
99,83,11,2841,2048,793,38.720703125
99,83,12,2394,4096,-1702,-41.552734375
99,83,13,16348,8192,8156,99.560546875
99,83,14,16591,16384,207,1.263427734375
99,83,15,59678,32768,26910,82.122802734375
99,84,1,0,2,-2,-100.0
99,84,2,1,4,-3,-75.0
99,84,3,10,8,2,25.0
99,84,4,11,16,-5,-31.25
99,84,5,4,32,-28,-87.5
99,84,6,163,64,99,154.6875
99,84,7,39,128,-89,-69.53125
99,84,8,144,256,-112,-43.75
99,84,9,646,512,134,26.171875
99,84,10,61,1024,-963,-94.04296875
99,84,11,508,2048,-1540,-75.1953125
99,84,12,6216,4096,2120,51.7578125
99,84,13,772,8192,-7420,-90.576171875
99,84,14,2934,16384,-13450,-82.09228515625
99,84,15,31848,32768,-920,-2.8076171875
99,85,1,0,2,-2,-100.0
99,85,2,3,4,-1,-25.0
99,85,3,3,8,-5,-62.5
99,85,4,12,16,-4,-25.0
99,85,5,15,32,-17,-53.125
99,85,6,25,64,-39,-60.9375
99,85,7,184,128,56,43.75
99,85,8,226,256,-30,-11.71875
99,85,9,912,512,400,78.125
99,85,10,1225,1024,201,19.62890625
99,85,11,739,2048,-1309,-63.916015625
99,85,12,4909,4096,813,19.8486328125
99,85,13,3909,8192,-4283,-52.28271484375
99,85,14,22901,16384,6517,39.776611328125
99,85,15,18677,32768,-14091,-43.0023193359375
99,86,1,0,2,-2,-100.0
99,86,2,1,4,-3,-75.0
99,86,3,11,8,3,37.5
99,86,4,10,16,-6,-37.5
99,86,5,55,32,23,71.875
99,86,6,40,64,-24,-37.5
99,86,7,31,128,-97,-75.78125
99,86,8,642,256,386,150.78125
99,86,9,117,512,-395,-77.1484375
99,86,10,794,1024,-230,-22.4609375
99,86,11,4165,2048,2117,103.369140625
99,86,12,1004,4096,-3092,-75.48828125
99,86,13,13616,8192,5424,66.2109375
99,86,14,1094,16384,-15290,-93.32275390625
99,86,15,13294,32768,-19474,-59.429931640625
99,87,1,0,2,-2,-100.0
99,87,2,1,4,-3,-75.0
99,87,3,3,8,-5,-62.5
99,87,4,17,16,1,6.25
99,87,5,15,32,-17,-53.125
99,87,6,23,64,-41,-64.0625
99,87,7,60,128,-68,-53.125
99,87,8,9,256,-247,-96.484375
99,87,9,575,512,63,12.3046875
99,87,10,13,1024,-1011,-98.73046875
99,87,11,312,2048,-1736,-84.765625
99,87,12,1398,4096,-2698,-65.869140625
99,87,13,7912,8192,-280,-3.41796875
99,87,14,7762,16384,-8622,-52.62451171875
99,87,15,12926,32768,-19842,-60.552978515625
99,88,1,0,2,-2,-100.0
99,88,2,2,4,-2,-50.0
99,88,3,12,8,4,50.0
99,88,4,5,16,-11,-68.75
99,88,5,86,32,54,168.75
99,88,6,9,64,-55,-85.9375
99,88,7,140,128,12,9.375
99,88,8,387,256,131,51.171875
99,88,9,196,512,-316,-61.71875
99,88,10,464,1024,-560,-54.6875
99,88,11,1440,2048,-608,-29.6875
99,88,12,3526,4096,-570,-13.916015625
99,88,13,1203,8192,-6989,-85.31494140625
99,88,14,9179,16384,-7205,-43.975830078125
99,88,15,7056,32768,-25712,-78.466796875
99,89,1,0,2,-2,-100.0
99,89,2,2,4,-2,-50.0
99,89,3,6,8,-2,-25.0
99,89,4,37,16,21,131.25
99,89,5,32,32,0,0.0
99,89,6,12,64,-52,-81.25
99,89,7,327,128,199,155.46875
99,89,8,30,256,-226,-88.28125
99,89,9,1146,512,634,123.828125
99,89,10,547,1024,-477,-46.58203125
99,89,11,4929,2048,2881,140.673828125
99,89,12,2226,4096,-1870,-45.654296875
99,89,13,2476,8192,-5716,-69.775390625
99,89,14,21234,16384,4850,29.60205078125
99,89,15,1573,32768,-31195,-95.1995849609375
99,90,1,0,2,-2,-100.0
99,90,2,4,4,0,0.0
99,90,3,12,8,4,50.0
99,90,4,30,16,14,87.5
99,90,5,12,32,-20,-62.5
99,90,6,137,64,73,114.0625
99,90,7,80,128,-48,-37.5
99,90,8,135,256,-121,-47.265625
99,90,9,404,512,-108,-21.09375
99,90,10,1396,1024,372,36.328125
99,90,11,6019,2048,3971,193.896484375
99,90,12,4973,4096,877,21.4111328125
99,90,13,4598,8192,-3594,-43.8720703125
99,90,14,4985,16384,-11399,-69.573974609375
99,90,15,26050,32768,-6718,-20.501708984375
99,91,1,0,2,-2,-100.0
99,91,2,2,4,-2,-50.0
99,91,3,3,8,-5,-62.5
99,91,4,11,16,-5,-31.25
99,91,5,38,32,6,18.75
99,91,6,19,64,-45,-70.3125
99,91,7,24,128,-104,-81.25
99,91,8,232,256,-24,-9.375
99,91,9,99,512,-413,-80.6640625
99,91,10,1989,1024,965,94.23828125
99,91,11,2344,2048,296,14.453125
99,91,12,2473,4096,-1623,-39.6240234375
99,91,13,1319,8192,-6873,-83.89892578125
99,91,14,15913,16384,-471,-2.874755859375
99,91,15,125316,32768,92548,282.43408203125
99,92,1,0,2,-2,-100.0
99,92,2,3,4,-1,-25.0
99,92,3,7,8,-1,-12.5
99,92,4,11,16,-5,-31.25
99,92,5,76,32,44,137.5
99,92,6,39,64,-25,-39.0625
99,92,7,274,128,146,114.0625
99,92,8,290,256,34,13.28125
99,92,9,754,512,242,47.265625
99,92,10,1347,1024,323,31.54296875
99,92,11,1031,2048,-1017,-49.658203125
99,92,12,5946,4096,1850,45.166015625
99,92,13,5954,8192,-2238,-27.3193359375
99,92,14,15184,16384,-1200,-7.32421875
99,92,15,28039,32768,-4729,-14.4317626953125
99,93,1,0,2,-2,-100.0
99,93,2,1,4,-3,-75.0
99,93,3,15,8,7,87.5
99,93,4,18,16,2,12.5
99,93,5,22,32,-10,-31.25
99,93,6,21,64,-43,-67.1875
99,93,7,13,128,-115,-89.84375
99,93,8,57,256,-199,-77.734375
99,93,9,56,512,-456,-89.0625
99,93,10,997,1024,-27,-2.63671875
99,93,11,1454,2048,-594,-29.00390625
99,93,12,2790,4096,-1306,-31.884765625
99,93,13,6613,8192,-1579,-19.27490234375
99,93,14,37344,16384,20960,127.9296875
99,93,15,36599,32768,3831,11.6912841796875
99,94,1,0,2,-2,-100.0
99,94,2,2,4,-2,-50.0
99,94,3,2,8,-6,-75.0
99,94,4,7,16,-9,-56.25
99,94,5,64,32,32,100.0
99,94,6,33,64,-31,-48.4375
99,94,7,115,128,-13,-10.15625
99,94,8,362,256,106,41.40625
99,94,9,775,512,263,51.3671875
99,94,10,447,1024,-577,-56.34765625
99,94,11,3385,2048,1337,65.283203125
99,94,12,4174,4096,78,1.904296875
99,94,13,18388,8192,10196,124.462890625
99,94,14,128545,16384,112161,684.576416015625
99,94,15,42836,32768,10068,30.72509765625
99,95,1,0,2,-2,-100.0
99,95,2,1,4,-3,-75.0
99,95,3,6,8,-2,-25.0
99,95,4,44,16,28,175.0
99,95,5,65,32,33,103.125
99,95,6,24,64,-40,-62.5
99,95,7,25,128,-103,-80.46875
99,95,8,65,256,-191,-74.609375
99,95,9,61,512,-451,-88.0859375
99,95,10,210,1024,-814,-79.4921875
99,95,11,738,2048,-1310,-63.96484375
99,95,12,4802,4096,706,17.236328125
99,95,13,448,8192,-7744,-94.53125
99,95,14,15074,16384,-1310,-7.99560546875
99,95,15,79005,32768,46237,141.1041259765625
99,96,1,0,2,-2,-100.0
99,96,2,2,4,-2,-50.0
99,96,3,2,8,-6,-75.0
99,96,4,12,16,-4,-25.0
99,96,5,99,32,67,209.375
99,96,6,32,64,-32,-50.0
99,96,7,6,128,-122,-95.3125
99,96,8,264,256,8,3.125
99,96,9,248,512,-264,-51.5625
99,96,10,1502,1024,478,46.6796875
99,96,11,6655,2048,4607,224.951171875
99,96,12,1435,4096,-2661,-64.9658203125
99,96,13,1375,8192,-6817,-83.21533203125
99,96,14,16481,16384,97,0.592041015625
99,96,15,37504,32768,4736,14.453125
99,97,1,0,2,-2,-100.0
99,97,2,1,4,-3,-75.0
99,97,3,2,8,-6,-75.0
99,97,4,25,16,9,56.25
99,97,5,7,32,-25,-78.125
99,97,6,27,64,-37,-57.8125
99,97,7,34,128,-94,-73.4375
99,97,8,14,256,-242,-94.53125
99,97,9,2428,512,1916,374.21875
99,97,10,211,1024,-813,-79.39453125
99,97,11,724,2048,-1324,-64.6484375
99,97,12,16241,4096,12145,296.5087890625
99,97,13,20420,8192,12228,149.267578125
99,97,14,24621,16384,8237,50.274658203125
99,97,15,20446,32768,-12322,-37.603759765625
99,98,1,0,2,-2,-100.0
99,98,2,2,4,-2,-50.0
99,98,3,7,8,-1,-12.5
99,98,4,8,16,-8,-50.0
99,98,5,48,32,16,50.0
99,98,6,60,64,-4,-6.25
99,98,7,93,128,-35,-27.34375
99,98,8,606,256,350,136.71875
99,98,9,1410,512,898,175.390625
99,98,10,230,1024,-794,-77.5390625
99,98,11,309,2048,-1739,-84.912109375
99,98,12,6528,4096,2432,59.375
99,98,13,2234,8192,-5958,-72.7294921875
99,98,14,38647,16384,22263,135.882568359375
99,98,15,31853,32768,-915,-2.7923583984375
99,99,1,0,2,-2,-100.0
99,99,2,1,4,-3,-75.0
99,99,3,9,8,1,12.5
99,99,4,7,16,-9,-56.25
99,99,5,6,32,-26,-81.25
99,99,6,90,64,26,40.625
99,99,7,55,128,-73,-57.03125
99,99,8,960,256,704,275.0
99,99,9,442,512,-70,-13.671875
99,99,10,810,1024,-214,-20.8984375
99,99,11,3525,2048,1477,72.119140625
99,99,12,2151,4096,-1945,-47.4853515625
99,99,13,10264,8192,2072,25.29296875
99,99,14,6501,16384,-9883,-60.321044921875
99,99,15,3887,32768,-28881,-88.1378173828125
100,1,1,0,2,-2,-100.0
100,1,2,3,4,-1,-25.0
100,1,3,2,8,-6,-75.0
100,1,4,6,16,-10,-62.5
100,1,5,6,32,-26,-81.25
100,1,6,17,64,-47,-73.4375
100,1,7,25,128,-103,-80.46875
100,1,8,139,256,-117,-45.703125
100,1,9,577,512,65,12.6953125
100,1,10,303,1024,-721,-70.41015625
100,1,11,1385,2048,-663,-32.373046875
100,1,12,45,4096,-4051,-98.9013671875
100,1,13,1860,8192,-6332,-77.294921875
100,1,14,2211,16384,-14173,-86.505126953125
100,1,15,6650,32768,-26118,-79.705810546875
100,2,1,0,2,-2,-100.0
100,2,2,1,4,-3,-75.0
100,2,3,10,8,2,25.0
100,2,4,33,16,17,106.25
100,2,5,5,32,-27,-84.375
100,2,6,33,64,-31,-48.4375
100,2,7,108,128,-20,-15.625
100,2,8,550,256,294,114.84375
100,2,9,136,512,-376,-73.4375
100,2,10,1173,1024,149,14.55078125
100,2,11,379,2048,-1669,-81.494140625
100,2,12,6726,4096,2630,64.208984375
100,2,13,2553,8192,-5639,-68.83544921875
100,2,14,12985,16384,-3399,-20.745849609375
100,2,15,2980,32768,-29788,-90.90576171875
100,3,1,0,2,-2,-100.0
100,3,2,1,4,-3,-75.0
100,3,3,3,8,-5,-62.5
100,3,4,25,16,9,56.25
100,3,5,22,32,-10,-31.25
100,3,6,108,64,44,68.75
100,3,7,166,128,38,29.6875
100,3,8,30,256,-226,-88.28125
100,3,9,155,512,-357,-69.7265625
100,3,10,381,1024,-643,-62.79296875
100,3,11,2440,2048,392,19.140625
100,3,12,649,4096,-3447,-84.1552734375
100,3,13,16582,8192,8390,102.4169921875
100,3,14,21789,16384,5405,32.989501953125
100,3,15,58159,32768,25391,77.4871826171875
100,4,1,0,2,-2,-100.0
100,4,2,1,4,-3,-75.0
100,4,3,5,8,-3,-37.5
100,4,4,8,16,-8,-50.0
100,4,5,7,32,-25,-78.125
100,4,6,21,64,-43,-67.1875
100,4,7,141,128,13,10.15625
100,4,8,780,256,524,204.6875
100,4,9,399,512,-113,-22.0703125
100,4,10,1603,1024,579,56.54296875
100,4,11,66,2048,-1982,-96.77734375
100,4,12,8559,4096,4463,108.9599609375
100,4,13,3564,8192,-4628,-56.494140625
100,4,14,10106,16384,-6278,-38.31787109375
100,4,15,91932,32768,59164,180.55419921875
100,5,1,0,2,-2,-100.0
100,5,2,3,4,-1,-25.0
100,5,3,6,8,-2,-25.0
100,5,4,14,16,-2,-12.5
100,5,5,32,32,0,0.0
100,5,6,60,64,-4,-6.25
100,5,7,196,128,68,53.125
100,5,8,471,256,215,83.984375
100,5,9,10,512,-502,-98.046875
100,5,10,2188,1024,1164,113.671875
100,5,11,806,2048,-1242,-60.64453125
100,5,12,433,4096,-3663,-89.4287109375
100,5,13,5720,8192,-2472,-30.17578125
100,5,14,612,16384,-15772,-96.2646484375
100,5,15,1700,32768,-31068,-94.81201171875
100,6,1,0,2,-2,-100.0
100,6,2,2,4,-2,-50.0
100,6,3,9,8,1,12.5
100,6,4,6,16,-10,-62.5
100,6,5,23,32,-9,-28.125
100,6,6,96,64,32,50.0
100,6,7,407,128,279,217.96875
100,6,8,664,256,408,159.375
100,6,9,50,512,-462,-90.234375
100,6,10,383,1024,-641,-62.59765625
100,6,11,601,2048,-1447,-70.654296875
100,6,12,10344,4096,6248,152.5390625
100,6,13,15451,8192,7259,88.61083984375
100,6,14,123,16384,-16261,-99.249267578125
100,6,15,2008,32768,-30760,-93.8720703125
100,7,1,0,2,-2,-100.0
100,7,2,3,4,-1,-25.0
100,7,3,5,8,-3,-37.5
100,7,4,17,16,1,6.25
100,7,5,12,32,-20,-62.5
100,7,6,158,64,94,146.875
100,7,7,243,128,115,89.84375
100,7,8,913,256,657,256.640625
100,7,9,913,512,401,78.3203125
100,7,10,374,1024,-650,-63.4765625
100,7,11,889,2048,-1159,-56.591796875
100,7,12,12427,4096,8331,203.3935546875
100,7,13,1093,8192,-7099,-86.65771484375
100,7,14,1679,16384,-14705,-89.752197265625
100,7,15,19726,32768,-13042,-39.801025390625
100,8,1,0,2,-2,-100.0
100,8,2,2,4,-2,-50.0
100,8,3,2,8,-6,-75.0
100,8,4,6,16,-10,-62.5
100,8,5,37,32,5,15.625
100,8,6,19,64,-45,-70.3125
100,8,7,100,128,-28,-21.875
100,8,8,61,256,-195,-76.171875
100,8,9,330,512,-182,-35.546875
100,8,10,1434,1024,410,40.0390625
100,8,11,436,2048,-1612,-78.7109375
100,8,12,3263,4096,-833,-20.3369140625
100,8,13,8151,8192,-41,-0.50048828125
100,8,14,42125,16384,25741,157.110595703125
100,8,15,74321,32768,41553,126.8096923828125
100,9,1,0,2,-2,-100.0
100,9,2,2,4,-2,-50.0
100,9,3,24,8,16,200.0
100,9,4,8,16,-8,-50.0
100,9,5,91,32,59,184.375
100,9,6,79,64,15,23.4375
100,9,7,82,128,-46,-35.9375
100,9,8,50,256,-206,-80.46875
100,9,9,740,512,228,44.53125
100,9,10,126,1024,-898,-87.6953125
100,9,11,1146,2048,-902,-44.04296875
100,9,12,15370,4096,11274,275.244140625
100,9,13,1148,8192,-7044,-85.986328125
100,9,14,8768,16384,-7616,-46.484375
100,9,15,37294,32768,4526,13.812255859375
100,10,1,0,2,-2,-100.0
100,10,2,1,4,-3,-75.0
100,10,3,5,8,-3,-37.5
100,10,4,12,16,-4,-25.0
100,10,5,20,32,-12,-37.5
100,10,6,119,64,55,85.9375
100,10,7,17,128,-111,-86.71875
100,10,8,55,256,-201,-78.515625
100,10,9,1892,512,1380,269.53125
100,10,10,338,1024,-686,-66.9921875
100,10,11,5375,2048,3327,162.451171875
100,10,12,348,4096,-3748,-91.50390625
100,10,13,13637,8192,5445,66.46728515625
100,10,14,8869,16384,-7515,-45.867919921875
100,10,15,13782,32768,-18986,-57.940673828125
100,11,1,0,2,-2,-100.0
100,11,2,2,4,-2,-50.0
100,11,3,13,8,5,62.5
100,11,4,5,16,-11,-68.75
100,11,5,39,32,7,21.875
100,11,6,71,64,7,10.9375
100,11,7,16,128,-112,-87.5
100,11,8,676,256,420,164.0625
100,11,9,2104,512,1592,310.9375
100,11,10,605,1024,-419,-40.91796875
100,11,11,5809,2048,3761,183.642578125
100,11,12,3502,4096,-594,-14.501953125
100,11,13,2193,8192,-5999,-73.22998046875
100,11,14,5059,16384,-11325,-69.122314453125
100,11,15,15208,32768,-17560,-53.5888671875
100,12,1,0,2,-2,-100.0
100,12,2,3,4,-1,-25.0
100,12,3,4,8,-4,-50.0
100,12,4,11,16,-5,-31.25
100,12,5,42,32,10,31.25
100,12,6,90,64,26,40.625
100,12,7,209,128,81,63.28125
100,12,8,164,256,-92,-35.9375
100,12,9,725,512,213,41.6015625
100,12,10,1083,1024,59,5.76171875
100,12,11,1924,2048,-124,-6.0546875
100,12,12,137,4096,-3959,-96.6552734375
100,12,13,3635,8192,-4557,-55.62744140625
100,12,14,12556,16384,-3828,-23.3642578125
100,12,15,9152,32768,-23616,-72.0703125
100,13,1,0,2,-2,-100.0
100,13,2,3,4,-1,-25.0
100,13,3,15,8,7,87.5
100,13,4,39,16,23,143.75
100,13,5,13,32,-19,-59.375
100,13,6,84,64,20,31.25
100,13,7,120,128,-8,-6.25
100,13,8,166,256,-90,-35.15625
100,13,9,19,512,-493,-96.2890625
100,13,10,3177,1024,2153,210.25390625
100,13,11,674,2048,-1374,-67.08984375
100,13,12,984,4096,-3112,-75.9765625
100,13,13,6447,8192,-1745,-21.30126953125
100,13,14,15793,16384,-591,-3.607177734375
100,13,15,36847,32768,4079,12.4481201171875
100,14,1,0,2,-2,-100.0
100,14,2,1,4,-3,-75.0
100,14,3,5,8,-3,-37.5
100,14,4,10,16,-6,-37.5
100,14,5,7,32,-25,-78.125
100,14,6,24,64,-40,-62.5
100,14,7,286,128,158,123.4375
100,14,8,550,256,294,114.84375
100,14,9,244,512,-268,-52.34375
100,14,10,358,1024,-666,-65.0390625
100,14,11,931,2048,-1117,-54.541015625
100,14,12,19679,4096,15583,380.4443359375
100,14,13,5224,8192,-2968,-36.23046875
100,14,14,2340,16384,-14044,-85.7177734375
100,14,15,78133,32768,45365,138.4429931640625
100,15,1,0,2,-2,-100.0
100,15,2,1,4,-3,-75.0
100,15,3,3,8,-5,-62.5
100,15,4,14,16,-2,-12.5
100,15,5,17,32,-15,-46.875
100,15,6,30,64,-34,-53.125
100,15,7,21,128,-107,-83.59375
100,15,8,109,256,-147,-57.421875
100,15,9,198,512,-314,-61.328125
100,15,10,342,1024,-682,-66.6015625
100,15,11,2603,2048,555,27.099609375
100,15,12,1029,4096,-3067,-74.8779296875
100,15,13,28710,8192,20518,250.4638671875
100,15,14,9447,16384,-6937,-42.340087890625
100,15,15,61805,32768,29037,88.6138916015625
100,16,1,0,2,-2,-100.0
100,16,2,3,4,-1,-25.0
100,16,3,10,8,2,25.0
100,16,4,23,16,7,43.75
100,16,5,20,32,-12,-37.5
100,16,6,44,64,-20,-31.25
100,16,7,291,128,163,127.34375
100,16,8,212,256,-44,-17.1875
100,16,9,2554,512,2042,398.828125
100,16,10,888,1024,-136,-13.28125
100,16,11,1047,2048,-1001,-48.876953125
100,16,12,8701,4096,4605,112.4267578125
100,16,13,1505,8192,-6687,-81.62841796875
100,16,14,69982,16384,53598,327.13623046875
100,16,15,13847,32768,-18921,-57.7423095703125
100,17,1,0,2,-2,-100.0
100,17,2,1,4,-3,-75.0
100,17,3,9,8,1,12.5
100,17,4,42,16,26,162.5
100,17,5,72,32,40,125.0
100,17,6,11,64,-53,-82.8125
100,17,7,27,128,-101,-78.90625
100,17,8,410,256,154,60.15625
100,17,9,260,512,-252,-49.21875
100,17,10,146,1024,-878,-85.7421875
100,17,11,489,2048,-1559,-76.123046875
100,17,12,634,4096,-3462,-84.521484375
100,17,13,3366,8192,-4826,-58.9111328125
100,17,14,10381,16384,-6003,-36.639404296875
100,17,15,9551,32768,-23217,-70.8526611328125
100,18,1,0,2,-2,-100.0
100,18,2,1,4,-3,-75.0
100,18,3,4,8,-4,-50.0
100,18,4,10,16,-6,-37.5
100,18,5,24,32,-8,-25.0
100,18,6,29,64,-35,-54.6875
100,18,7,190,128,62,48.4375
100,18,8,729,256,473,184.765625
100,18,9,965,512,453,88.4765625
100,18,10,194,1024,-830,-81.0546875
100,18,11,769,2048,-1279,-62.451171875
100,18,12,1230,4096,-2866,-69.970703125
100,18,13,9889,8192,1697,20.71533203125
100,18,14,2451,16384,-13933,-85.040283203125
100,18,15,11481,32768,-21287,-64.9627685546875
100,19,1,0,2,-2,-100.0
100,19,2,3,4,-1,-25.0
100,19,3,7,8,-1,-12.5
100,19,4,3,16,-13,-81.25
100,19,5,49,32,17,53.125
100,19,6,70,64,6,9.375
100,19,7,137,128,9,7.03125
100,19,8,246,256,-10,-3.90625
100,19,9,135,512,-377,-73.6328125
100,19,10,105,1024,-919,-89.74609375
100,19,11,715,2048,-1333,-65.087890625
100,19,12,1800,4096,-2296,-56.0546875
100,19,13,7742,8192,-450,-5.4931640625
100,19,14,12398,16384,-3986,-24.32861328125
100,19,15,1679,32768,-31089,-94.8760986328125
100,20,1,0,2,-2,-100.0
100,20,2,1,4,-3,-75.0
100,20,3,4,8,-4,-50.0
100,20,4,9,16,-7,-43.75
100,20,5,14,32,-18,-56.25
100,20,6,47,64,-17,-26.5625
100,20,7,104,128,-24,-18.75
100,20,8,25,256,-231,-90.234375
100,20,9,638,512,126,24.609375
100,20,10,53,1024,-971,-94.82421875
100,20,11,678,2048,-1370,-66.89453125
100,20,12,50,4096,-4046,-98.779296875
100,20,13,14974,8192,6782,82.7880859375
100,20,14,60,16384,-16324,-99.6337890625
100,20,15,15101,32768,-17667,-53.9154052734375
100,21,1,0,2,-2,-100.0
100,21,2,2,4,-2,-50.0
100,21,3,7,8,-1,-12.5
100,21,4,7,16,-9,-56.25
100,21,5,12,32,-20,-62.5
100,21,6,50,64,-14,-21.875
100,21,7,107,128,-21,-16.40625
100,21,8,73,256,-183,-71.484375
100,21,9,12,512,-500,-97.65625
100,21,10,445,1024,-579,-56.54296875
100,21,11,442,2048,-1606,-78.41796875
100,21,12,182,4096,-3914,-95.556640625
100,21,13,520,8192,-7672,-93.65234375
100,21,14,15775,16384,-609,-3.717041015625
100,21,15,100017,32768,67249,205.2276611328125
100,22,1,0,2,-2,-100.0
100,22,2,4,4,0,0.0
100,22,3,2,8,-6,-75.0
100,22,4,10,16,-6,-37.5
100,22,5,54,32,22,68.75
100,22,6,126,64,62,96.875
100,22,7,52,128,-76,-59.375
100,22,8,325,256,69,26.953125
100,22,9,43,512,-469,-91.6015625
100,22,10,1266,1024,242,23.6328125
100,22,11,86,2048,-1962,-95.80078125
100,22,12,1730,4096,-2366,-57.763671875
100,22,13,7079,8192,-1113,-13.58642578125
100,22,14,14640,16384,-1744,-10.64453125
100,22,15,158534,32768,125766,383.807373046875
100,23,1,0,2,-2,-100.0
100,23,2,1,4,-3,-75.0
100,23,3,7,8,-1,-12.5
100,23,4,15,16,-1,-6.25
100,23,5,30,32,-2,-6.25
100,23,6,59,64,-5,-7.8125
100,23,7,183,128,55,42.96875
100,23,8,962,256,706,275.78125
100,23,9,322,512,-190,-37.109375
100,23,10,315,1024,-709,-69.23828125
100,23,11,670,2048,-1378,-67.28515625
100,23,12,1690,4096,-2406,-58.740234375
100,23,13,884,8192,-7308,-89.208984375
100,23,14,5483,16384,-10901,-66.534423828125
100,23,15,17387,32768,-15381,-46.9390869140625
100,24,1,0,2,-2,-100.0
100,24,2,1,4,-3,-75.0
100,24,3,9,8,1,12.5
100,24,4,6,16,-10,-62.5
100,24,5,31,32,-1,-3.125
100,24,6,66,64,2,3.125
100,24,7,212,128,84,65.625
100,24,8,14,256,-242,-94.53125
100,24,9,1665,512,1153,225.1953125
100,24,10,125,1024,-899,-87.79296875
100,24,11,118,2048,-1930,-94.23828125
100,24,12,1602,4096,-2494,-60.888671875
100,24,13,2648,8192,-5544,-67.67578125
100,24,14,49578,16384,33194,202.60009765625
100,24,15,49064,32768,16296,49.7314453125
100,25,1,0,2,-2,-100.0
100,25,2,1,4,-3,-75.0
100,25,3,10,8,2,25.0
100,25,4,5,16,-11,-68.75
100,25,5,148,32,116,362.5
100,25,6,12,64,-52,-81.25
100,25,7,325,128,197,153.90625
100,25,8,50,256,-206,-80.46875
100,25,9,856,512,344,67.1875
100,25,10,723,1024,-301,-29.39453125
100,25,11,1949,2048,-99,-4.833984375
100,25,12,8677,4096,4581,111.8408203125
100,25,13,2296,8192,-5896,-71.97265625
100,25,14,26640,16384,10256,62.59765625
100,25,15,47302,32768,14534,44.354248046875
100,26,1,0,2,-2,-100.0
100,26,2,1,4,-3,-75.0
100,26,3,2,8,-6,-75.0
100,26,4,3,16,-13,-81.25
100,26,5,29,32,-3,-9.375
100,26,6,5,64,-59,-92.1875
100,26,7,245,128,117,91.40625
100,26,8,9,256,-247,-96.484375
100,26,9,755,512,243,47.4609375
100,26,10,88,1024,-936,-91.40625
100,26,11,181,2048,-1867,-91.162109375
100,26,12,416,4096,-3680,-89.84375
100,26,13,1017,8192,-7175,-87.58544921875
100,26,14,20116,16384,3732,22.7783203125
100,26,15,8168,32768,-24600,-75.0732421875
100,27,1,0,2,-2,-100.0
100,27,2,1,4,-3,-75.0
100,27,3,4,8,-4,-50.0
100,27,4,8,16,-8,-50.0
100,27,5,41,32,9,28.125
100,27,6,160,64,96,150.0
100,27,7,86,128,-42,-32.8125
100,27,8,432,256,176,68.75
100,27,9,325,512,-187,-36.5234375
100,27,10,92,1024,-932,-91.015625
100,27,11,2200,2048,152,7.421875
100,27,12,496,4096,-3600,-87.890625
100,27,13,6400,8192,-1792,-21.875
100,27,14,54646,16384,38262,233.53271484375
100,27,15,4954,32768,-27814,-84.881591796875
100,28,1,0,2,-2,-100.0
100,28,2,1,4,-3,-75.0
100,28,3,8,8,0,0.0
100,28,4,12,16,-4,-25.0
100,28,5,21,32,-11,-34.375
100,28,6,84,64,20,31.25
100,28,7,27,128,-101,-78.90625
100,28,8,142,256,-114,-44.53125
100,28,9,157,512,-355,-69.3359375
100,28,10,365,1024,-659,-64.35546875
100,28,11,1073,2048,-975,-47.607421875
100,28,12,2624,4096,-1472,-35.9375
100,28,13,13966,8192,5774,70.4833984375
100,28,14,2938,16384,-13446,-82.06787109375
100,28,15,11927,32768,-20841,-63.6016845703125
100,29,1,0,2,-2,-100.0
100,29,2,5,4,1,25.0
100,29,3,14,8,6,75.0
100,29,4,14,16,-2,-12.5
100,29,5,14,32,-18,-56.25
100,29,6,19,64,-45,-70.3125
100,29,7,6,128,-122,-95.3125
100,29,8,117,256,-139,-54.296875
100,29,9,154,512,-358,-69.921875
100,29,10,403,1024,-621,-60.64453125
100,29,11,11,2048,-2037,-99.462890625
100,29,12,130,4096,-3966,-96.826171875
100,29,13,3539,8192,-4653,-56.79931640625
100,29,14,9754,16384,-6630,-40.46630859375
100,29,15,5697,32768,-27071,-82.6141357421875
100,30,1,0,2,-2,-100.0
100,30,2,5,4,1,25.0
100,30,3,6,8,-2,-25.0
100,30,4,5,16,-11,-68.75
100,30,5,60,32,28,87.5
100,30,6,47,64,-17,-26.5625
100,30,7,287,128,159,124.21875
100,30,8,128,256,-128,-50.0
100,30,9,1867,512,1355,264.6484375
100,30,10,1627,1024,603,58.88671875
100,30,11,114,2048,-1934,-94.43359375
100,30,12,416,4096,-3680,-89.84375
100,30,13,2376,8192,-5816,-70.99609375
100,30,14,6728,16384,-9656,-58.935546875
100,30,15,55,32768,-32713,-99.8321533203125
100,31,1,0,2,-2,-100.0
100,31,2,1,4,-3,-75.0
100,31,3,3,8,-5,-62.5
100,31,4,29,16,13,81.25
100,31,5,5,32,-27,-84.375
100,31,6,57,64,-7,-10.9375
100,31,7,21,128,-107,-83.59375
100,31,8,123,256,-133,-51.953125
100,31,9,239,512,-273,-53.3203125
100,31,10,10,1024,-1014,-99.0234375
100,31,11,1293,2048,-755,-36.865234375
100,31,12,155,4096,-3941,-96.2158203125
100,31,13,1168,8192,-7024,-85.7421875
100,31,14,3168,16384,-13216,-80.6640625
100,31,15,43692,32768,10924,33.33740234375
100,32,1,0,2,-2,-100.0
100,32,2,2,4,-2,-50.0
100,32,3,2,8,-6,-75.0
100,32,4,7,16,-9,-56.25
100,32,5,8,32,-24,-75.0
100,32,6,20,64,-44,-68.75
100,32,7,20,128,-108,-84.375
100,32,8,102,256,-154,-60.15625
100,32,9,740,512,228,44.53125
100,32,10,648,1024,-376,-36.71875
100,32,11,2005,2048,-43,-2.099609375
100,32,12,12554,4096,8458,206.494140625
100,32,13,4853,8192,-3339,-40.75927734375
100,32,14,40970,16384,24586,150.06103515625
100,32,15,6283,32768,-26485,-80.8258056640625
100,33,1,0,2,-2,-100.0
100,33,2,2,4,-2,-50.0
100,33,3,2,8,-6,-75.0
100,33,4,3,16,-13,-81.25
100,33,5,15,32,-17,-53.125
100,33,6,111,64,47,73.4375
100,33,7,21,128,-107,-83.59375
100,33,8,69,256,-187,-73.046875
100,33,9,663,512,151,29.4921875
100,33,10,361,1024,-663,-64.74609375
100,33,11,1989,2048,-59,-2.880859375
100,33,12,1846,4096,-2250,-54.931640625
100,33,13,3386,8192,-4806,-58.6669921875
100,33,14,4953,16384,-11431,-69.769287109375
100,33,15,40204,32768,7436,22.69287109375
100,34,1,0,2,-2,-100.0
100,34,2,3,4,-1,-25.0
100,34,3,5,8,-3,-37.5
100,34,4,15,16,-1,-6.25
100,34,5,69,32,37,115.625
100,34,6,82,64,18,28.125
100,34,7,76,128,-52,-40.625
100,34,8,60,256,-196,-76.5625
100,34,9,693,512,181,35.3515625
100,34,10,839,1024,-185,-18.06640625
100,34,11,1239,2048,-809,-39.501953125
100,34,12,2999,4096,-1097,-26.7822265625
100,34,13,1357,8192,-6835,-83.43505859375
100,34,14,80152,16384,63768,389.208984375
100,34,15,2406,32768,-30362,-92.657470703125
100,35,1,0,2,-2,-100.0
100,35,2,1,4,-3,-75.0
100,35,3,3,8,-5,-62.5
100,35,4,30,16,14,87.5
100,35,5,20,32,-12,-37.5
100,35,6,13,64,-51,-79.6875
100,35,7,82,128,-46,-35.9375
100,35,8,161,256,-95,-37.109375
100,35,9,303,512,-209,-40.8203125
100,35,10,636,1024,-388,-37.890625
100,35,11,1552,2048,-496,-24.21875
100,35,12,1183,4096,-2913,-71.1181640625
100,35,13,2868,8192,-5324,-64.990234375
100,35,14,28491,16384,12107,73.895263671875
100,35,15,11625,32768,-21143,-64.5233154296875
100,36,1,0,2,-2,-100.0
100,36,2,1,4,-3,-75.0
100,36,3,3,8,-5,-62.5
100,36,4,20,16,4,25.0
100,36,5,58,32,26,81.25
100,36,6,11,64,-53,-82.8125
100,36,7,21,128,-107,-83.59375
100,36,8,58,256,-198,-77.34375
100,36,9,694,512,182,35.546875
100,36,10,699,1024,-325,-31.73828125
100,36,11,3503,2048,1455,71.044921875
100,36,12,15740,4096,11644,284.27734375
100,36,13,21421,8192,13229,161.48681640625
100,36,14,9703,16384,-6681,-40.777587890625
100,36,15,4250,32768,-28518,-87.030029296875
100,37,1,0,2,-2,-100.0
100,37,2,3,4,-1,-25.0
100,37,3,4,8,-4,-50.0
100,37,4,15,16,-1,-6.25
100,37,5,18,32,-14,-43.75
100,37,6,33,64,-31,-48.4375
100,37,7,135,128,7,5.46875
100,37,8,513,256,257,100.390625
100,37,9,646,512,134,26.171875
100,37,10,234,1024,-790,-77.1484375
100,37,11,2347,2048,299,14.599609375
100,37,12,2565,4096,-1531,-37.3779296875
100,37,13,21359,8192,13167,160.72998046875
100,37,14,141,16384,-16243,-99.139404296875
100,37,15,12439,32768,-20329,-62.0391845703125
100,38,1,0,2,-2,-100.0
100,38,2,4,4,0,0.0
100,38,3,2,8,-6,-75.0
100,38,4,8,16,-8,-50.0
100,38,5,22,32,-10,-31.25
100,38,6,197,64,133,207.8125
100,38,7,226,128,98,76.5625
100,38,8,49,256,-207,-80.859375
100,38,9,197,512,-315,-61.5234375
100,38,10,1238,1024,214,20.8984375
100,38,11,4927,2048,2879,140.576171875
100,38,12,1802,4096,-2294,-56.005859375
100,38,13,19230,8192,11038,134.7412109375
100,38,14,10485,16384,-5899,-36.004638671875
100,38,15,46091,32768,13323,40.6585693359375
100,39,1,0,2,-2,-100.0
100,39,2,1,4,-3,-75.0
100,39,3,5,8,-3,-37.5
100,39,4,7,16,-9,-56.25
100,39,5,26,32,-6,-18.75
100,39,6,28,64,-36,-56.25
100,39,7,13,128,-115,-89.84375
100,39,8,110,256,-146,-57.03125
100,39,9,99,512,-413,-80.6640625
100,39,10,1662,1024,638,62.3046875
100,39,11,4985,2048,2937,143.408203125
100,39,12,5424,4096,1328,32.421875
100,39,13,480,8192,-7712,-94.140625
100,39,14,50745,16384,34361,209.722900390625
100,39,15,20585,32768,-12183,-37.1795654296875
100,40,1,0,2,-2,-100.0
100,40,2,2,4,-2,-50.0
100,40,3,5,8,-3,-37.5
100,40,4,9,16,-7,-43.75
100,40,5,39,32,7,21.875
100,40,6,7,64,-57,-89.0625
100,40,7,350,128,222,173.4375
100,40,8,331,256,75,29.296875
100,40,9,157,512,-355,-69.3359375
100,40,10,83,1024,-941,-91.89453125
100,40,11,29,2048,-2019,-98.583984375
100,40,12,1707,4096,-2389,-58.3251953125
100,40,13,2981,8192,-5211,-63.61083984375
100,40,14,1744,16384,-14640,-89.35546875
100,40,15,3611,32768,-29157,-88.9801025390625
100,41,1,0,2,-2,-100.0
100,41,2,7,4,3,75.0
100,41,3,8,8,0,0.0
100,41,4,9,16,-7,-43.75
100,41,5,49,32,17,53.125
100,41,6,31,64,-33,-51.5625
100,41,7,187,128,59,46.09375
100,41,8,76,256,-180,-70.3125
100,41,9,296,512,-216,-42.1875
100,41,10,403,1024,-621,-60.64453125
100,41,11,58,2048,-1990,-97.16796875
100,41,12,3048,4096,-1048,-25.5859375
100,41,13,7991,8192,-201,-2.45361328125
100,41,14,30298,16384,13914,84.92431640625
100,41,15,37373,32768,4605,14.0533447265625
100,42,1,0,2,-2,-100.0
100,42,2,1,4,-3,-75.0
100,42,3,2,8,-6,-75.0
100,42,4,13,16,-3,-18.75
100,42,5,36,32,4,12.5
100,42,6,8,64,-56,-87.5
100,42,7,21,128,-107,-83.59375
100,42,8,591,256,335,130.859375
100,42,9,759,512,247,48.2421875
100,42,10,157,1024,-867,-84.66796875
100,42,11,935,2048,-1113,-54.345703125
100,42,12,366,4096,-3730,-91.064453125
100,42,13,7375,8192,-817,-9.97314453125
100,42,14,14332,16384,-2052,-12.5244140625
100,42,15,54102,32768,21334,65.106201171875
100,43,1,0,2,-2,-100.0
100,43,2,5,4,1,25.0
100,43,3,2,8,-6,-75.0
100,43,4,15,16,-1,-6.25
100,43,5,4,32,-28,-87.5
100,43,6,29,64,-35,-54.6875
100,43,7,146,128,18,14.0625
100,43,8,261,256,5,1.953125
100,43,9,520,512,8,1.5625
100,43,10,1754,1024,730,71.2890625
100,43,11,1968,2048,-80,-3.90625
100,43,12,3946,4096,-150,-3.662109375
100,43,13,10731,8192,2539,30.99365234375
100,43,14,1483,16384,-14901,-90.948486328125
100,43,15,29723,32768,-3045,-9.2926025390625
100,44,1,0,2,-2,-100.0
100,44,2,2,4,-2,-50.0
100,44,3,2,8,-6,-75.0
100,44,4,13,16,-3,-18.75
100,44,5,91,32,59,184.375
100,44,6,12,64,-52,-81.25
100,44,7,154,128,26,20.3125
100,44,8,613,256,357,139.453125
100,44,9,194,512,-318,-62.109375
100,44,10,1502,1024,478,46.6796875
100,44,11,1140,2048,-908,-44.3359375
100,44,12,19803,4096,15707,383.4716796875
100,44,13,11552,8192,3360,41.015625
100,44,14,21936,16384,5552,33.88671875
100,44,15,3393,32768,-29375,-89.6453857421875
100,45,1,0,2,-2,-100.0
100,45,2,1,4,-3,-75.0
100,45,3,5,8,-3,-37.5
100,45,4,10,16,-6,-37.5
100,45,5,5,32,-27,-84.375
100,45,6,75,64,11,17.1875
100,45,7,99,128,-29,-22.65625
100,45,8,256,256,0,0.0
100,45,9,428,512,-84,-16.40625
100,45,10,2190,1024,1166,113.8671875
100,45,11,369,2048,-1679,-81.982421875
100,45,12,10210,4096,6114,149.267578125
100,45,13,9128,8192,936,11.42578125
100,45,14,15074,16384,-1310,-7.99560546875
100,45,15,7041,32768,-25727,-78.5125732421875
100,46,1,0,2,-2,-100.0
100,46,2,1,4,-3,-75.0
100,46,3,6,8,-2,-25.0
100,46,4,16,16,0,0.0
100,46,5,12,32,-20,-62.5
100,46,6,84,64,20,31.25
100,46,7,157,128,29,22.65625
100,46,8,169,256,-87,-33.984375
100,46,9,34,512,-478,-93.359375
100,46,10,1528,1024,504,49.21875
100,46,11,816,2048,-1232,-60.15625
100,46,12,3197,4096,-899,-21.9482421875
100,46,13,22619,8192,14427,176.11083984375
100,46,14,20538,16384,4154,25.35400390625
100,46,15,2302,32768,-30466,-92.974853515625
100,47,1,0,2,-2,-100.0
100,47,2,2,4,-2,-50.0
100,47,3,3,8,-5,-62.5
100,47,4,19,16,3,18.75
100,47,5,42,32,10,31.25
100,47,6,56,64,-8,-12.5
100,47,7,31,128,-97,-75.78125
100,47,8,76,256,-180,-70.3125
100,47,9,128,512,-384,-75.0
100,47,10,310,1024,-714,-69.7265625
100,47,11,1435,2048,-613,-29.931640625
100,47,12,6668,4096,2572,62.79296875
100,47,13,1414,8192,-6778,-82.7392578125
100,47,14,2263,16384,-14121,-86.187744140625
100,47,15,49875,32768,17107,52.2064208984375
100,48,1,0,2,-2,-100.0
100,48,2,2,4,-2,-50.0
100,48,3,9,8,1,12.5
100,48,4,12,16,-4,-25.0
100,48,5,8,32,-24,-75.0
100,48,6,46,64,-18,-28.125
100,48,7,540,128,412,321.875
100,48,8,540,256,284,110.9375
100,48,9,11,512,-501,-97.8515625
100,48,10,362,1024,-662,-64.6484375
100,48,11,2134,2048,86,4.19921875
100,48,12,3238,4096,-858,-20.947265625
100,48,13,13022,8192,4830,58.9599609375
100,48,14,31677,16384,15293,93.341064453125
100,48,15,24502,32768,-8266,-25.225830078125
100,49,1,0,2,-2,-100.0
100,49,2,1,4,-3,-75.0
100,49,3,10,8,2,25.0
100,49,4,21,16,5,31.25
100,49,5,6,32,-26,-81.25
100,49,6,34,64,-30,-46.875
100,49,7,24,128,-104,-81.25
100,49,8,67,256,-189,-73.828125
100,49,9,540,512,28,5.46875
100,49,10,1144,1024,120,11.71875
100,49,11,368,2048,-1680,-82.03125
100,49,12,390,4096,-3706,-90.478515625
100,49,13,9649,8192,1457,17.78564453125
100,49,14,1434,16384,-14950,-91.24755859375
100,49,15,24309,32768,-8459,-25.8148193359375
100,50,1,0,2,-2,-100.0
100,50,2,2,4,-2,-50.0
100,50,3,3,8,-5,-62.5
100,50,4,53,16,37,231.25
100,50,5,6,32,-26,-81.25
100,50,6,279,64,215,335.9375
100,50,7,90,128,-38,-29.6875
100,50,8,39,256,-217,-84.765625
100,50,9,394,512,-118,-23.046875
100,50,10,669,1024,-355,-34.66796875
100,50,11,506,2048,-1542,-75.29296875
100,50,12,234,4096,-3862,-94.287109375
100,50,13,7534,8192,-658,-8.0322265625
100,50,14,10138,16384,-6246,-38.12255859375
100,50,15,6048,32768,-26720,-81.54296875
100,51,1,0,2,-2,-100.0
100,51,2,1,4,-3,-75.0
100,51,3,6,8,-2,-25.0
100,51,4,60,16,44,275.0
100,51,5,57,32,25,78.125
100,51,6,40,64,-24,-37.5
100,51,7,51,128,-77,-60.15625
100,51,8,46,256,-210,-82.03125
100,51,9,1584,512,1072,209.375
100,51,10,163,1024,-861,-84.08203125
100,51,11,136,2048,-1912,-93.359375
100,51,12,1745,4096,-2351,-57.3974609375
100,51,13,22415,8192,14223,173.62060546875
100,51,14,826,16384,-15558,-94.95849609375
100,51,15,22509,32768,-10259,-31.3079833984375
100,52,1,0,2,-2,-100.0
100,52,2,1,4,-3,-75.0
100,52,3,3,8,-5,-62.5
100,52,4,6,16,-10,-62.5
100,52,5,14,32,-18,-56.25
100,52,6,141,64,77,120.3125
100,52,7,74,128,-54,-42.1875
100,52,8,235,256,-21,-8.203125
100,52,9,445,512,-67,-13.0859375
100,52,10,1500,1024,476,46.484375
100,52,11,1643,2048,-405,-19.775390625
100,52,12,17178,4096,13082,319.384765625
100,52,13,3423,8192,-4769,-58.21533203125
100,52,14,17663,16384,1279,7.806396484375
100,52,15,69120,32768,36352,110.9375
100,53,1,0,2,-2,-100.0
100,53,2,1,4,-3,-75.0
100,53,3,5,8,-3,-37.5
100,53,4,12,16,-4,-25.0
100,53,5,43,32,11,34.375
100,53,6,13,64,-51,-79.6875
100,53,7,57,128,-71,-55.46875
100,53,8,85,256,-171,-66.796875
100,53,9,2235,512,1723,336.5234375
100,53,10,817,1024,-207,-20.21484375
100,53,11,575,2048,-1473,-71.923828125
100,53,12,473,4096,-3623,-88.4521484375
100,53,13,14700,8192,6508,79.443359375
100,53,14,33759,16384,17375,106.048583984375
100,53,15,26055,32768,-6713,-20.4864501953125
100,54,1,0,2,-2,-100.0
100,54,2,2,4,-2,-50.0
100,54,3,6,8,-2,-25.0
100,54,4,19,16,3,18.75
100,54,5,9,32,-23,-71.875
100,54,6,228,64,164,256.25
100,54,7,64,128,-64,-50.0
100,54,8,257,256,1,0.390625
100,54,9,432,512,-80,-15.625
100,54,10,1039,1024,15,1.46484375
100,54,11,2570,2048,522,25.48828125
100,54,12,1712,4096,-2384,-58.203125
100,54,13,405,8192,-7787,-95.05615234375
100,54,14,6886,16384,-9498,-57.97119140625
100,54,15,11131,32768,-21637,-66.0308837890625
100,55,1,0,2,-2,-100.0
100,55,2,2,4,-2,-50.0
100,55,3,10,8,2,25.0
100,55,4,22,16,6,37.5
100,55,5,10,32,-22,-68.75
100,55,6,94,64,30,46.875
100,55,7,564,128,436,340.625
100,55,8,255,256,-1,-0.390625
100,55,9,116,512,-396,-77.34375
100,55,10,1108,1024,84,8.203125
100,55,11,4587,2048,2539,123.974609375
100,55,12,2365,4096,-1731,-42.2607421875
100,55,13,7351,8192,-841,-10.26611328125
100,55,14,5874,16384,-10510,-64.14794921875
100,55,15,13283,32768,-19485,-59.4635009765625
100,56,1,0,2,-2,-100.0
100,56,2,1,4,-3,-75.0
100,56,3,6,8,-2,-25.0
100,56,4,41,16,25,156.25
100,56,5,12,32,-20,-62.5
100,56,6,78,64,14,21.875
100,56,7,141,128,13,10.15625
100,56,8,150,256,-106,-41.40625
100,56,9,246,512,-266,-51.953125
100,56,10,1506,1024,482,47.0703125
100,56,11,389,2048,-1659,-81.005859375
100,56,12,7442,4096,3346,81.689453125
100,56,13,13501,8192,5309,64.80712890625
100,56,14,2937,16384,-13447,-82.073974609375
100,56,15,19211,32768,-13557,-41.3726806640625
100,57,1,0,2,-2,-100.0
100,57,2,1,4,-3,-75.0
100,57,3,12,8,4,50.0
100,57,4,5,16,-11,-68.75
100,57,5,29,32,-3,-9.375
100,57,6,11,64,-53,-82.8125
100,57,7,27,128,-101,-78.90625
100,57,8,140,256,-116,-45.3125
100,57,9,2081,512,1569,306.4453125
100,57,10,668,1024,-356,-34.765625
100,57,11,2087,2048,39,1.904296875
100,57,12,1789,4096,-2307,-56.3232421875
100,57,13,14313,8192,6121,74.71923828125
100,57,14,14792,16384,-1592,-9.716796875
100,57,15,28329,32768,-4439,-13.5467529296875
100,58,1,0,2,-2,-100.0
100,58,2,1,4,-3,-75.0
100,58,3,3,8,-5,-62.5
100,58,4,12,16,-4,-25.0
100,58,5,16,32,-16,-50.0
100,58,6,37,64,-27,-42.1875
100,58,7,463,128,335,261.71875
100,58,8,162,256,-94,-36.71875
100,58,9,916,512,404,78.90625
100,58,10,25,1024,-999,-97.55859375
100,58,11,81,2048,-1967,-96.044921875
100,58,12,338,4096,-3758,-91.748046875
100,58,13,10691,8192,2499,30.50537109375
100,58,14,39241,16384,22857,139.508056640625
100,58,15,36407,32768,3639,11.1053466796875
100,59,1,0,2,-2,-100.0
100,59,2,1,4,-3,-75.0
100,59,3,10,8,2,25.0
100,59,4,21,16,5,31.25
100,59,5,4,32,-28,-87.5
100,59,6,36,64,-28,-43.75
100,59,7,13,128,-115,-89.84375
100,59,8,136,256,-120,-46.875
100,59,9,94,512,-418,-81.640625
100,59,10,719,1024,-305,-29.78515625
100,59,11,1094,2048,-954,-46.58203125
100,59,12,619,4096,-3477,-84.8876953125
100,59,13,25419,8192,17227,210.29052734375
100,59,14,2875,16384,-13509,-82.452392578125
100,59,15,12622,32768,-20146,-61.480712890625
100,60,1,0,2,-2,-100.0
100,60,2,1,4,-3,-75.0
100,60,3,5,8,-3,-37.5
100,60,4,6,16,-10,-62.5
100,60,5,29,32,-3,-9.375
100,60,6,76,64,12,18.75
100,60,7,317,128,189,147.65625
100,60,8,1175,256,919,358.984375
100,60,9,18,512,-494,-96.484375
100,60,10,389,1024,-635,-62.01171875
100,60,11,38,2048,-2010,-98.14453125
100,60,12,2556,4096,-1540,-37.59765625
100,60,13,6611,8192,-1581,-19.29931640625
100,60,14,2890,16384,-13494,-82.36083984375
100,60,15,58255,32768,25487,77.7801513671875
100,61,1,0,2,-2,-100.0
100,61,2,2,4,-2,-50.0
100,61,3,28,8,20,250.0
100,61,4,12,16,-4,-25.0
100,61,5,13,32,-19,-59.375
100,61,6,71,64,7,10.9375
100,61,7,36,128,-92,-71.875
100,61,8,634,256,378,147.65625
100,61,9,329,512,-183,-35.7421875
100,61,10,1043,1024,19,1.85546875
100,61,11,1684,2048,-364,-17.7734375
100,61,12,649,4096,-3447,-84.1552734375
100,61,13,7544,8192,-648,-7.91015625
100,61,14,1483,16384,-14901,-90.948486328125
100,61,15,2788,32768,-29980,-91.49169921875
100,62,1,0,2,-2,-100.0
100,62,2,1,4,-3,-75.0
100,62,3,13,8,5,62.5
100,62,4,30,16,14,87.5
100,62,5,17,32,-15,-46.875
100,62,6,134,64,70,109.375
100,62,7,79,128,-49,-38.28125
100,62,8,615,256,359,140.234375
100,62,9,1312,512,800,156.25
100,62,10,2821,1024,1797,175.48828125
100,62,11,1121,2048,-927,-45.263671875
100,62,12,2496,4096,-1600,-39.0625
100,62,13,13511,8192,5319,64.92919921875
100,62,14,8746,16384,-7638,-46.61865234375
100,62,15,39580,32768,6812,20.78857421875
100,63,1,0,2,-2,-100.0
100,63,2,4,4,0,0.0
100,63,3,2,8,-6,-75.0
100,63,4,18,16,2,12.5
100,63,5,105,32,73,228.125
100,63,6,7,64,-57,-89.0625
100,63,7,65,128,-63,-49.21875
100,63,8,553,256,297,116.015625
100,63,9,322,512,-190,-37.109375
100,63,10,125,1024,-899,-87.79296875
100,63,11,582,2048,-1466,-71.58203125
100,63,12,2630,4096,-1466,-35.791015625
100,63,13,7729,8192,-463,-5.65185546875
100,63,14,458,16384,-15926,-97.20458984375
100,63,15,17965,32768,-14803,-45.1751708984375
100,64,1,0,2,-2,-100.0
100,64,2,2,4,-2,-50.0
100,64,3,4,8,-4,-50.0
100,64,4,17,16,1,6.25
100,64,5,53,32,21,65.625
100,64,6,40,64,-24,-37.5
100,64,7,107,128,-21,-16.40625
100,64,8,28,256,-228,-89.0625
100,64,9,246,512,-266,-51.953125
100,64,10,3657,1024,2633,257.12890625
100,64,11,3476,2048,1428,69.7265625
100,64,12,1284,4096,-2812,-68.65234375
100,64,13,7723,8192,-469,-5.72509765625
100,64,14,49415,16384,33031,201.605224609375
100,64,15,138241,32768,105473,321.8780517578125
100,65,1,0,2,-2,-100.0
100,65,2,1,4,-3,-75.0
100,65,3,2,8,-6,-75.0
100,65,4,6,16,-10,-62.5
100,65,5,26,32,-6,-18.75
100,65,6,178,64,114,178.125
100,65,7,223,128,95,74.21875
100,65,8,327,256,71,27.734375
100,65,9,1501,512,989,193.1640625
100,65,10,116,1024,-908,-88.671875
100,65,11,4351,2048,2303,112.451171875
100,65,12,8939,4096,4843,118.2373046875
100,65,13,24085,8192,15893,194.00634765625
100,65,14,5969,16384,-10415,-63.568115234375
100,65,15,19367,32768,-13401,-40.8966064453125
100,66,1,0,2,-2,-100.0
100,66,2,2,4,-2,-50.0
100,66,3,3,8,-5,-62.5
100,66,4,9,16,-7,-43.75
100,66,5,18,32,-14,-43.75
100,66,6,214,64,150,234.375
100,66,7,258,128,130,101.5625
100,66,8,49,256,-207,-80.859375
100,66,9,821,512,309,60.3515625
100,66,10,1438,1024,414,40.4296875
100,66,11,5974,2048,3926,191.69921875
100,66,12,1181,4096,-2915,-71.1669921875
100,66,13,19819,8192,11627,141.93115234375
100,66,14,2432,16384,-13952,-85.15625
100,66,15,16231,32768,-16537,-50.4669189453125
100,67,1,0,2,-2,-100.0
100,67,2,3,4,-1,-25.0
100,67,3,4,8,-4,-50.0
100,67,4,24,16,8,50.0
100,67,5,8,32,-24,-75.0
100,67,6,66,64,2,3.125
100,67,7,435,128,307,239.84375
100,67,8,152,256,-104,-40.625
100,67,9,461,512,-51,-9.9609375
100,67,10,1443,1024,419,40.91796875
100,67,11,581,2048,-1467,-71.630859375
100,67,12,1102,4096,-2994,-73.095703125
100,67,13,7507,8192,-685,-8.36181640625
100,67,14,19827,16384,3443,21.014404296875
100,67,15,41625,32768,8857,27.0294189453125
100,68,1,0,2,-2,-100.0
100,68,2,2,4,-2,-50.0
100,68,3,11,8,3,37.5
100,68,4,3,16,-13,-81.25
100,68,5,36,32,4,12.5
100,68,6,17,64,-47,-73.4375
100,68,7,211,128,83,64.84375
100,68,8,26,256,-230,-89.84375
100,68,9,47,512,-465,-90.8203125
100,68,10,1012,1024,-12,-1.171875
100,68,11,171,2048,-1877,-91.650390625
100,68,12,1340,4096,-2756,-67.28515625
100,68,13,6862,8192,-1330,-16.2353515625
100,68,14,34771,16384,18387,112.225341796875
100,68,15,61943,32768,29175,89.0350341796875
100,69,1,0,2,-2,-100.0
100,69,2,2,4,-2,-50.0
100,69,3,9,8,1,12.5
100,69,4,12,16,-4,-25.0
100,69,5,13,32,-19,-59.375
100,69,6,17,64,-47,-73.4375
100,69,7,171,128,43,33.59375
100,69,8,146,256,-110,-42.96875
100,69,9,338,512,-174,-33.984375
100,69,10,62,1024,-962,-93.9453125
100,69,11,3937,2048,1889,92.236328125
100,69,12,924,4096,-3172,-77.44140625
100,69,13,15413,8192,7221,88.14697265625
100,69,14,19673,16384,3289,20.074462890625
100,69,15,16984,32768,-15784,-48.1689453125
100,70,1,0,2,-2,-100.0
100,70,2,1,4,-3,-75.0
100,70,3,9,8,1,12.5
100,70,4,10,16,-6,-37.5
100,70,5,20,32,-12,-37.5
100,70,6,150,64,86,134.375
100,70,7,198,128,70,54.6875
100,70,8,61,256,-195,-76.171875
100,70,9,408,512,-104,-20.3125
100,70,10,254,1024,-770,-75.1953125
100,70,11,626,2048,-1422,-69.43359375
100,70,12,11555,4096,7459,182.1044921875
100,70,13,6176,8192,-2016,-24.609375
100,70,14,31386,16384,15002,91.56494140625
100,70,15,106064,32768,73296,223.681640625
100,71,1,0,2,-2,-100.0
100,71,2,1,4,-3,-75.0
100,71,3,2,8,-6,-75.0
100,71,4,3,16,-13,-81.25
100,71,5,26,32,-6,-18.75
100,71,6,36,64,-28,-43.75
100,71,7,198,128,70,54.6875
100,71,8,56,256,-200,-78.125
100,71,9,596,512,84,16.40625
100,71,10,309,1024,-715,-69.82421875
100,71,11,350,2048,-1698,-82.91015625
100,71,12,115,4096,-3981,-97.1923828125
100,71,13,5869,8192,-2323,-28.35693359375
100,71,14,4727,16384,-11657,-71.148681640625
100,71,15,29365,32768,-3403,-10.3851318359375
100,72,1,0,2,-2,-100.0
100,72,2,2,4,-2,-50.0
100,72,3,2,8,-6,-75.0
100,72,4,8,16,-8,-50.0
100,72,5,73,32,41,128.125
100,72,6,15,64,-49,-76.5625
100,72,7,114,128,-14,-10.9375
100,72,8,12,256,-244,-95.3125
100,72,9,498,512,-14,-2.734375
100,72,10,50,1024,-974,-95.1171875
100,72,11,1164,2048,-884,-43.1640625
100,72,12,4135,4096,39,0.9521484375
100,72,13,1973,8192,-6219,-75.91552734375
100,72,14,15654,16384,-730,-4.45556640625
100,72,15,29113,32768,-3655,-11.1541748046875
100,73,1,0,2,-2,-100.0
100,73,2,2,4,-2,-50.0
100,73,3,2,8,-6,-75.0
100,73,4,3,16,-13,-81.25
100,73,5,21,32,-11,-34.375
100,73,6,33,64,-31,-48.4375
100,73,7,39,128,-89,-69.53125
100,73,8,173,256,-83,-32.421875
100,73,9,378,512,-134,-26.171875
100,73,10,359,1024,-665,-64.94140625
100,73,11,221,2048,-1827,-89.208984375
100,73,12,10448,4096,6352,155.078125
100,73,13,2600,8192,-5592,-68.26171875
100,73,14,11612,16384,-4772,-29.1259765625
100,73,15,126281,32768,93513,285.3790283203125
100,74,1,0,2,-2,-100.0
100,74,2,1,4,-3,-75.0
100,74,3,11,8,3,37.5
100,74,4,3,16,-13,-81.25
100,74,5,4,32,-28,-87.5
100,74,6,117,64,53,82.8125
100,74,7,30,128,-98,-76.5625
100,74,8,548,256,292,114.0625
100,74,9,42,512,-470,-91.796875
100,74,10,689,1024,-335,-32.71484375
100,74,11,1614,2048,-434,-21.19140625
100,74,12,5073,4096,977,23.8525390625
100,74,13,4657,8192,-3535,-43.15185546875
100,74,14,18172,16384,1788,10.9130859375
100,74,15,39277,32768,6509,19.8638916015625
100,75,1,0,2,-2,-100.0
100,75,2,1,4,-3,-75.0
100,75,3,10,8,2,25.0
100,75,4,5,16,-11,-68.75
100,75,5,31,32,-1,-3.125
100,75,6,6,64,-58,-90.625
100,75,7,172,128,44,34.375
100,75,8,16,256,-240,-93.75
100,75,9,1036,512,524,102.34375
100,75,10,1246,1024,222,21.6796875
100,75,11,1540,2048,-508,-24.8046875
100,75,12,283,4096,-3813,-93.0908203125
100,75,13,1651,8192,-6541,-79.84619140625
100,75,14,10275,16384,-6109,-37.286376953125
100,75,15,13245,32768,-19523,-59.5794677734375
100,76,1,0,2,-2,-100.0
100,76,2,4,4,0,0.0
100,76,3,3,8,-5,-62.5
100,76,4,16,16,0,0.0
100,76,5,22,32,-10,-31.25
100,76,6,85,64,21,32.8125
100,76,7,215,128,87,67.96875
100,76,8,162,256,-94,-36.71875
100,76,9,152,512,-360,-70.3125
100,76,10,310,1024,-714,-69.7265625
100,76,11,1744,2048,-304,-14.84375
100,76,12,3822,4096,-274,-6.689453125
100,76,13,663,8192,-7529,-91.90673828125
100,76,14,13184,16384,-3200,-19.53125
100,76,15,25587,32768,-7181,-21.9146728515625
100,77,1,0,2,-2,-100.0
100,77,2,3,4,-1,-25.0
100,77,3,2,8,-6,-75.0
100,77,4,32,16,16,100.0
100,77,5,89,32,57,178.125
100,77,6,5,64,-59,-92.1875
100,77,7,75,128,-53,-41.40625
100,77,8,446,256,190,74.21875
100,77,9,380,512,-132,-25.78125
100,77,10,473,1024,-551,-53.80859375
100,77,11,2625,2048,577,28.173828125
100,77,12,3665,4096,-431,-10.5224609375
100,77,13,11261,8192,3069,37.46337890625
100,77,14,6631,16384,-9753,-59.527587890625
100,77,15,21895,32768,-10873,-33.1817626953125
100,78,1,0,2,-2,-100.0
100,78,2,4,4,0,0.0
100,78,3,2,8,-6,-75.0
100,78,4,4,16,-12,-75.0
100,78,5,27,32,-5,-15.625
100,78,6,17,64,-47,-73.4375
100,78,7,87,128,-41,-32.03125
100,78,8,530,256,274,107.03125
100,78,9,314,512,-198,-38.671875
100,78,10,1831,1024,807,78.80859375
100,78,11,5182,2048,3134,153.02734375
100,78,12,17924,4096,13828,337.59765625
100,78,13,13441,8192,5249,64.07470703125
100,78,14,1113,16384,-15271,-93.206787109375
100,78,15,9244,32768,-23524,-71.78955078125
100,79,1,0,2,-2,-100.0
100,79,2,1,4,-3,-75.0
100,79,3,3,8,-5,-62.5
100,79,4,34,16,18,112.5
100,79,5,34,32,2,6.25
100,79,6,11,64,-53,-82.8125
100,79,7,59,128,-69,-53.90625
100,79,8,463,256,207,80.859375
100,79,9,1556,512,1044,203.90625
100,79,10,951,1024,-73,-7.12890625
100,79,11,1564,2048,-484,-23.6328125
100,79,12,14011,4096,9915,242.0654296875
100,79,13,3675,8192,-4517,-55.13916015625
100,79,14,29320,16384,12936,78.955078125
100,79,15,30614,32768,-2154,-6.573486328125
100,80,1,0,2,-2,-100.0
100,80,2,1,4,-3,-75.0
100,80,3,3,8,-5,-62.5
100,80,4,7,16,-9,-56.25
100,80,5,6,32,-26,-81.25
100,80,6,98,64,34,53.125
100,80,7,59,128,-69,-53.90625
100,80,8,234,256,-22,-8.59375
100,80,9,227,512,-285,-55.6640625
100,80,10,839,1024,-185,-18.06640625
100,80,11,1352,2048,-696,-33.984375
100,80,12,5937,4096,1841,44.9462890625
100,80,13,340,8192,-7852,-95.849609375
100,80,14,28640,16384,12256,74.8046875
100,80,15,15290,32768,-17478,-53.338623046875
100,81,1,0,2,-2,-100.0
100,81,2,1,4,-3,-75.0
100,81,3,2,8,-6,-75.0
100,81,4,6,16,-10,-62.5
100,81,5,61,32,29,90.625
100,81,6,19,64,-45,-70.3125
100,81,7,183,128,55,42.96875
100,81,8,96,256,-160,-62.5
100,81,9,478,512,-34,-6.640625
100,81,10,128,1024,-896,-87.5
100,81,11,979,2048,-1069,-52.197265625
100,81,12,5986,4096,1890,46.142578125
100,81,13,10714,8192,2522,30.7861328125
100,81,14,378,16384,-16006,-97.69287109375
100,81,15,27646,32768,-5122,-15.631103515625
100,82,1,0,2,-2,-100.0
100,82,2,3,4,-1,-25.0
100,82,3,7,8,-1,-12.5
100,82,4,8,16,-8,-50.0
100,82,5,11,32,-21,-65.625
100,82,6,68,64,4,6.25
100,82,7,39,128,-89,-69.53125
100,82,8,55,256,-201,-78.515625
100,82,9,482,512,-30,-5.859375
100,82,10,632,1024,-392,-38.28125
100,82,11,1097,2048,-951,-46.435546875
100,82,12,999,4096,-3097,-75.6103515625
100,82,13,10526,8192,2334,28.4912109375
100,82,14,7338,16384,-9046,-55.21240234375
100,82,15,65552,32768,32784,100.048828125
100,83,1,0,2,-2,-100.0
100,83,2,2,4,-2,-50.0
100,83,3,4,8,-4,-50.0
100,83,4,6,16,-10,-62.5
100,83,5,21,32,-11,-34.375
100,83,6,11,64,-53,-82.8125
100,83,7,89,128,-39,-30.46875
100,83,8,305,256,49,19.140625
100,83,9,44,512,-468,-91.40625
100,83,10,183,1024,-841,-82.12890625
100,83,11,96,2048,-1952,-95.3125
100,83,12,762,4096,-3334,-81.396484375
100,83,13,1263,8192,-6929,-84.58251953125
100,83,14,10977,16384,-5407,-33.001708984375
100,83,15,54653,32768,21885,66.7877197265625
100,84,1,0,2,-2,-100.0
100,84,2,3,4,-1,-25.0
100,84,3,3,8,-5,-62.5
100,84,4,10,16,-6,-37.5
100,84,5,25,32,-7,-21.875
100,84,6,33,64,-31,-48.4375
100,84,7,40,128,-88,-68.75
100,84,8,69,256,-187,-73.046875
100,84,9,29,512,-483,-94.3359375
100,84,10,1492,1024,468,45.703125
100,84,11,6359,2048,4311,210.498046875
100,84,12,4502,4096,406,9.912109375
100,84,13,7738,8192,-454,-5.5419921875
100,84,14,13920,16384,-2464,-15.0390625
100,84,15,30529,32768,-2239,-6.8328857421875
100,85,1,0,2,-2,-100.0
100,85,2,2,4,-2,-50.0
100,85,3,2,8,-6,-75.0
100,85,4,8,16,-8,-50.0
100,85,5,16,32,-16,-50.0
100,85,6,86,64,22,34.375
100,85,7,103,128,-25,-19.53125
100,85,8,399,256,143,55.859375
100,85,9,176,512,-336,-65.625
100,85,10,93,1024,-931,-90.91796875
100,85,11,2960,2048,912,44.53125
100,85,12,238,4096,-3858,-94.189453125
100,85,13,8088,8192,-104,-1.26953125
100,85,14,7910,16384,-8474,-51.72119140625
100,85,15,57989,32768,25221,76.9683837890625
100,86,1,0,2,-2,-100.0
100,86,2,1,4,-3,-75.0
100,86,3,2,8,-6,-75.0
100,86,4,8,16,-8,-50.0
100,86,5,65,32,33,103.125
100,86,6,26,64,-38,-59.375
100,86,7,169,128,41,32.03125
100,86,8,86,256,-170,-66.40625
100,86,9,573,512,61,11.9140625
100,86,10,26,1024,-998,-97.4609375
100,86,11,4023,2048,1975,96.435546875
100,86,12,5620,4096,1524,37.20703125
100,86,13,9946,8192,1754,21.4111328125
100,86,14,2218,16384,-14166,-86.46240234375
100,86,15,79582,32768,46814,142.864990234375
100,87,1,0,2,-2,-100.0
100,87,2,3,4,-1,-25.0
100,87,3,15,8,7,87.5
100,87,4,14,16,-2,-12.5
100,87,5,50,32,18,56.25
100,87,6,56,64,-8,-12.5
100,87,7,149,128,21,16.40625
100,87,8,385,256,129,50.390625
100,87,9,448,512,-64,-12.5
100,87,10,488,1024,-536,-52.34375
100,87,11,1712,2048,-336,-16.40625
100,87,12,1316,4096,-2780,-67.87109375
100,87,13,7771,8192,-421,-5.13916015625
100,87,14,7216,16384,-9168,-55.95703125
100,87,15,50049,32768,17281,52.7374267578125
100,88,1,0,2,-2,-100.0
100,88,2,1,4,-3,-75.0
100,88,3,8,8,0,0.0
100,88,4,7,16,-9,-56.25
100,88,5,12,32,-20,-62.5
100,88,6,134,64,70,109.375
100,88,7,47,128,-81,-63.28125
100,88,8,305,256,49,19.140625
100,88,9,136,512,-376,-73.4375
100,88,10,289,1024,-735,-71.77734375
100,88,11,1201,2048,-847,-41.357421875
100,88,12,2093,4096,-2003,-48.9013671875
100,88,13,2008,8192,-6184,-75.48828125
100,88,14,9288,16384,-7096,-43.310546875
100,88,15,2112,32768,-30656,-93.5546875
100,89,1,0,2,-2,-100.0
100,89,2,3,4,-1,-25.0
100,89,3,2,8,-6,-75.0
100,89,4,5,16,-11,-68.75
100,89,5,10,32,-22,-68.75
100,89,6,166,64,102,159.375
100,89,7,10,128,-118,-92.1875
100,89,8,1040,256,784,306.25
100,89,9,735,512,223,43.5546875
100,89,10,450,1024,-574,-56.0546875
100,89,11,1425,2048,-623,-30.419921875
100,89,12,17256,4096,13160,321.2890625
100,89,13,12669,8192,4477,54.65087890625
100,89,14,412,16384,-15972,-97.4853515625
100,89,15,13514,32768,-19254,-58.758544921875
100,90,1,0,2,-2,-100.0
100,90,2,1,4,-3,-75.0
100,90,3,2,8,-6,-75.0
100,90,4,6,16,-10,-62.5
100,90,5,12,32,-20,-62.5
100,90,6,20,64,-44,-68.75
100,90,7,106,128,-22,-17.1875
100,90,8,538,256,282,110.15625
100,90,9,1259,512,747,145.8984375
100,90,10,404,1024,-620,-60.546875
100,90,11,4687,2048,2639,128.857421875
100,90,12,4317,4096,221,5.3955078125
100,90,13,1572,8192,-6620,-80.810546875
100,90,14,2643,16384,-13741,-83.868408203125
100,90,15,5995,32768,-26773,-81.7047119140625
100,91,1,0,2,-2,-100.0
100,91,2,1,4,-3,-75.0
100,91,3,4,8,-4,-50.0
100,91,4,27,16,11,68.75
100,91,5,10,32,-22,-68.75
100,91,6,5,64,-59,-92.1875
100,91,7,56,128,-72,-56.25
100,91,8,126,256,-130,-50.78125
100,91,9,174,512,-338,-66.015625
100,91,10,1239,1024,215,20.99609375
100,91,11,2778,2048,730,35.64453125
100,91,12,8230,4096,4134,100.927734375
100,91,13,156,8192,-8036,-98.095703125
100,91,14,4368,16384,-12016,-73.33984375
100,91,15,2695,32768,-30073,-91.7755126953125
100,92,1,0,2,-2,-100.0
100,92,2,1,4,-3,-75.0
100,92,3,7,8,-1,-12.5
100,92,4,10,16,-6,-37.5
100,92,5,21,32,-11,-34.375
100,92,6,25,64,-39,-60.9375
100,92,7,134,128,6,4.6875
100,92,8,98,256,-158,-61.71875
100,92,9,595,512,83,16.2109375
100,92,10,1078,1024,54,5.2734375
100,92,11,5726,2048,3678,179.58984375
100,92,12,5825,4096,1729,42.2119140625
100,92,13,27936,8192,19744,241.015625
100,92,14,2209,16384,-14175,-86.517333984375
100,92,15,4962,32768,-27806,-84.857177734375
100,93,1,0,2,-2,-100.0
100,93,2,2,4,-2,-50.0
100,93,3,7,8,-1,-12.5
100,93,4,20,16,4,25.0
100,93,5,58,32,26,81.25
100,93,6,5,64,-59,-92.1875
100,93,7,13,128,-115,-89.84375
100,93,8,566,256,310,121.09375
100,93,9,942,512,430,83.984375
100,93,10,1265,1024,241,23.53515625
100,93,11,802,2048,-1246,-60.83984375
100,93,12,1885,4096,-2211,-53.9794921875
100,93,13,13845,8192,5653,69.00634765625
100,93,14,425,16384,-15959,-97.406005859375
100,93,15,16868,32768,-15900,-48.52294921875
100,94,1,0,2,-2,-100.0
100,94,2,3,4,-1,-25.0
100,94,3,7,8,-1,-12.5
100,94,4,5,16,-11,-68.75
100,94,5,4,32,-28,-87.5
100,94,6,28,64,-36,-56.25
100,94,7,105,128,-23,-17.96875
100,94,8,11,256,-245,-95.703125
100,94,9,353,512,-159,-31.0546875
100,94,10,15,1024,-1009,-98.53515625
100,94,11,1612,2048,-436,-21.2890625
100,94,12,2246,4096,-1850,-45.166015625
100,94,13,16440,8192,8248,100.68359375
100,94,14,29111,16384,12727,77.679443359375
100,94,15,11879,32768,-20889,-63.7481689453125
100,95,1,0,2,-2,-100.0
100,95,2,2,4,-2,-50.0
100,95,3,3,8,-5,-62.5
100,95,4,17,16,1,6.25
100,95,5,58,32,26,81.25
100,95,6,54,64,-10,-15.625
100,95,7,34,128,-94,-73.4375
100,95,8,128,256,-128,-50.0
100,95,9,231,512,-281,-54.8828125
100,95,10,1219,1024,195,19.04296875
100,95,11,1377,2048,-671,-32.763671875
100,95,12,2827,4096,-1269,-30.9814453125
100,95,13,4598,8192,-3594,-43.8720703125
100,95,14,200,16384,-16184,-98.779296875
100,95,15,51307,32768,18539,56.5765380859375
100,96,1,0,2,-2,-100.0
100,96,2,10,4,6,150.0
100,96,3,2,8,-6,-75.0
100,96,4,12,16,-4,-25.0
100,96,5,4,32,-28,-87.5
100,96,6,12,64,-52,-81.25
100,96,7,93,128,-35,-27.34375
100,96,8,565,256,309,120.703125
100,96,9,73,512,-439,-85.7421875
100,96,10,1000,1024,-24,-2.34375
100,96,11,2694,2048,646,31.54296875
100,96,12,434,4096,-3662,-89.404296875
100,96,13,2945,8192,-5247,-64.05029296875
100,96,14,13494,16384,-2890,-17.63916015625
100,96,15,13071,32768,-19697,-60.1104736328125
100,97,1,0,2,-2,-100.0
100,97,2,2,4,-2,-50.0
100,97,3,2,8,-6,-75.0
100,97,4,3,16,-13,-81.25
100,97,5,29,32,-3,-9.375
100,97,6,98,64,34,53.125
100,97,7,118,128,-10,-7.8125
100,97,8,172,256,-84,-32.8125
100,97,9,23,512,-489,-95.5078125
100,97,10,1501,1024,477,46.58203125
100,97,11,3906,2048,1858,90.72265625
100,97,12,3802,4096,-294,-7.177734375
100,97,13,7602,8192,-590,-7.2021484375
100,97,14,5533,16384,-10851,-66.229248046875
100,97,15,15061,32768,-17707,-54.0374755859375
100,98,1,0,2,-2,-100.0
100,98,2,5,4,1,25.0
100,98,3,7,8,-1,-12.5
100,98,4,18,16,2,12.5
100,98,5,8,32,-24,-75.0
100,98,6,159,64,95,148.4375
100,98,7,7,128,-121,-94.53125
100,98,8,189,256,-67,-26.171875
100,98,9,522,512,10,1.953125
100,98,10,163,1024,-861,-84.08203125
100,98,11,512,2048,-1536,-75.0
100,98,12,7669,4096,3573,87.2314453125
100,98,13,6926,8192,-1266,-15.4541015625
100,98,14,13093,16384,-3291,-20.086669921875
100,98,15,67542,32768,34774,106.121826171875
100,99,1,0,2,-2,-100.0
100,99,2,1,4,-3,-75.0
100,99,3,5,8,-3,-37.5
100,99,4,8,16,-8,-50.0
100,99,5,10,32,-22,-68.75
100,99,6,75,64,11,17.1875
100,99,7,112,128,-16,-12.5
100,99,8,99,256,-157,-61.328125
100,99,9,271,512,-241,-47.0703125
100,99,10,259,1024,-765,-74.70703125
100,99,11,1966,2048,-82,-4.00390625
100,99,12,1083,4096,-3013,-73.5595703125
100,99,13,8038,8192,-154,-1.8798828125
100,99,14,35570,16384,19186,117.10205078125
100,99,15,800,32768,-31968,-97.55859375
100,100,1,0,2,-2,-100.0
100,100,2,1,4,-3,-75.0
100,100,3,9,8,1,12.5
100,100,4,8,16,-8,-50.0
100,100,5,34,32,2,6.25
100,100,6,86,64,22,34.375
100,100,7,38,128,-90,-70.3125
100,100,8,153,256,-103,-40.234375
100,100,9,12,512,-500,-97.65625
100,100,10,19,1024,-1005,-98.14453125
100,100,11,44,2048,-2004,-97.8515625
100,100,12,4084,4096,-12,-0.29296875
100,100,13,7198,8192,-994,-12.1337890625
100,100,14,33590,16384,17206,105.01708984375
100,100,15,2619,32768,-30149,-92.0074462890625
